"Locality","DailyAvgNewCasesPast7Days","TotalCases","State","Date","TotalCases7DaysAgo","NewCasesPast7Days","FIPS-Code","PercentIncreaseTotalCasesPast7Days"
"Autauga","0","1","Alabama","3/24/20","0","1","01001","1"
"Baldwin","0","4","Alabama","3/24/20","1","3","01003","300"
"Calhoun","0","2","Alabama","3/24/20","0","2","01015","1"
"Chambers","1","5","Alabama","3/24/20","0","5","01017","1"
"Cullman","0","3","Alabama","3/24/20","0","3","01043","1"
"Elmore","1","8","Alabama","3/24/20","2","6","01051","300"
"Franklin","0","1","Alabama","3/24/20","0","1","01059","1"
"Houston","0","1","Alabama","3/24/20","0","1","01069","1"
"Jackson","0","2","Alabama","3/24/20","0","2","01071","1"
"Jefferson","10","91","Alabama","3/24/20","21","70","01073","333.33"
"Lamar","0","1","Alabama","3/24/20","0","1","01075","1"
"Lauderdale","0","3","Alabama","3/24/20","0","3","01077","1"
"Lee","3","26","Alabama","3/24/20","3","23","01081","766.67"
"Limestone","0","4","Alabama","3/24/20","1","3","01083","300"
"Madison","3","21","Alabama","3/24/20","1","20","01089","2000"
"Marion","0","1","Alabama","3/24/20","0","1","01093","1"
"Mobile","1","6","Alabama","3/24/20","0","6","01097","1"
"Montgomery","1","9","Alabama","3/24/20","2","7","01101","350"
"Morgan","0","2","Alabama","3/24/20","0","2","01103","1"
"Shelby","3","27","Alabama","3/24/20","4","23","01117","575"
"St. Clair","0","4","Alabama","3/24/20","1","3","01115","300"
"Talladega","0","2","Alabama","3/24/20","0","2","01121","1"
"Tallapoosa","0","2","Alabama","3/24/20","0","2","01123","1"
"Tuscaloosa","1","10","Alabama","3/24/20","3","7","01125","233.33"
"Walker","1","5","Alabama","3/24/20","0","5","01127","1"
"Washington","0","1","Alabama","3/24/20","0","1","01129","1"
"Anchorage","2","17","Alaska","3/24/20","1","16","02020","1600"
"Fairbanks North Star","1","7","Alaska","3/24/20","2","5","02090","250"
"Juneau","0","1","Alaska","3/24/20","0","1","02110","1"
"Kenai Peninsula","0","3","Alaska","3/24/20","0","3","02122","1"
"Ketchikan Gateway","1","6","Alaska","3/24/20","0","6","02130","1"
"Apache","1","4","Arizona","3/24/20","0","4","04001","1"
"Cochise","0","1","Arizona","3/24/20","0","1","04003","1"
"Coconino","3","18","Arizona","3/24/20","0","18","04005","1"
"Graham","0","2","Arizona","3/24/20","1","1","04009","100"
"Maricopa","27","199","Arizona","3/24/20","9","190","04013","2111.11"
"Navajo","4","32","Arizona","3/24/20","1","31","04017","3100"
"Pima","5","42","Arizona","3/24/20","4","38","04019","950"
"Pinal","2","22","Arizona","3/24/20","5","17","04021","340"
"Santa Cruz","0","1","Arizona","3/24/20","0","1","04023","1"
"Yavapai","0","3","Arizona","3/24/20","0","3","04025","1"
"Yuma","0","2","Arizona","3/24/20","0","2","04027","1"
"Benton","0","1","Arkansas","3/24/20","0","1","05007","1"
"Boone","0","1","Arkansas","3/24/20","0","1","05009","1"
"Bradley","1","4","Arkansas","3/24/20","0","4","05011","1"
"Clark","1","6","Arkansas","3/24/20","0","6","05019","1"
"Cleburne","5","32","Arkansas","3/24/20","0","32","05023","1"
"Cleveland","0","3","Arkansas","3/24/20","0","3","05025","1"
"Columbia","0","1","Arkansas","3/24/20","0","1","05027","1"
"Conway","0","1","Arkansas","3/24/20","0","1","05029","1"
"Craighead","1","4","Arkansas","3/24/20","0","4","05031","1"
"Crawford","0","1","Arkansas","3/24/20","0","1","05033","1"
"Crittenden","0","1","Arkansas","3/24/20","0","1","05035","1"
"Cross","0","1","Arkansas","3/24/20","0","1","05037","1"
"Desha","0","2","Arkansas","3/24/20","0","2","05041","1"
"Faulkner","2","14","Arkansas","3/24/20","0","14","05045","1"
"Garland","1","10","Arkansas","3/24/20","0","10","05051","1"
"Grant","0","3","Arkansas","3/24/20","0","3","05053","1"
"Greene","0","1","Arkansas","3/24/20","0","1","05055","1"
"Hempstead","0","1","Arkansas","3/24/20","0","1","05057","1"
"Independence","0","3","Arkansas","3/24/20","0","3","05063","1"
"Jefferson","3","21","Arkansas","3/24/20","3","18","05069","600"
"Lawrence","0","1","Arkansas","3/24/20","0","1","05075","1"
"Lincoln","0","2","Arkansas","3/24/20","0","2","05079","1"
"Pike","0","1","Arkansas","3/24/20","0","1","05109","1"
"Poinsett","0","3","Arkansas","3/24/20","0","3","05111","1"
"Polk","0","1","Arkansas","3/24/20","0","1","05113","1"
"Pope","0","1","Arkansas","3/24/20","0","1","05115","1"
"Pulaski","9","64","Arkansas","3/24/20","0","64","05119","1"
"Saline","1","4","Arkansas","3/24/20","0","4","05125","1"
"Searcy","0","2","Arkansas","3/24/20","0","2","05129","1"
"Sebastian","0","1","Arkansas","3/24/20","0","1","05131","1"
"Sevier","0","1","Arkansas","3/24/20","0","1","05133","1"
"Stone","0","1","Arkansas","3/24/20","0","1","05137","1"
"Union","0","1","Arkansas","3/24/20","0","1","05139","1"
"Van Buren","1","5","Arkansas","3/24/20","0","5","05141","1"
"Washington","1","5","Arkansas","3/24/20","0","5","05143","1"
"White","0","1","Arkansas","3/24/20","0","1","05145","1"
"Woodruff","0","1","Arkansas","3/24/20","0","1","05147","1"
"Alameda","15","135","California","3/24/20","27","108","06001","400"
"Amador","0","2","California","3/24/20","0","2","06005","1"
"Butte","0","2","California","3/24/20","0","2","06007","1"
"Calaveras","0","2","California","3/24/20","2","0","06009","0"
"Contra Costa","7","86","California","3/24/20","39","47","06013","120.51"
"El Dorado","0","2","California","3/24/20","0","2","06017","1"
"Fresno","2","13","California","3/24/20","2","11","06019","550"
"Humboldt","0","4","California","3/24/20","1","3","06023","300"
"Imperial","1","6","California","3/24/20","2","4","06025","200"
"Kern","2","13","California","3/24/20","1","12","06029","1200"
"Los Angeles","74","662","California","3/24/20","144","518","06037","359.72"
"Madera","1","6","California","3/24/20","1","5","06039","500"
"Marin","5","47","California","3/24/20","11","36","06041","327.27"
"Mendocino","0","2","California","3/24/20","0","2","06045","1"
"Merced","0","1","California","3/24/20","0","1","06047","1"
"Mono","0","1","California","3/24/20","0","1","06051","1"
"Monterey","3","20","California","3/24/20","2","18","06053","900"
"Napa","0","2","California","3/24/20","0","2","06055","1"
"Nevada","0","3","California","3/24/20","1","2","06057","200"
"Orange","19","152","California","3/24/20","22","130","06059","590.91"
"Placer","2","20","California","3/24/20","5","15","06061","300"
"Riverside","6","57","California","3/24/20","15","42","06065","280"
"Sacramento","7","88","California","3/24/20","40","48","06067","120"
"San Benito","0","6","California","3/24/20","3","3","06069","100"
"San Bernardino","4","31","California","3/24/20","2","29","06071","1450"
"San Diego","24","226","California","3/24/20","55","171","06073","310.91"
"San Francisco","16","152","California","3/24/20","43","109","06075","253.49"
"San Joaquin","5","51","California","3/24/20","13","38","06077","292.31"
"San Luis Obispo","6","42","California","3/24/20","3","39","06079","1300"
"San Mateo","14","161","California","3/24/20","64","97","06081","151.56"
"Santa Barbara","2","18","California","3/24/20","2","16","06083","800"
"Santa Clara","31","375","California","3/24/20","155","220","06085","141.94"
"Santa Cruz","1","22","California","3/24/20","13","9","06087","69.23"
"Shasta","0","2","California","3/24/20","1","1","06089","100"
"Siskiyou","0","2","California","3/24/20","0","2","06093","1"
"Solano","2","21","California","3/24/20","7","14","06095","200"
"Sonoma","4","29","California","3/24/20","4","25","06097","625"
"Stanislaus","1","11","California","3/24/20","3","8","06099","266.67"
"Tulare","2","17","California","3/24/20","3","14","06107","466.67"
"Ventura","4","35","California","3/24/20","10","25","06111","250"
"Yolo","1","8","California","3/24/20","4","4","06113","100"
"Yuba","0","3","California","3/24/20","0","3","06115","1"
"Adams","2","27","Colorado","3/24/20","10","17","08001","170"
"Arapahoe","7","69","Colorado","3/24/20","18","51","08005","283.33"
"Boulder","6","49","Colorado","3/24/20","8","41","08013","512.5"
"Broomfield","1","5","Colorado","3/24/20","0","5","08014","1"
"Chaffee","0","3","Colorado","3/24/20","0","3","08015","1"
"Clear Creek","0","3","Colorado","3/24/20","2","1","08019","50"
"Crowley","0","1","Colorado","3/24/20","0","1","08025","1"
"Delta","0","1","Colorado","3/24/20","0","1","08029","1"
"Denver","19","176","Colorado","3/24/20","41","135","08031","329.27"
"Douglas","6","53","Colorado","3/24/20","9","44","08035","488.89"
"Eagle","9","96","Colorado","3/24/20","34","62","08037","182.35"
"El Paso","14","106","Colorado","3/24/20","6","100","08041","1666.67"
"Elbert","0","3","Colorado","3/24/20","0","3","08039","1"
"Fremont","0","1","Colorado","3/24/20","0","1","08043","1"
"Garfield","1","10","Colorado","3/24/20","2","8","08045","400"
"Grand","0","2","Colorado","3/24/20","0","2","08049","1"
"Gunnison","4","40","Colorado","3/24/20","11","29","08051","263.64"
"Hinsdale","0","1","Colorado","3/24/20","0","1","08053","1"
"Huerfano","0","1","Colorado","3/24/20","0","1","08055","1"
"Jefferson","8","73","Colorado","3/24/20","17","56","08059","329.41"
"La Plata","0","1","Colorado","3/24/20","0","1","08067","1"
"Larimer","6","43","Colorado","3/24/20","2","41","08069","2050"
"Logan","0","2","Colorado","3/24/20","0","2","08075","1"
"Mesa","1","5","Colorado","3/24/20","1","4","08077","400"
"Montrose","0","3","Colorado","3/24/20","0","3","08085","1"
"Morgan","0","3","Colorado","3/24/20","0","3","08087","1"
"Park","0","1","Colorado","3/24/20","0","1","08093","1"
"Pitkin","1","18","Colorado","3/24/20","11","7","08097","63.64"
"Pueblo","0","3","Colorado","3/24/20","1","2","08101","200"
"Routt","0","4","Colorado","3/24/20","2","2","08107","100"
"San Miguel","0","1","Colorado","3/24/20","0","1","08113","1"
"Summit","1","10","Colorado","3/24/20","3","7","08117","233.33"
"Teller","0","3","Colorado","3/24/20","0","3","08119","1"
"Weld","10","76","Colorado","3/24/20","5","71","08123","1420"
"Yuma","0","1","Colorado","3/24/20","0","1","08125","1"
"Fairfield","48","384","Connecticut","3/24/20","48","336","09001","700"
"Hartford","12","88","Connecticut","3/24/20","7","81","09003","1157.14"
"Litchfield","2","22","Connecticut","3/24/20","5","17","09005","340"
"Middlesex","1","8","Connecticut","3/24/20","0","8","09007","1"
"New Haven","12","89","Connecticut","3/24/20","8","81","09009","1012.5"
"New London","1","6","Connecticut","3/24/20","0","6","09011","1"
"Tolland","3","19","Connecticut","3/24/20","0","19","09013","1"
"Windham","0","2","Connecticut","3/24/20","0","2","09015","1"
"Kent","1","10","Delaware","3/24/20","0","10","10001","1"
"New Castle","8","71","Delaware","3/24/20","15","56","10003","373.33"
"Sussex","3","23","Delaware","3/24/20","1","22","10005","2200"
"","0","49","Diamond Princess","3/24/20","47","2",,"4.26"
"District of Columbia","17","141","District of Columbia","3/24/20","22","119","11001","540.91"
"Alachua","5","37","Florida","3/24/20","4","33","12001","825"
"Baker","1","4","Florida","3/24/20","0","4","12003","1"
"Bay","0","1","Florida","3/24/20","0","1","12005","1"
"Bradford","0","1","Florida","3/24/20","0","1","12007","1"
"Brevard","1","9","Florida","3/24/20","1","8","12009","800"
"Broward","38","311","Florida","3/24/20","48","263","12011","547.92"
"Charlotte","0","3","Florida","3/24/20","1","2","12015","200"
"Citrus","1","9","Florida","3/24/20","2","7","12017","350"
"Clay","1","10","Florida","3/24/20","4","6","12019","150"
"Collier","5","41","Florida","3/24/20","6","35","12021","583.33"
"Columbia","0","3","Florida","3/24/20","0","3","12023","1"
"DeSoto","0","1","Florida","3/24/20","0","1","12027","1"
"Duval","6","50","Florida","3/24/20","10","40","12031","400"
"Escambia","1","10","Florida","3/24/20","1","9","12033","900"
"Flagler","1","4","Florida","3/24/20","0","4","12035","1"
"Gadsden","0","1","Florida","3/24/20","0","1","12039","1"
"Hernando","1","5","Florida","3/24/20","0","5","12053","1"
"Highlands","1","4","Florida","3/24/20","0","4","12055","1"
"Hillsborough","12","91","Florida","3/24/20","7","84","12057","1200"
"Indian River","2","11","Florida","3/24/20","0","11","12061","1"
"Jackson","0","1","Florida","3/24/20","0","1","12063","1"
"Lake","2","14","Florida","3/24/20","1","13","12069","1300"
"Lee","4","32","Florida","3/24/20","5","27","12071","540"
"Leon","1","8","Florida","3/24/20","0","8","12073","1"
"Manatee","1","16","Florida","3/24/20","7","9","12081","128.57"
"Marion","1","4","Florida","3/24/20","0","4","12083","1"
"Martin","1","4","Florida","3/24/20","0","4","12085","1"
"Miami-Dade","43","338","Florida","3/24/20","40","298","12086","745"
"Monroe","0","3","Florida","3/24/20","0","3","12087","1"
"Nassau","0","1","Florida","3/24/20","1","0","12089","0"
"Okaloosa","2","14","Florida","3/24/20","2","12","12091","600"
"Orange","6","50","Florida","3/24/20","6","44","12095","733.33"
"Osceola","3","26","Florida","3/24/20","6","20","12097","333.33"
"Palm Beach","13","101","Florida","3/24/20","13","88","12099","676.92"
"Pasco","2","15","Florida","3/24/20","2","13","12101","650"
"Pinellas","6","45","Florida","3/24/20","4","41","12103","1025"
"Polk","2","13","Florida","3/24/20","1","12","12105","1200"
"Putnam","0","2","Florida","3/24/20","0","2","12107","1"
"Santa Rosa","0","4","Florida","3/24/20","1","3","12113","300"
"Sarasota","3","26","Florida","3/24/20","2","24","12115","1200"
"Seminole","3","23","Florida","3/24/20","4","19","12117","475"
"St. Johns","3","22","Florida","3/24/20","2","20","12109","1000"
"St. Lucie","1","6","Florida","3/24/20","0","6","12111","1"
"Sumter","1","10","Florida","3/24/20","0","10","12119","1"
"Volusia","1","18","Florida","3/24/20","9","9","12127","100"
"Walton","1","10","Florida","3/24/20","0","10","12131","1"
"Baker","0","2","Georgia","3/24/20","0","2","13007","1"
"Baldwin","0","2","Georgia","3/24/20","0","2","13009","1"
"Barrow","0","1","Georgia","3/24/20","0","1","13013","1"
"Bartow","9","74","Georgia","3/24/20","10","64","13015","640"
"Ben Hill","0","1","Georgia","3/24/20","0","1","13017","1"
"Bibb","1","4","Georgia","3/24/20","0","4","13021","1"
"Bryan","0","2","Georgia","3/24/20","0","2","13029","1"
"Burke","0","1","Georgia","3/24/20","0","1","13033","1"
"Butts","0","2","Georgia","3/24/20","0","2","13035","1"
"Camden","0","1","Georgia","3/24/20","0","1","13039","1"
"Carroll","4","26","Georgia","3/24/20","0","26","13045","1"
"Catoosa","0","1","Georgia","3/24/20","0","1","13047","1"
"Charlton","0","1","Georgia","3/24/20","1","0","13049","0"
"Chatham","1","7","Georgia","3/24/20","0","7","13051","1"
"Chattooga","0","1","Georgia","3/24/20","0","1","13055","1"
"Cherokee","3","28","Georgia","3/24/20","7","21","13057","300"
"Clarke","2","16","Georgia","3/24/20","3","13","13059","433.33"
"Clayton","2","21","Georgia","3/24/20","5","16","13063","320"
"Clinch","0","1","Georgia","3/24/20","0","1","13065","1"
"Cobb","9","86","Georgia","3/24/20","25","61","13067","244"
"Coffee","0","2","Georgia","3/24/20","0","2","13069","1"
"Colquitt","0","2","Georgia","3/24/20","0","2","13071","1"
"Columbia","1","4","Georgia","3/24/20","0","4","13073","1"
"Coweta","1","10","Georgia","3/24/20","3","7","13077","233.33"
"Crisp","0","3","Georgia","3/24/20","0","3","13081","1"
"Dawson","0","1","Georgia","3/24/20","0","1","13085","1"
"DeKalb","11","94","Georgia","3/24/20","15","79","13089","526.67"
"Dougherty","12","90","Georgia","3/24/20","6","84","13095","1400"
"Douglas","2","11","Georgia","3/24/20","0","11","13097","1"
"Early","0","2","Georgia","3/24/20","0","2","13099","1"
"Effingham","0","2","Georgia","3/24/20","0","2","13103","1"
"Fayette","1","12","Georgia","3/24/20","5","7","13113","140"
"Floyd","1","11","Georgia","3/24/20","6","5","13115","83.33"
"Forsyth","1","8","Georgia","3/24/20","1","7","13117","700"
"Fulton","22","184","Georgia","3/24/20","33","151","13121","457.58"
"Glynn","1","5","Georgia","3/24/20","0","5","13127","1"
"Gordon","1","7","Georgia","3/24/20","2","5","13129","250"
"Greene","0","1","Georgia","3/24/20","0","1","13133","1"
"Gwinnett","5","45","Georgia","3/24/20","7","38","13135","542.86"
"Hall","2","14","Georgia","3/24/20","1","13","13139","1300"
"Harris","0","1","Georgia","3/24/20","0","1","13145","1"
"Heard","0","1","Georgia","3/24/20","0","1","13149","1"
"Henry","2","13","Georgia","3/24/20","2","11","13151","550"
"Houston","0","3","Georgia","3/24/20","0","3","13153","1"
"Irwin","0","1","Georgia","3/24/20","0","1","13155","1"
"Jasper","0","1","Georgia","3/24/20","0","1","13159","1"
"Lamar","0","3","Georgia","3/24/20","0","3","13171","1"
"Laurens","1","5","Georgia","3/24/20","0","5","13175","1"
"Lee","3","20","Georgia","3/24/20","2","18","13177","900"
"Liberty","0","1","Georgia","3/24/20","0","1","13179","1"
"Lincoln","0","1","Georgia","3/24/20","0","1","13181","1"
"Lowndes","1","10","Georgia","3/24/20","4","6","13185","150"
"Lumpkin","0","3","Georgia","3/24/20","0","3","13187","1"
"Macon","0","1","Georgia","3/24/20","0","1","13193","1"
"Madison","0","1","Georgia","3/24/20","0","1","13195","1"
"Meriwether","0","1","Georgia","3/24/20","0","1","13199","1"
"Miller","0","1","Georgia","3/24/20","0","1","13201","1"
"Mitchell","0","3","Georgia","3/24/20","0","3","13205","1"
"Monroe","0","3","Georgia","3/24/20","0","3","13207","1"
"Morgan","0","1","Georgia","3/24/20","0","1","13211","1"
"Muscogee","0","3","Georgia","3/24/20","0","3","13215","1"
"Newton","1","5","Georgia","3/24/20","1","4","13217","400"
"Oconee","1","5","Georgia","3/24/20","0","5","13219","1"
"Paulding","1","6","Georgia","3/24/20","1","5","13223","500"
"Peach","0","3","Georgia","3/24/20","0","3","13225","1"
"Pickens","1","4","Georgia","3/24/20","0","4","13227","1"
"Pierce","0","1","Georgia","3/24/20","0","1","13229","1"
"Polk","1","8","Georgia","3/24/20","1","7","13233","700"
"Pulaski","0","1","Georgia","3/24/20","0","1","13235","1"
"Randolph","0","1","Georgia","3/24/20","0","1","13243","1"
"Richmond","1","11","Georgia","3/24/20","3","8","13245","266.67"
"Rockdale","1","7","Georgia","3/24/20","0","7","13247","1"
"Spalding","1","5","Georgia","3/24/20","1","4","13255","400"
"Stephens","0","1","Georgia","3/24/20","0","1","13257","1"
"Sumter","0","2","Georgia","3/24/20","0","2","13261","1"
"Tattnall","0","1","Georgia","3/24/20","0","1","13267","1"
"Terrell","0","3","Georgia","3/24/20","0","3","13273","1"
"Tift","0","2","Georgia","3/24/20","0","2","13277","1"
"Troup","1","6","Georgia","3/24/20","1","5","13285","500"
"Turner","0","1","Georgia","3/24/20","0","1","13287","1"
"Twiggs","0","1","Georgia","3/24/20","0","1","13289","1"
"Walton","0","1","Georgia","3/24/20","0","1","13297","1"
"Washington","0","1","Georgia","3/24/20","0","1","13303","1"
"Whitfield","0","2","Georgia","3/24/20","0","2","13313","1"
"Worth","1","4","Georgia","3/24/20","0","4","13321","1"
"","1","28","Grand Princess","3/24/20","21","7",,"33.33"
"","4","32","Guam","3/24/20","3","29",,"966.67"
"Hawaii","0","2","Hawaii","3/24/20","0","2","15001","1"
"Honolulu","7","58","Hawaii","3/24/20","6","52","15003","866.67"
"Kauai","0","1","Hawaii","3/24/20","2","-1","15007","-50"
"Maui","1","9","Hawaii","3/24/20","2","7","15009","350"
"Ada","2","19","Idaho","3/24/20","3","16","16001","533.33"
"Bannock","0","2","Idaho","3/24/20","0","2","16005","1"
"Bingham","0","2","Idaho","3/24/20","0","2","16011","1"
"Blaine","5","36","Idaho","3/24/20","3","33","16013","1100"
"Canyon","1","5","Idaho","3/24/20","0","5","16027","1"
"Cassia","0","1","Idaho","3/24/20","0","1","16031","1"
"Jefferson","0","2","Idaho","3/24/20","0","2","16051","1"
"Kootenai","1","8","Idaho","3/24/20","0","8","16055","1"
"Madison","0","2","Idaho","3/24/20","1","1","16065","100"
"Teton","0","2","Idaho","3/24/20","1","1","16081","100"
"Twin Falls","0","1","Idaho","3/24/20","0","1","16083","1"
"Valley","0","1","Idaho","3/24/20","0","1","16085","1"
"Adams","0","1","Illinois","3/24/20","0","1","17001","1"
"Champaign","0","4","Illinois","3/24/20","1","3","17019","300"
"Christian","0","1","Illinois","3/24/20","0","1","17021","1"
"Clinton","0","3","Illinois","3/24/20","2","1","17027","50"
"Cook","155","1194","Illinois","3/24/20","107","1087","17031","1015.89"
"Cumberland","0","1","Illinois","3/24/20","1","0","17035","0"
"DeKalb","0","1","Illinois","3/24/20","0","1","17037","1"
"DuPage","11","103","Illinois","3/24/20","26","77","17043","296.15"
"Grundy","0","1","Illinois","3/24/20","0","1","17063","1"
"Jackson","0","1","Illinois","3/24/20","0","1","17077","1"
"Jo Daviess","0","1","Illinois","3/24/20","0","1","17085","1"
"Kane","3","24","Illinois","3/24/20","3","21","17089","700"
"Kankakee","1","4","Illinois","3/24/20","0","4","17091","1"
"Kendall","1","4","Illinois","3/24/20","0","4","17093","1"
"Lake","15","111","Illinois","3/24/20","7","104","17097","1485.71"
"LaSalle","0","3","Illinois","3/24/20","0","3","17099","1"
"Livingston","0","1","Illinois","3/24/20","0","1","17105","1"
"Madison","0","2","Illinois","3/24/20","0","2","17119","1"
"McHenry","2","14","Illinois","3/24/20","2","12","17111","600"
"McLean","1","7","Illinois","3/24/20","0","7","17113","1"
"Monroe","0","1","Illinois","3/24/20","0","1","17133","1"
"Peoria","0","3","Illinois","3/24/20","1","2","17143","200"
"Rock Island","0","1","Illinois","3/24/20","0","1","17161","1"
"Sangamon","0","5","Illinois","3/24/20","4","1","17167","25"
"St. Clair","1","7","Illinois","3/24/20","2","5","17163","250"
"Stephenson","0","1","Illinois","3/24/20","0","1","17177","1"
"Washington","0","1","Illinois","3/24/20","0","1","17189","1"
"Whiteside","0","1","Illinois","3/24/20","1","0","17195","0"
"Will","4","28","Illinois","3/24/20","2","26","17197","1300"
"Winnebago","1","5","Illinois","3/24/20","1","4","17201","400"
"Woodford","0","3","Illinois","3/24/20","1","2","17203","200"
"Adams","0","1","Indiana","3/24/20","1","0","18001","0"
"Allen","1","7","Indiana","3/24/20","0","7","18003","1"
"Bartholomew","1","5","Indiana","3/24/20","1","4","18005","400"
"Boone","0","3","Indiana","3/24/20","1","2","18011","200"
"Brown","0","1","Indiana","3/24/20","0","1","18013","1"
"Clark","1","5","Indiana","3/24/20","0","5","18019","1"
"Dearborn","0","2","Indiana","3/24/20","0","2","18029","1"
"Decatur","1","6","Indiana","3/24/20","0","6","18031","1"
"Delaware","1","4","Indiana","3/24/20","0","4","18035","1"
"Dubois","0","1","Indiana","3/24/20","0","1","18037","1"
"Elkhart","1","4","Indiana","3/24/20","0","4","18039","1"
"Fayette","0","2","Indiana","3/24/20","0","2","18041","1"
"Floyd","1","6","Indiana","3/24/20","1","5","18043","500"
"Franklin","1","7","Indiana","3/24/20","2","5","18047","250"
"Gibson","0","2","Indiana","3/24/20","0","2","18051","1"
"Grant","0","3","Indiana","3/24/20","0","3","18053","1"
"Greene","0","1","Indiana","3/24/20","0","1","18055","1"
"Hamilton","3","25","Indiana","3/24/20","1","24","18057","2400"
"Hancock","1","4","Indiana","3/24/20","0","4","18059","1"
"Hendricks","1","13","Indiana","3/24/20","3","10","18063","333.33"
"Howard","1","6","Indiana","3/24/20","2","4","18067","200"
"Jackson","0","1","Indiana","3/24/20","0","1","18071","1"
"Jennings","0","2","Indiana","3/24/20","0","2","18079","1"
"Johnson","2","18","Indiana","3/24/20","3","15","18081","500"
"Lake","2","17","Indiana","3/24/20","2","15","18089","750"
"LaPorte","0","2","Indiana","3/24/20","1","1","18091","100"
"Lawrence","0","1","Indiana","3/24/20","0","1","18093","1"
"Madison","0","3","Indiana","3/24/20","0","3","18095","1"
"Marion","22","161","Indiana","3/24/20","9","152","18097","1688.89"
"Miami","0","1","Indiana","3/24/20","0","1","18103","1"
"Monroe","0","3","Indiana","3/24/20","0","3","18105","1"
"Montgomery","0","1","Indiana","3/24/20","0","1","18107","1"
"Morgan","0","3","Indiana","3/24/20","0","3","18109","1"
"Noble","0","1","Indiana","3/24/20","1","0","18113","0"
"Ohio","0","1","Indiana","3/24/20","0","1","18115","1"
"Owen","0","2","Indiana","3/24/20","0","2","18119","1"
"Porter","0","1","Indiana","3/24/20","0","1","18127","1"
"Putnam","0","1","Indiana","3/24/20","0","1","18133","1"
"Ripley","1","6","Indiana","3/24/20","0","6","18137","1"
"Scott","0","1","Indiana","3/24/20","0","1","18143","1"
"Shelby","0","1","Indiana","3/24/20","0","1","18145","1"
"St. Joseph","2","18","Indiana","3/24/20","1","17","18141","1700"
"Starke","0","2","Indiana","3/24/20","0","2","18149","1"
"Tippecanoe","0","3","Indiana","3/24/20","0","3","18157","1"
"Tipton","0","2","Indiana","3/24/20","0","2","18159","1"
"Vanderburgh","0","1","Indiana","3/24/20","0","1","18163","1"
"Vigo","0","3","Indiana","3/24/20","0","3","18167","1"
"Warrick","0","1","Indiana","3/24/20","0","1","18173","1"
"Washington","0","2","Indiana","3/24/20","0","2","18175","1"
"Wells","0","1","Indiana","3/24/20","1","0","18179","0"
"Adair","0","1","Iowa","3/24/20","0","1","19001","1"
"Allamakee","1","6","Iowa","3/24/20","2","4","19005","200"
"Black Hawk","1","4","Iowa","3/24/20","0","4","19013","1"
"Buchanan","0","1","Iowa","3/24/20","0","1","19019","1"
"Carroll","0","1","Iowa","3/24/20","1","0","19027","0"
"Cedar","0","1","Iowa","3/24/20","0","1","19031","1"
"Cerro Gordo","0","2","Iowa","3/24/20","0","2","19033","1"
"Dallas","1","7","Iowa","3/24/20","2","5","19049","250"
"Dubuque","1","6","Iowa","3/24/20","0","6","19061","1"
"Fayette","0","1","Iowa","3/24/20","0","1","19065","1"
"Hancock","0","2","Iowa","3/24/20","0","2","19081","1"
"Harrison","0","3","Iowa","3/24/20","1","2","19085","200"
"Henry","0","1","Iowa","3/24/20","0","1","19087","1"
"Jasper","0","1","Iowa","3/24/20","0","1","19099","1"
"Johnson","3","37","Iowa","3/24/20","15","22","19103","146.67"
"Kossuth","0","1","Iowa","3/24/20","0","1","19109","1"
"Linn","1","6","Iowa","3/24/20","0","6","19113","1"
"Muscatine","1","5","Iowa","3/24/20","0","5","19139","1"
"Polk","2","15","Iowa","3/24/20","1","14","19153","1400"
"Pottawattamie","0","2","Iowa","3/24/20","1","1","19155","100"
"Poweshiek","0","2","Iowa","3/24/20","0","2","19157","1"
"Scott","0","1","Iowa","3/24/20","0","1","19163","1"
"Sioux","0","1","Iowa","3/24/20","0","1","19167","1"
"Story","0","2","Iowa","3/24/20","0","2","19169","1"
"Tama","1","4","Iowa","3/24/20","0","4","19171","1"
"Wapello","0","1","Iowa","3/24/20","0","1","19179","1"
"Warren","0","1","Iowa","3/24/20","0","1","19181","1"
"Washington","1","4","Iowa","3/24/20","0","4","19183","1"
"Winneshiek","0","1","Iowa","3/24/20","0","1","19191","1"
"Woodbury","0","2","Iowa","3/24/20","0","2","19193","1"
"Bourbon","0","1","Kansas","3/24/20","0","1","20011","1"
"Butler","0","3","Kansas","3/24/20","1","2","20015","200"
"Cherokee","0","2","Kansas","3/24/20","0","2","20021","1"
"Crawford","0","2","Kansas","3/24/20","0","2","20037","1"
"Doniphan","0","1","Kansas","3/24/20","0","1","20043","1"
"Douglas","1","6","Kansas","3/24/20","1","5","20045","500"
"Ford","0","0","Kansas","3/24/20","1","-1","20057","-100"
"Franklin","0","1","Kansas","3/24/20","1","0","20059","0"
"Jackson","0","1","Kansas","3/24/20","0","1","20085","1"
"Johnson","4","36","Kansas","3/24/20","10","26","20091","260"
"Leavenworth","1","7","Kansas","3/24/20","0","7","20103","1"
"Linn","0","2","Kansas","3/24/20","0","2","20107","1"
"Lyon","0","2","Kansas","3/24/20","0","2","20111","1"
"Mitchell","0","1","Kansas","3/24/20","0","1","20123","1"
"Morris","0","2","Kansas","3/24/20","0","2","20127","1"
"Pottawatomie","0","1","Kansas","3/24/20","0","1","20149","1"
"Reno","0","2","Kansas","3/24/20","0","2","20155","1"
"Sedgwick","1","7","Kansas","3/24/20","0","7","20173","1"
"Woodson","0","1","Kansas","3/24/20","0","1","20207","1"
"Wyandotte","3","22","Kansas","3/24/20","4","18","20209","450"
"Anderson","0","2","Kentucky","3/24/20","0","2","21005","1"
"Boone","0","1","Kentucky","3/24/20","0","1","21015","1"
"Bourbon","0","2","Kentucky","3/24/20","1","1","21017","100"
"Breathitt","0","1","Kentucky","3/24/20","0","1","21025","1"
"Calloway","0","1","Kentucky","3/24/20","0","1","21035","1"
"Campbell","0","1","Kentucky","3/24/20","0","1","21037","1"
"Christian","0","2","Kentucky","3/24/20","0","2","21047","1"
"Clark","0","2","Kentucky","3/24/20","1","1","21049","100"
"Daviess","2","11","Kentucky","3/24/20","0","11","21059","1"
"Fayette","1","15","Kentucky","3/24/20","7","8","21067","114.29"
"Franklin","0","2","Kentucky","3/24/20","0","2","21073","1"
"Hardin","0","2","Kentucky","3/24/20","0","2","21093","1"
"Harrison","0","8","Kentucky","3/24/20","6","2","21097","33.33"
"Henderson","0","2","Kentucky","3/24/20","0","2","21101","1"
"Jefferson","4","33","Kentucky","3/24/20","7","26","21111","371.43"
"Jessamine","0","1","Kentucky","3/24/20","0","1","21113","1"
"Kenton","1","5","Kentucky","3/24/20","0","5","21117","1"
"Laurel","0","1","Kentucky","3/24/20","0","1","21125","1"
"Logan","0","1","Kentucky","3/24/20","0","1","21141","1"
"Lyon","0","1","Kentucky","3/24/20","1","0","21143","0"
"Madison","0","2","Kentucky","3/24/20","0","2","21151","1"
"Martin","0","1","Kentucky","3/24/20","0","1","21159","1"
"McCracken","0","1","Kentucky","3/24/20","0","1","21145","1"
"Menifee","0","1","Kentucky","3/24/20","0","1","21165","1"
"Montgomery","0","2","Kentucky","3/24/20","2","0","21173","0"
"Muhlenberg","0","2","Kentucky","3/24/20","0","2","21177","1"
"Nelson","0","1","Kentucky","3/24/20","1","0","21179","0"
"Oldham","0","1","Kentucky","3/24/20","0","1","21185","1"
"Pulaski","0","3","Kentucky","3/24/20","0","3","21199","1"
"Scott","0","1","Kentucky","3/24/20","0","1","21209","1"
"Simpson","0","1","Kentucky","3/24/20","0","1","21213","1"
"Spencer","0","1","Kentucky","3/24/20","0","1","21215","1"
"Warren","1","4","Kentucky","3/24/20","0","4","21227","1"
"Webster","0","1","Kentucky","3/24/20","0","1","21233","1"
"Acadia","0","2","Louisiana","3/24/20","0","2","22001","1"
"Allen","0","2","Louisiana","3/24/20","0","2","22003","1"
"Ascension","5","36","Louisiana","3/24/20","1","35","22005","3500"
"Assumption","0","2","Louisiana","3/24/20","0","2","22007","1"
"Avoyelles","0","3","Louisiana","3/24/20","0","3","22009","1"
"Beauregard","0","2","Louisiana","3/24/20","0","2","22011","1"
"Bienville","0","1","Louisiana","3/24/20","0","1","22013","1"
"Bossier","2","12","Louisiana","3/24/20","1","11","22015","1100"
"Caddo","5","40","Louisiana","3/24/20","4","36","22017","900"
"Calcasieu","1","5","Louisiana","3/24/20","0","5","22019","1"
"Catahoula","0","1","Louisiana","3/24/20","0","1","22025","1"
"Claiborne","0","2","Louisiana","3/24/20","0","2","22027","1"
"De Soto","1","6","Louisiana","3/24/20","0","6","22031","1"
"East Baton Rouge","8","58","Louisiana","3/24/20","1","57","22033","5700"
"Evangeline","0","2","Louisiana","3/24/20","0","2","22039","1"
"Grant","0","1","Louisiana","3/24/20","0","1","22043","1"
"Iberia","0","2","Louisiana","3/24/20","0","2","22045","1"
"Iberville","2","14","Louisiana","3/24/20","0","14","22047","1"
"Jefferson","37","293","Louisiana","3/24/20","35","258","22051","737.14"
"Lafayette","2","12","Louisiana","3/24/20","0","12","22055","1"
"Lafourche","2","16","Louisiana","3/24/20","2","14","22057","700"
"Lincoln","0","2","Louisiana","3/24/20","0","2","22061","1"
"Livingston","1","6","Louisiana","3/24/20","0","6","22063","1"
"Natchitoches","0","2","Louisiana","3/24/20","0","2","22069","1"
"Orleans","77","675","Louisiana","3/24/20","136","539","22071","396.32"
"Ouachita","1","7","Louisiana","3/24/20","0","7","22073","1"
"Plaquemines","1","8","Louisiana","3/24/20","0","8","22075","1"
"Rapides","1","10","Louisiana","3/24/20","0","10","22079","1"
"Richland","0","1","Louisiana","3/24/20","0","1","22083","1"
"St. Bernard","2","19","Louisiana","3/24/20","2","17","22087","850"
"St. Charles","2","15","Louisiana","3/24/20","3","12","22089","400"
"St. James","1","9","Louisiana","3/24/20","0","9","22093","1"
"St. John the Baptist","3","21","Louisiana","3/24/20","1","20","22095","2000"
"St. Landry","0","3","Louisiana","3/24/20","0","3","22097","1"
"St. Martin","0","1","Louisiana","3/24/20","0","1","22099","1"
"St. Mary","0","2","Louisiana","3/24/20","0","2","22101","1"
"St. Tammany","7","52","Louisiana","3/24/20","6","46","22103","766.67"
"Tangipahoa","1","4","Louisiana","3/24/20","0","4","22105","1"
"Terrebonne","2","14","Louisiana","3/24/20","3","11","22109","366.67"
"Vernon","0","2","Louisiana","3/24/20","0","2","22115","1"
"Washington","0","3","Louisiana","3/24/20","1","2","22117","200"
"Webster","0","3","Louisiana","3/24/20","0","3","22119","1"
"West Baton Rouge","1","5","Louisiana","3/24/20","0","5","22121","1"
"Androscoggin","0","3","Maine","3/24/20","2","1","23001","50"
"Cumberland","8","74","Maine","3/24/20","18","56","23005","311.11"
"Kennebec","1","5","Maine","3/24/20","1","4","23011","400"
"Knox","0","1","Maine","3/24/20","1","0","23013","0"
"Lincoln","0","5","Maine","3/24/20","2","3","23015","150"
"Oxford","1","6","Maine","3/24/20","1","5","23017","500"
"Penobscot","1","4","Maine","3/24/20","0","4","23019","1"
"Sagadahoc","0","3","Maine","3/24/20","0","3","23023","1"
"Waldo","0","1","Maine","3/24/20","0","1","23027","1"
"York","2","16","Maine","3/24/20","1","15","23031","1500"
"Anne Arundel","3","24","Maryland","3/24/20","3","21","24003","700"
"Baltimore","5","42","Maryland","3/24/20","6","36","24005","600"
"Baltimore City","6","41","Maryland","3/24/20","2","39","24510","1950"
"Calvert","0","3","Maryland","3/24/20","0","3","24009","1"
"Caroline","0","1","Maryland","3/24/20","0","1","24011","1"
"Carroll","0","5","Maryland","3/24/20","2","3","24013","150"
"Cecil","0","3","Maryland","3/24/20","0","3","24015","1"
"Charles","1","5","Maryland","3/24/20","1","4","24017","400"
"Frederick","0","4","Maryland","3/24/20","1","3","24021","300"
"Garrett","0","3","Maryland","3/24/20","0","3","24023","1"
"Harford","0","5","Maryland","3/24/20","2","3","24025","150"
"Howard","4","30","Maryland","3/24/20","4","26","24027","650"
"Montgomery","12","107","Maryland","3/24/20","24","83","24031","345.83"
"Prince George's","7","63","Maryland","3/24/20","14","49","24033","350"
"Queen Anne's","0","1","Maryland","3/24/20","0","1","24035","1"
"Somerset","0","1","Maryland","3/24/20","0","1","24039","1"
"St. Mary's","0","2","Maryland","3/24/20","0","2","24037","1"
"Talbot","0","1","Maryland","3/24/20","1","0","24041","0"
"Washington","0","2","Maryland","3/24/20","0","2","24043","1"
"Wicomico","1","4","Maryland","3/24/20","0","4","24045","1"
"Worcester","0","2","Maryland","3/24/20","0","2","24047","1"
"Barnstable","5","40","Massachusetts","3/24/20","2","38","25001","1900"
"Berkshire","3","37","Massachusetts","3/24/20","14","23","25003","164.29"
"Bristol","4","31","Massachusetts","3/24/20","5","26","25005","520"
"Dukes and Nantucket","0","2","Massachusetts","3/24/20","0","2","00000","1"
"Essex","16","118","Massachusetts","3/24/20","8","110","25009","1375"
"Franklin","1","10","Massachusetts","3/24/20","0","10","25011","1"
"Hampden","3","24","Massachusetts","3/24/20","1","23","25013","2300"
"Hampshire","1","8","Massachusetts","3/24/20","0","8","25015","1"
"Middlesex","31","304","Massachusetts","3/24/20","89","215","25017","241.57"
"Norfolk","12","129","Massachusetts","3/24/20","43","86","25021","200"
"Plymouth","8","64","Massachusetts","3/24/20","5","59","25023","1180"
"Suffolk","27","234","Massachusetts","3/24/20","42","192","25025","457.14"
"Worcester","9","73","Massachusetts","3/24/20","8","65","25027","812.5"
"Allegan","0","1","Michigan","3/24/20","0","1","26005","1"
"Antrim","0","1","Michigan","3/24/20","0","1","26009","1"
"Barry","0","1","Michigan","3/24/20","0","1","26015","1"
"Bay","0","4","Michigan","3/24/20","1","3","26017","300"
"Berrien","4","33","Michigan","3/24/20","3","30","26021","1000"
"Calhoun","1","4","Michigan","3/24/20","0","4","26025","1"
"Cass","0","2","Michigan","3/24/20","0","2","26027","1"
"Charlevoix","0","3","Michigan","3/24/20","1","2","26029","200"
"Chippewa","0","1","Michigan","3/24/20","0","1","26033","1"
"Clare","0","1","Michigan","3/24/20","0","1","26035","1"
"Clinton","1","5","Michigan","3/24/20","0","5","26037","1"
"Eaton","0","3","Michigan","3/24/20","0","3","26045","1"
"Emmet","0","2","Michigan","3/24/20","0","2","26047","1"
"Genesee","5","36","Michigan","3/24/20","0","36","26049","1"
"Gladwin","0","2","Michigan","3/24/20","0","2","26051","1"
"Grand Traverse","0","3","Michigan","3/24/20","0","3","26055","1"
"Hillsdale","0","1","Michigan","3/24/20","0","1","26059","1"
"Ingham","2","18","Michigan","3/24/20","6","12","26065","200"
"Isabella","0","2","Michigan","3/24/20","0","2","26073","1"
"Jackson","1","9","Michigan","3/24/20","2","7","26075","350"
"Kalamazoo","1","4","Michigan","3/24/20","0","4","26077","1"
"Kalkaska","0","1","Michigan","3/24/20","0","1","26079","1"
"Kent","4","31","Michigan","3/24/20","5","26","26081","520"
"Lapeer","0","1","Michigan","3/24/20","0","1","26087","1"
"Leelanau","0","1","Michigan","3/24/20","1","0","26089","0"
"Livingston","2","17","Michigan","3/24/20","0","17","26093","1"
"Macomb","31","226","Michigan","3/24/20","8","218","26099","2725"
"Manistee","0","1","Michigan","3/24/20","0","1","26101","1"
"Marquette","0","1","Michigan","3/24/20","0","1","26103","1"
"Midland","1","9","Michigan","3/24/20","2","7","26111","350"
"Monroe","2","12","Michigan","3/24/20","1","11","26115","1100"
"Montcalm","0","1","Michigan","3/24/20","1","0","26117","0"
"Muskegon","0","3","Michigan","3/24/20","0","3","26121","1"
"Newaygo","0","2","Michigan","3/24/20","0","2","26123","1"
"Oakland","69","514","Michigan","3/24/20","31","483","26125","1558.06"
"Ogemaw","0","1","Michigan","3/24/20","0","1","26129","1"
"Otsego","1","5","Michigan","3/24/20","1","4","26137","400"
"Ottawa","2","17","Michigan","3/24/20","2","15","26139","750"
"Out of MI","1","6","Michigan","3/24/20","0","6","80026","1"
"Roscommon","0","1","Michigan","3/24/20","0","1","26143","1"
"Saginaw","1","8","Michigan","3/24/20","0","8","26145","1"
"St. Clair","1","10","Michigan","3/24/20","2","8","26147","400"
"Tuscola","0","1","Michigan","3/24/20","0","1","26157","1"
"Washtenaw","7","58","Michigan","3/24/20","9","49","26161","544.44"
"Wayne","123","878","Michigan","3/24/20","14","864","26163","6171.43"
"Wexford","0","1","Michigan","3/24/20","0","1","26165","1"
"Anoka","1","7","Minnesota","3/24/20","3","4","27003","133.33"
"Benton","0","1","Minnesota","3/24/20","1","0","27009","0"
"Big Stone","0","1","Minnesota","3/24/20","0","1","27011","1"
"Blue Earth","1","5","Minnesota","3/24/20","0","5","27013","1"
"Carver","1","8","Minnesota","3/24/20","1","7","27019","700"
"Cass","0","1","Minnesota","3/24/20","0","1","27021","1"
"Chisago","0","2","Minnesota","3/24/20","0","2","27025","1"
"Clay","0","3","Minnesota","3/24/20","0","3","27027","1"
"Dakota","2","21","Minnesota","3/24/20","6","15","27037","250"
"Dodge","0","3","Minnesota","3/24/20","0","3","27039","1"
"Fillmore","0","3","Minnesota","3/24/20","0","3","27045","1"
"Hennepin","11","103","Minnesota","3/24/20","24","79","27053","329.17"
"Jackson","0","1","Minnesota","3/24/20","0","1","27063","1"
"Le Sueur","1","5","Minnesota","3/24/20","0","5","27079","1"
"Martin","1","8","Minnesota","3/24/20","0","8","27091","1"
"Mower","1","6","Minnesota","3/24/20","0","6","27099","1"
"Nicollet","0","3","Minnesota","3/24/20","0","3","27103","1"
"Olmsted","2","18","Minnesota","3/24/20","5","13","27109","260"
"Ramsey","2","26","Minnesota","3/24/20","11","15","27123","136.36"
"Renville","0","1","Minnesota","3/24/20","1","0","27129","0"
"Rice","0","2","Minnesota","3/24/20","0","2","27131","1"
"Scott","1","5","Minnesota","3/24/20","0","5","27139","1"
"Sherburne","0","1","Minnesota","3/24/20","0","1","27141","1"
"St. Louis","0","2","Minnesota","3/24/20","0","2","27137","1"
"Stearns","0","5","Minnesota","3/24/20","3","2","27145","66.67"
"Steele","1","5","Minnesota","3/24/20","0","5","27147","1"
"Wabasha","0","1","Minnesota","3/24/20","0","1","27157","1"
"Waseca","0","1","Minnesota","3/24/20","1","0","27161","0"
"Washington","1","10","Minnesota","3/24/20","2","8","27163","400"
"Wright","0","3","Minnesota","3/24/20","1","2","27171","200"
"Adams","0","2","Mississippi","3/24/20","0","2","28001","1"
"Attala","0","3","Mississippi","3/24/20","0","3","28007","1"
"Bolivar","1","4","Mississippi","3/24/20","0","4","28011","1"
"Chickasaw","1","6","Mississippi","3/24/20","0","6","28017","1"
"Choctaw","0","1","Mississippi","3/24/20","0","1","28019","1"
"Clay","0","1","Mississippi","3/24/20","0","1","28025","1"
"Coahoma","2","11","Mississippi","3/24/20","0","11","28027","1"
"Copiah","0","5","Mississippi","3/24/20","2","3","28029","150"
"DeSoto","4","29","Mississippi","3/24/20","0","29","28033","1"
"Forrest","2","14","Mississippi","3/24/20","3","11","28035","366.67"
"Franklin","0","3","Mississippi","3/24/20","0","3","28037","1"
"George","0","1","Mississippi","3/24/20","0","1","28039","1"
"Grenada","0","2","Mississippi","3/24/20","0","2","28043","1"
"Hancock","1","5","Mississippi","3/24/20","1","4","28045","400"
"Harrison","3","24","Mississippi","3/24/20","1","23","28047","2300"
"Hinds","4","31","Mississippi","3/24/20","6","25","28049","416.67"
"Holmes","1","6","Mississippi","3/24/20","0","6","28051","1"
"Humphreys","0","1","Mississippi","3/24/20","0","1","28053","1"
"Itawamba","0","3","Mississippi","3/24/20","0","3","28057","1"
"Jackson","1","10","Mississippi","3/24/20","1","9","28059","900"
"Jones","0","1","Mississippi","3/24/20","0","1","28067","1"
"Lafayette","1","8","Mississippi","3/24/20","0","8","28071","1"
"Lamar","0","2","Mississippi","3/24/20","0","2","28073","1"
"Lawrence","0","2","Mississippi","3/24/20","0","2","28077","1"
"Leake","0","2","Mississippi","3/24/20","0","2","28079","1"
"Lee","2","12","Mississippi","3/24/20","0","12","28081","1"
"Leflore","1","10","Mississippi","3/24/20","4","6","28083","150"
"Lincoln","1","4","Mississippi","3/24/20","0","4","28085","1"
"Lowndes","1","6","Mississippi","3/24/20","0","6","28087","1"
"Madison","2","14","Mississippi","3/24/20","0","14","28089","1"
"Marion","0","1","Mississippi","3/24/20","0","1","28091","1"
"Marshall","0","3","Mississippi","3/24/20","0","3","28093","1"
"Monroe","0","3","Mississippi","3/24/20","1","2","28095","200"
"Montgomery","0","2","Mississippi","3/24/20","0","2","28097","1"
"Newton","0","1","Mississippi","3/24/20","0","1","28101","1"
"Noxubee","0","1","Mississippi","3/24/20","0","1","28103","1"
"Oktibbeha","1","5","Mississippi","3/24/20","0","5","28105","1"
"Panola","0","2","Mississippi","3/24/20","0","2","28107","1"
"Pearl River","2","13","Mississippi","3/24/20","2","11","28109","550"
"Perry","0","1","Mississippi","3/24/20","0","1","28111","1"
"Pike","1","7","Mississippi","3/24/20","0","7","28113","1"
"Pontotoc","0","2","Mississippi","3/24/20","0","2","28115","1"
"Rankin","2","13","Mississippi","3/24/20","0","13","28121","1"
"Scott","0","2","Mississippi","3/24/20","0","2","28123","1"
"Simpson","0","1","Mississippi","3/24/20","0","1","28127","1"
"Smith","0","1","Mississippi","3/24/20","0","1","28129","1"
"Sunflower","0","3","Mississippi","3/24/20","0","3","28133","1"
"Tallahatchie","0","2","Mississippi","3/24/20","0","2","28135","1"
"Tate","0","1","Mississippi","3/24/20","0","1","28137","1"
"Tippah","2","11","Mississippi","3/24/20","0","11","28139","1"
"Tunica","0","3","Mississippi","3/24/20","0","3","28143","1"
"Union","0","1","Mississippi","3/24/20","0","1","28145","1"
"Walthall","0","2","Mississippi","3/24/20","0","2","28147","1"
"Washington","1","5","Mississippi","3/24/20","0","5","28151","1"
"Webster","0","2","Mississippi","3/24/20","0","2","28155","1"
"Wilkinson","1","4","Mississippi","3/24/20","0","4","28157","1"
"Winston","0","2","Mississippi","3/24/20","0","2","28159","1"
"Yazoo","0","3","Mississippi","3/24/20","0","3","28163","1"
"Adair","0","1","Missouri","3/24/20","0","1","29001","1"
"Bates","0","1","Missouri","3/24/20","0","1","29013","1"
"Boone","3","20","Missouri","3/24/20","1","19","29019","1900"
"Callaway","0","2","Missouri","3/24/20","0","2","29027","1"
"Camden","0","1","Missouri","3/24/20","0","1","29029","1"
"Cass","1","6","Missouri","3/24/20","1","5","29037","500"
"Christian","0","2","Missouri","3/24/20","0","2","29043","1"
"Clay","0","3","Missouri","3/24/20","0","3","29047","1"
"Clinton","0","1","Missouri","3/24/20","0","1","29049","1"
"Cole","1","5","Missouri","3/24/20","1","4","29051","400"
"Dunklin","0","1","Missouri","3/24/20","0","1","29069","1"
"Greene","2","19","Missouri","3/24/20","3","16","29077","533.33"
"Henry","0","1","Missouri","3/24/20","1","0","29083","0"
"Jackson","2","14","Missouri","3/24/20","1","13","29095","1300"
"Jasper","0","1","Missouri","3/24/20","0","1","29097","1"
"Jefferson","1","4","Missouri","3/24/20","0","4","29099","1"
"Johnson","0","1","Missouri","3/24/20","0","1","29101","1"
"Kansas City","3","21","Missouri","3/24/20","0","21","00000","1"
"Lafayette","0","1","Missouri","3/24/20","0","1","29107","1"
"Moniteau","0","1","Missouri","3/24/20","0","1","29135","1"
"Pemiscot","0","1","Missouri","3/24/20","0","1","29155","1"
"Perry","0","2","Missouri","3/24/20","0","2","29157","1"
"Platte","0","2","Missouri","3/24/20","0","2","29165","1"
"Pulaski","1","4","Missouri","3/24/20","0","4","29169","1"
"Randolph","0","1","Missouri","3/24/20","0","1","29175","1"
"Scott","0","1","Missouri","3/24/20","0","1","29201","1"
"St. Charles","1","8","Missouri","3/24/20","0","8","29183","1"
"St. Francois","0","2","Missouri","3/24/20","0","2","29187","1"
"St. Louis","16","120","Missouri","3/24/20","5","115","29189","2300"
"St. Louis City","5","37","Missouri","3/24/20","1","36","29510","3600"
"Taney","0","1","Missouri","3/24/20","0","1","29213","1"
"Broadwater","0","1","Montana","3/24/20","1","0","30007","0"
"Cascade","0","3","Montana","3/24/20","0","3","30013","1"
"Flathead","1","4","Montana","3/24/20","0","4","30029","1"
"Gallatin","2","16","Montana","3/24/20","1","15","30031","1500"
"Lewis and Clark","0","3","Montana","3/24/20","0","3","30049","1"
"Madison","0","1","Montana","3/24/20","0","1","30057","1"
"Missoula","0","6","Montana","3/24/20","3","3","30063","100"
"Ravalli","0","1","Montana","3/24/20","0","1","30081","1"
"Roosevelt","0","1","Montana","3/24/20","0","1","30085","1"
"Silver Bow","0","2","Montana","3/24/20","1","1","30093","100"
"Yellowstone","1","7","Montana","3/24/20","2","5","30111","250"
"Adams","0","1","Nebraska","3/24/20","0","1","31001","1"
"Buffalo","0","2","Nebraska","3/24/20","0","2","31019","1"
"Cass","0","2","Nebraska","3/24/20","1","1","31025","100"
"Douglas","3","39","Nebraska","3/24/20","19","20","31055","105.26"
"Gage","0","1","Nebraska","3/24/20","0","1","31067","1"
"Knox","0","2","Nebraska","3/24/20","2","0","31107","0"
"Lancaster","0","2","Nebraska","3/24/20","0","2","31109","1"
"Lincoln","0","3","Nebraska","3/24/20","0","3","31111","1"
"Madison","0","1","Nebraska","3/24/20","0","1","31119","1"
"Nemaha","0","1","Nebraska","3/24/20","0","1","31127","1"
"Sarpy","1","8","Nebraska","3/24/20","1","7","31153","700"
"Saunders","0","1","Nebraska","3/24/20","0","1","31155","1"
"Washington","0","3","Nebraska","3/24/20","0","3","31177","1"
"Carson City","0","2","Nevada","3/24/20","1","1","32510","100"
"Clark","24","212","Nevada","3/24/20","42","170","32003","404.76"
"Douglas","0","2","Nevada","3/24/20","0","2","32005","1"
"Elko","0","2","Nevada","3/24/20","0","2","32007","1"
"Nye","0","1","Nevada","3/24/20","0","1","32023","1"
"Washoe","5","44","Nevada","3/24/20","12","32","32031","266.67"
"Belknap","1","7","New Hampshire","3/24/20","0","7","33001","1"
"Carroll","1","7","New Hampshire","3/24/20","1","6","33003","600"
"Cheshire","0","1","New Hampshire","3/24/20","0","1","33005","1"
"Grafton","2","20","New Hampshire","3/24/20","7","13","33009","185.71"
"Hillsborough","2","19","New Hampshire","3/24/20","4","15","33011","375"
"Merrimack","1","4","New Hampshire","3/24/20","0","4","33013","1"
"Rockingham","3","38","New Hampshire","3/24/20","14","24","33015","171.43"
"Strafford","1","4","New Hampshire","3/24/20","0","4","33017","1"
"Sullivan","0","1","New Hampshire","3/24/20","0","1","33019","1"
"Atlantic","1","6","New Jersey","3/24/20","0","6","34001","1"
"Bergen","88","701","New Jersey","3/24/20","84","617","34003","734.52"
"Burlington","5","42","New Jersey","3/24/20","5","37","34005","740"
"Camden","7","51","New Jersey","3/24/20","3","48","34007","1600"
"Cape May","0","3","New Jersey","3/24/20","0","3","34009","1"
"Cumberland","0","2","New Jersey","3/24/20","0","2","34011","1"
"Essex","44","342","New Jersey","3/24/20","32","310","34013","968.75"
"Gloucester","2","19","New Jersey","3/24/20","2","17","34015","850"
"Hudson","30","234","New Jersey","3/24/20","24","210","34017","875"
"Hunterdon","3","25","New Jersey","3/24/20","4","21","34019","525"
"Mercer","7","58","New Jersey","3/24/20","9","49","34021","544.44"
"Middlesex","36","277","New Jersey","3/24/20","22","255","34023","1159.09"
"Monmouth","38","288","New Jersey","3/24/20","22","266","34025","1209.09"
"Morris","28","204","New Jersey","3/24/20","7","197","34027","2814.29"
"Ocean","25","180","New Jersey","3/24/20","4","176","34029","4400"
"Passaic","29","216","New Jersey","3/24/20","10","206","34031","2060"
"Salem","0","1","New Jersey","3/24/20","0","1","34033","1"
"Somerset","14","102","New Jersey","3/24/20","7","95","34035","1357.14"
"Sussex","3","18","New Jersey","3/24/20","0","18","34037","1"
"Union","33","246","New Jersey","3/24/20","15","231","34039","1540"
"Warren","2","15","New Jersey","3/24/20","0","15","34041","1"
"Bernalillo","4","43","New Mexico","3/24/20","14","29","35001","207.14"
"Chaves","1","4","New Mexico","3/24/20","0","4","35005","1"
"Cibola","0","1","New Mexico","3/24/20","0","1","35006","1"
"Curry","0","1","New Mexico","3/24/20","0","1","35009","1"
"Dona Ana","2","13","New Mexico","3/24/20","0","13","35013","1"
"Lea","0","1","New Mexico","3/24/20","0","1","35025","1"
"McKinley","0","3","New Mexico","3/24/20","0","3","35031","1"
"San Juan","1","7","New Mexico","3/24/20","0","7","35045","1"
"San Miguel","0","1","New Mexico","3/24/20","0","1","35047","1"
"Sandoval","1","7","New Mexico","3/24/20","2","5","35043","250"
"Santa Fe","1","14","New Mexico","3/24/20","4","10","35049","250"
"Socorro","0","2","New Mexico","3/24/20","2","0","35053","0"
"Taos","0","3","New Mexico","3/24/20","1","2","35055","200"
"Albany","17","146","New York","3/24/20","25","121","36001","484"
"Allegany","0","2","New York","3/24/20","2","0","36003","0"
"Broome","1","9","New York","3/24/20","1","8","36007","800"
"Cayuga","0","2","New York","3/24/20","0","2","36011","1"
"Chautauqua","0","2","New York","3/24/20","0","2","36013","1"
"Chemung","0","3","New York","3/24/20","0","3","36015","1"
"Chenango","0","3","New York","3/24/20","0","3","36017","1"
"Clinton","1","6","New York","3/24/20","1","5","36019","500"
"Columbia","3","18","New York","3/24/20","0","18","36021","1"
"Cortland","0","2","New York","3/24/20","0","2","36023","1"
"Delaware","0","3","New York","3/24/20","1","2","36025","200"
"Dutchess","15","124","New York","3/24/20","16","108","36027","675"
"Erie","15","114","New York","3/24/20","11","103","36029","936.36"
"Essex","0","3","New York","3/24/20","1","2","36031","200"
"Fulton","0","1","New York","3/24/20","0","1","36035","1"
"Genesee","0","1","New York","3/24/20","0","1","36037","1"
"Greene","0","4","New York","3/24/20","2","2","36039","100"
"Hamilton","0","2","New York","3/24/20","0","2","36041","1"
"Herkimer","0","4","New York","3/24/20","1","3","36043","300"
"Jefferson","0","2","New York","3/24/20","0","2","36045","1"
"Livingston","0","3","New York","3/24/20","0","3","36051","1"
"Madison","1","4","New York","3/24/20","0","4","36053","1"
"Monroe","13","106","New York","3/24/20","14","92","36055","657.14"
"Montgomery","0","3","New York","3/24/20","1","2","36057","200"
"Nassau","390","2869","New York","3/24/20","140","2729","36059","1949.29"
"New York","2013","14904","New York","3/24/20","814","14090","36061","1730.96"
"Niagara","1","10","New York","3/24/20","0","10","36063","1"
"Oneida","1","10","New York","3/24/20","1","9","36065","900"
"Onondaga","8","60","New York","3/24/20","2","58","36067","2900"
"Ontario","1","6","New York","3/24/20","1","5","36069","500"
"Orange","69","498","New York","3/24/20","15","483","36071","3220"
"Oswego","0","2","New York","3/24/20","0","2","36075","1"
"Otsego","0","1","New York","3/24/20","0","1","36077","1"
"Putnam","11","82","New York","3/24/20","2","80","36079","4000"
"Rensselaer","5","33","New York","3/24/20","1","32","36083","3200"
"Rockland","93","671","New York","3/24/20","22","649","36087","2950"
"Saratoga","6","53","New York","3/24/20","9","44","36091","488.89"
"Schenectady","6","44","New York","3/24/20","5","39","36093","780"
"Schoharie","0","1","New York","3/24/20","0","1","36095","1"
"St. Lawrence","0","1","New York","3/24/20","0","1","36089","1"
"Steuben","1","8","New York","3/24/20","0","8","36101","1"
"Suffolk","255","1880","New York","3/24/20","97","1783","36103","1838.14"
"Sullivan","3","23","New York","3/24/20","1","22","36105","2200"
"Tioga","0","1","New York","3/24/20","1","0","36107","0"
"Tompkins","2","16","New York","3/24/20","2","14","36109","700"
"Ulster","4","35","New York","3/24/20","8","27","36111","337.5"
"Warren","0","2","New York","3/24/20","0","2","36113","1"
"Washington","0","3","New York","3/24/20","0","3","36115","1"
"Wayne","1","6","New York","3/24/20","0","6","36117","1"
"Westchester","502","3891","New York","3/24/20","380","3511","36119","923.95"
"Wyoming","0","4","New York","3/24/20","1","3","36121","300"
"Alamance","0","3","North Carolina","3/24/20","0","3","37001","1"
"Beaufort","0","2","North Carolina","3/24/20","0","2","37013","1"
"Bertie","0","1","North Carolina","3/24/20","0","1","37015","1"
"Brunswick","1","10","North Carolina","3/24/20","1","9","37019","900"
"Buncombe","2","12","North Carolina","3/24/20","0","12","37021","1"
"Cabarrus","1","10","North Carolina","3/24/20","1","9","37025","900"
"Caldwell","0","1","North Carolina","3/24/20","0","1","37027","1"
"Carteret","1","5","North Carolina","3/24/20","0","5","37031","1"
"Catawba","1","4","North Carolina","3/24/20","0","4","37035","1"
"Chatham","0","3","North Carolina","3/24/20","3","0","37037","0"
"Cherokee","1","4","North Carolina","3/24/20","0","4","37039","1"
"Chowan","0","1","North Carolina","3/24/20","0","1","37041","1"
"Craven","0","3","North Carolina","3/24/20","1","2","37049","200"
"Cumberland","1","5","North Carolina","3/24/20","0","5","37051","1"
"Davidson","0","3","North Carolina","3/24/20","0","3","37057","1"
"Davie","0","1","North Carolina","3/24/20","0","1","37059","1"
"Duplin","0","1","North Carolina","3/24/20","0","1","37061","1"
"Durham","8","71","North Carolina","3/24/20","16","55","37063","343.75"
"Forsyth","2","14","North Carolina","3/24/20","2","12","37067","600"
"Franklin","1","4","North Carolina","3/24/20","0","4","37069","1"
"Gaston","1","4","North Carolina","3/24/20","0","4","37071","1"
"Granville","0","1","North Carolina","3/24/20","0","1","37077","1"
"Guilford","2","16","North Carolina","3/24/20","1","15","37081","1500"
"Harnett","1","9","North Carolina","3/24/20","3","6","37085","200"
"Henderson","0","2","North Carolina","3/24/20","0","2","37089","1"
"Hertford","0","1","North Carolina","3/24/20","0","1","37091","1"
"Hoke","0","1","North Carolina","3/24/20","0","1","37093","1"
"Hyde","0","1","North Carolina","3/24/20","0","1","37095","1"
"Iredell","1","9","North Carolina","3/24/20","1","8","37097","800"
"Jackson","0","1","North Carolina","3/24/20","0","1","37099","1"
"Johnston","0","4","North Carolina","3/24/20","2","2","37101","100"
"Lee","0","1","North Carolina","3/24/20","0","1","37105","1"
"Lenoir","0","1","North Carolina","3/24/20","0","1","37107","1"
"Lincoln","0","1","North Carolina","3/24/20","1","0","37109","0"
"McDowell","0","2","North Carolina","3/24/20","0","2","37111","1"
"Mecklenburg","19","142","North Carolina","3/24/20","11","131","37119","1190.91"
"Montgomery","0","1","North Carolina","3/24/20","0","1","37123","1"
"Moore","0","2","North Carolina","3/24/20","0","2","37125","1"
"Nash","1","4","North Carolina","3/24/20","0","4","37127","1"
"New Hanover","1","10","North Carolina","3/24/20","0","10","37129","1"
"Northampton","0","1","North Carolina","3/24/20","0","1","37131","1"
"Onslow","0","3","North Carolina","3/24/20","1","2","37133","200"
"Orange","1","6","North Carolina","3/24/20","1","5","37135","500"
"Pasquotank","0","1","North Carolina","3/24/20","0","1","37139","1"
"Pitt","1","6","North Carolina","3/24/20","0","6","37147","1"
"Randolph","0","3","North Carolina","3/24/20","0","3","37151","1"
"Robeson","0","2","North Carolina","3/24/20","0","2","37155","1"
"Rowan","1","5","North Carolina","3/24/20","0","5","37159","1"
"Sampson","0","1","North Carolina","3/24/20","1","0","37163","0"
"Scotland","0","1","North Carolina","3/24/20","0","1","37165","1"
"Transylvania","0","1","North Carolina","3/24/20","0","1","37175","1"
"Union","3","18","North Carolina","3/24/20","0","18","37179","1"
"Vance","0","1","North Carolina","3/24/20","0","1","37181","1"
"Wake","7","66","North Carolina","3/24/20","15","51","37183","340"
"Watauga","0","3","North Carolina","3/24/20","1","2","37189","200"
"Wayne","0","2","North Carolina","3/24/20","1","1","37191","100"
"Wilson","0","4","North Carolina","3/24/20","1","3","37195","300"
"Burleigh","3","18","North Dakota","3/24/20","0","18","38015","1"
"Cass","0","3","North Dakota","3/24/20","1","2","38017","200"
"Dunn","0","1","North Dakota","3/24/20","0","1","38025","1"
"Morton","1","7","North Dakota","3/24/20","0","7","38059","1"
"Pierce","0","2","North Dakota","3/24/20","0","2","38069","1"
"Ramsey","0","1","North Dakota","3/24/20","0","1","38071","1"
"Walsh","0","1","North Dakota","3/24/20","0","1","38099","1"
"Ward","0","3","North Dakota","3/24/20","2","1","38101","50"
"Ashland","0","1","Ohio","3/24/20","0","1","39005","1"
"Ashtabula","0","3","Ohio","3/24/20","0","3","39007","1"
"Belmont","0","2","Ohio","3/24/20","2","0","39013","0"
"Butler","2","18","Ohio","3/24/20","6","12","39017","200"
"Carroll","0","3","Ohio","3/24/20","0","3","39019","1"
"Champaign","0","1","Ohio","3/24/20","0","1","39021","1"
"Clark","0","2","Ohio","3/24/20","0","2","39023","1"
"Clermont","1","5","Ohio","3/24/20","0","5","39025","1"
"Clinton","0","1","Ohio","3/24/20","0","1","39027","1"
"Columbiana","0","3","Ohio","3/24/20","0","3","39029","1"
"Coshocton","0","3","Ohio","3/24/20","2","1","39031","50"
"Crawford","0","1","Ohio","3/24/20","0","1","39033","1"
"Cuyahoga","19","167","Ohio","3/24/20","31","136","39035","438.71"
"Darke","0","1","Ohio","3/24/20","1","0","39037","0"
"Defiance","0","2","Ohio","3/24/20","0","2","39039","1"
"Delaware","2","11","Ohio","3/24/20","0","11","39041","1"
"Erie","0","1","Ohio","3/24/20","0","1","39043","1"
"Fairfield","0","2","Ohio","3/24/20","0","2","39045","1"
"Franklin","10","75","Ohio","3/24/20","4","71","39049","1775"
"Gallia","0","1","Ohio","3/24/20","0","1","39053","1"
"Geauga","1","5","Ohio","3/24/20","1","4","39055","400"
"Greene","0","3","Ohio","3/24/20","0","3","39057","1"
"Hamilton","5","38","Ohio","3/24/20","0","38","39061","1"
"Hancock","0","1","Ohio","3/24/20","0","1","39063","1"
"Highland","0","1","Ohio","3/24/20","0","1","39071","1"
"Huron","0","2","Ohio","3/24/20","0","2","39077","1"
"Knox","0","1","Ohio","3/24/20","0","1","39083","1"
"Lake","1","11","Ohio","3/24/20","1","10","39085","1000"
"Licking","0","2","Ohio","3/24/20","0","2","39089","1"
"Logan","0","2","Ohio","3/24/20","0","2","39091","1"
"Lorain","4","30","Ohio","3/24/20","4","26","39093","650"
"Lucas","2","13","Ohio","3/24/20","1","12","39095","1200"
"Madison","0","1","Ohio","3/24/20","0","1","39097","1"
"Mahoning","4","28","Ohio","3/24/20","1","27","39099","2700"
"Marion","1","4","Ohio","3/24/20","0","4","39101","1"
"Medina","2","15","Ohio","3/24/20","3","12","39103","400"
"Miami","3","19","Ohio","3/24/20","0","19","39109","1"
"Montgomery","1","10","Ohio","3/24/20","0","10","39113","1"
"Portage","1","4","Ohio","3/24/20","0","4","39133","1"
"Richland","1","4","Ohio","3/24/20","0","4","39139","1"
"Sandusky","0","1","Ohio","3/24/20","0","1","39143","1"
"Seneca","0","1","Ohio","3/24/20","0","1","39147","1"
"Stark","1","13","Ohio","3/24/20","3","10","39151","333.33"
"Summit","5","36","Ohio","3/24/20","4","32","39153","800"
"Trumbull","0","4","Ohio","3/24/20","2","2","39155","100"
"Tuscarawas","0","3","Ohio","3/24/20","1","2","39157","200"
"Union","0","2","Ohio","3/24/20","0","2","39159","1"
"Warren","1","7","Ohio","3/24/20","0","7","39165","1"
"Washington","0","1","Ohio","3/24/20","0","1","39167","1"
"Wood","0","2","Ohio","3/24/20","0","2","39173","1"
"Canadian","0","4","Oklahoma","3/24/20","1","3","40017","300"
"Cleveland","3","22","Oklahoma","3/24/20","2","20","40027","1000"
"Custer","0","2","Oklahoma","3/24/20","0","2","40039","1"
"Garvin","0","2","Oklahoma","3/24/20","0","2","40049","1"
"Grady","0","1","Oklahoma","3/24/20","0","1","40051","1"
"Jackson","0","1","Oklahoma","3/24/20","1","0","40065","0"
"Kay","0","5","Oklahoma","3/24/20","2","3","40071","150"
"Logan","0","1","Oklahoma","3/24/20","0","1","40083","1"
"Mayes","0","1","Oklahoma","3/24/20","0","1","40097","1"
"McClain","0","1","Oklahoma","3/24/20","0","1","40087","1"
"Muskogee","0","1","Oklahoma","3/24/20","0","1","40101","1"
"Noble","0","2","Oklahoma","3/24/20","0","2","40103","1"
"Oklahoma","5","41","Oklahoma","3/24/20","6","35","40109","583.33"
"Pawnee","0","4","Oklahoma","3/24/20","1","3","40117","300"
"Payne","0","3","Oklahoma","3/24/20","1","2","40119","200"
"Pontotoc","0","1","Oklahoma","3/24/20","0","1","40123","1"
"Tulsa","1","12","Oklahoma","3/24/20","3","9","40143","300"
"Washington","0","2","Oklahoma","3/24/20","0","2","40147","1"
"Benton","0","4","Oregon","3/24/20","2","2","41003","100"
"Clackamas","2","17","Oregon","3/24/20","6","11","41005","183.33"
"Clatsop","0","1","Oregon","3/24/20","0","1","41007","1"
"Deschutes","1","10","Oregon","3/24/20","6","4","41017","66.67"
"Douglas","0","1","Oregon","3/24/20","1","0","41019","0"
"Grant","0","1","Oregon","3/24/20","0","1","41023","1"
"Hood River","0","1","Oregon","3/24/20","0","1","41027","1"
"Jackson","0","3","Oregon","3/24/20","2","1","41029","50"
"Josephine","0","1","Oregon","3/24/20","0","1","41033","1"
"Klamath","0","1","Oregon","3/24/20","1","0","41035","0"
"Lane","1","4","Oregon","3/24/20","0","4","41039","1"
"Linn","1","21","Oregon","3/24/20","15","6","41043","40"
"Marion","4","32","Oregon","3/24/20","4","28","41047","700"
"Multnomah","3","25","Oregon","3/24/20","3","22","41051","733.33"
"Polk","0","3","Oregon","3/24/20","2","1","41053","50"
"Umatilla","0","2","Oregon","3/24/20","2","0","41059","0"
"Union","0","1","Oregon","3/24/20","0","1","41061","1"
"Washington","8","76","Oregon","3/24/20","21","55","41067","261.9"
"Yamhill","1","6","Oregon","3/24/20","1","5","41071","500"
"Adams","1","6","Pennsylvania","3/24/20","0","6","42001","1"
"Allegheny","7","58","Pennsylvania","3/24/20","10","48","42003","480"
"Armstrong","0","1","Pennsylvania","3/24/20","0","1","42005","1"
"Beaver","0","3","Pennsylvania","3/24/20","1","2","42007","200"
"Berks","2","16","Pennsylvania","3/24/20","0","16","42011","1"
"Bradford","0","1","Pennsylvania","3/24/20","0","1","42015","1"
"Bucks","9","69","Pennsylvania","3/24/20","8","61","42017","762.5"
"Butler","1","6","Pennsylvania","3/24/20","0","6","42019","1"
"Cambria","0","1","Pennsylvania","3/24/20","0","1","42021","1"
"Carbon","0","1","Pennsylvania","3/24/20","0","1","42025","1"
"Centre","1","7","Pennsylvania","3/24/20","0","7","42027","1"
"Chester","5","40","Pennsylvania","3/24/20","6","34","42029","566.67"
"Clearfield","0","1","Pennsylvania","3/24/20","0","1","42033","1"
"Columbia","0","1","Pennsylvania","3/24/20","0","1","42037","1"
"Cumberland","0","13","Pennsylvania","3/24/20","10","3","42041","30"
"Dauphin","1","4","Pennsylvania","3/24/20","0","4","42043","1"
"Delaware","11","84","Pennsylvania","3/24/20","9","75","42045","833.33"
"Erie","1","5","Pennsylvania","3/24/20","0","5","42049","1"
"Fayette","0","2","Pennsylvania","3/24/20","0","2","42051","1"
"Franklin","0","3","Pennsylvania","3/24/20","0","3","42055","1"
"Juniata","0","1","Pennsylvania","3/24/20","0","1","42067","1"
"Lackawanna","2","15","Pennsylvania","3/24/20","0","15","42069","1"
"Lancaster","1","10","Pennsylvania","3/24/20","0","10","42071","1"
"Lebanon","0","3","Pennsylvania","3/24/20","0","3","42075","1"
"Lehigh","4","27","Pennsylvania","3/24/20","1","26","42077","2600"
"Luzerne","3","21","Pennsylvania","3/24/20","1","20","42079","2000"
"Mercer","0","2","Pennsylvania","3/24/20","0","2","42085","1"
"Monroe","5","45","Pennsylvania","3/24/20","8","37","42089","462.5"
"Montgomery","18","159","Pennsylvania","3/24/20","34","125","42091","367.65"
"Montour","0","3","Pennsylvania","3/24/20","0","3","42093","1"
"Northampton","5","33","Pennsylvania","3/24/20","1","32","42095","3200"
"Philadelphia","33","252","Pennsylvania","3/24/20","19","233","42101","1226.32"
"Pike","0","4","Pennsylvania","3/24/20","1","3","42103","300"
"Potter","0","1","Pennsylvania","3/24/20","0","1","42105","1"
"Schuylkill","1","5","Pennsylvania","3/24/20","0","5","42107","1"
"Somerset","0","1","Pennsylvania","3/24/20","0","1","42111","1"
"Washington","1","9","Pennsylvania","3/24/20","2","7","42125","350"
"Wayne","0","4","Pennsylvania","3/24/20","1","3","42127","300"
"Westmoreland","2","11","Pennsylvania","3/24/20","0","11","42129","1"
"York","3","18","Pennsylvania","3/24/20","0","18","42133","1"
"","5","39","Puerto Rico","3/24/20","5","34",,"680"
"Bristol","3","24","Rhode Island","3/24/20","0","24","44001","1"
"Kent","1","7","Rhode Island","3/24/20","0","7","44003","1"
"Newport","1","9","Rhode Island","3/24/20","0","9","44005","1"
"Providence","4","52","Rhode Island","3/24/20","23","29","44007","126.09"
"Washington","1","9","Rhode Island","3/24/20","0","9","44009","1"
"Abbeville","0","1","South Carolina","3/24/20","0","1","45001","1"
"Aiken","0","2","South Carolina","3/24/20","0","2","45003","1"
"Anderson","2","16","South Carolina","3/24/20","2","14","45007","700"
"Beaufort","3","22","South Carolina","3/24/20","4","18","45013","450"
"Berkeley","1","4","South Carolina","3/24/20","0","4","45015","1"
"Calhoun","0","1","South Carolina","3/24/20","1","0","45017","0"
"Charleston","5","36","South Carolina","3/24/20","3","33","45019","1100"
"Chester","0","1","South Carolina","3/24/20","0","1","45023","1"
"Chesterfield","0","1","South Carolina","3/24/20","0","1","45025","1"
"Clarendon","1","5","South Carolina","3/24/20","0","5","45027","1"
"Colleton","0","1","South Carolina","3/24/20","0","1","45029","1"
"Darlington","1","8","South Carolina","3/24/20","0","8","45031","1"
"Dillon","0","1","South Carolina","3/24/20","0","1","45033","1"
"Dorchester","0","3","South Carolina","3/24/20","0","3","45035","1"
"Edgefield","0","1","South Carolina","3/24/20","0","1","45037","1"
"Fairfield","0","2","South Carolina","3/24/20","1","1","45039","100"
"Florence","1","5","South Carolina","3/24/20","0","5","45041","1"
"Georgetown","0","2","South Carolina","3/24/20","0","2","45043","1"
"Greenville","5","39","South Carolina","3/24/20","2","37","45045","1850"
"Greenwood","0","2","South Carolina","3/24/20","0","2","45047","1"
"Horry","2","19","South Carolina","3/24/20","4","15","45051","375"
"Jasper","0","2","South Carolina","3/24/20","0","2","45053","1"
"Kershaw","5","58","South Carolina","3/24/20","22","36","45055","163.64"
"Lancaster","1","7","South Carolina","3/24/20","2","5","45057","250"
"Lee","0","2","South Carolina","3/24/20","0","2","45061","1"
"Lexington","2","19","South Carolina","3/24/20","3","16","45063","533.33"
"Marlboro","0","1","South Carolina","3/24/20","0","1","45069","1"
"Newberry","0","1","South Carolina","3/24/20","0","1","45071","1"
"Oconee","0","2","South Carolina","3/24/20","0","2","45073","1"
"Orangeburg","1","8","South Carolina","3/24/20","0","8","45075","1"
"Pickens","0","1","South Carolina","3/24/20","0","1","45077","1"
"Richland","6","45","South Carolina","3/24/20","1","44","45079","4400"
"Saluda","0","1","South Carolina","3/24/20","0","1","45081","1"
"Spartanburg","0","4","South Carolina","3/24/20","1","3","45083","300"
"Sumter","1","8","South Carolina","3/24/20","0","8","45085","1"
"York","1","11","South Carolina","3/24/20","1","10","45091","1000"
"Beadle","2","13","South Dakota","3/24/20","1","12","46005","1200"
"Bon Homme","0","1","South Dakota","3/24/20","1","0","46009","0"
"Brookings","0","1","South Dakota","3/24/20","0","1","46011","1"
"Brown","0","1","South Dakota","3/24/20","0","1","46013","1"
"Charles Mix","0","1","South Dakota","3/24/20","1","0","46023","0"
"Codington","0","1","South Dakota","3/24/20","0","1","46029","1"
"Davison","0","2","South Dakota","3/24/20","1","1","46035","100"
"Hughes","0","1","South Dakota","3/24/20","0","1","46065","1"
"Lyman","0","1","South Dakota","3/24/20","0","1","46085","1"
"McCook","0","2","South Dakota","3/24/20","1","1","46087","100"
"Minnehaha","0","5","South Dakota","3/24/20","5","0","46099","0"
"Pennington","0","1","South Dakota","3/24/20","1","0","46103","0"
"Anderson","0","1","Tennessee","3/24/20","0","1","47001","1"
"Blount","0","3","Tennessee","3/24/20","0","3","47009","1"
"Bradley","0","2","Tennessee","3/24/20","0","2","47011","1"
"Campbell","0","2","Tennessee","3/24/20","1","1","47013","100"
"Carroll","0","3","Tennessee","3/24/20","0","3","47017","1"
"Cheatham","1","5","Tennessee","3/24/20","0","5","47021","1"
"Chester","0","1","Tennessee","3/24/20","0","1","47023","1"
"Claiborne","0","1","Tennessee","3/24/20","0","1","47025","1"
"Cocke","0","1","Tennessee","3/24/20","0","1","47029","1"
"Cumberland","0","3","Tennessee","3/24/20","0","3","47035","1"
"Davidson","30","253","Tennessee","3/24/20","42","211","47037","502.38"
"Dickson","1","5","Tennessee","3/24/20","0","5","47043","1"
"Dyer","0","2","Tennessee","3/24/20","0","2","47045","1"
"Fayette","0","2","Tennessee","3/24/20","0","2","47047","1"
"Franklin","0","1","Tennessee","3/24/20","0","1","47051","1"
"Gibson","0","2","Tennessee","3/24/20","0","2","47053","1"
"Greene","1","5","Tennessee","3/24/20","0","5","47059","1"
"Grundy","0","1","Tennessee","3/24/20","0","1","47061","1"
"Hamblen","0","2","Tennessee","3/24/20","0","2","47063","1"
"Hamilton","1","8","Tennessee","3/24/20","1","7","47065","700"
"Hardin","0","1","Tennessee","3/24/20","0","1","47071","1"
"Houston","0","1","Tennessee","3/24/20","0","1","47083","1"
"Jefferson","0","4","Tennessee","3/24/20","1","3","47089","300"
"Knox","2","15","Tennessee","3/24/20","2","13","47093","650"
"Lincoln","0","1","Tennessee","3/24/20","0","1","47103","1"
"Loudon","0","2","Tennessee","3/24/20","0","2","47105","1"
"Madison","0","1","Tennessee","3/24/20","0","1","47113","1"
"Marion","0","1","Tennessee","3/24/20","0","1","47115","1"
"Maury","1","6","Tennessee","3/24/20","0","6","47119","1"
"McMinn","0","2","Tennessee","3/24/20","0","2","47107","1"
"Monroe","0","2","Tennessee","3/24/20","0","2","47123","1"
"Montgomery","1","6","Tennessee","3/24/20","0","6","47125","1"
"Out of TN","14","95","Tennessee","3/24/20","0","95","80047","1"
"Overton","0","1","Tennessee","3/24/20","0","1","47133","1"
"Perry","0","1","Tennessee","3/24/20","0","1","47135","1"
"Putnam","1","8","Tennessee","3/24/20","0","8","47141","1"
"Roane","0","1","Tennessee","3/24/20","0","1","47145","1"
"Robertson","2","12","Tennessee","3/24/20","0","12","47147","1"
"Rutherford","2","13","Tennessee","3/24/20","1","12","47149","1200"
"Scott","0","1","Tennessee","3/24/20","0","1","47151","1"
"Sevier","0","2","Tennessee","3/24/20","1","1","47155","100"
"Shelby","19","135","Tennessee","3/24/20","3","132","47157","4400"
"Sullivan","0","2","Tennessee","3/24/20","1","1","47163","100"
"Sumner","5","34","Tennessee","3/24/20","0","34","47165","1"
"Tipton","1","6","Tennessee","3/24/20","0","6","47167","1"
"Washington","1","7","Tennessee","3/24/20","0","7","47179","1"
"Williamson","6","64","Tennessee","3/24/20","21","43","47187","204.76"
"Wilson","1","7","Tennessee","3/24/20","0","7","47189","1"
"Atascosa","0","2","Texas","3/24/20","0","2","48013","1"
"Bastrop","0","1","Texas","3/24/20","0","1","48021","1"
"Bell","2","18","Texas","3/24/20","2","16","48027","800"
"Bexar","9","69","Texas","3/24/20","4","65","48029","1625"
"Blanco","0","1","Texas","3/24/20","0","1","48031","1"
"Bowie","0","1","Texas","3/24/20","1","0","48037","0"
"Brazoria","4","28","Texas","3/24/20","2","26","48039","1300"
"Brazos","2","16","Texas","3/24/20","1","15","48041","1500"
"Brown","0","2","Texas","3/24/20","0","2","48049","1"
"Burnet","0","1","Texas","3/24/20","0","1","48053","1"
"Cameron","1","6","Texas","3/24/20","0","6","48061","1"
"Castro","0","2","Texas","3/24/20","0","2","48069","1"
"Chambers","0","1","Texas","3/24/20","0","1","48071","1"
"Collin","5","45","Texas","3/24/20","8","37","48085","462.5"
"Comal","1","5","Texas","3/24/20","0","5","48091","1"
"Crane","0","1","Texas","3/24/20","0","1","48103","1"
"Dallas","20","169","Texas","3/24/20","28","141","48113","503.57"
"Deaf Smith","0","1","Texas","3/24/20","0","1","48117","1"
"Denton","5","38","Texas","3/24/20","1","37","48121","3700"
"DeWitt","0","1","Texas","3/24/20","0","1","48123","1"
"Eastland","0","1","Texas","3/24/20","0","1","48133","1"
"El Paso","1","10","Texas","3/24/20","3","7","48141","233.33"
"Ellis","1","6","Texas","3/24/20","0","6","48139","1"
"Erath","0","1","Texas","3/24/20","0","1","48143","1"
"Falls","0","1","Texas","3/24/20","0","1","48145","1"
"Fannin","0","1","Texas","3/24/20","0","1","48147","1"
"Fayette","0","1","Texas","3/24/20","0","1","48149","1"
"Fort Bend","5","46","Texas","3/24/20","9","37","48157","411.11"
"Gaines","0","1","Texas","3/24/20","0","1","48165","1"
"Galveston","2","18","Texas","3/24/20","2","16","48167","800"
"Grayson","0","2","Texas","3/24/20","0","2","48181","1"
"Gregg","0","1","Texas","3/24/20","1","0","48183","0"
"Grimes","0","2","Texas","3/24/20","0","2","48185","1"
"Guadalupe","1","4","Texas","3/24/20","0","4","48187","1"
"Hardin","0","2","Texas","3/24/20","0","2","48199","1"
"Harris","17","134","Texas","3/24/20","16","118","48201","737.5"
"Hays","1","7","Texas","3/24/20","3","4","48209","133.33"
"Hidalgo","0","2","Texas","3/24/20","0","2","48215","1"
"Hockley","0","3","Texas","3/24/20","0","3","48219","1"
"Hopkins","0","1","Texas","3/24/20","0","1","48223","1"
"Hunt","0","1","Texas","3/24/20","0","1","48231","1"
"Jefferson","1","6","Texas","3/24/20","0","6","48245","1"
"Johnson","0","2","Texas","3/24/20","0","2","48251","1"
"Kendall","0","1","Texas","3/24/20","0","1","48259","1"
"Lamar","0","1","Texas","3/24/20","0","1","48277","1"
"Lavaca","0","1","Texas","3/24/20","1","0","48285","0"
"Liberty","0","1","Texas","3/24/20","0","1","48291","1"
"Llano","0","1","Texas","3/24/20","0","1","48299","1"
"Lubbock","2","12","Texas","3/24/20","0","12","48303","1"
"Matagorda","0","4","Texas","3/24/20","2","2","48321","100"
"Maverick","0","1","Texas","3/24/20","0","1","48323","1"
"McLennan","3","24","Texas","3/24/20","0","24","48309","1"
"Medina","0","1","Texas","3/24/20","0","1","48325","1"
"Midland","0","3","Texas","3/24/20","0","3","48329","1"
"Milam","0","2","Texas","3/24/20","0","2","48331","1"
"Montgomery","3","23","Texas","3/24/20","4","19","48339","475"
"Nueces","1","6","Texas","3/24/20","0","6","48355","1"
"Oldham","0","1","Texas","3/24/20","0","1","48359","1"
"Orange","0","1","Texas","3/24/20","0","1","48361","1"
"Parker","0","1","Texas","3/24/20","0","1","48367","1"
"Potter","0","3","Texas","3/24/20","0","3","48375","1"
"Randall","0","2","Texas","3/24/20","0","2","48381","1"
"Robertson","0","1","Texas","3/24/20","0","1","48395","1"
"Rusk","0","1","Texas","3/24/20","1","0","48401","0"
"Smith","1","14","Texas","3/24/20","4","10","48423","250"
"Tarrant","9","71","Texas","3/24/20","6","65","48439","1083.33"
"Terry","0","1","Texas","3/24/20","0","1","48445","1"
"Tom Green","0","1","Texas","3/24/20","0","1","48451","1"
"Travis","11","86","Texas","3/24/20","10","76","48453","760"
"Van Zandt","0","1","Texas","3/24/20","0","1","48467","1"
"Victoria","0","3","Texas","3/24/20","0","3","48469","1"
"Walker","0","1","Texas","3/24/20","0","1","48471","1"
"Waller","0","1","Texas","3/24/20","0","1","48473","1"
"Webb","0","4","Texas","3/24/20","1","3","48479","300"
"Wharton","0","1","Texas","3/24/20","0","1","48481","1"
"Wichita","1","5","Texas","3/24/20","0","5","48485","1"
"Williamson","2","14","Texas","3/24/20","0","14","48491","1"
"Bear River","0","1","Utah","3/24/20","0","1","00000","1"
"Cache","0","3","Utah","3/24/20","0","3","49005","1"
"Davis","4","31","Utah","3/24/20","4","27","49011","675"
"Out of UT","2","13","Utah","3/24/20","0","13","80049","1"
"Salt Lake","15","124","Utah","3/24/20","20","104","49035","520"
"Summit","11","82","Utah","3/24/20","8","74","49043","925"
"Tooele","0","2","Utah","3/24/20","1","1","49045","100"
"Utah","2","13","Utah","3/24/20","0","13","49049","1"
"Wasatch","2","15","Utah","3/24/20","2","13","49051","650"
"Washington","1","5","Utah","3/24/20","0","5","49053","1"
"Weber-Morgan","1","9","Utah","3/24/20","4","5","00000","125"
"Addison","1","8","Vermont","3/24/20","0","8","50001","1"
"Bennington","1","9","Vermont","3/24/20","3","6","50003","200"
"Caledonia","0","1","Vermont","3/24/20","0","1","50005","1"
"Chittenden","5","40","Vermont","3/24/20","4","36","50007","900"
"Franklin","0","2","Vermont","3/24/20","0","2","50011","1"
"Lamoille","0","2","Vermont","3/24/20","0","2","50015","1"
"Orange","0","3","Vermont","3/24/20","1","2","50017","200"
"Orleans","0","2","Vermont","3/24/20","0","2","50019","1"
"Rutland","1","5","Vermont","3/24/20","0","5","50021","1"
"Washington","0","3","Vermont","3/24/20","1","2","50023","200"
"Windham","1","5","Vermont","3/24/20","0","5","50025","1"
"Windsor","2","15","Vermont","3/24/20","3","12","50027","400"
"","2","17","Virgin Islands","3/24/20","2","15",,"750"
"Accomack","0","1","Virginia","3/24/20","0","1","51001","1"
"Albemarle","0","2","Virginia","3/24/20","0","2","51003","1"
"Alexandria","1","8","Virginia","3/24/20","2","6","51510","300"
"Amherst","0","1","Virginia","3/24/20","0","1","51009","1"
"Arlington","3","36","Virginia","3/24/20","13","23","51013","176.92"
"Bedford","0","1","Virginia","3/24/20","0","1","51019","1"
"Botetourt","0","1","Virginia","3/24/20","0","1","51023","1"
"Charles City","0","1","Virginia","3/24/20","0","1","51036","1"
"Charlottesville","1","5","Virginia","3/24/20","1","4","51540","400"
"Chesapeake","0","1","Virginia","3/24/20","0","1","51550","1"
"Chesterfield","1","10","Virginia","3/24/20","4","6","51041","150"
"Culpeper","0","2","Virginia","3/24/20","0","2","51047","1"
"Danville","0","1","Virginia","3/24/20","0","1","51590","1"
"Fairfax","5","46","Virginia","3/24/20","12","34","51059","283.33"
"Fluvanna","0","1","Virginia","3/24/20","0","1","51065","1"
"Franklin","0","1","Virginia","3/24/20","0","1","51067","1"
"Gloucester","0","2","Virginia","3/24/20","0","2","51073","1"
"Goochland","0","3","Virginia","3/24/20","1","2","51075","200"
"Halifax","0","1","Virginia","3/24/20","0","1","51083","1"
"Hanover","0","1","Virginia","3/24/20","1","0","51085","0"
"Harrisonburg","0","1","Virginia","3/24/20","1","0","51660","0"
"Henrico","2","14","Virginia","3/24/20","2","12","51087","600"
"Isle of Wight","0","2","Virginia","3/24/20","0","2","51093","1"
"James City","4","37","Virginia","3/24/20","12","25","51095","208.33"
"Lee","0","2","Virginia","3/24/20","0","2","51105","1"
"Loudoun","2","18","Virginia","3/24/20","5","13","51107","260"
"Louisa","0","2","Virginia","3/24/20","0","2","51109","1"
"Madison","0","1","Virginia","3/24/20","0","1","51113","1"
"Mecklenburg","0","2","Virginia","3/24/20","0","2","51117","1"
"Nelson","0","1","Virginia","3/24/20","0","1","51125","1"
"Newport News","0","3","Virginia","3/24/20","0","3","51700","1"
"Norfolk","1","8","Virginia","3/24/20","0","8","51710","1"
"Orange","0","1","Virginia","3/24/20","0","1","51137","1"
"Prince Edward","0","1","Virginia","3/24/20","1","0","51147","0"
"Prince William","3","23","Virginia","3/24/20","4","19","51153","475"
"Richmond City","2","11","Virginia","3/24/20","0","11","51760","1"
"Rockbridge","0","1","Virginia","3/24/20","0","1","51163","1"
"Rockingham","0","3","Virginia","3/24/20","0","3","51165","1"
"Spotsylvania","0","2","Virginia","3/24/20","1","1","51177","100"
"Stafford","1","6","Virginia","3/24/20","1","5","51179","500"
"Suffolk","0","1","Virginia","3/24/20","0","1","51800","1"
"Virginia Beach","2","17","Virginia","3/24/20","4","13","51810","325"
"Williamsburg","1","5","Virginia","3/24/20","1","4","51830","400"
"York","1","6","Virginia","3/24/20","1","5","51199","500"
"Adams","0","1","Washington","3/24/20","0","1","53001","1"
"Benton","1","9","Washington","3/24/20","0","9","53005","1"
"Chelan","1","6","Washington","3/24/20","2","4","53007","200"
"Clallam","1","4","Washington","3/24/20","0","4","53009","1"
"Clark","1","13","Washington","3/24/20","4","9","53011","225"
"Columbia","0","1","Washington","3/24/20","1","0","53013","0"
"Cowlitz","0","3","Washington","3/24/20","1","2","53015","200"
"Douglas","0","1","Washington","3/24/20","0","1","53017","1"
"Franklin","1","5","Washington","3/24/20","0","5","53021","1"
"Grant","2","23","Washington","3/24/20","7","16","53025","228.57"
"Grays Harbor","0","1","Washington","3/24/20","1","0","53027","0"
"Island","2","25","Washington","3/24/20","14","11","53029","78.57"
"Jefferson","1","8","Washington","3/24/20","3","5","53031","166.67"
"King","86","1170","Washington","3/24/20","569","601","53033","105.62"
"Kitsap","2","18","Washington","3/24/20","7","11","53035","157.14"
"Kittitas","0","5","Washington","3/24/20","3","2","53037","66.67"
"Klickitat","0","4","Washington","3/24/20","1","3","53039","300"
"Lewis","0","2","Washington","3/24/20","1","1","53041","100"
"Lincoln","0","1","Washington","3/24/20","1","0","53043","0"
"Mason","0","1","Washington","3/24/20","0","1","53045","1"
"Pierce","13","138","Washington","3/24/20","45","93","53053","206.67"
"San Juan","0","1","Washington","3/24/20","0","1","53055","1"
"Skagit","5","45","Washington","3/24/20","9","36","53057","400"
"Snohomish","50","614","Washington","3/24/20","266","348","53061","130.83"
"Spokane","4","29","Washington","3/24/20","4","25","53063","625"
"Stevens","0","1","Washington","3/24/20","0","1","53065","1"
"Thurston","1","11","Washington","3/24/20","5","6","53067","120"
"Walla Walla","0","1","Washington","3/24/20","0","1","53071","1"
"Whatcom","6","48","Washington","3/24/20","6","42","53073","700"
"Whitman","0","2","Washington","3/24/20","0","2","53075","1"
"Yakima","3","25","Washington","3/24/20","5","20","53077","400"
"Harrison","0","2","West Virginia","3/24/20","0","2","54033","1"
"Jackson","0","1","West Virginia","3/24/20","0","1","54035","1"
"Jefferson","0","3","West Virginia","3/24/20","0","3","54037","1"
"Kanawha","1","4","West Virginia","3/24/20","0","4","54039","1"
"Marshall","0","2","West Virginia","3/24/20","0","2","54051","1"
"Mercer","0","2","West Virginia","3/24/20","0","2","54055","1"
"Monongalia","1","5","West Virginia","3/24/20","0","5","54061","1"
"Putnam","0","1","West Virginia","3/24/20","0","1","54079","1"
"Tucker","0","2","West Virginia","3/24/20","0","2","54093","1"
"Bayfield","0","1","Wisconsin","3/24/20","0","1","55007","1"
"Brown","0","3","Wisconsin","3/24/20","0","3","55009","1"
"Calumet","0","1","Wisconsin","3/24/20","0","1","55015","1"
"Chippewa","0","1","Wisconsin","3/24/20","0","1","55017","1"
"Columbia","1","5","Wisconsin","3/24/20","0","5","55021","1"
"Dane","8","72","Wisconsin","3/24/20","19","53","55025","278.95"
"Dodge","0","2","Wisconsin","3/24/20","0","2","55027","1"
"Douglas","1","4","Wisconsin","3/24/20","0","4","55031","1"
"Dunn","0","1","Wisconsin","3/24/20","0","1","55033","1"
"Eau Claire","1","4","Wisconsin","3/24/20","0","4","55035","1"
"Fond du Lac","1","18","Wisconsin","3/24/20","12","6","55039","50"
"Green","0","1","Wisconsin","3/24/20","0","1","55045","1"
"Iowa","0","1","Wisconsin","3/24/20","0","1","55049","1"
"Jefferson","1","4","Wisconsin","3/24/20","0","4","55055","1"
"Kenosha","1","13","Wisconsin","3/24/20","4","9","55059","225"
"La Crosse","1","5","Wisconsin","3/24/20","0","5","55063","1"
"Marathon","0","1","Wisconsin","3/24/20","0","1","55073","1"
"Milwaukee","31","243","Wisconsin","3/24/20","24","219","55079","912.5"
"Outagamie","0","2","Wisconsin","3/24/20","1","1","55087","100"
"Ozaukee","2","16","Wisconsin","3/24/20","0","16","55089","1"
"Pierce","0","3","Wisconsin","3/24/20","1","2","55093","200"
"Racine","1","5","Wisconsin","3/24/20","1","4","55101","400"
"Rock","0","3","Wisconsin","3/24/20","0","3","55105","1"
"Sauk","1","4","Wisconsin","3/24/20","0","4","55111","1"
"Sheboygan","0","6","Wisconsin","3/24/20","3","3","55117","100"
"St. Croix","1","4","Wisconsin","3/24/20","0","4","55109","1"
"Walworth","1","4","Wisconsin","3/24/20","0","4","55127","1"
"Washington","2","17","Wisconsin","3/24/20","0","17","55131","1"
"Waukesha","4","31","Wisconsin","3/24/20","4","27","55133","675"
"Winnebago","0","5","Wisconsin","3/24/20","3","2","55139","66.67"
"Wood","0","1","Wisconsin","3/24/20","1","0","55141","0"
"Campbell","0","1","Wyoming","3/24/20","0","1","56005","1"
"Carbon","0","2","Wyoming","3/24/20","0","2","56007","1"
"Fremont","0","10","Wyoming","3/24/20","8","2","56013","25"
"Laramie","1","7","Wyoming","3/24/20","1","6","56021","600"
"Natrona","0","2","Wyoming","3/24/20","0","2","56025","1"
"Park","0","1","Wyoming","3/24/20","0","1","56029","1"
"Sheridan","0","4","Wyoming","3/24/20","2","2","56033","100"
"Teton","0","2","Wyoming","3/24/20","0","2","56039","1"
