"Locality","DailyAvgNewCasesPast7Days","TotalCases","State","Date","TotalCases7DaysAgo","NewCasesPast7Days","FIPS-Code","PercentIncreaseTotalCasesPast7Days"
"Baldwin","0","2","Alabama","3/21/20","0","2","01003","1"
"Calhoun","0","1","Alabama","3/21/20","0","1","01015","1"
"Chambers","0","1","Alabama","3/21/20","0","1","01017","1"
"Cullman","0","2","Alabama","3/21/20","0","2","01043","1"
"Elmore","1","6","Alabama","3/21/20","1","5","01051","500"
"Jackson","0","1","Alabama","3/21/20","0","1","01071","1"
"Jefferson","9","61","Alabama","3/21/20","1","60","01073","6000"
"Lamar","0","1","Alabama","3/21/20","0","1","01075","1"
"Lauderdale","0","2","Alabama","3/21/20","0","2","01077","1"
"Lee","2","12","Alabama","3/21/20","0","12","01081","1"
"Limestone","0","1","Alabama","3/21/20","1","0","01083","0"
"Madison","1","9","Alabama","3/21/20","1","8","01089","800"
"Marion","0","1","Alabama","3/21/20","0","1","01093","1"
"Mobile","0","2","Alabama","3/21/20","0","2","01097","1"
"Montgomery","0","3","Alabama","3/21/20","1","2","01101","200"
"Shelby","2","16","Alabama","3/21/20","0","16","01117","1"
"St. Clair","0","1","Alabama","3/21/20","0","1","01115","1"
"Talladega","0","1","Alabama","3/21/20","0","1","01121","1"
"Tuscaloosa","1","6","Alabama","3/21/20","1","5","01125","500"
"Walker","0","1","Alabama","3/21/20","0","1","01127","1"
"Washington","0","1","Alabama","3/21/20","0","1","01129","1"
"Anchorage","0","4","Alaska","3/21/20","1","3","02020","300"
"Fairbanks North Star","1","6","Alaska","3/21/20","0","6","02090","1"
"Ketchikan Gateway","0","3","Alaska","3/21/20","0","3","02130","1"
"Apache","0","3","Arizona","3/21/20","0","3","04001","1"
"Cochise","0","1","Arizona","3/21/20","0","1","04003","1"
"Coconino","2","11","Arizona","3/21/20","0","11","04005","1"
"Graham","0","1","Arizona","3/21/20","1","0","04009","0"
"Maricopa","6","49","Arizona","3/21/20","4","45","04013","1125"
"Navajo","1","10","Arizona","3/21/20","0","10","04017","1"
"Pima","1","12","Arizona","3/21/20","2","10","04019","500"
"Pinal","1","14","Arizona","3/21/20","5","9","04021","180"
"Santa Cruz","0","1","Arizona","3/21/20","0","1","04023","1"
"Yavapai","0","1","Arizona","3/21/20","0","1","04025","1"
"Yuma","0","1","Arizona","3/21/20","0","1","04027","1"
"Jefferson","0","3","Arkansas","3/21/20","3","0","05069","0"
"Washington","0","1","Arkansas","3/21/20","0","1","05143","1"
"Alameda","8","68","California","3/21/20","11","57","06001","518.18"
"Amador","0","1","California","3/21/20","0","1","06005","1"
"Calaveras","0","2","California","3/21/20","2","0","06009","0"
"Contra Costa","3","51","California","3/21/20","29","22","06013","75.86"
"Fresno","1","6","California","3/21/20","1","5","06019","500"
"Humboldt","0","1","California","3/21/20","1","0","06023","0"
"Imperial","0","4","California","3/21/20","2","2","06025","100"
"Kern","1","5","California","3/21/20","0","5","06029","1"
"Los Angeles","34","292","California","3/21/20","53","239","06037","450.94"
"Madera","0","3","California","3/21/20","1","2","06039","200"
"Marin","5","38","California","3/21/20","5","33","06041","660"
"Mendocino","0","1","California","3/21/20","0","1","06045","1"
"Mono","0","1","California","3/21/20","0","1","06051","1"
"Monterey","2","11","California","3/21/20","0","11","06053","1"
"Nevada","0","1","California","3/21/20","0","1","06057","1"
"Orange","9","78","California","3/21/20","14","64","06059","457.14"
"Placer","0","9","California","3/21/20","7","2","06061","28.57"
"Riverside","2","28","California","3/21/20","14","14","06065","100"
"Sacramento","3","53","California","3/21/20","29","24","06067","82.76"
"San Benito","0","5","California","3/21/20","3","2","06069","66.67"
"San Bernardino","1","10","California","3/21/20","0","10","06071","1"
"San Diego","17","127","California","3/21/20","10","117","06073","1170"
"San Francisco","8","84","California","3/21/20","28","56","06075","200"
"San Joaquin","3","31","California","3/21/20","8","23","06077","287.5"
"San Luis Obispo","3","21","California","3/21/20","0","21","06079","1"
"San Mateo","11","110","California","3/21/20","32","78","06081","243.75"
"Santa Barbara","1","9","California","3/21/20","0","9","06083","1"
"Santa Clara","24","263","California","3/21/20","95","168","06085","176.84"
"Santa Cruz","1","15","California","3/21/20","7","8","06087","114.29"
"Shasta","0","1","California","3/21/20","1","0","06089","0"
"Solano","1","13","California","3/21/20","6","7","06095","116.67"
"Sonoma","3","22","California","3/21/20","1","21","06097","2100"
"Stanislaus","0","5","California","3/21/20","2","3","06099","150"
"Tulare","1","11","California","3/21/20","2","9","06107","450"
"Ventura","2","19","California","3/21/20","5","14","06111","280"
"Yolo","1","6","California","3/21/20","2","4","06113","200"
"Adams","1","14","Colorado","3/21/20","6","8","08001","133.33"
"Arapahoe","4","40","Colorado","3/21/20","10","30","08005","300"
"Boulder","4","30","Colorado","3/21/20","1","29","08013","2900"
"Broomfield","0","1","Colorado","3/21/20","0","1","08014","1"
"Chaffee","0","2","Colorado","3/21/20","0","2","08015","1"
"Clear Creek","0","3","Colorado","3/21/20","1","2","08019","200"
"Crowley","0","1","Colorado","3/21/20","0","1","08025","1"
"Denver","11","97","Colorado","3/21/20","23","74","08031","321.74"
"Douglas","3","27","Colorado","3/21/20","4","23","08035","575"
"Eagle","8","74","Colorado","3/21/20","20","54","08037","270"
"El Paso","5","37","Colorado","3/21/20","3","34","08041","1133.33"
"Elbert","0","3","Colorado","3/21/20","0","3","08039","1"
"Garfield","1","7","Colorado","3/21/20","0","7","08045","1"
"Grand","0","2","Colorado","3/21/20","0","2","08049","1"
"Gunnison","2","18","Colorado","3/21/20","7","11","08051","157.14"
"Hinsdale","0","1","Colorado","3/21/20","0","1","08053","1"
"Jefferson","5","43","Colorado","3/21/20","9","34","08059","377.78"
"Larimer","3","19","Colorado","3/21/20","1","18","08069","1800"
"Mesa","0","1","Colorado","3/21/20","1","0","08077","0"
"Montrose","0","1","Colorado","3/21/20","0","1","08085","1"
"Morgan","0","2","Colorado","3/21/20","0","2","08087","1"
"Park","0","1","Colorado","3/21/20","0","1","08093","1"
"Pitkin","1","15","Colorado","3/21/20","11","4","08097","36.36"
"Pueblo","0","3","Colorado","3/21/20","1","2","08101","200"
"Routt","0","2","Colorado","3/21/20","1","1","08107","100"
"San Miguel","0","1","Colorado","3/21/20","0","1","08113","1"
"Summit","1","7","Colorado","3/21/20","2","5","08117","250"
"Weld","3","21","Colorado","3/21/20","2","19","08123","950"
"Yuma","0","1","Colorado","3/21/20","0","1","08125","1"
"Fairfield","15","122","Connecticut","3/21/20","15","107","09001","713.33"
"Hartford","4","29","Connecticut","3/21/20","1","28","09003","2800"
"Litchfield","1","8","Connecticut","3/21/20","3","5","09005","166.67"
"Middlesex","1","5","Connecticut","3/21/20","0","5","09007","1"
"New Haven","3","23","Connecticut","3/21/20","4","19","09009","475"
"New London","0","1","Connecticut","3/21/20","0","1","09011","1"
"Tolland","1","4","Connecticut","3/21/20","0","4","09013","1"
"Windham","0","2","Connecticut","3/21/20","0","2","09015","1"
"Kent","1","5","Delaware","3/21/20","0","5","10001","1"
"New Castle","4","32","Delaware","3/21/20","6","26","10003","433.33"
"Sussex","1","8","Delaware","3/21/20","0","8","10005","1"
"","7","49","Diamond Princess","3/21/20","0","49",,"1"
"District of Columbia","14","98","District of Columbia","3/21/20","0","98","11001","1"
"Alachua","3","25","Florida","3/21/20","1","24","12001","2400"
"Baker","0","1","Florida","3/21/20","0","1","12003","1"
"Bay","0","1","Florida","3/21/20","0","1","12005","1"
"Brevard","1","5","Florida","3/21/20","0","5","12009","1"
"Broward","21","164","Florida","3/21/20","20","144","12011","720"
"Charlotte","0","2","Florida","3/21/20","1","1","12015","100"
"Citrus","1","8","Florida","3/21/20","0","8","12017","1"
"Clay","1","6","Florida","3/21/20","1","5","12019","500"
"Collier","4","28","Florida","3/21/20","3","25","12021","833.33"
"Duval","3","25","Florida","3/21/20","1","24","12031","2400"
"Escambia","0","1","Florida","3/21/20","0","1","12033","1"
"Gadsden","0","1","Florida","3/21/20","0","1","12039","1"
"Hernando","1","6","Florida","3/21/20","0","6","12053","1"
"Hillsborough","6","47","Florida","3/21/20","2","45","12057","2250"
"Indian River","1","5","Florida","3/21/20","0","5","12061","1"
"Jackson","0","1","Florida","3/21/20","0","1","12063","1"
"Lake","1","4","Florida","3/21/20","0","4","12069","1"
"Lee","2","17","Florida","3/21/20","4","13","12071","325"
"Leon","1","4","Florida","3/21/20","0","4","12073","1"
"Manatee","1","13","Florida","3/21/20","4","9","12081","225"
"Marion","0","2","Florida","3/21/20","0","2","12083","1"
"Martin","0","1","Florida","3/21/20","0","1","12085","1"
"Miami-Dade","23","169","Florida","3/21/20","8","161","12086","2012.5"
"Monroe","0","1","Florida","3/21/20","0","1","12087","1"
"Nassau","0","1","Florida","3/21/20","1","0","12089","0"
"Okaloosa","2","12","Florida","3/21/20","1","11","12091","1100"
"Orange","4","29","Florida","3/21/20","1","28","12095","2800"
"Osceola","3","21","Florida","3/21/20","1","20","12097","2000"
"Palm Beach","7","56","Florida","3/21/20","5","51","12099","1020"
"Pasco","1","8","Florida","3/21/20","1","7","12101","700"
"Pinellas","4","29","Florida","3/21/20","2","27","12103","1350"
"Polk","1","10","Florida","3/21/20","0","10","12105","1"
"Putnam","0","1","Florida","3/21/20","0","1","12107","1"
"Santa Rosa","0","3","Florida","3/21/20","1","2","12113","200"
"Sarasota","2","14","Florida","3/21/20","1","13","12115","1300"
"Seminole","2","12","Florida","3/21/20","1","11","12117","1100"
"St. Johns","1","9","Florida","3/21/20","0","9","12109","1"
"St. Lucie","0","1","Florida","3/21/20","0","1","12111","1"
"Sumter","1","4","Florida","3/21/20","0","4","12119","1"
"Volusia","1","11","Florida","3/21/20","4","7","12127","175"
"Walton","1","4","Florida","3/21/20","0","4","12131","1"
"Baldwin","0","2","Georgia","3/21/20","0","2","13009","1"
"Barrow","0","1","Georgia","3/21/20","0","1","13013","1"
"Bartow","7","56","Georgia","3/21/20","7","49","13015","700"
"Bibb","0","1","Georgia","3/21/20","0","1","13021","1"
"Carroll","2","14","Georgia","3/21/20","0","14","13045","1"
"Charlton","0","1","Georgia","3/21/20","1","0","13049","0"
"Chatham","1","4","Georgia","3/21/20","0","4","13051","1"
"Cherokee","2","17","Georgia","3/21/20","5","12","13057","240"
"Clarke","1","9","Georgia","3/21/20","0","9","13059","1"
"Clayton","2","13","Georgia","3/21/20","0","13","13063","1"
"Cobb","5","50","Georgia","3/21/20","15","35","13067","233.33"
"Columbia","0","3","Georgia","3/21/20","0","3","13073","1"
"Coweta","1","8","Georgia","3/21/20","2","6","13077","300"
"Dawson","0","1","Georgia","3/21/20","0","1","13085","1"
"DeKalb","5","41","Georgia","3/21/20","8","33","13089","412.5"
"Dougherty","6","47","Georgia","3/21/20","7","40","13095","571.43"
"Douglas","1","4","Georgia","3/21/20","0","4","13097","1"
"Early","0","2","Georgia","3/21/20","0","2","13099","1"
"Effingham","0","1","Georgia","3/21/20","0","1","13103","1"
"Fayette","1","9","Georgia","3/21/20","4","5","13113","125"
"Floyd","1","8","Georgia","3/21/20","3","5","13115","166.67"
"Forsyth","1","4","Georgia","3/21/20","0","4","13117","1"
"Fulton","12","99","Georgia","3/21/20","13","86","13121","661.54"
"Glynn","0","2","Georgia","3/21/20","0","2","13127","1"
"Gordon","0","4","Georgia","3/21/20","2","2","13129","100"
"Gwinnett","3","23","Georgia","3/21/20","2","21","13135","1050"
"Hall","1","8","Georgia","3/21/20","0","8","13139","1"
"Heard","0","1","Georgia","3/21/20","0","1","13149","1"
"Henry","1","7","Georgia","3/21/20","1","6","13151","600"
"Houston","0","2","Georgia","3/21/20","0","2","13153","1"
"Lamar","0","1","Georgia","3/21/20","0","1","13171","1"
"Laurens","0","2","Georgia","3/21/20","0","2","13175","1"
"Lee","2","14","Georgia","3/21/20","1","13","13177","1300"
"Lincoln","0","1","Georgia","3/21/20","0","1","13181","1"
"Lowndes","1","7","Georgia","3/21/20","1","6","13185","600"
"Lumpkin","0","1","Georgia","3/21/20","0","1","13187","1"
"Miller","0","1","Georgia","3/21/20","0","1","13201","1"
"Monroe","0","1","Georgia","3/21/20","0","1","13207","1"
"Muscogee","0","2","Georgia","3/21/20","0","2","13215","1"
"Newton","1","4","Georgia","3/21/20","0","4","13217","1"
"Oconee","0","1","Georgia","3/21/20","0","1","13219","1"
"Paulding","1","4","Georgia","3/21/20","0","4","13223","1"
"Peach","0","2","Georgia","3/21/20","0","2","13225","1"
"Pickens","0","2","Georgia","3/21/20","0","2","13227","1"
"Polk","0","4","Georgia","3/21/20","1","3","13233","300"
"Randolph","0","1","Georgia","3/21/20","0","1","13243","1"
"Richmond","1","10","Georgia","3/21/20","0","10","13245","1"
"Rockdale","0","2","Georgia","3/21/20","0","2","13247","1"
"Spalding","0","2","Georgia","3/21/20","0","2","13255","1"
"Sumter","0","2","Georgia","3/21/20","0","2","13261","1"
"Terrell","0","2","Georgia","3/21/20","0","2","13273","1"
"Tift","0","2","Georgia","3/21/20","0","2","13277","1"
"Troup","1","4","Georgia","3/21/20","0","4","13285","1"
"Turner","0","1","Georgia","3/21/20","0","1","13287","1"
"Whitfield","0","1","Georgia","3/21/20","0","1","13313","1"
"Worth","0","2","Georgia","3/21/20","0","2","13321","1"
"","3","23","Grand Princess","3/21/20","0","23",,"1"
"","2","15","Guam","3/21/20","0","15",,"1"
"Honolulu","4","28","Hawaii","3/21/20","2","26","15003","1300"
"Kauai","0","3","Hawaii","3/21/20","2","1","15007","50"
"Maui","1","5","Hawaii","3/21/20","0","5","15009","1"
"Ada","1","11","Idaho","3/21/20","1","10","16001","1000"
"Bingham","0","2","Idaho","3/21/20","0","2","16011","1"
"Blaine","3","21","Idaho","3/21/20","1","20","16013","2000"
"Canyon","0","1","Idaho","3/21/20","0","1","16027","1"
"Kootenai","0","3","Idaho","3/21/20","0","3","16055","1"
"Madison","0","1","Idaho","3/21/20","0","1","16065","1"
"Teton","0","2","Idaho","3/21/20","0","2","16081","1"
"Twin Falls","0","1","Idaho","3/21/20","0","1","16083","1"
"Adams","0","1","Illinois","3/21/20","0","1","17001","1"
"Champaign","0","3","Illinois","3/21/20","0","3","17019","1"
"Christian","0","1","Illinois","3/21/20","0","1","17021","1"
"Clinton","0","3","Illinois","3/21/20","0","3","17027","1"
"Coles","0","0","Illinois","3/21/20","1","-1","17029","-100"
"Cook","71","548","Illinois","3/21/20","50","498","17031","996"
"Cumberland","0","1","Illinois","3/21/20","1","0","17035","0"
"DeKalb","0","1","Illinois","3/21/20","0","1","17037","1"
"DuPage","9","65","Illinois","3/21/20","1","64","17043","6400"
"Jackson","0","1","Illinois","3/21/20","0","1","17077","1"
"Kane","1","8","Illinois","3/21/20","3","5","17089","166.67"
"Kankakee","0","2","Illinois","3/21/20","0","2","17091","1"
"Kendall","0","2","Illinois","3/21/20","0","2","17093","1"
"Lake","9","63","Illinois","3/21/20","3","60","17097","2000"
"LaSalle","0","1","Illinois","3/21/20","0","1","17099","1"
"Madison","0","2","Illinois","3/21/20","0","2","17119","1"
"McHenry","1","11","Illinois","3/21/20","2","9","17111","450"
"McLean","1","6","Illinois","3/21/20","0","6","17113","1"
"Peoria","0","3","Illinois","3/21/20","0","3","17143","1"
"Sangamon","1","4","Illinois","3/21/20","0","4","17167","1"
"St. Clair","0","3","Illinois","3/21/20","2","1","17163","50"
"Washington","0","1","Illinois","3/21/20","0","1","17189","1"
"Whiteside","0","1","Illinois","3/21/20","0","1","17195","1"
"Will","2","12","Illinois","3/21/20","0","12","17197","1"
"Williamson","0","1","Illinois","3/21/20","0","1","17199","1"
"Winnebago","1","4","Illinois","3/21/20","0","4","17201","1"
"Woodford","0","2","Illinois","3/21/20","1","1","17203","100"
"Adams","0","1","Indiana","3/21/20","1","0","18001","0"
"Allen","1","4","Indiana","3/21/20","0","4","18003","1"
"Bartholomew","0","1","Indiana","3/21/20","0","1","18005","1"
"Boone","0","2","Indiana","3/21/20","1","1","18011","100"
"Clark","1","4","Indiana","3/21/20","0","4","18019","1"
"Delaware","0","1","Indiana","3/21/20","0","1","18035","1"
"Elkhart","0","1","Indiana","3/21/20","0","1","18039","1"
"Fayette","0","1","Indiana","3/21/20","0","1","18041","1"
"Floyd","1","5","Indiana","3/21/20","0","5","18043","1"
"Franklin","0","2","Indiana","3/21/20","0","2","18047","1"
"Grant","0","1","Indiana","3/21/20","0","1","18053","1"
"Greene","0","1","Indiana","3/21/20","0","1","18055","1"
"Hamilton","1","10","Indiana","3/21/20","0","10","18057","1"
"Hancock","0","1","Indiana","3/21/20","1","0","18059","0"
"Hendricks","1","6","Indiana","3/21/20","2","4","18063","200"
"Howard","1","5","Indiana","3/21/20","1","4","18067","400"
"Jennings","0","1","Indiana","3/21/20","0","1","18079","1"
"Johnson","1","7","Indiana","3/21/20","3","4","18081","133.33"
"Lake","1","7","Indiana","3/21/20","0","7","18089","1"
"LaPorte","0","2","Indiana","3/21/20","1","1","18091","100"
"Madison","0","1","Indiana","3/21/20","0","1","18095","1"
"Marion","6","46","Indiana","3/21/20","3","43","18097","1433.33"
"Monroe","0","1","Indiana","3/21/20","0","1","18105","1"
"Noble","0","1","Indiana","3/21/20","1","0","18113","0"
"Owen","0","1","Indiana","3/21/20","0","1","18119","1"
"Scott","0","1","Indiana","3/21/20","0","1","18143","1"
"Shelby","0","1","Indiana","3/21/20","0","1","18145","1"
"St. Joseph","1","6","Indiana","3/21/20","1","5","18141","500"
"Tippecanoe","0","2","Indiana","3/21/20","0","2","18157","1"
"Vanderburgh","0","1","Indiana","3/21/20","0","1","18163","1"
"Vigo","0","2","Indiana","3/21/20","0","2","18167","1"
"Wayne","0","1","Indiana","3/21/20","0","1","18177","1"
"Wells","0","1","Indiana","3/21/20","1","0","18179","0"
"Adair","0","1","Iowa","3/21/20","0","1","19001","1"
"Allamakee","1","5","Iowa","3/21/20","0","5","19005","1"
"Black Hawk","0","3","Iowa","3/21/20","0","3","19013","1"
"Carroll","0","1","Iowa","3/21/20","1","0","19027","0"
"Dallas","1","5","Iowa","3/21/20","0","5","19049","1"
"Dubuque","0","2","Iowa","3/21/20","0","2","19061","1"
"Fayette","0","1","Iowa","3/21/20","0","1","19065","1"
"Harrison","0","1","Iowa","3/21/20","1","0","19085","0"
"Henry","0","1","Iowa","3/21/20","0","1","19087","1"
"Johnson","2","27","Iowa","3/21/20","14","13","19103","92.86"
"Linn","0","3","Iowa","3/21/20","0","3","19113","1"
"Muscatine","0","2","Iowa","3/21/20","0","2","19139","1"
"Polk","1","10","Iowa","3/21/20","0","10","19153","1"
"Pottawattamie","0","2","Iowa","3/21/20","1","1","19155","100"
"Scott","0","1","Iowa","3/21/20","0","1","19163","1"
"Story","0","1","Iowa","3/21/20","0","1","19169","1"
"Washington","0","2","Iowa","3/21/20","0","2","19183","1"
"Winneshiek","0","1","Iowa","3/21/20","0","1","19191","1"
"Butler","0","2","Kansas","3/21/20","1","1","20015","100"
"Cherokee","0","1","Kansas","3/21/20","0","1","20021","1"
"Douglas","0","3","Kansas","3/21/20","0","3","20045","1"
"Franklin","0","1","Kansas","3/21/20","1","0","20059","0"
"Jackson","0","1","Kansas","3/21/20","0","1","20085","1"
"Johnson","3","25","Kansas","3/21/20","5","20","20091","400"
"Leavenworth","1","4","Kansas","3/21/20","0","4","20103","1"
"Linn","0","1","Kansas","3/21/20","0","1","20107","1"
"Mitchell","0","1","Kansas","3/21/20","0","1","20123","1"
"Morris","0","2","Kansas","3/21/20","0","2","20127","1"
"Reno","0","1","Kansas","3/21/20","0","1","20155","1"
"Riley","0","1","Kansas","3/21/20","0","1","20161","1"
"Sedgwick","0","1","Kansas","3/21/20","0","1","20173","1"
"Wyandotte","2","13","Kansas","3/21/20","1","12","20209","1200"
"Anderson","0","1","Kentucky","3/21/20","0","1","21005","1"
"Bourbon","0","2","Kentucky","3/21/20","0","2","21017","1"
"Calloway","0","1","Kentucky","3/21/20","0","1","21035","1"
"Christian","0","1","Kentucky","3/21/20","0","1","21047","1"
"Clark","0","2","Kentucky","3/21/20","0","2","21049","1"
"Daviess","0","1","Kentucky","3/21/20","0","1","21059","1"
"Fayette","1","10","Kentucky","3/21/20","3","7","21067","233.33"
"Franklin","0","1","Kentucky","3/21/20","0","1","21073","1"
"Hardin","0","1","Kentucky","3/21/20","0","1","21093","1"
"Harrison","0","7","Kentucky","3/21/20","6","1","21097","16.67"
"Henderson","0","2","Kentucky","3/21/20","0","2","21101","1"
"Jefferson","3","25","Kentucky","3/21/20","4","21","21111","525"
"Kenton","0","1","Kentucky","3/21/20","0","1","21117","1"
"Lyon","0","1","Kentucky","3/21/20","0","1","21143","1"
"Montgomery","0","2","Kentucky","3/21/20","2","0","21173","0"
"Nelson","0","1","Kentucky","3/21/20","1","0","21179","0"
"Oldham","0","1","Kentucky","3/21/20","0","1","21185","1"
"Pulaski","0","2","Kentucky","3/21/20","0","2","21199","1"
"Warren","0","2","Kentucky","3/21/20","0","2","21227","1"
"Ascension","2","12","Louisiana","3/21/20","0","12","22005","1"
"Assumption","0","1","Louisiana","3/21/20","0","1","22007","1"
"Avoyelles","0","1","Louisiana","3/21/20","0","1","22009","1"
"Beauregard","0","1","Louisiana","3/21/20","0","1","22011","1"
"Bienville","0","1","Louisiana","3/21/20","0","1","22013","1"
"Bossier","1","5","Louisiana","3/21/20","1","4","22015","400"
"Caddo","2","15","Louisiana","3/21/20","1","14","22017","1400"
"Calcasieu","1","4","Louisiana","3/21/20","0","4","22019","1"
"Catahoula","0","1","Louisiana","3/21/20","0","1","22025","1"
"Claiborne","0","1","Louisiana","3/21/20","0","1","22027","1"
"De Soto","0","2","Louisiana","3/21/20","0","2","22031","1"
"East Baton Rouge","3","18","Louisiana","3/21/20","0","18","22033","1"
"Evangeline","0","2","Louisiana","3/21/20","0","2","22039","1"
"Iberia","0","2","Louisiana","3/21/20","0","2","22045","1"
"Iberville","0","2","Louisiana","3/21/20","0","2","22047","1"
"Jefferson","22","166","Louisiana","3/21/20","11","155","22051","1409.09"
"Lafayette","1","6","Louisiana","3/21/20","0","6","22055","1"
"Lafourche","1","11","Louisiana","3/21/20","1","10","22057","1000"
"Livingston","0","2","Louisiana","3/21/20","0","2","22063","1"
"Orleans","52","418","Louisiana","3/21/20","53","365","22071","688.68"
"Ouachita","0","2","Louisiana","3/21/20","0","2","22073","1"
"Plaquemines","1","4","Louisiana","3/21/20","0","4","22075","1"
"Rapides","0","2","Louisiana","3/21/20","0","2","22079","1"
"St. Bernard","2","12","Louisiana","3/21/20","0","12","22087","1"
"St. Charles","1","7","Louisiana","3/21/20","2","5","22089","250"
"St. James","0","1","Louisiana","3/21/20","0","1","22093","1"
"St. John the Baptist","1","9","Louisiana","3/21/20","1","8","22095","800"
"St. Landry","0","3","Louisiana","3/21/20","0","3","22097","1"
"St. Mary","0","1","Louisiana","3/21/20","0","1","22101","1"
"St. Tammany","3","22","Louisiana","3/21/20","2","20","22103","1000"
"Tangipahoa","0","3","Louisiana","3/21/20","0","3","22105","1"
"Terrebonne","1","11","Louisiana","3/21/20","1","10","22109","1000"
"Washington","0","2","Louisiana","3/21/20","0","2","22117","1"
"Webster","0","1","Louisiana","3/21/20","0","1","22119","1"
"West Baton Rouge","0","3","Louisiana","3/21/20","0","3","22121","1"
"Androscoggin","0","3","Maine","3/21/20","1","2","23001","200"
"Cumberland","6","41","Maine","3/21/20","0","41","23005","1"
"Kennebec","1","4","Maine","3/21/20","0","4","23011","1"
"Lincoln","1","4","Maine","3/21/20","0","4","23015","1"
"Oxford","1","4","Maine","3/21/20","0","4","23017","1"
"Penobscot","0","2","Maine","3/21/20","0","2","23019","1"
"Sagadahoc","0","1","Maine","3/21/20","0","1","23023","1"
"York","1","8","Maine","3/21/20","0","8","23031","1"
"Anne Arundel","2","15","Maryland","3/21/20","1","14","24003","1400"
"Baltimore","2","19","Maryland","3/21/20","2","17","24005","850"
"Baltimore City","2","15","Maryland","3/21/20","0","15","24510","1"
"Calvert","0","1","Maryland","3/21/20","0","1","24009","1"
"Caroline","0","1","Maryland","3/21/20","0","1","24011","1"
"Carroll","0","3","Maryland","3/21/20","1","2","24013","200"
"Charles","0","4","Maryland","3/21/20","1","3","24017","300"
"Frederick","0","1","Maryland","3/21/20","0","1","24021","1"
"Harford","0","5","Maryland","3/21/20","2","3","24025","150"
"Howard","3","19","Maryland","3/21/20","0","19","24027","1"
"Montgomery","9","68","Maryland","3/21/20","6","62","24031","1033.33"
"Prince George's","4","36","Maryland","3/21/20","7","29","24033","414.29"
"Queen Anne's","0","1","Maryland","3/21/20","0","1","24035","1"
"Somerset","0","1","Maryland","3/21/20","0","1","24039","1"
"Talbot","0","1","Maryland","3/21/20","0","1","24041","1"
"Wicomico","0","2","Maryland","3/21/20","0","2","24045","1"
"Worcester","0","1","Maryland","3/21/20","0","1","24047","1"
"Barnstable","1","11","Massachusetts","3/21/20","1","10","25001","1000"
"Berkshire","2","21","Massachusetts","3/21/20","9","12","25003","133.33"
"Bristol","2","14","Massachusetts","3/21/20","1","13","25005","1300"
"Dukes and Nantucket","0","1","Massachusetts","3/21/20","0","1","00000","1"
"Essex","5","41","Massachusetts","3/21/20","5","36","25009","720"
"Franklin","1","6","Massachusetts","3/21/20","0","6","25011","1"
"Hampden","1","9","Massachusetts","3/21/20","0","9","25013","1"
"Hampshire","0","2","Massachusetts","3/21/20","0","2","25015","1"
"Middlesex","16","177","Massachusetts","3/21/20","65","112","25017","172.31"
"Norfolk","6","69","Massachusetts","3/21/20","28","41","25021","146.43"
"Plymouth","3","20","Massachusetts","3/21/20","0","20","25023","1"
"Suffolk","12","108","Massachusetts","3/21/20","27","81","25025","300"
"Worcester","3","24","Massachusetts","3/21/20","2","22","25027","1100"
"Allegan","0","1","Michigan","3/21/20","0","1","26005","1"
"Antrim","0","1","Michigan","3/21/20","0","1","26009","1"
"Barry","0","1","Michigan","3/21/20","0","1","26015","1"
"Bay","0","2","Michigan","3/21/20","1","1","26017","100"
"Berrien","2","14","Michigan","3/21/20","2","12","26021","600"
"Calhoun","0","1","Michigan","3/21/20","0","1","26025","1"
"Cass","0","2","Michigan","3/21/20","0","2","26027","1"
"Charlevoix","0","1","Michigan","3/21/20","1","0","26029","0"
"Clare","0","1","Michigan","3/21/20","0","1","26035","1"
"Clinton","0","2","Michigan","3/21/20","0","2","26037","1"
"Eaton","0","2","Michigan","3/21/20","0","2","26045","1"
"Genesee","1","7","Michigan","3/21/20","0","7","26049","1"
"Ingham","2","14","Michigan","3/21/20","2","12","26065","600"
"Jackson","0","3","Michigan","3/21/20","0","3","26075","1"
"Kalamazoo","0","1","Michigan","3/21/20","0","1","26077","1"
"Kent","3","21","Michigan","3/21/20","3","18","26081","600"
"Leelanau","0","1","Michigan","3/21/20","0","1","26089","1"
"Livingston","1","9","Michigan","3/21/20","0","9","26093","1"
"Macomb","14","102","Michigan","3/21/20","1","101","26099","10100"
"Midland","1","6","Michigan","3/21/20","2","4","26111","200"
"Monroe","0","3","Michigan","3/21/20","0","3","26115","1"
"Montcalm","0","1","Michigan","3/21/20","1","0","26117","0"
"Oakland","38","279","Michigan","3/21/20","11","268","26125","2436.36"
"Otsego","0","1","Michigan","3/21/20","0","1","26137","1"
"Ottawa","1","4","Michigan","3/21/20","0","4","26139","1"
"Saginaw","0","1","Michigan","3/21/20","0","1","26145","1"
"St. Clair","1","7","Michigan","3/21/20","1","6","26147","600"
"Washtenaw","4","33","Michigan","3/21/20","4","29","26161","725"
"Wayne","14","103","Michigan","3/21/20","6","97","26163","1616.67"
"Wexford","0","1","Michigan","3/21/20","0","1","26165","1"
"Anoka","1","5","Minnesota","3/21/20","1","4","27003","400"
"Benton","0","1","Minnesota","3/21/20","0","1","27009","1"
"Blue Earth","0","3","Minnesota","3/21/20","0","3","27013","1"
"Carver","0","3","Minnesota","3/21/20","1","2","27019","200"
"Chisago","0","1","Minnesota","3/21/20","0","1","27025","1"
"Clay","0","1","Minnesota","3/21/20","0","1","27027","1"
"Dakota","1","7","Minnesota","3/21/20","2","5","27037","250"
"Dodge","0","1","Minnesota","3/21/20","0","1","27039","1"
"Hennepin","7","52","Minnesota","3/21/20","6","46","27053","766.67"
"Jackson","0","1","Minnesota","3/21/20","0","1","27063","1"
"Martin","1","5","Minnesota","3/21/20","0","5","27091","1"
"Mower","0","3","Minnesota","3/21/20","0","3","27099","1"
"Nicollet","0","2","Minnesota","3/21/20","0","2","27103","1"
"Olmsted","2","12","Minnesota","3/21/20","1","11","27109","1100"
"Ramsey","2","17","Minnesota","3/21/20","5","12","27123","240"
"Renville","0","1","Minnesota","3/21/20","1","0","27129","0"
"Rice","0","1","Minnesota","3/21/20","0","1","27131","1"
"Scott","0","2","Minnesota","3/21/20","0","2","27139","1"
"St. Louis","0","1","Minnesota","3/21/20","0","1","27137","1"
"Stearns","0","4","Minnesota","3/21/20","3","1","27145","33.33"
"Steele","0","2","Minnesota","3/21/20","0","2","27147","1"
"Wabasha","0","1","Minnesota","3/21/20","0","1","27157","1"
"Waseca","0","1","Minnesota","3/21/20","0","1","27161","1"
"Washington","1","4","Minnesota","3/21/20","0","4","27163","1"
"Wright","0","3","Minnesota","3/21/20","1","2","27171","200"
"Adams","0","2","Mississippi","3/21/20","0","2","28001","1"
"Bolivar","0","2","Mississippi","3/21/20","0","2","28011","1"
"Clay","0","1","Mississippi","3/21/20","0","1","28025","1"
"Coahoma","1","5","Mississippi","3/21/20","0","5","28027","1"
"Copiah","0","2","Mississippi","3/21/20","1","1","28029","100"
"DeSoto","2","13","Mississippi","3/21/20","0","13","28033","1"
"Forrest","0","5","Mississippi","3/21/20","3","2","28035","66.67"
"Franklin","0","2","Mississippi","3/21/20","0","2","28037","1"
"George","0","1","Mississippi","3/21/20","0","1","28039","1"
"Grenada","0","1","Mississippi","3/21/20","0","1","28043","1"
"Hancock","1","4","Mississippi","3/21/20","0","4","28045","1"
"Harrison","1","8","Mississippi","3/21/20","0","8","28047","1"
"Hinds","1","7","Mississippi","3/21/20","0","7","28049","1"
"Holmes","0","3","Mississippi","3/21/20","0","3","28051","1"
"Humphreys","0","1","Mississippi","3/21/20","0","1","28053","1"
"Jackson","0","3","Mississippi","3/21/20","0","3","28059","1"
"Jones","0","1","Mississippi","3/21/20","0","1","28067","1"
"Lafayette","0","1","Mississippi","3/21/20","0","1","28071","1"
"Lawrence","0","1","Mississippi","3/21/20","0","1","28077","1"
"Lee","0","1","Mississippi","3/21/20","0","1","28081","1"
"Leflore","1","7","Mississippi","3/21/20","1","6","28083","600"
"Madison","0","3","Mississippi","3/21/20","0","3","28089","1"
"Marshall","0","1","Mississippi","3/21/20","0","1","28093","1"
"Monroe","0","2","Mississippi","3/21/20","0","2","28095","1"
"Pearl River","1","7","Mississippi","3/21/20","1","6","28109","600"
"Perry","0","1","Mississippi","3/21/20","0","1","28111","1"
"Pike","0","1","Mississippi","3/21/20","0","1","28113","1"
"Rankin","0","3","Mississippi","3/21/20","0","3","28121","1"
"Smith","0","1","Mississippi","3/21/20","0","1","28129","1"
"Tippah","0","3","Mississippi","3/21/20","0","3","28139","1"
"Walthall","0","1","Mississippi","3/21/20","0","1","28147","1"
"Webster","0","1","Mississippi","3/21/20","0","1","28155","1"
"Wilkinson","0","1","Mississippi","3/21/20","0","1","28157","1"
"Winston","0","1","Mississippi","3/21/20","0","1","28159","1"
"Yazoo","0","1","Mississippi","3/21/20","0","1","28163","1"
"Adair","0","1","Missouri","3/21/20","0","1","29001","1"
"Boone","1","10","Missouri","3/21/20","0","10","29019","1"
"Cass","1","6","Missouri","3/21/20","0","6","29037","1"
"Christian","0","2","Missouri","3/21/20","0","2","29043","1"
"Cole","0","3","Missouri","3/21/20","0","3","29051","1"
"Dunklin","0","1","Missouri","3/21/20","0","1","29069","1"
"Greene","1","8","Missouri","3/21/20","1","7","29077","700"
"Henry","0","1","Missouri","3/21/20","1","0","29083","0"
"Jackson","1","8","Missouri","3/21/20","0","8","29095","1"
"Jasper","0","1","Missouri","3/21/20","0","1","29097","1"
"Kansas City","2","12","Missouri","3/21/20","0","12","00000","1"
"Pulaski","0","1","Missouri","3/21/20","0","1","29169","1"
"Scott","0","1","Missouri","3/21/20","0","1","29201","1"
"St. Charles","0","2","Missouri","3/21/20","0","2","29183","1"
"St. Louis","3","22","Missouri","3/21/20","2","20","29189","1000"
"St. Louis City","1","10","Missouri","3/21/20","0","10","29510","1"
"Broadwater","0","1","Montana","3/21/20","0","1","30007","1"
"Flathead","0","2","Montana","3/21/20","0","2","30029","1"
"Gallatin","1","7","Montana","3/21/20","1","6","30031","600"
"Lewis and Clark","0","3","Montana","3/21/20","1","2","30049","200"
"Madison","0","1","Montana","3/21/20","0","1","30057","1"
"Missoula","0","3","Montana","3/21/20","0","3","30063","1"
"Ravalli","0","1","Montana","3/21/20","0","1","30081","1"
"Roosevelt","0","1","Montana","3/21/20","0","1","30085","1"
"Silver Bow","0","2","Montana","3/21/20","1","1","30093","100"
"Yellowstone","1","5","Montana","3/21/20","1","4","30111","400"
"Adams","0","1","Nebraska","3/21/20","0","1","31001","1"
"Buffalo","0","1","Nebraska","3/21/20","0","1","31019","1"
"Cass","0","1","Nebraska","3/21/20","1","0","31025","0"
"Douglas","1","25","Nebraska","3/21/20","16","9","31055","56.25"
"Knox","0","2","Nebraska","3/21/20","1","1","31107","100"
"Lancaster","0","2","Nebraska","3/21/20","0","2","31109","1"
"Lincoln","0","3","Nebraska","3/21/20","0","3","31111","1"
"Nemaha","0","1","Nebraska","3/21/20","0","1","31127","1"
"Sarpy","0","2","Nebraska","3/21/20","0","2","31153","1"
"Carson City","0","2","Nevada","3/21/20","0","2","32510","1"
"Clark","16","126","Nevada","3/21/20","16","110","32003","687.5"
"Elko","0","1","Nevada","3/21/20","0","1","32007","1"
"Washoe","3","22","Nevada","3/21/20","4","18","32031","450"
"Carroll","1","5","New Hampshire","3/21/20","0","5","33003","1"
"Cheshire","0","1","New Hampshire","3/21/20","0","1","33005","1"
"Coos","0","1","New Hampshire","3/21/20","0","1","33007","1"
"Grafton","1","13","New Hampshire","3/21/20","3","10","33009","333.33"
"Hillsborough","2","11","New Hampshire","3/21/20","0","11","33011","1"
"Merrimack","1","4","New Hampshire","3/21/20","0","4","33013","1"
"Rockingham","3","25","New Hampshire","3/21/20","4","21","33015","525"
"Strafford","0","1","New Hampshire","3/21/20","0","1","33017","1"
"Atlantic","1","4","New Jersey","3/21/20","0","4","34001","1"
"Bergen","48","363","New Jersey","3/21/20","25","338","34003","1352"
"Burlington","3","21","New Jersey","3/21/20","3","18","34005","600"
"Camden","2","15","New Jersey","3/21/20","2","13","34007","650"
"Cape May","0","2","New Jersey","3/21/20","0","2","34009","1"
"Cumberland","0","1","New Jersey","3/21/20","0","1","34011","1"
"Essex","14","107","New Jersey","3/21/20","7","100","34013","1428.57"
"Gloucester","1","6","New Jersey","3/21/20","0","6","34015","1"
"Hudson","13","97","New Jersey","3/21/20","5","92","34017","1840"
"Hunterdon","2","14","New Jersey","3/21/20","0","14","34019","1"
"Mercer","4","30","New Jersey","3/21/20","1","29","34021","2900"
"Middlesex","15","116","New Jersey","3/21/20","10","106","34023","1060"
"Monmouth","12","92","New Jersey","3/21/20","8","84","34025","1050"
"Morris","9","64","New Jersey","3/21/20","3","61","34027","2033.33"
"Ocean","9","62","New Jersey","3/21/20","1","61","34029","6100"
"Passaic","9","67","New Jersey","3/21/20","2","65","34031","3250"
"Somerset","5","34","New Jersey","3/21/20","1","33","34035","3300"
"Sussex","1","6","New Jersey","3/21/20","0","6","34037","1"
"Union","11","81","New Jersey","3/21/20","1","80","34039","8000"
"Warren","1","5","New Jersey","3/21/20","0","5","34041","1"
"Bernalillo","4","32","New Mexico","3/21/20","6","26","35001","433.33"
"Lea","0","1","New Mexico","3/21/20","0","1","35025","1"
"McKinley","0","1","New Mexico","3/21/20","0","1","35031","1"
"San Miguel","0","1","New Mexico","3/21/20","0","1","35047","1"
"Sandoval","1","7","New Mexico","3/21/20","2","5","35043","250"
"Santa Fe","1","8","New Mexico","3/21/20","3","5","35049","166.67"
"Socorro","0","2","New Mexico","3/21/20","2","0","35053","0"
"Taos","0","3","New Mexico","3/21/20","0","3","35055","1"
"Albany","12","88","New York","3/21/20","7","81","36001","1157.14"
"Allegany","0","2","New York","3/21/20","0","2","36003","1"
"Broome","0","2","New York","3/21/20","1","1","36007","100"
"Chenango","0","2","New York","3/21/20","0","2","36017","1"
"Clinton","1","4","New York","3/21/20","0","4","36019","1"
"Columbia","1","7","New York","3/21/20","0","7","36021","1"
"Delaware","0","1","New York","3/21/20","1","0","36025","0"
"Dutchess","6","49","New York","3/21/20","4","45","36027","1125"
"Erie","7","50","New York","3/21/20","3","47","36029","1566.67"
"Essex","0","2","New York","3/21/20","0","2","36031","1"
"Fulton","0","1","New York","3/21/20","0","1","36035","1"
"Genesee","0","1","New York","3/21/20","0","1","36037","1"
"Greene","0","2","New York","3/21/20","0","2","36039","1"
"Hamilton","0","2","New York","3/21/20","0","2","36041","1"
"Herkimer","0","3","New York","3/21/20","1","2","36043","200"
"Jefferson","0","1","New York","3/21/20","0","1","36045","1"
"Livingston","0","2","New York","3/21/20","0","2","36051","1"
"Monroe","6","46","New York","3/21/20","2","44","36055","2200"
"Montgomery","0","3","New York","3/21/20","0","3","36057","1"
"Nassau","167","1234","New York","3/21/20","68","1166","36059","1714.71"
"New York","1037","7530","New York","3/21/20","269","7261","36061","2699.26"
"Niagara","1","9","New York","3/21/20","0","9","36063","1"
"Oneida","1","4","New York","3/21/20","0","4","36065","1"
"Onondaga","5","34","New York","3/21/20","0","34","36067","1"
"Ontario","1","4","New York","3/21/20","0","4","36069","1"
"Orange","22","163","New York","3/21/20","6","157","36071","2616.67"
"Putnam","4","31","New York","3/21/20","0","31","36079","1"
"Rensselaer","3","20","New York","3/21/20","0","20","36083","1"
"Rockland","36","262","New York","3/21/20","10","252","36087","2520"
"Saratoga","5","35","New York","3/21/20","3","32","36091","1066.67"
"Schenectady","4","32","New York","3/21/20","1","31","36093","3100"
"Schoharie","0","1","New York","3/21/20","0","1","36095","1"
"Steuben","0","2","New York","3/21/20","0","2","36101","1"
"Suffolk","90","662","New York","3/21/20","33","629","36103","1906.06"
"Sullivan","2","12","New York","3/21/20","0","12","36105","1"
"Tioga","0","1","New York","3/21/20","1","0","36107","0"
"Tompkins","1","11","New York","3/21/20","1","10","36109","1000"
"Ulster","2","18","New York","3/21/20","5","13","36111","260"
"Warren","0","1","New York","3/21/20","0","1","36113","1"
"Washington","0","1","New York","3/21/20","0","1","36115","1"
"Wayne","0","3","New York","3/21/20","0","3","36117","1"
"Westchester","174","1387","New York","3/21/20","172","1215","36119","706.4"
"Wyoming","0","2","New York","3/21/20","0","2","36121","1"
"Alamance","0","2","North Carolina","3/21/20","0","2","37001","1"
"Brunswick","0","4","North Carolina","3/21/20","1","3","37019","300"
"Buncombe","0","2","North Carolina","3/21/20","0","2","37021","1"
"Cabarrus","1","5","North Carolina","3/21/20","1","4","37025","400"
"Carteret","1","5","North Carolina","3/21/20","0","5","37031","1"
"Catawba","0","1","North Carolina","3/21/20","0","1","37035","1"
"Chatham","0","3","North Carolina","3/21/20","1","2","37037","200"
"Cherokee","1","4","North Carolina","3/21/20","0","4","37039","1"
"Chowan","0","1","North Carolina","3/21/20","0","1","37041","1"
"Craven","0","2","North Carolina","3/21/20","1","1","37049","100"
"Cumberland","0","3","North Carolina","3/21/20","0","3","37051","1"
"Davidson","0","1","North Carolina","3/21/20","0","1","37057","1"
"Davie","0","1","North Carolina","3/21/20","0","1","37059","1"
"Durham","6","40","North Carolina","3/21/20","1","39","37063","3900"
"Forsyth","1","12","North Carolina","3/21/20","2","10","37067","500"
"Franklin","1","4","North Carolina","3/21/20","0","4","37069","1"
"Gaston","0","1","North Carolina","3/21/20","0","1","37071","1"
"Granville","0","1","North Carolina","3/21/20","0","1","37077","1"
"Guilford","1","7","North Carolina","3/21/20","0","7","37081","1"
"Harnett","1","7","North Carolina","3/21/20","1","6","37085","600"
"Hoke","0","1","North Carolina","3/21/20","0","1","37093","1"
"Hyde","0","1","North Carolina","3/21/20","0","1","37095","1"
"Iredell","0","2","North Carolina","3/21/20","0","2","37097","1"
"Johnston","0","3","North Carolina","3/21/20","2","1","37101","50"
"Lee","0","1","North Carolina","3/21/20","0","1","37105","1"
"Lincoln","0","1","North Carolina","3/21/20","0","1","37109","1"
"Mecklenburg","11","77","North Carolina","3/21/20","2","75","37119","3750"
"Montgomery","0","1","North Carolina","3/21/20","0","1","37123","1"
"Moore","0","2","North Carolina","3/21/20","0","2","37125","1"
"New Hanover","1","4","North Carolina","3/21/20","0","4","37129","1"
"Onslow","0","3","North Carolina","3/21/20","1","2","37133","200"
"Orange","1","4","North Carolina","3/21/20","0","4","37135","1"
"Pasquotank","0","1","North Carolina","3/21/20","0","1","37139","1"
"Pitt","0","2","North Carolina","3/21/20","0","2","37147","1"
"Robeson","0","1","North Carolina","3/21/20","0","1","37155","1"
"Rowan","0","2","North Carolina","3/21/20","0","2","37159","1"
"Sampson","0","1","North Carolina","3/21/20","0","1","37163","1"
"Union","1","6","North Carolina","3/21/20","0","6","37179","1"
"Wake","3","32","North Carolina","3/21/20","11","21","37183","190.91"
"Watauga","0","2","North Carolina","3/21/20","0","2","37189","1"
"Wayne","0","1","North Carolina","3/21/20","1","0","37191","0"
"Wilson","0","2","North Carolina","3/21/20","0","2","37195","1"
"Burleigh","2","15","North Dakota","3/21/20","0","15","38015","1"
"Cass","0","1","North Dakota","3/21/20","0","1","38017","1"
"Morton","1","7","North Dakota","3/21/20","0","7","38059","1"
"Pierce","0","1","North Dakota","3/21/20","0","1","38069","1"
"Ramsey","0","1","North Dakota","3/21/20","0","1","38071","1"
"Ward","0","3","North Dakota","3/21/20","1","2","38101","200"
"Ashland","0","1","Ohio","3/21/20","0","1","39005","1"
"Ashtabula","0","1","Ohio","3/21/20","0","1","39007","1"
"Belmont","0","2","Ohio","3/21/20","2","0","39013","0"
"Butler","2","16","Ohio","3/21/20","4","12","39017","300"
"Clark","0","1","Ohio","3/21/20","0","1","39023","1"
"Clermont","0","2","Ohio","3/21/20","0","2","39025","1"
"Coshocton","0","2","Ohio","3/21/20","0","2","39031","1"
"Cuyahoga","12","92","Ohio","3/21/20","11","81","39035","736.36"
"Darke","0","1","Ohio","3/21/20","0","1","39037","1"
"Defiance","0","2","Ohio","3/21/20","0","2","39039","1"
"Delaware","1","4","Ohio","3/21/20","0","4","39041","1"
"Erie","0","1","Ohio","3/21/20","0","1","39043","1"
"Franklin","3","21","Ohio","3/21/20","1","20","39049","2000"
"Gallia","0","1","Ohio","3/21/20","0","1","39053","1"
"Geauga","0","1","Ohio","3/21/20","0","1","39055","1"
"Hamilton","1","8","Ohio","3/21/20","0","8","39061","1"
"Huron","0","1","Ohio","3/21/20","0","1","39077","1"
"Lake","1","4","Ohio","3/21/20","0","4","39085","1"
"Licking","0","1","Ohio","3/21/20","0","1","39089","1"
"Lorain","2","14","Ohio","3/21/20","1","13","39093","1300"
"Lucas","1","4","Ohio","3/21/20","0","4","39095","1"
"Mahoning","2","14","Ohio","3/21/20","0","14","39099","1"
"Marion","0","1","Ohio","3/21/20","0","1","39101","1"
"Medina","1","9","Ohio","3/21/20","0","9","39103","1"
"Miami","2","11","Ohio","3/21/20","0","11","39109","1"
"Montgomery","0","1","Ohio","3/21/20","0","1","39113","1"
"Richland","0","1","Ohio","3/21/20","0","1","39139","1"
"Stark","1","8","Ohio","3/21/20","3","5","39151","166.67"
"Summit","2","15","Ohio","3/21/20","2","13","39153","650"
"Trumbull","0","3","Ohio","3/21/20","2","1","39155","50"
"Tuscarawas","0","1","Ohio","3/21/20","0","1","39157","1"
"Union","0","1","Ohio","3/21/20","0","1","39159","1"
"Warren","0","2","Ohio","3/21/20","0","2","39165","1"
"Canadian","0","2","Oklahoma","3/21/20","0","2","40017","1"
"Cleveland","2","12","Oklahoma","3/21/20","0","12","40027","1"
"Custer","0","1","Oklahoma","3/21/20","0","1","40039","1"
"Garvin","0","2","Oklahoma","3/21/20","0","2","40049","1"
"Grady","0","1","Oklahoma","3/21/20","0","1","40051","1"
"Jackson","0","1","Oklahoma","3/21/20","1","0","40065","0"
"Kay","0","3","Oklahoma","3/21/20","0","3","40071","1"
"Logan","0","1","Oklahoma","3/21/20","0","1","40083","1"
"McClain","0","1","Oklahoma","3/21/20","0","1","40087","1"
"Oklahoma","3","20","Oklahoma","3/21/20","1","19","40109","1900"
"Pawnee","0","2","Oklahoma","3/21/20","0","2","40117","1"
"Payne","0","1","Oklahoma","3/21/20","0","1","40119","1"
"Tulsa","0","5","Oklahoma","3/21/20","2","3","40143","150"
"Washington","0","1","Oklahoma","3/21/20","0","1","40147","1"
"Benton","0","2","Oregon","3/21/20","0","2","41003","1"
"Clackamas","1","11","Oregon","3/21/20","1","10","41005","1000"
"Deschutes","1","9","Oregon","3/21/20","3","6","41017","200"
"Douglas","0","1","Oregon","3/21/20","1","0","41019","0"
"Grant","0","1","Oregon","3/21/20","0","1","41023","1"
"Jackson","0","2","Oregon","3/21/20","2","0","41029","0"
"Josephine","0","1","Oregon","3/21/20","0","1","41033","1"
"Klamath","0","1","Oregon","3/21/20","1","0","41035","0"
"Lane","0","3","Oregon","3/21/20","0","3","41039","1"
"Linn","1","19","Oregon","3/21/20","9","10","41043","111.11"
"Marion","2","19","Oregon","3/21/20","2","17","41047","850"
"Multnomah","2","18","Oregon","3/21/20","1","17","41051","1700"
"Polk","0","1","Oregon","3/21/20","1","0","41053","0"
"Umatilla","0","2","Oregon","3/21/20","2","0","41059","0"
"Union","0","1","Oregon","3/21/20","0","1","41061","1"
"Washington","4","42","Oregon","3/21/20","13","29","41067","223.08"
"Yamhill","1","4","Oregon","3/21/20","0","4","41071","1"
"Adams","1","4","Pennsylvania","3/21/20","0","4","42001","1"
"Allegheny","4","31","Pennsylvania","3/21/20","2","29","42003","1450"
"Beaver","0","3","Pennsylvania","3/21/20","0","3","42007","1"
"Berks","1","7","Pennsylvania","3/21/20","0","7","42011","1"
"Bucks","4","28","Pennsylvania","3/21/20","3","25","42017","833.33"
"Butler","0","1","Pennsylvania","3/21/20","0","1","42019","1"
"Centre","0","1","Pennsylvania","3/21/20","0","1","42027","1"
"Chester","2","19","Pennsylvania","3/21/20","2","17","42029","850"
"Cumberland","1","11","Pennsylvania","3/21/20","3","8","42041","266.67"
"Dauphin","0","1","Pennsylvania","3/21/20","0","1","42043","1"
"Delaware","4","33","Pennsylvania","3/21/20","6","27","42045","450"
"Erie","0","1","Pennsylvania","3/21/20","0","1","42049","1"
"Franklin","0","1","Pennsylvania","3/21/20","0","1","42055","1"
"Lackawanna","1","5","Pennsylvania","3/21/20","0","5","42069","1"
"Lancaster","1","4","Pennsylvania","3/21/20","0","4","42071","1"
"Lebanon","0","2","Pennsylvania","3/21/20","0","2","42075","1"
"Lehigh","2","13","Pennsylvania","3/21/20","0","13","42077","1"
"Luzerne","1","6","Pennsylvania","3/21/20","0","6","42079","1"
"Monroe","3","25","Pennsylvania","3/21/20","3","22","42089","733.33"
"Montgomery","8","77","Pennsylvania","3/21/20","20","57","42091","285"
"Montour","0","1","Pennsylvania","3/21/20","0","1","42093","1"
"Northampton","2","17","Pennsylvania","3/21/20","1","16","42095","1600"
"Philadelphia","12","85","Pennsylvania","3/21/20","4","81","42101","2025"
"Pike","0","3","Pennsylvania","3/21/20","1","2","42103","200"
"Potter","0","1","Pennsylvania","3/21/20","0","1","42105","1"
"Washington","1","5","Pennsylvania","3/21/20","1","4","42125","400"
"Wayne","0","1","Pennsylvania","3/21/20","1","0","42127","0"
"Westmoreland","1","4","Pennsylvania","3/21/20","0","4","42129","1"
"York","1","9","Pennsylvania","3/21/20","0","9","42133","1"
"","3","21","Puerto Rico","3/21/20","0","21",,"1"
"Bristol","1","4","Rhode Island","3/21/20","0","4","44001","1"
"Kent","1","4","Rhode Island","3/21/20","0","4","44003","1"
"Newport","1","8","Rhode Island","3/21/20","0","8","44005","1"
"Providence","1","30","Rhode Island","3/21/20","20","10","44007","50"
"Washington","1","8","Rhode Island","3/21/20","0","8","44009","1"
"Abbeville","0","1","South Carolina","3/21/20","0","1","45001","1"
"Aiken","0","1","South Carolina","3/21/20","0","1","45003","1"
"Anderson","1","10","South Carolina","3/21/20","0","10","45007","1"
"Beaufort","1","13","South Carolina","3/21/20","3","10","45013","333.33"
"Berkeley","0","1","South Carolina","3/21/20","0","1","45015","1"
"Calhoun","0","1","South Carolina","3/21/20","0","1","45017","1"
"Charleston","1","9","South Carolina","3/21/20","1","8","45019","800"
"Clarendon","0","1","South Carolina","3/21/20","0","1","45027","1"
"Colleton","0","1","South Carolina","3/21/20","0","1","45029","1"
"Darlington","0","2","South Carolina","3/21/20","0","2","45031","1"
"Dillon","0","1","South Carolina","3/21/20","0","1","45033","1"
"Dorchester","0","1","South Carolina","3/21/20","0","1","45035","1"
"Edgefield","0","1","South Carolina","3/21/20","0","1","45037","1"
"Fairfield","0","1","South Carolina","3/21/20","0","1","45039","1"
"Florence","0","1","South Carolina","3/21/20","0","1","45041","1"
"Greenville","2","17","South Carolina","3/21/20","0","17","45045","1"
"Greenwood","0","3","South Carolina","3/21/20","0","3","45047","1"
"Horry","1","9","South Carolina","3/21/20","0","9","45051","1"
"Kershaw","5","43","South Carolina","3/21/20","11","32","45055","290.91"
"Lancaster","0","3","South Carolina","3/21/20","2","1","45057","50"
"Lee","0","1","South Carolina","3/21/20","0","1","45061","1"
"Lexington","2","12","South Carolina","3/21/20","1","11","45063","1100"
"Marlboro","0","1","South Carolina","3/21/20","0","1","45069","1"
"Newberry","0","1","South Carolina","3/21/20","0","1","45071","1"
"Orangeburg","0","3","South Carolina","3/21/20","0","3","45075","1"
"Pickens","0","1","South Carolina","3/21/20","0","1","45077","1"
"Richland","4","27","South Carolina","3/21/20","0","27","45079","1"
"Saluda","0","1","South Carolina","3/21/20","0","1","45081","1"
"Spartanburg","0","2","South Carolina","3/21/20","1","1","45083","100"
"Sumter","0","3","South Carolina","3/21/20","0","3","45085","1"
"York","0","2","South Carolina","3/21/20","0","2","45091","1"
"Beadle","0","4","South Dakota","3/21/20","1","3","46005","300"
"Bon Homme","0","1","South Dakota","3/21/20","1","0","46009","0"
"Charles Mix","0","1","South Dakota","3/21/20","1","0","46023","0"
"Davison","0","1","South Dakota","3/21/20","0","1","46035","1"
"McCook","0","1","South Dakota","3/21/20","1","0","46087","0"
"Minnehaha","0","5","South Dakota","3/21/20","3","2","46099","66.67"
"Pennington","0","1","South Dakota","3/21/20","1","0","46103","0"
"Anderson","0","1","Tennessee","3/21/20","0","1","47001","1"
"Blount","0","1","Tennessee","3/21/20","0","1","47009","1"
"Bradley","0","1","Tennessee","3/21/20","0","1","47011","1"
"Campbell","0","2","Tennessee","3/21/20","1","1","47013","100"
"Carroll","0","1","Tennessee","3/21/20","0","1","47017","1"
"Cheatham","0","2","Tennessee","3/21/20","0","2","47021","1"
"Cocke","0","1","Tennessee","3/21/20","0","1","47029","1"
"Cumberland","0","2","Tennessee","3/21/20","0","2","47035","1"
"Davidson","18","140","Tennessee","3/21/20","14","126","47037","900"
"Dickson","0","3","Tennessee","3/21/20","0","3","47043","1"
"Dyer","0","2","Tennessee","3/21/20","0","2","47045","1"
"Fayette","0","1","Tennessee","3/21/20","0","1","47047","1"
"Greene","0","1","Tennessee","3/21/20","0","1","47059","1"
"Hamblen","0","2","Tennessee","3/21/20","0","2","47063","1"
"Hamilton","1","7","Tennessee","3/21/20","1","6","47065","600"
"Jefferson","0","1","Tennessee","3/21/20","1","0","47089","0"
"Knox","0","4","Tennessee","3/21/20","1","3","47093","300"
"Maury","0","1","Tennessee","3/21/20","0","1","47119","1"
"Monroe","0","3","Tennessee","3/21/20","0","3","47123","1"
"Montgomery","0","3","Tennessee","3/21/20","0","3","47125","1"
"Putnam","1","5","Tennessee","3/21/20","0","5","47141","1"
"Roane","0","1","Tennessee","3/21/20","0","1","47145","1"
"Robertson","0","2","Tennessee","3/21/20","0","2","47147","1"
"Rutherford","1","5","Tennessee","3/21/20","1","4","47149","400"
"Scott","0","2","Tennessee","3/21/20","0","2","47151","1"
"Sevier","0","2","Tennessee","3/21/20","0","2","47155","1"
"Shelby","6","42","Tennessee","3/21/20","2","40","47157","2000"
"Sullivan","0","1","Tennessee","3/21/20","1","0","47163","0"
"Sumner","2","11","Tennessee","3/21/20","0","11","47165","1"
"Tipton","0","2","Tennessee","3/21/20","0","2","47167","1"
"Washington","0","2","Tennessee","3/21/20","0","2","47179","1"
"Williamson","5","47","Tennessee","3/21/20","10","37","47187","370"
"Wilson","0","3","Tennessee","3/21/20","0","3","47189","1"
"Bell","1","8","Texas","3/21/20","1","7","48027","700"
"Bexar","5","39","Texas","3/21/20","2","37","48029","1850"
"Bowie","0","1","Texas","3/21/20","0","1","48037","1"
"Brazoria","2","14","Texas","3/21/20","2","12","48039","600"
"Brazos","1","10","Texas","3/21/20","0","10","48041","1"
"Brown","0","2","Texas","3/21/20","0","2","48049","1"
"Cameron","0","2","Texas","3/21/20","0","2","48061","1"
"Castro","0","1","Texas","3/21/20","0","1","48069","1"
"Collin","3","27","Texas","3/21/20","6","21","48085","350"
"Comal","0","2","Texas","3/21/20","0","2","48091","1"
"Crane","0","1","Texas","3/21/20","0","1","48103","1"
"Dallas","12","95","Texas","3/21/20","9","86","48113","955.56"
"Denton","3","24","Texas","3/21/20","0","24","48121","1"
"DeWitt","0","1","Texas","3/21/20","0","1","48123","1"
"El Paso","1","7","Texas","3/21/20","1","6","48141","600"
"Ellis","0","3","Texas","3/21/20","0","3","48139","1"
"Fannin","0","1","Texas","3/21/20","0","1","48147","1"
"Fayette","0","1","Texas","3/21/20","0","1","48149","1"
"Fort Bend","3","29","Texas","3/21/20","9","20","48157","222.22"
"Galveston","1","8","Texas","3/21/20","1","7","48167","700"
"Gregg","0","1","Texas","3/21/20","4","-3","48183","-75"
"Grimes","0","2","Texas","3/21/20","0","2","48185","1"
"Guadalupe","0","1","Texas","3/21/20","0","1","48187","1"
"Harris","8","68","Texas","3/21/20","11","57","48201","518.18"
"Hays","1","6","Texas","3/21/20","0","6","48209","1"
"Hockley","0","3","Texas","3/21/20","0","3","48219","1"
"Jefferson","0","1","Texas","3/21/20","0","1","48245","1"
"Johnson","0","2","Texas","3/21/20","0","2","48251","1"
"Kendall","0","1","Texas","3/21/20","0","1","48259","1"
"Lamar","0","1","Texas","3/21/20","0","1","48277","1"
"Lavaca","0","1","Texas","3/21/20","1","0","48285","0"
"Lubbock","1","9","Texas","3/21/20","0","9","48303","1"
"Matagorda","0","3","Texas","3/21/20","0","3","48321","1"
"McLennan","2","16","Texas","3/21/20","0","16","48309","1"
"Medina","0","1","Texas","3/21/20","0","1","48325","1"
"Midland","0","1","Texas","3/21/20","0","1","48329","1"
"Milam","0","1","Texas","3/21/20","0","1","48331","1"
"Montgomery","1","13","Texas","3/21/20","4","9","48339","225"
"Nueces","0","1","Texas","3/21/20","0","1","48355","1"
"Oldham","0","1","Texas","3/21/20","0","1","48359","1"
"Randall","0","2","Texas","3/21/20","0","2","48381","1"
"Rusk","0","1","Texas","3/21/20","0","1","48401","1"
"Smith","0","6","Texas","3/21/20","3","3","48423","100"
"Tarrant","6","42","Texas","3/21/20","3","39","48439","1300"
"Travis","8","62","Texas","3/21/20","3","59","48453","1966.67"
"Upshur","0","1","Texas","3/21/20","0","1","48459","1"
"Van Zandt","0","1","Texas","3/21/20","0","1","48467","1"
"Webb","0","1","Texas","3/21/20","0","1","48479","1"
"Wharton","0","1","Texas","3/21/20","0","1","48481","1"
"Wichita","1","4","Texas","3/21/20","0","4","48485","1"
"Williamson","1","9","Texas","3/21/20","0","9","48491","1"
"Bear River","0","1","Utah","3/21/20","0","1","00000","1"
"Cache","0","2","Utah","3/21/20","0","2","49005","1"
"Davis","2","14","Utah","3/21/20","1","13","49011","1300"
"Salt Lake","8","57","Utah","3/21/20","1","56","49035","5600"
"Summit","4","32","Utah","3/21/20","5","27","49043","540"
"Tooele","0","2","Utah","3/21/20","0","2","49045","1"
"Utah","0","3","Utah","3/21/20","0","3","49049","1"
"Wasatch","1","7","Utah","3/21/20","0","7","49051","1"
"Weber-Morgan","0","0","Utah","3/21/20","1","-1","00000","-100"
"Addison","0","3","Vermont","3/21/20","0","3","50001","1"
"Bennington","0","4","Vermont","3/21/20","1","3","50003","300"
"Chittenden","3","22","Vermont","3/21/20","1","21","50007","2100"
"Franklin","0","2","Vermont","3/21/20","0","2","50011","1"
"Orange","1","4","Vermont","3/21/20","0","4","50017","1"
"Rutland","0","2","Vermont","3/21/20","0","2","50021","1"
"Washington","0","2","Vermont","3/21/20","1","1","50023","100"
"Windham","0","1","Vermont","3/21/20","0","1","50025","1"
"Windsor","1","9","Vermont","3/21/20","2","7","50027","350"
"","1","6","Virgin Islands","3/21/20","0","6",,"1"
"Accomack","0","1","Virginia","3/21/20","0","1","51001","1"
"Albemarle","0","1","Virginia","3/21/20","0","1","51003","1"
"Alexandria","1","5","Virginia","3/21/20","0","5","51510","1"
"Arlington","2","22","Virginia","3/21/20","7","15","51013","214.29"
"Botetourt","0","1","Virginia","3/21/20","0","1","51023","1"
"Charles City","0","1","Virginia","3/21/20","0","1","51036","1"
"Charlottesville","0","3","Virginia","3/21/20","0","3","51540","1"
"Chesterfield","1","7","Virginia","3/21/20","1","6","51041","600"
"Fairfax","2","22","Virginia","3/21/20","10","12","51059","120"
"Franklin","0","1","Virginia","3/21/20","0","1","51067","1"
"Gloucester","0","2","Virginia","3/21/20","0","2","51073","1"
"Goochland","0","1","Virginia","3/21/20","0","1","51075","1"
"Hanover","0","1","Virginia","3/21/20","1","0","51085","0"
"Harrisonburg","0","1","Virginia","3/21/20","1","0","51660","0"
"Henrico","1","7","Virginia","3/21/20","0","7","51087","1"
"Isle of Wight","0","1","Virginia","3/21/20","0","1","51093","1"
"James City","2","20","Virginia","3/21/20","8","12","51095","150"
"Lee","0","2","Virginia","3/21/20","0","2","51105","1"
"Loudoun","1","14","Virginia","3/21/20","5","9","51107","180"
"Mecklenburg","0","1","Virginia","3/21/20","0","1","51117","1"
"Newport News","0","2","Virginia","3/21/20","0","2","51700","1"
"Norfolk","0","3","Virginia","3/21/20","0","3","51710","1"
"Prince Edward","0","1","Virginia","3/21/20","1","0","51147","0"
"Prince William","2","14","Virginia","3/21/20","2","12","51153","600"
"Richmond City","1","6","Virginia","3/21/20","0","6","51760","1"
"Rockbridge","0","1","Virginia","3/21/20","0","1","51163","1"
"Spotsylvania","0","1","Virginia","3/21/20","1","0","51177","0"
"Stafford","0","2","Virginia","3/21/20","0","2","51179","1"
"Suffolk","0","1","Virginia","3/21/20","0","1","51800","1"
"Virginia Beach","1","5","Virginia","3/21/20","0","5","51810","1"
"Williamsburg","1","4","Virginia","3/21/20","0","4","51830","1"
"York","0","3","Virginia","3/21/20","0","3","51199","1"
"Benton","1","7","Washington","3/21/20","0","7","53005","1"
"Chelan","0","3","Washington","3/21/20","0","3","53007","1"
"Clallam","0","2","Washington","3/21/20","0","2","53009","1"
"Clark","1","9","Washington","3/21/20","3","6","53011","200"
"Columbia","0","1","Washington","3/21/20","1","0","53013","0"
"Cowlitz","0","2","Washington","3/21/20","0","2","53015","1"
"Franklin","0","2","Washington","3/21/20","0","2","53021","1"
"Grant","1","11","Washington","3/21/20","2","9","53025","450"
"Grays Harbor","0","1","Washington","3/21/20","1","0","53027","0"
"Island","2","19","Washington","3/21/20","6","13","53029","216.67"
"Jefferson","0","4","Washington","3/21/20","1","3","53031","300"
"King","78","934","Washington","3/21/20","387","547","53033","141.34"
"Kitsap","2","15","Washington","3/21/20","3","12","53035","400"
"Kittitas","0","4","Washington","3/21/20","3","1","53037","33.33"
"Klickitat","1","4","Washington","3/21/20","0","4","53039","1"
"Lewis","0","2","Washington","3/21/20","0","2","53041","1"
"Lincoln","0","1","Washington","3/21/20","0","1","53043","1"
"Mason","0","1","Washington","3/21/20","0","1","53045","1"
"Pierce","10","95","Washington","3/21/20","26","69","53053","265.38"
"San Juan","0","1","Washington","3/21/20","0","1","53055","1"
"Skagit","3","28","Washington","3/21/20","4","24","53057","600"
"Snohomish","42","447","Washington","3/21/20","154","293","53061","190.26"
"Spokane","2","16","Washington","3/21/20","3","13","53063","433.33"
"Stevens","0","1","Washington","3/21/20","0","1","53065","1"
"Thurston","1","9","Washington","3/21/20","3","6","53067","200"
"Walla Walla","0","1","Washington","3/21/20","0","1","53071","1"
"Whatcom","2","14","Washington","3/21/20","2","12","53073","600"
"Yakima","1","13","Washington","3/21/20","4","9","53077","225"
"Jackson","0","1","West Virginia","3/21/20","0","1","54035","1"
"Jefferson","0","2","West Virginia","3/21/20","0","2","54037","1"
"Kanawha","0","2","West Virginia","3/21/20","0","2","54039","1"
"Marshall","0","2","West Virginia","3/21/20","0","2","54051","1"
"Mercer","0","2","West Virginia","3/21/20","0","2","54055","1"
"Monongalia","0","1","West Virginia","3/21/20","0","1","54061","1"
"Tucker","0","2","West Virginia","3/21/20","0","2","54093","1"
"Bayfield","0","1","Wisconsin","3/21/20","0","1","55007","1"
"Brown","0","3","Wisconsin","3/21/20","0","3","55009","1"
"Calumet","0","1","Wisconsin","3/21/20","0","1","55015","1"
"Chippewa","0","1","Wisconsin","3/21/20","0","1","55017","1"
"Columbia","1","5","Wisconsin","3/21/20","0","5","55021","1"
"Dane","6","49","Wisconsin","3/21/20","6","43","55025","716.67"
"Douglas","0","1","Wisconsin","3/21/20","0","1","55031","1"
"Dunn","0","1","Wisconsin","3/21/20","0","1","55033","1"
"Eau Claire","0","3","Wisconsin","3/21/20","0","3","55035","1"
"Fond du Lac","1","15","Wisconsin","3/21/20","6","9","55039","150"
"Green","0","1","Wisconsin","3/21/20","0","1","55045","1"
"Jefferson","0","1","Wisconsin","3/21/20","0","1","55055","1"
"Kenosha","1","5","Wisconsin","3/21/20","0","5","55059","1"
"La Crosse","1","5","Wisconsin","3/21/20","0","5","55063","1"
"Marathon","0","1","Wisconsin","3/21/20","0","1","55073","1"
"Milwaukee","17","126","Wisconsin","3/21/20","6","120","55079","2000"
"Outagamie","0","2","Wisconsin","3/21/20","0","2","55087","1"
"Ozaukee","2","11","Wisconsin","3/21/20","0","11","55089","1"
"Pierce","0","1","Wisconsin","3/21/20","1","0","55093","0"
"Racine","0","4","Wisconsin","3/21/20","1","3","55101","300"
"Rock","0","3","Wisconsin","3/21/20","0","3","55105","1"
"Sauk","0","2","Wisconsin","3/21/20","0","2","55111","1"
"Sheboygan","0","6","Wisconsin","3/21/20","3","3","55117","100"
"St. Croix","0","2","Wisconsin","3/21/20","0","2","55109","1"
"Walworth","0","3","Wisconsin","3/21/20","0","3","55127","1"
"Washington","0","3","Wisconsin","3/21/20","0","3","55131","1"
"Waukesha","2","20","Wisconsin","3/21/20","3","17","55133","566.67"
"Winnebago","1","5","Wisconsin","3/21/20","1","4","55139","400"
"Wood","0","1","Wisconsin","3/21/20","0","1","55141","1"
"Campbell","0","1","Wyoming","3/21/20","0","1","56005","1"
"Carbon","0","1","Wyoming","3/21/20","0","1","56007","1"
"Fremont","1","9","Wyoming","3/21/20","1","8","56013","800"
"Laramie","1","4","Wyoming","3/21/20","0","4","56021","1"
"Natrona","0","1","Wyoming","3/21/20","0","1","56025","1"
"Park","0","1","Wyoming","3/21/20","0","1","56029","1"
"Sheridan","0","4","Wyoming","3/21/20","1","3","56033","300"
"Teton","0","2","Wyoming","3/21/20","0","2","56039","1"
