"Locality","DailyAvgNewCasesPast7Days","TotalCases","State","Date","TotalCases7DaysAgo","NewCasesPast7Days","FIPS-Code","PercentIncreaseTotalCasesPast7Days"
"Autauga","1","6","Alabama","3/27/20","0","6","01001","1"
"Baldwin","0","5","Alabama","3/27/20","2","3","01003","150"
"Blount","1","4","Alabama","3/27/20","0","4","01009","1"
"Bullock","0","2","Alabama","3/27/20","0","2","01011","1"
"Butler","0","1","Alabama","3/27/20","0","1","01013","1"
"Calhoun","0","3","Alabama","3/27/20","1","2","01015","200"
"Chambers","2","13","Alabama","3/27/20","2","11","01017","550"
"Cherokee","0","1","Alabama","3/27/20","0","1","01019","1"
"Chilton","1","6","Alabama","3/27/20","0","6","01021","1"
"Choctaw","0","1","Alabama","3/27/20","0","1","01023","1"
"Clay","0","1","Alabama","3/27/20","0","1","01027","1"
"Cleburne","0","3","Alabama","3/27/20","0","3","01029","1"
"Colbert","0","1","Alabama","3/27/20","0","1","01033","1"
"Coosa","0","2","Alabama","3/27/20","0","2","01037","1"
"Covington","0","1","Alabama","3/27/20","0","1","01039","1"
"Crenshaw","0","1","Alabama","3/27/20","0","1","01041","1"
"Cullman","1","6","Alabama","3/27/20","0","6","01043","1"
"Dallas","0","2","Alabama","3/27/20","0","2","01047","1"
"DeKalb","0","1","Alabama","3/27/20","0","1","01049","1"
"Elmore","1","12","Alabama","3/27/20","5","7","01051","140"
"Etowah","1","4","Alabama","3/27/20","0","4","01055","1"
"Franklin","0","3","Alabama","3/27/20","0","3","01059","1"
"Greene","0","1","Alabama","3/27/20","0","1","01063","1"
"Houston","0","3","Alabama","3/27/20","0","3","01069","1"
"Jackson","0","4","Alabama","3/27/20","1","3","01071","300"
"Jefferson","18","177","Alabama","3/27/20","50","127","01073","254"
"Lamar","0","1","Alabama","3/27/20","1","0","01075","0"
"Lauderdale","1","9","Alabama","3/27/20","1","8","01077","800"
"Lawrence","0","2","Alabama","3/27/20","0","2","01079","1"
"Lee","5","48","Alabama","3/27/20","11","37","01081","336.36"
"Limestone","2","14","Alabama","3/27/20","1","13","01083","1300"
"Lowndes","0","1","Alabama","3/27/20","0","1","01085","1"
"Madison","6","47","Alabama","3/27/20","7","40","01089","571.43"
"Marengo","0","2","Alabama","3/27/20","0","2","01091","1"
"Marion","1","7","Alabama","3/27/20","0","7","01093","1"
"Marshall","1","4","Alabama","3/27/20","0","4","01095","1"
"Mobile","3","23","Alabama","3/27/20","3","20","01097","666.67"
"Montgomery","2","18","Alabama","3/27/20","3","15","01101","500"
"Morgan","1","9","Alabama","3/27/20","0","9","01103","1"
"Pickens","0","1","Alabama","3/27/20","0","1","01107","1"
"Pike","0","2","Alabama","3/27/20","0","2","01109","1"
"Randolph","0","1","Alabama","3/27/20","0","1","01111","1"
"Russell","0","1","Alabama","3/27/20","0","1","01113","1"
"Shelby","8","66","Alabama","3/27/20","10","56","01117","560"
"St. Clair","1","9","Alabama","3/27/20","1","8","01115","800"
"Talladega","0","4","Alabama","3/27/20","1","3","01121","300"
"Tallapoosa","1","4","Alabama","3/27/20","0","4","01123","1"
"Tuscaloosa","2","21","Alabama","3/27/20","4","17","01125","425"
"Walker","3","23","Alabama","3/27/20","1","22","01127","2200"
"Washington","0","2","Alabama","3/27/20","1","1","01129","100"
"Wilcox","0","2","Alabama","3/27/20","0","2","01131","1"
"Winston","0","2","Alabama","3/27/20","0","2","01133","1"
"Anchorage","4","30","Alaska","3/27/20","4","26","02020","650"
"Fairbanks North Star","1","10","Alaska","3/27/20","5","5","02090","100"
"Juneau","0","3","Alaska","3/27/20","0","3","02110","1"
"Kenai Peninsula","1","4","Alaska","3/27/20","0","4","02122","1"
"Ketchikan Gateway","1","11","Alaska","3/27/20","2","9","02130","450"
"Apache","2","11","Arizona","3/27/20","0","11","04001","1"
"Cochise","0","2","Arizona","3/27/20","1","1","04003","100"
"Coconino","5","41","Arizona","3/27/20","8","33","04005","412.5"
"Graham","0","4","Arizona","3/27/20","1","3","04009","300"
"La Paz","0","2","Arizona","3/27/20","0","2","04012","1"
"Maricopa","52","399","Arizona","3/27/20","34","365","04013","1073.53"
"Mohave","1","4","Arizona","3/27/20","0","4","04015","1"
"Navajo","7","49","Arizona","3/27/20","3","46","04017","1533.33"
"Pima","13","102","Arizona","3/27/20","8","94","04019","1175"
"Pinal","4","36","Arizona","3/27/20","10","26","04021","260"
"Santa Cruz","0","2","Arizona","3/27/20","1","1","04023","100"
"Yavapai","1","9","Arizona","3/27/20","1","8","04025","800"
"Yuma","0","4","Arizona","3/27/20","1","3","04027","300"
"Benton","3","23","Arkansas","3/27/20","0","23","05007","1"
"Boone","0","1","Arkansas","3/27/20","0","1","05009","1"
"Bradley","1","4","Arkansas","3/27/20","0","4","05011","1"
"Chicot","0","1","Arkansas","3/27/20","0","1","05017","1"
"Clark","2","17","Arkansas","3/27/20","0","17","05019","1"
"Cleburne","7","49","Arkansas","3/27/20","0","49","05023","1"
"Cleveland","0","3","Arkansas","3/27/20","0","3","05025","1"
"Columbia","0","1","Arkansas","3/27/20","0","1","05027","1"
"Conway","0","1","Arkansas","3/27/20","0","1","05029","1"
"Craighead","1","4","Arkansas","3/27/20","0","4","05031","1"
"Crawford","0","1","Arkansas","3/27/20","0","1","05033","1"
"Crittenden","1","9","Arkansas","3/27/20","0","9","05035","1"
"Cross","0","1","Arkansas","3/27/20","0","1","05037","1"
"Desha","0","2","Arkansas","3/27/20","0","2","05041","1"
"Drew","0","1","Arkansas","3/27/20","0","1","05043","1"
"Faulkner","4","27","Arkansas","3/27/20","0","27","05045","1"
"Garland","3","20","Arkansas","3/27/20","0","20","05051","1"
"Grant","0","3","Arkansas","3/27/20","0","3","05053","1"
"Greene","0","1","Arkansas","3/27/20","0","1","05055","1"
"Hempstead","0","1","Arkansas","3/27/20","0","1","05057","1"
"Hot Spring","0","1","Arkansas","3/27/20","0","1","05059","1"
"Independence","0","3","Arkansas","3/27/20","0","3","05063","1"
"Jefferson","3","23","Arkansas","3/27/20","3","20","05069","666.67"
"Lawrence","0","1","Arkansas","3/27/20","0","1","05075","1"
"Lincoln","1","5","Arkansas","3/27/20","0","5","05079","1"
"Lonoke","0","1","Arkansas","3/27/20","0","1","05085","1"
"Pike","0","1","Arkansas","3/27/20","0","1","05109","1"
"Poinsett","0","3","Arkansas","3/27/20","0","3","05111","1"
"Polk","0","1","Arkansas","3/27/20","0","1","05113","1"
"Pope","0","1","Arkansas","3/27/20","0","1","05115","1"
"Pulaski","13","88","Arkansas","3/27/20","0","88","05119","1"
"Randolph","0","1","Arkansas","3/27/20","0","1","05121","1"
"Saline","1","4","Arkansas","3/27/20","0","4","05125","1"
"Searcy","0","2","Arkansas","3/27/20","0","2","05129","1"
"Sebastian","0","2","Arkansas","3/27/20","0","2","05131","1"
"Sevier","0","1","Arkansas","3/27/20","0","1","05133","1"
"Stone","0","1","Arkansas","3/27/20","0","1","05137","1"
"Union","0","1","Arkansas","3/27/20","0","1","05139","1"
"Van Buren","2","16","Arkansas","3/27/20","0","16","05141","1"
"Washington","2","13","Arkansas","3/27/20","1","12","05143","1200"
"White","1","6","Arkansas","3/27/20","0","6","05145","1"
"Woodruff","0","1","Arkansas","3/27/20","0","1","05147","1"
"Alameda","25","220","California","3/27/20","48","172","06001","358.33"
"Amador","0","2","California","3/27/20","0","2","06005","1"
"Butte","1","5","California","3/27/20","0","5","06007","1"
"Calaveras","0","3","California","3/27/20","2","1","06009","50"
"Contra Costa","14","147","California","3/27/20","46","101","06013","219.57"
"El Dorado","1","9","California","3/27/20","0","9","06017","1"
"Fresno","3","27","California","3/27/20","6","21","06019","350"
"Humboldt","2","12","California","3/27/20","1","11","06023","1100"
"Imperial","2","17","California","3/27/20","4","13","06025","325"
"Inyo","0","3","California","3/27/20","0","3","06027","1"
"Kern","4","33","California","3/27/20","4","29","06029","725"
"Los Angeles","168","1465","California","3/27/20","292","1173","06037","401.71"
"Madera","1","10","California","3/27/20","3","7","06039","233.33"
"Marin","4","65","California","3/27/20","38","27","06041","71.05"
"Mendocino","0","2","California","3/27/20","1","1","06045","100"
"Merced","1","4","California","3/27/20","0","4","06047","1"
"Mono","1","6","California","3/27/20","0","6","06051","1"
"Monterey","3","24","California","3/27/20","5","19","06053","380"
"Napa","1","6","California","3/27/20","0","6","06055","1"
"Nevada","1","8","California","3/27/20","1","7","06057","700"
"Orange","37","321","California","3/27/20","65","256","06059","393.85"
"Placer","3","30","California","3/27/20","9","21","06061","233.33"
"Riverside","17","149","California","3/27/20","28","121","06065","432.14"
"Sacramento","16","164","California","3/27/20","53","111","06067","209.43"
"San Benito","1","13","California","3/27/20","5","8","06069","160"
"San Bernardino","6","54","California","3/27/20","9","45","06071","500"
"San Diego","31","341","California","3/27/20","127","214","06073","168.5"
"San Francisco","29","279","California","3/27/20","76","203","06075","267.11"
"San Joaquin","9","90","California","3/27/20","25","65","06077","260"
"San Luis Obispo","6","59","California","3/27/20","16","43","06079","268.75"
"San Mateo","20","239","California","3/27/20","100","139","06081","139"
"Santa Barbara","3","32","California","3/27/20","9","23","06083","255.56"
"Santa Clara","54","574","California","3/27/20","196","378","06085","192.86"
"Santa Cruz","2","32","California","3/27/20","15","17","06087","113.33"
"Shasta","0","3","California","3/27/20","1","2","06089","200"
"Siskiyou","0","3","California","3/27/20","0","3","06093","1"
"Solano","3","34","California","3/27/20","13","21","06095","161.54"
"Sonoma","5","44","California","3/27/20","9","35","06097","388.89"
"Stanislaus","2","17","California","3/27/20","5","12","06099","240"
"Sutter","0","2","California","3/27/20","0","2","06101","1"
"Tulare","2","20","California","3/27/20","7","13","06107","185.71"
"Ventura","6","61","California","3/27/20","19","42","06111","221.05"
"Yolo","1","13","California","3/27/20","5","8","06113","160"
"Yuba","0","3","California","3/27/20","0","3","06115","1"
"Adams","8","71","Colorado","3/27/20","12","59","08001","491.67"
"Alamosa","0","1","Colorado","3/27/20","0","1","08003","1"
"Arapahoe","18","155","Colorado","3/27/20","29","126","08005","434.48"
"Baca","0","1","Colorado","3/27/20","0","1","08009","1"
"Boulder","7","76","Colorado","3/27/20","24","52","08013","216.67"
"Broomfield","2","13","Colorado","3/27/20","1","12","08014","1200"
"Chaffee","1","5","Colorado","3/27/20","0","5","08015","1"
"Clear Creek","0","3","Colorado","3/27/20","2","1","08019","50"
"Costilla","0","1","Colorado","3/27/20","0","1","08023","1"
"Crowley","0","1","Colorado","3/27/20","1","0","08025","0"
"Delta","0","2","Colorado","3/27/20","0","2","08029","1"
"Denver","33","312","Colorado","3/27/20","79","233","08031","294.94"
"Douglas","9","79","Colorado","3/27/20","17","62","08035","364.71"
"Eagle","16","170","Colorado","3/27/20","61","109","08037","178.69"
"El Paso","19","160","Colorado","3/27/20","27","133","08041","492.59"
"Elbert","0","3","Colorado","3/27/20","0","3","08039","1"
"Fremont","0","1","Colorado","3/27/20","0","1","08043","1"
"Garfield","2","16","Colorado","3/27/20","4","12","08045","300"
"Grand","0","2","Colorado","3/27/20","2","0","08049","0"
"Gunnison","8","66","Colorado","3/27/20","13","53","08051","407.69"
"Hinsdale","0","1","Colorado","3/27/20","0","1","08053","1"
"Huerfano","0","1","Colorado","3/27/20","0","1","08055","1"
"Jefferson","17","158","Colorado","3/27/20","37","121","08059","327.03"
"Kit Carson","0","2","Colorado","3/27/20","0","2","08063","1"
"La Plata","2","13","Colorado","3/27/20","0","13","08067","1"
"Larimer","9","67","Colorado","3/27/20","7","60","08069","857.14"
"Lincoln","0","1","Colorado","3/27/20","0","1","08073","1"
"Logan","0","3","Colorado","3/27/20","0","3","08075","1"
"Mesa","1","7","Colorado","3/27/20","1","6","08077","600"
"Montrose","1","6","Colorado","3/27/20","0","6","08085","1"
"Morgan","0","4","Colorado","3/27/20","2","2","08087","100"
"Otero","0","2","Colorado","3/27/20","0","2","08089","1"
"Park","0","1","Colorado","3/27/20","1","0","08093","0"
"Pitkin","1","25","Colorado","3/27/20","15","10","08097","66.67"
"Pueblo","0","6","Colorado","3/27/20","3","3","08101","100"
"Rio Grande","0","2","Colorado","3/27/20","0","2","08105","1"
"Routt","1","12","Colorado","3/27/20","2","10","08107","500"
"San Miguel","0","1","Colorado","3/27/20","1","0","08113","0"
"Summit","1","13","Colorado","3/27/20","7","6","08117","85.71"
"Teller","1","7","Colorado","3/27/20","0","7","08119","1"
"Washington","0","1","Colorado","3/27/20","0","1","08121","1"
"Weld","16","129","Colorado","3/27/20","15","114","08123","760"
"Yuma","0","2","Colorado","3/27/20","1","1","08125","100"
"Fairfield","90","752","Connecticut","3/27/20","122","630","09001","516.39"
"Hartford","23","189","Connecticut","3/27/20","29","160","09003","551.72"
"Litchfield","6","52","Connecticut","3/27/20","8","44","09005","550"
"Middlesex","3","25","Connecticut","3/27/20","5","20","09007","400"
"New Haven","28","222","Connecticut","3/27/20","23","199","09009","865.22"
"New London","2","15","Connecticut","3/27/20","1","14","09011","1400"
"Tolland","4","33","Connecticut","3/27/20","4","29","09013","725"
"Windham","0","3","Connecticut","3/27/20","2","1","09015","50"
"Kent","2","21","Delaware","3/27/20","5","16","10001","320"
"New Castle","11","105","Delaware","3/27/20","27","78","10003","288.89"
"Sussex","4","37","Delaware","3/27/20","7","30","10005","428.57"
"","0","49","Diamond Princess","3/27/20","49","0",,"0"
"District of Columbia","29","271","District of Columbia","3/27/20","71","200","11001","281.69"
"Alachua","6","57","Florida","3/27/20","15","42","12001","280"
"Baker","1","7","Florida","3/27/20","0","7","12003","1"
"Bay","0","3","Florida","3/27/20","0","3","12005","1"
"Bradford","0","1","Florida","3/27/20","0","1","12007","1"
"Brevard","2","16","Florida","3/27/20","4","12","12009","300"
"Broward","69","614","Florida","3/27/20","128","486","12011","379.69"
"Charlotte","0","5","Florida","3/27/20","2","3","12015","150"
"Citrus","1","11","Florida","3/27/20","3","8","12017","266.67"
"Clay","3","22","Florida","3/27/20","4","18","12019","450"
"Collier","8","81","Florida","3/27/20","25","56","12021","224"
"Columbia","0","3","Florida","3/27/20","0","3","12023","1"
"DeSoto","1","6","Florida","3/27/20","0","6","12027","1"
"Duval","10","90","Florida","3/27/20","17","73","12031","429.41"
"Escambia","3","22","Florida","3/27/20","1","21","12033","2100"
"Flagler","2","11","Florida","3/27/20","0","11","12035","1"
"Gadsden","0","1","Florida","3/27/20","1","0","12039","0"
"Hernando","1","10","Florida","3/27/20","4","6","12053","150"
"Highlands","1","5","Florida","3/27/20","0","5","12055","1"
"Hillsborough","19","167","Florida","3/27/20","32","135","12057","421.88"
"Indian River","2","14","Florida","3/27/20","3","11","12061","366.67"
"Jackson","0","1","Florida","3/27/20","1","0","12063","0"
"Lake","4","29","Florida","3/27/20","3","26","12069","866.67"
"Lee","9","76","Florida","3/27/20","14","62","12071","442.86"
"Leon","1","14","Florida","3/27/20","4","10","12073","250"
"Manatee","3","28","Florida","3/27/20","10","18","12081","180"
"Marion","1","8","Florida","3/27/20","0","8","12083","1"
"Martin","2","16","Florida","3/27/20","1","15","12085","1500"
"Miami-Dade","91","763","Florida","3/27/20","124","639","12086","515.32"
"Monroe","2","16","Florida","3/27/20","1","15","12087","1500"
"Nassau","1","6","Florida","3/27/20","1","5","12089","500"
"Okaloosa","2","23","Florida","3/27/20","7","16","12091","228.57"
"Orange","19","156","Florida","3/27/20","23","133","12095","578.26"
"Osceola","6","53","Florida","3/27/20","13","40","12097","307.69"
"Palm Beach","22","194","Florida","3/27/20","42","152","12099","361.9"
"Pasco","2","23","Florida","3/27/20","7","16","12101","228.57"
"Pinellas","8","77","Florida","3/27/20","22","55","12103","250"
"Polk","2","26","Florida","3/27/20","9","17","12105","188.89"
"Putnam","2","12","Florida","3/27/20","0","12","12107","1"
"Santa Rosa","1","11","Florida","3/27/20","3","8","12113","266.67"
"Sarasota","5","40","Florida","3/27/20","8","32","12115","400"
"Seminole","6","49","Florida","3/27/20","10","39","12117","390"
"St. Johns","4","36","Florida","3/27/20","7","29","12109","414.29"
"St. Lucie","2","14","Florida","3/27/20","0","14","12111","1"
"Sumter","4","29","Florida","3/27/20","2","27","12119","1350"
"Suwannee","0","1","Florida","3/27/20","0","1","12121","1"
"Volusia","4","39","Florida","3/27/20","10","29","12127","290"
"Walton","1","13","Florida","3/27/20","3","10","12131","333.33"
"Washington","0","1","Florida","3/27/20","0","1","12133","1"
"Baker","0","1","Georgia","3/27/20","0","1","13007","1"
"Baldwin","0","2","Georgia","3/27/20","0","2","13009","1"
"Barrow","1","6","Georgia","3/27/20","1","5","13013","500"
"Bartow","6","98","Georgia","3/27/20","54","44","13015","81.48"
"Ben Hill","0","2","Georgia","3/27/20","0","2","13017","1"
"Bibb","1","10","Georgia","3/27/20","1","9","13021","900"
"Bryan","1","4","Georgia","3/27/20","0","4","13029","1"
"Burke","0","3","Georgia","3/27/20","0","3","13033","1"
"Butts","0","3","Georgia","3/27/20","0","3","13035","1"
"Calhoun","0","2","Georgia","3/27/20","0","2","13037","1"
"Camden","0","2","Georgia","3/27/20","0","2","13039","1"
"Carroll","7","55","Georgia","3/27/20","7","48","13045","685.71"
"Catoosa","0","1","Georgia","3/27/20","0","1","13047","1"
"Charlton","0","1","Georgia","3/27/20","1","0","13049","0"
"Chatham","1","10","Georgia","3/27/20","2","8","13051","400"
"Chattooga","0","1","Georgia","3/27/20","0","1","13055","1"
"Cherokee","4","46","Georgia","3/27/20","16","30","13057","187.5"
"Clarke","3","32","Georgia","3/27/20","10","22","13059","220"
"Clayton","5","46","Georgia","3/27/20","10","36","13063","360"
"Clinch","0","1","Georgia","3/27/20","0","1","13065","1"
"Cobb","14","144","Georgia","3/27/20","47","97","13067","206.38"
"Coffee","0","3","Georgia","3/27/20","0","3","13069","1"
"Colquitt","1","4","Georgia","3/27/20","0","4","13071","1"
"Columbia","1","10","Georgia","3/27/20","2","8","13073","400"
"Coweta","2","19","Georgia","3/27/20","6","13","13077","216.67"
"Crisp","1","4","Georgia","3/27/20","0","4","13081","1"
"Dawson","0","2","Georgia","3/27/20","1","1","13085","100"
"Decatur","0","2","Georgia","3/27/20","0","2","13087","1"
"DeKalb","21","181","Georgia","3/27/20","36","145","13089","402.78"
"Dodge","0","1","Georgia","3/27/20","0","1","13091","1"
"Dougherty","21","193","Georgia","3/27/20","44","149","13095","338.64"
"Douglas","4","27","Georgia","3/27/20","1","26","13097","2600"
"Early","1","10","Georgia","3/27/20","2","8","13099","400"
"Effingham","0","4","Georgia","3/27/20","1","3","13103","300"
"Fannin","0","2","Georgia","3/27/20","0","2","13111","1"
"Fayette","1","19","Georgia","3/27/20","9","10","13113","111.11"
"Floyd","2","20","Georgia","3/27/20","7","13","13115","185.71"
"Forsyth","2","19","Georgia","3/27/20","3","16","13117","533.33"
"Franklin","0","1","Georgia","3/27/20","0","1","13119","1"
"Fulton","31","307","Georgia","3/27/20","88","219","13121","248.86"
"Glynn","1","6","Georgia","3/27/20","2","4","13127","200"
"Gordon","1","12","Georgia","3/27/20","3","9","13129","300"
"Greene","0","1","Georgia","3/27/20","0","1","13133","1"
"Gwinnett","11","102","Georgia","3/27/20","23","79","13135","343.48"
"Habersham","0","1","Georgia","3/27/20","0","1","13137","1"
"Hall","3","24","Georgia","3/27/20","6","18","13139","300"
"Haralson","0","1","Georgia","3/27/20","0","1","13143","1"
"Harris","0","1","Georgia","3/27/20","0","1","13145","1"
"Heard","0","1","Georgia","3/27/20","1","0","13149","0"
"Henry","5","40","Georgia","3/27/20","6","34","13151","566.67"
"Houston","1","9","Georgia","3/27/20","2","7","13153","350"
"Irwin","0","3","Georgia","3/27/20","0","3","13155","1"
"Jackson","0","2","Georgia","3/27/20","0","2","13157","1"
"Jasper","0","2","Georgia","3/27/20","0","2","13159","1"
"Jones","0","2","Georgia","3/27/20","0","2","13169","1"
"Lamar","0","3","Georgia","3/27/20","1","2","13171","200"
"Laurens","1","7","Georgia","3/27/20","2","5","13175","250"
"Lee","3","35","Georgia","3/27/20","13","22","13177","169.23"
"Liberty","0","1","Georgia","3/27/20","0","1","13179","1"
"Lincoln","0","3","Georgia","3/27/20","0","3","13181","1"
"Long","0","1","Georgia","3/27/20","0","1","13183","1"
"Lowndes","1","16","Georgia","3/27/20","7","9","13185","128.57"
"Lumpkin","1","4","Georgia","3/27/20","0","4","13187","1"
"Macon","0","1","Georgia","3/27/20","0","1","13193","1"
"Madison","0","3","Georgia","3/27/20","0","3","13195","1"
"Meriwether","0","3","Georgia","3/27/20","0","3","13199","1"
"Miller","0","2","Georgia","3/27/20","1","1","13201","100"
"Mitchell","2","14","Georgia","3/27/20","0","14","13205","1"
"Monroe","0","3","Georgia","3/27/20","1","2","13207","200"
"Morgan","0","1","Georgia","3/27/20","0","1","13211","1"
"Muscogee","1","8","Georgia","3/27/20","2","6","13215","300"
"Newton","2","15","Georgia","3/27/20","4","11","13217","275"
"Oconee","1","10","Georgia","3/27/20","2","8","13219","400"
"Paulding","1","12","Georgia","3/27/20","3","9","13223","300"
"Peach","1","6","Georgia","3/27/20","1","5","13225","500"
"Pickens","0","4","Georgia","3/27/20","2","2","13227","100"
"Pierce","0","1","Georgia","3/27/20","0","1","13229","1"
"Polk","1","10","Georgia","3/27/20","3","7","13233","233.33"
"Pulaski","0","1","Georgia","3/27/20","0","1","13235","1"
"Randolph","0","3","Georgia","3/27/20","1","2","13243","200"
"Richmond","0","11","Georgia","3/27/20","8","3","13245","37.5"
"Rockdale","2","16","Georgia","3/27/20","1","15","13247","1500"
"Seminole","0","2","Georgia","3/27/20","0","2","13253","1"
"Spalding","1","11","Georgia","3/27/20","2","9","13255","450"
"Stephens","0","1","Georgia","3/27/20","0","1","13257","1"
"Sumter","1","10","Georgia","3/27/20","2","8","13261","400"
"Tattnall","0","2","Georgia","3/27/20","0","2","13267","1"
"Taylor","0","1","Georgia","3/27/20","0","1","13269","1"
"Terrell","1","6","Georgia","3/27/20","2","4","13273","200"
"Thomas","0","3","Georgia","3/27/20","0","3","13275","1"
"Tift","1","11","Georgia","3/27/20","1","10","13277","1000"
"Toombs","0","1","Georgia","3/27/20","0","1","13279","1"
"Troup","1","11","Georgia","3/27/20","2","9","13285","450"
"Turner","0","2","Georgia","3/27/20","1","1","13287","100"
"Twiggs","0","2","Georgia","3/27/20","0","2","13289","1"
"Upson","0","2","Georgia","3/27/20","0","2","13293","1"
"Ware","0","2","Georgia","3/27/20","0","2","13299","1"
"Washington","0","2","Georgia","3/27/20","0","2","13303","1"
"White","0","1","Georgia","3/27/20","0","1","13311","1"
"Whitfield","1","6","Georgia","3/27/20","1","5","13313","500"
"Wilkes","0","1","Georgia","3/27/20","0","1","13317","1"
"Worth","1","7","Georgia","3/27/20","2","5","13321","250"
"","1","28","Grand Princess","3/27/20","23","5",,"21.74"
"","5","51","Guam","3/27/20","14","37",,"264.29"
"Hawaii","1","5","Hawaii","3/27/20","0","5","15001","1"
"Honolulu","7","76","Hawaii","3/27/20","28","48","15003","171.43"
"Kauai","0","5","Hawaii","3/27/20","3","2","15007","66.67"
"Maui","1","14","Hawaii","3/27/20","5","9","15009","180"
"Ada","7","54","Idaho","3/27/20","8","46","16001","575"
"Bannock","0","2","Idaho","3/27/20","0","2","16005","1"
"Bingham","0","1","Idaho","3/27/20","1","0","16011","0"
"Blaine","11","93","Idaho","3/27/20","19","74","16013","389.47"
"Canyon","3","23","Idaho","3/27/20","1","22","16027","2200"
"Cassia","0","1","Idaho","3/27/20","0","1","16031","1"
"Custer","0","1","Idaho","3/27/20","0","1","16037","1"
"Fremont","0","1","Idaho","3/27/20","1","0","16043","0"
"Idaho","0","1","Idaho","3/27/20","0","1","16049","1"
"Jefferson","0","2","Idaho","3/27/20","0","2","16051","1"
"Kootenai","1","10","Idaho","3/27/20","3","7","16055","233.33"
"Madison","0","2","Idaho","3/27/20","1","1","16065","100"
"Nez Perce","1","4","Idaho","3/27/20","0","4","16069","1"
"Payette","1","4","Idaho","3/27/20","0","4","16075","1"
"Teton","0","2","Idaho","3/27/20","1","1","16081","100"
"Twin Falls","0","3","Idaho","3/27/20","1","2","16083","200"
"Valley","0","1","Idaho","3/27/20","0","1","16085","1"
"Adams","0","1","Illinois","3/27/20","1","0","17001","0"
"Bureau","0","1","Illinois","3/27/20","0","1","17011","1"
"Champaign","1","10","Illinois","3/27/20","1","9","17019","900"
"Christian","0","1","Illinois","3/27/20","0","1","17021","1"
"Clinton","0","5","Illinois","3/27/20","3","2","17027","66.67"
"Cook","280","2239","Illinois","3/27/20","278","1961","17031","705.4"
"Cumberland","0","1","Illinois","3/27/20","1","0","17035","0"
"DeKalb","1","4","Illinois","3/27/20","0","4","17037","1"
"Douglas","0","1","Illinois","3/27/20","0","1","17041","1"
"DuPage","21","199","Illinois","3/27/20","54","145","17043","268.52"
"Franklin","0","1","Illinois","3/27/20","0","1","17055","1"
"Grundy","0","2","Illinois","3/27/20","0","2","17063","1"
"Henry","0","1","Illinois","3/27/20","0","1","17073","1"
"Iroquois","0","1","Illinois","3/27/20","0","1","17075","1"
"Jackson","0","1","Illinois","3/27/20","1","0","17077","0"
"Jo Daviess","0","1","Illinois","3/27/20","0","1","17085","1"
"Kane","10","75","Illinois","3/27/20","6","69","17089","1150"
"Kankakee","2","17","Illinois","3/27/20","1","16","17091","1600"
"Kendall","1","8","Illinois","3/27/20","1","7","17093","700"
"Lake","28","230","Illinois","3/27/20","37","193","17097","521.62"
"LaSalle","0","0","Illinois","3/27/20","1","-1","17099","-100"
"Livingston","0","2","Illinois","3/27/20","0","2","17105","1"
"Madison","1","8","Illinois","3/27/20","1","7","17119","700"
"Marshall","0","1","Illinois","3/27/20","0","1","17123","1"
"McHenry","6","45","Illinois","3/27/20","6","39","17111","650"
"McLean","1","10","Illinois","3/27/20","1","9","17113","900"
"Monroe","0","3","Illinois","3/27/20","0","3","17133","1"
"Morgan","0","1","Illinois","3/27/20","0","1","17137","1"
"Peoria","0","6","Illinois","3/27/20","3","3","17143","100"
"Rock Island","1","4","Illinois","3/27/20","0","4","17161","1"
"Sangamon","0","7","Illinois","3/27/20","4","3","17167","75"
"St. Clair","2","15","Illinois","3/27/20","3","12","17163","400"
"Stephenson","0","2","Illinois","3/27/20","0","2","17177","1"
"Tazewell","0","2","Illinois","3/27/20","0","2","17179","1"
"Washington","0","1","Illinois","3/27/20","1","0","17189","0"
"Whiteside","0","2","Illinois","3/27/20","1","1","17195","100"
"Will","14","104","Illinois","3/27/20","9","95","17197","1055.56"
"Williamson","0","1","Illinois","3/27/20","1","0","17199","0"
"Winnebago","1","8","Illinois","3/27/20","1","7","17201","700"
"Woodford","0","3","Illinois","3/27/20","2","1","17203","50"
"Adams","0","1","Indiana","3/27/20","1","0","18001","0"
"Allen","2","21","Indiana","3/27/20","4","17","18003","425"
"Bartholomew","1","6","Indiana","3/27/20","1","5","18005","500"
"Boone","1","7","Indiana","3/27/20","2","5","18011","250"
"Brown","0","2","Indiana","3/27/20","0","2","18013","1"
"Clark","2","12","Indiana","3/27/20","1","11","18019","1100"
"Clinton","0","1","Indiana","3/27/20","0","1","18023","1"
"Dearborn","1","4","Indiana","3/27/20","0","4","18029","1"
"Decatur","4","26","Indiana","3/27/20","0","26","18031","1"
"DeKalb","0","1","Indiana","3/27/20","0","1","18033","1"
"Delaware","1","8","Indiana","3/27/20","1","7","18035","700"
"Dubois","0","1","Indiana","3/27/20","0","1","18037","1"
"Elkhart","1","9","Indiana","3/27/20","0","9","18039","1"
"Fayette","0","3","Indiana","3/27/20","1","2","18041","200"
"Floyd","1","11","Indiana","3/27/20","5","6","18043","120"
"Fountain","0","1","Indiana","3/27/20","0","1","18045","1"
"Franklin","3","21","Indiana","3/27/20","2","19","18047","950"
"Fulton","0","1","Indiana","3/27/20","0","1","18049","1"
"Gibson","0","3","Indiana","3/27/20","0","3","18051","1"
"Grant","1","5","Indiana","3/27/20","1","4","18053","400"
"Hamilton","7","52","Indiana","3/27/20","5","47","18057","940"
"Hancock","2","13","Indiana","3/27/20","0","13","18059","1"
"Harrison","1","4","Indiana","3/27/20","0","4","18061","1"
"Hendricks","3","28","Indiana","3/27/20","4","24","18063","600"
"Henry","0","1","Indiana","3/27/20","0","1","18065","1"
"Howard","0","7","Indiana","3/27/20","5","2","18067","40"
"Huntington","0","1","Indiana","3/27/20","0","1","18069","1"
"Jackson","1","4","Indiana","3/27/20","0","4","18071","1"
"Jasper","1","4","Indiana","3/27/20","0","4","18073","1"
"Jennings","1","5","Indiana","3/27/20","1","4","18079","400"
"Johnson","5","42","Indiana","3/27/20","4","38","18081","950"
"Kosciusko","0","1","Indiana","3/27/20","0","1","18085","1"
"LaGrange","0","2","Indiana","3/27/20","0","2","18087","1"
"Lake","6","47","Indiana","3/27/20","6","41","18089","683.33"
"LaPorte","0","2","Indiana","3/27/20","1","1","18091","100"
"Lawrence","1","5","Indiana","3/27/20","0","5","18093","1"
"Madison","1","7","Indiana","3/27/20","1","6","18095","600"
"Marion","66","484","Indiana","3/27/20","25","459","18097","1836"
"Marshall","1","4","Indiana","3/27/20","0","4","18099","1"
"Miami","0","1","Indiana","3/27/20","0","1","18103","1"
"Monroe","1","8","Indiana","3/27/20","0","8","18105","1"
"Montgomery","0","3","Indiana","3/27/20","0","3","18107","1"
"Morgan","1","10","Indiana","3/27/20","0","10","18109","1"
"Noble","0","1","Indiana","3/27/20","1","0","18113","0"
"Ohio","0","1","Indiana","3/27/20","0","1","18115","1"
"Orange","0","1","Indiana","3/27/20","0","1","18117","1"
"Owen","1","5","Indiana","3/27/20","1","4","18119","400"
"Porter","1","6","Indiana","3/27/20","0","6","18127","1"
"Posey","0","1","Indiana","3/27/20","0","1","18129","1"
"Putnam","0","2","Indiana","3/27/20","0","2","18133","1"
"Ripley","2","14","Indiana","3/27/20","0","14","18137","1"
"Rush","0","3","Indiana","3/27/20","0","3","18139","1"
"Scott","0","1","Indiana","3/27/20","0","1","18143","1"
"Shelby","1","6","Indiana","3/27/20","1","5","18145","500"
"St. Joseph","3","27","Indiana","3/27/20","6","21","18141","350"
"Starke","0","1","Indiana","3/27/20","0","1","18149","1"
"Sullivan","0","1","Indiana","3/27/20","0","1","18153","1"
"Tippecanoe","1","8","Indiana","3/27/20","2","6","18157","300"
"Tipton","0","2","Indiana","3/27/20","0","2","18159","1"
"Vanderburgh","1","6","Indiana","3/27/20","1","5","18163","500"
"Vigo","0","3","Indiana","3/27/20","1","2","18167","200"
"Wabash","0","1","Indiana","3/27/20","0","1","18169","1"
"Warren","0","1","Indiana","3/27/20","0","1","18171","1"
"Warrick","0","3","Indiana","3/27/20","0","3","18173","1"
"Washington","1","4","Indiana","3/27/20","0","4","18175","1"
"Wayne","0","1","Indiana","3/27/20","1","0","18177","0"
"Wells","0","1","Indiana","3/27/20","1","0","18179","0"
"Adair","0","1","Iowa","3/27/20","1","0","19001","0"
"Allamakee","1","7","Iowa","3/27/20","3","4","19005","133.33"
"Appanoose","0","1","Iowa","3/27/20","0","1","19007","1"
"Benton","0","3","Iowa","3/27/20","0","3","19011","1"
"Black Hawk","1","7","Iowa","3/27/20","1","6","19013","600"
"Buchanan","0","1","Iowa","3/27/20","0","1","19019","1"
"Butler","0","1","Iowa","3/27/20","0","1","19023","1"
"Carroll","0","1","Iowa","3/27/20","1","0","19027","0"
"Cedar","1","5","Iowa","3/27/20","0","5","19031","1"
"Cerro Gordo","0","3","Iowa","3/27/20","0","3","19033","1"
"Clayton","0","1","Iowa","3/27/20","0","1","19043","1"
"Clinton","0","1","Iowa","3/27/20","0","1","19045","1"
"Dallas","1","9","Iowa","3/27/20","5","4","19049","80"
"Des Moines","0","1","Iowa","3/27/20","0","1","19057","1"
"Dickinson","0","1","Iowa","3/27/20","0","1","19059","1"
"Dubuque","1","8","Iowa","3/27/20","1","7","19061","700"
"Fayette","0","1","Iowa","3/27/20","0","1","19065","1"
"Hancock","0","3","Iowa","3/27/20","0","3","19081","1"
"Hardin","0","1","Iowa","3/27/20","0","1","19083","1"
"Harrison","1","7","Iowa","3/27/20","1","6","19085","600"
"Henry","0","2","Iowa","3/27/20","0","2","19087","1"
"Iowa","0","1","Iowa","3/27/20","0","1","19095","1"
"Jasper","0","2","Iowa","3/27/20","0","2","19099","1"
"Johnson","5","58","Iowa","3/27/20","22","36","19103","163.64"
"Kossuth","0","1","Iowa","3/27/20","0","1","19109","1"
"Linn","3","22","Iowa","3/27/20","0","22","19113","1"
"Mahaska","0","2","Iowa","3/27/20","0","2","19123","1"
"Marshall","0","1","Iowa","3/27/20","0","1","19127","1"
"Monona","0","2","Iowa","3/27/20","0","2","19133","1"
"Montgomery","0","1","Iowa","3/27/20","0","1","19137","1"
"Muscatine","1","7","Iowa","3/27/20","1","6","19139","600"
"Page","0","2","Iowa","3/27/20","0","2","19145","1"
"Polk","3","28","Iowa","3/27/20","6","22","19153","366.67"
"Pottawattamie","0","3","Iowa","3/27/20","1","2","19155","200"
"Poweshiek","1","4","Iowa","3/27/20","0","4","19157","1"
"Scott","1","7","Iowa","3/27/20","0","7","19163","1"
"Sioux","0","2","Iowa","3/27/20","0","2","19167","1"
"Story","0","2","Iowa","3/27/20","0","2","19169","1"
"Tama","1","5","Iowa","3/27/20","0","5","19171","1"
"Wapello","0","1","Iowa","3/27/20","0","1","19179","1"
"Warren","0","1","Iowa","3/27/20","0","1","19181","1"
"Washington","1","11","Iowa","3/27/20","1","10","19183","1000"
"Webster","0","1","Iowa","3/27/20","0","1","19187","1"
"Winneshiek","0","2","Iowa","3/27/20","1","1","19191","100"
"Woodbury","0","3","Iowa","3/27/20","0","3","19193","1"
"Wright","0","1","Iowa","3/27/20","0","1","19197","1"
"Bourbon","0","3","Kansas","3/27/20","0","3","20011","1"
"Butler","0","3","Kansas","3/27/20","2","1","20015","50"
"Cherokee","0","2","Kansas","3/27/20","1","1","20021","100"
"Clay","0","1","Kansas","3/27/20","0","1","20027","1"
"Coffey","0","1","Kansas","3/27/20","0","1","20031","1"
"Crawford","0","3","Kansas","3/27/20","0","3","20037","1"
"Doniphan","0","1","Kansas","3/27/20","0","1","20043","1"
"Douglas","2","14","Kansas","3/27/20","1","13","20045","1300"
"Franklin","0","2","Kansas","3/27/20","1","1","20059","100"
"Gove","0","1","Kansas","3/27/20","0","1","20063","1"
"Harvey","0","1","Kansas","3/27/20","0","1","20079","1"
"Jackson","0","1","Kansas","3/27/20","1","0","20085","0"
"Jefferson","0","1","Kansas","3/27/20","0","1","20087","1"
"Johnson","6","66","Kansas","3/27/20","23","43","20091","186.96"
"Leavenworth","1","12","Kansas","3/27/20","4","8","20103","200"
"Linn","0","4","Kansas","3/27/20","1","3","20107","300"
"Lyon","1","4","Kansas","3/27/20","0","4","20111","1"
"McPherson","0","1","Kansas","3/27/20","0","1","20113","1"
"Mitchell","0","2","Kansas","3/27/20","0","2","20123","1"
"Morris","0","2","Kansas","3/27/20","2","0","20127","0"
"Neosho","0","1","Kansas","3/27/20","0","1","20133","1"
"Osage","0","1","Kansas","3/27/20","0","1","20139","1"
"Ottawa","0","1","Kansas","3/27/20","0","1","20143","1"
"Pottawatomie","0","1","Kansas","3/27/20","0","1","20149","1"
"Reno","1","5","Kansas","3/27/20","1","4","20155","400"
"Riley","0","2","Kansas","3/27/20","1","1","20161","100"
"Sedgwick","3","20","Kansas","3/27/20","1","19","20173","1900"
"Shawnee","1","5","Kansas","3/27/20","0","5","20177","1"
"Sumner","0","1","Kansas","3/27/20","0","1","20191","1"
"Woodson","0","1","Kansas","3/27/20","0","1","20207","1"
"Wyandotte","5","43","Kansas","3/27/20","9","34","20209","377.78"
"Allen","0","1","Kentucky","3/27/20","0","1","21003","1"
"Anderson","0","2","Kentucky","3/27/20","1","1","21005","100"
"Boone","0","1","Kentucky","3/27/20","0","1","21015","1"
"Bourbon","0","2","Kentucky","3/27/20","2","0","21017","0"
"Breathitt","0","2","Kentucky","3/27/20","0","2","21025","1"
"Calloway","0","1","Kentucky","3/27/20","1","0","21035","0"
"Campbell","0","1","Kentucky","3/27/20","0","1","21037","1"
"Christian","0","2","Kentucky","3/27/20","1","1","21047","100"
"Clark","0","2","Kentucky","3/27/20","2","0","21049","0"
"Daviess","2","14","Kentucky","3/27/20","1","13","21059","1300"
"Fayette","3","28","Kentucky","3/27/20","10","18","21067","180"
"Franklin","0","2","Kentucky","3/27/20","1","1","21073","100"
"Hardin","0","2","Kentucky","3/27/20","1","1","21093","100"
"Harrison","0","10","Kentucky","3/27/20","7","3","21097","42.86"
"Henderson","0","2","Kentucky","3/27/20","2","0","21101","0"
"Jefferson","1","35","Kentucky","3/27/20","25","10","21111","40"
"Jessamine","0","1","Kentucky","3/27/20","0","1","21113","1"
"Kenton","1","8","Kentucky","3/27/20","1","7","21117","700"
"Laurel","0","1","Kentucky","3/27/20","0","1","21125","1"
"Logan","0","1","Kentucky","3/27/20","0","1","21141","1"
"Lyon","0","1","Kentucky","3/27/20","1","0","21143","0"
"Madison","0","2","Kentucky","3/27/20","0","2","21151","1"
"Martin","0","1","Kentucky","3/27/20","0","1","21159","1"
"McCracken","0","2","Kentucky","3/27/20","0","2","21145","1"
"Menifee","0","1","Kentucky","3/27/20","0","1","21165","1"
"Montgomery","0","2","Kentucky","3/27/20","2","0","21173","0"
"Muhlenberg","0","2","Kentucky","3/27/20","0","2","21177","1"
"Nelson","0","1","Kentucky","3/27/20","1","0","21179","0"
"Oldham","0","1","Kentucky","3/27/20","1","0","21185","0"
"Pulaski","0","3","Kentucky","3/27/20","2","1","21199","50"
"Scott","0","1","Kentucky","3/27/20","0","1","21209","1"
"Simpson","0","1","Kentucky","3/27/20","0","1","21213","1"
"Spencer","0","1","Kentucky","3/27/20","0","1","21215","1"
"Warren","0","5","Kentucky","3/27/20","2","3","21227","150"
"Webster","0","1","Kentucky","3/27/20","0","1","21233","1"
"Acadia","1","8","Louisiana","3/27/20","0","8","22001","1"
"Allen","1","5","Louisiana","3/27/20","0","5","22003","1"
"Ascension","12","90","Louisiana","3/27/20","3","87","22005","2900"
"Assumption","1","8","Louisiana","3/27/20","1","7","22007","700"
"Avoyelles","1","10","Louisiana","3/27/20","0","10","22009","1"
"Beauregard","1","4","Louisiana","3/27/20","0","4","22011","1"
"Bienville","0","1","Louisiana","3/27/20","0","1","22013","1"
"Bossier","5","37","Louisiana","3/27/20","5","32","22015","640"
"Caddo","18","140","Louisiana","3/27/20","12","128","22017","1066.67"
"Calcasieu","3","22","Louisiana","3/27/20","3","19","22019","633.33"
"Catahoula","0","1","Louisiana","3/27/20","1","0","22025","0"
"Claiborne","0","3","Louisiana","3/27/20","0","3","22027","1"
"De Soto","2","13","Louisiana","3/27/20","2","11","22031","550"
"East Baton Rouge","17","124","Louisiana","3/27/20","7","117","22033","1671.43"
"East Feliciana","1","5","Louisiana","3/27/20","0","5","22037","1"
"Evangeline","1","4","Louisiana","3/27/20","0","4","22039","1"
"Grant","0","1","Louisiana","3/27/20","0","1","22043","1"
"Iberia","0","4","Louisiana","3/27/20","2","2","22045","100"
"Iberville","3","20","Louisiana","3/27/20","1","19","22047","1900"
"Jackson","0","3","Louisiana","3/27/20","0","3","22049","1"
"Jefferson","63","548","Louisiana","3/27/20","104","444","22051","426.92"
"Jefferson Davis","0","1","Louisiana","3/27/20","0","1","22053","1"
"Lafayette","5","44","Louisiana","3/27/20","6","38","22055","633.33"
"Lafourche","4","30","Louisiana","3/27/20","5","25","22057","500"
"Lincoln","1","7","Louisiana","3/27/20","0","7","22061","1"
"Livingston","1","11","Louisiana","3/27/20","1","10","22063","1000"
"Madison","0","1","Louisiana","3/27/20","0","1","22065","1"
"Morehouse","0","2","Louisiana","3/27/20","0","2","22067","1"
"Natchitoches","0","2","Louisiana","3/27/20","0","2","22069","1"
"Orleans","121","1170","Louisiana","3/27/20","326","844","22071","258.9"
"Ouachita","4","25","Louisiana","3/27/20","0","25","22073","1"
"Plaquemines","2","16","Louisiana","3/27/20","1","15","22075","1500"
"Pointe Coupee","0","1","Louisiana","3/27/20","0","1","22077","1"
"Rapides","3","26","Louisiana","3/27/20","3","23","22079","766.67"
"Richland","0","2","Louisiana","3/27/20","0","2","22083","1"
"St. Bernard","4","31","Louisiana","3/27/20","5","26","22087","520"
"St. Charles","2","23","Louisiana","3/27/20","7","16","22089","228.57"
"St. James","6","40","Louisiana","3/27/20","1","39","22093","3900"
"St. John the Baptist","5","41","Louisiana","3/27/20","6","35","22095","583.33"
"St. Landry","1","10","Louisiana","3/27/20","2","8","22097","400"
"St. Martin","1","10","Louisiana","3/27/20","0","10","22099","1"
"St. Mary","1","6","Louisiana","3/27/20","0","6","22101","1"
"St. Tammany","14","111","Louisiana","3/27/20","12","99","22103","825"
"Tangipahoa","1","7","Louisiana","3/27/20","1","6","22105","600"
"Terrebonne","2","23","Louisiana","3/27/20","7","16","22109","228.57"
"Union","1","4","Louisiana","3/27/20","0","4","22111","1"
"Vermilion","0","2","Louisiana","3/27/20","0","2","22113","1"
"Vernon","0","2","Louisiana","3/27/20","0","2","22115","1"
"Washington","1","8","Louisiana","3/27/20","2","6","22117","300"
"Webster","1","9","Louisiana","3/27/20","1","8","22119","800"
"West Baton Rouge","1","11","Louisiana","3/27/20","3","8","22121","266.67"
"Winn","0","1","Louisiana","3/27/20","0","1","22127","1"
"Androscoggin","0","6","Maine","3/27/20","3","3","23001","100"
"Cumberland","8","92","Maine","3/27/20","35","57","23005","162.86"
"Franklin","0","1","Maine","3/27/20","0","1","23007","1"
"Kennebec","0","6","Maine","3/27/20","4","2","23011","50"
"Knox","0","2","Maine","3/27/20","0","2","23013","1"
"Lincoln","0","5","Maine","3/27/20","4","1","23015","25"
"Oxford","1","8","Maine","3/27/20","1","7","23017","700"
"Penobscot","1","6","Maine","3/27/20","2","4","23019","200"
"Sagadahoc","1","4","Maine","3/27/20","0","4","23023","1"
"Waldo","0","2","Maine","3/27/20","0","2","23027","1"
"York","4","33","Maine","3/27/20","5","28","23031","560"
"Anne Arundel","8","63","Maryland","3/27/20","9","54","24003","600"
"Baltimore","13","103","Maryland","3/27/20","13","90","24005","692.31"
"Baltimore City","11","88","Maryland","3/27/20","11","77","24510","700"
"Calvert","1","9","Maryland","3/27/20","1","8","24009","800"
"Caroline","0","1","Maryland","3/27/20","0","1","24011","1"
"Carroll","1","9","Maryland","3/27/20","4","5","24013","125"
"Cecil","1","9","Maryland","3/27/20","0","9","24015","1"
"Charles","2","17","Maryland","3/27/20","2","15","24017","750"
"Frederick","2","15","Maryland","3/27/20","1","14","24021","1400"
"Garrett","0","3","Maryland","3/27/20","0","3","24023","1"
"Harford","2","18","Maryland","3/27/20","5","13","24025","260"
"Howard","6","62","Maryland","3/27/20","18","44","24027","244.44"
"Kent","0","2","Maryland","3/27/20","0","2","24029","1"
"Montgomery","22","208","Maryland","3/27/20","51","157","24031","307.84"
"Prince George's","17","148","Maryland","3/27/20","31","117","24033","377.42"
"Queen Anne's","0","2","Maryland","3/27/20","0","2","24035","1"
"Somerset","0","1","Maryland","3/27/20","0","1","24039","1"
"St. Mary's","1","4","Maryland","3/27/20","0","4","24037","1"
"Talbot","0","1","Maryland","3/27/20","1","0","24041","0"
"Washington","1","5","Maryland","3/27/20","0","5","24043","1"
"Wicomico","1","5","Maryland","3/27/20","1","4","24045","400"
"Worcester","0","2","Maryland","3/27/20","1","1","24047","100"
"Barnstable","13","100","Massachusetts","3/27/20","9","91","25001","1011.11"
"Berkshire","12","105","Massachusetts","3/27/20","20","85","25003","425"
"Bristol","18","129","Massachusetts","3/27/20","6","123","25005","2050"
"Dukes and Nantucket","1","4","Massachusetts","3/27/20","0","4","00000","1"
"Essex","46","350","Massachusetts","3/27/20","29","321","25009","1106.9"
"Franklin","3","24","Massachusetts","3/27/20","1","23","25011","2300"
"Hampden","12","90","Massachusetts","3/27/20","3","87","25013","2900"
"Hampshire","3","20","Massachusetts","3/27/20","2","18","25015","900"
"Middlesex","77","685","Massachusetts","3/27/20","144","541","25017","375.69"
"Norfolk","47","393","Massachusetts","3/27/20","64","329","25021","514.06"
"Plymouth","25","187","Massachusetts","3/27/20","11","176","25023","1600"
"Suffolk","78","631","Massachusetts","3/27/20","86","545","25025","633.72"
"Worcester","29","219","Massachusetts","3/27/20","19","200","25027","1052.63"
"Allegan","0","1","Michigan","3/27/20","0","1","26005","1"
"Antrim","0","1","Michigan","3/27/20","0","1","26009","1"
"Barry","0","2","Michigan","3/27/20","0","2","26015","1"
"Bay","1","6","Michigan","3/27/20","1","5","26017","500"
"Berrien","6","50","Michigan","3/27/20","11","39","26021","354.55"
"Calhoun","1","10","Michigan","3/27/20","0","10","26025","1"
"Cass","0","3","Michigan","3/27/20","0","3","26027","1"
"Charlevoix","0","4","Michigan","3/27/20","1","3","26029","300"
"Cheboygan","0","1","Michigan","3/27/20","0","1","26031","1"
"Chippewa","0","1","Michigan","3/27/20","0","1","26033","1"
"Clare","0","1","Michigan","3/27/20","0","1","26035","1"
"Clinton","1","8","Michigan","3/27/20","1","7","26037","700"
"Crawford","0","1","Michigan","3/27/20","0","1","26039","1"
"Eaton","1","8","Michigan","3/27/20","2","6","26045","300"
"Emmet","0","3","Michigan","3/27/20","0","3","26047","1"
"Genesee","13","93","Michigan","3/27/20","4","89","26049","2225"
"Gladwin","0","2","Michigan","3/27/20","0","2","26051","1"
"Gogebic","0","1","Michigan","3/27/20","0","1","26053","1"
"Grand Traverse","0","3","Michigan","3/27/20","0","3","26055","1"
"Gratiot","0","1","Michigan","3/27/20","0","1","26057","1"
"Hillsdale","1","6","Michigan","3/27/20","0","6","26059","1"
"Huron","0","1","Michigan","3/27/20","0","1","26063","1"
"Ingham","3","29","Michigan","3/27/20","10","19","26065","190"
"Ionia","0","2","Michigan","3/27/20","0","2","26067","1"
"Iosco","0","1","Michigan","3/27/20","0","1","26069","1"
"Isabella","1","4","Michigan","3/27/20","0","4","26073","1"
"Jackson","2","20","Michigan","3/27/20","3","17","26075","566.67"
"Kalamazoo","2","12","Michigan","3/27/20","0","12","26077","1"
"Kalkaska","1","4","Michigan","3/27/20","0","4","26079","1"
"Kent","5","45","Michigan","3/27/20","12","33","26081","275"
"Lapeer","1","4","Michigan","3/27/20","0","4","26087","1"
"Leelanau","0","1","Michigan","3/27/20","1","0","26089","0"
"Lenawee","1","8","Michigan","3/27/20","0","8","26091","1"
"Livingston","5","38","Michigan","3/27/20","4","34","26093","850"
"Macomb","46","406","Michigan","3/27/20","87","319","26099","366.67"
"Manistee","0","1","Michigan","3/27/20","0","1","26101","1"
"Marquette","0","1","Michigan","3/27/20","0","1","26103","1"
"Mecosta","0","1","Michigan","3/27/20","0","1","26107","1"
"Midland","1","13","Michigan","3/27/20","6","7","26111","116.67"
"Missaukee","0","1","Michigan","3/27/20","0","1","26113","1"
"Monroe","4","28","Michigan","3/27/20","3","25","26115","833.33"
"Montcalm","0","3","Michigan","3/27/20","1","2","26117","200"
"Muskegon","1","6","Michigan","3/27/20","0","6","26121","1"
"Newaygo","0","1","Michigan","3/27/20","0","1","26123","1"
"Oakland","103","945","Michigan","3/27/20","226","719","26125","318.14"
"Oceana","0","1","Michigan","3/27/20","0","1","26127","1"
"Ogemaw","0","2","Michigan","3/27/20","0","2","26129","1"
"Otsego","1","7","Michigan","3/27/20","1","6","26137","600"
"Ottawa","3","23","Michigan","3/27/20","3","20","26139","666.67"
"Out of MI","1","8","Michigan","3/27/20","0","8","80026","1"
"Roscommon","0","1","Michigan","3/27/20","0","1","26143","1"
"Saginaw","2","14","Michigan","3/27/20","0","14","26145","1"
"Sanilac","0","2","Michigan","3/27/20","0","2","26151","1"
"Shiawassee","0","2","Michigan","3/27/20","0","2","26155","1"
"St. Clair","2","21","Michigan","3/27/20","7","14","26147","200"
"Tuscola","0","2","Michigan","3/27/20","0","2","26157","1"
"Van Buren","1","4","Michigan","3/27/20","0","4","26159","1"
"Washtenaw","21","165","Michigan","3/27/20","19","146","26161","768.42"
"Wayne","249","1814","Michigan","3/27/20","68","1746","26163","2567.65"
"Wexford","0","1","Michigan","3/27/20","0","1","26165","1"
"Anoka","1","10","Minnesota","3/27/20","5","5","27003","100"
"Beltrami","0","1","Minnesota","3/27/20","0","1","27007","1"
"Benton","0","1","Minnesota","3/27/20","1","0","27009","0"
"Big Stone","0","1","Minnesota","3/27/20","0","1","27011","1"
"Blue Earth","1","7","Minnesota","3/27/20","2","5","27013","250"
"Carver","1","8","Minnesota","3/27/20","3","5","27019","166.67"
"Cass","0","1","Minnesota","3/27/20","0","1","27021","1"
"Chisago","0","2","Minnesota","3/27/20","1","1","27025","100"
"Clay","0","4","Minnesota","3/27/20","1","3","27027","300"
"Dakota","3","28","Minnesota","3/27/20","7","21","27037","300"
"Dodge","1","5","Minnesota","3/27/20","0","5","27039","1"
"Faribault","0","1","Minnesota","3/27/20","0","1","27043","1"
"Fillmore","0","3","Minnesota","3/27/20","0","3","27045","1"
"Goodhue","0","2","Minnesota","3/27/20","0","2","27049","1"
"Hennepin","14","141","Minnesota","3/27/20","45","96","27053","213.33"
"Jackson","0","1","Minnesota","3/27/20","0","1","27063","1"
"Kandiyohi","0","1","Minnesota","3/27/20","0","1","27067","1"
"Le Sueur","1","10","Minnesota","3/27/20","0","10","27079","1"
"Lincoln","0","1","Minnesota","3/27/20","0","1","27081","1"
"Mahnomen","0","1","Minnesota","3/27/20","0","1","27087","1"
"Martin","2","18","Minnesota","3/27/20","4","14","27091","350"
"Mower","1","10","Minnesota","3/27/20","1","9","27099","900"
"Nicollet","0","3","Minnesota","3/27/20","2","1","27103","50"
"Olmsted","3","34","Minnesota","3/27/20","11","23","27109","209.09"
"Ramsey","3","34","Minnesota","3/27/20","16","18","27123","112.5"
"Renville","0","1","Minnesota","3/27/20","1","0","27129","0"
"Rice","0","2","Minnesota","3/27/20","1","1","27131","100"
"Scott","1","7","Minnesota","3/27/20","2","5","27139","250"
"Sherburne","0","3","Minnesota","3/27/20","0","3","27141","1"
"Sibley","0","1","Minnesota","3/27/20","0","1","27143","1"
"St. Louis","1","5","Minnesota","3/27/20","0","5","27137","1"
"Stearns","0","5","Minnesota","3/27/20","4","1","27145","25"
"Steele","1","5","Minnesota","3/27/20","0","5","27147","1"
"Wabasha","1","4","Minnesota","3/27/20","0","4","27157","1"
"Waseca","0","3","Minnesota","3/27/20","1","2","27161","200"
"Washington","3","22","Minnesota","3/27/20","3","19","27163","633.33"
"Wilkin","0","1","Minnesota","3/27/20","0","1","27167","1"
"Winona","1","4","Minnesota","3/27/20","0","4","27169","1"
"Wright","0","5","Minnesota","3/27/20","2","3","27171","150"
"Adams","1","6","Mississippi","3/27/20","1","5","28001","500"
"Attala","1","8","Mississippi","3/27/20","0","8","28007","1"
"Benton","0","2","Mississippi","3/27/20","0","2","28009","1"
"Bolivar","1","9","Mississippi","3/27/20","2","7","28011","350"
"Calhoun","0","3","Mississippi","3/27/20","0","3","28013","1"
"Chickasaw","1","9","Mississippi","3/27/20","0","9","28017","1"
"Choctaw","1","4","Mississippi","3/27/20","0","4","28019","1"
"Clay","0","2","Mississippi","3/27/20","0","2","28025","1"
"Coahoma","2","18","Mississippi","3/27/20","3","15","28027","500"
"Copiah","1","8","Mississippi","3/27/20","2","6","28029","300"
"DeSoto","8","63","Mississippi","3/27/20","4","59","28033","1475"
"Forrest","2","16","Mississippi","3/27/20","4","12","28035","300"
"Franklin","0","2","Mississippi","3/27/20","1","1","28037","100"
"George","0","1","Mississippi","3/27/20","0","1","28039","1"
"Grenada","0","2","Mississippi","3/27/20","0","2","28043","1"
"Hancock","1","9","Mississippi","3/27/20","3","6","28045","200"
"Harrison","4","34","Mississippi","3/27/20","8","26","28047","325"
"Hinds","6","50","Mississippi","3/27/20","7","43","28049","614.29"
"Holmes","1","10","Mississippi","3/27/20","3","7","28051","233.33"
"Humphreys","0","1","Mississippi","3/27/20","1","0","28053","0"
"Itawamba","0","3","Mississippi","3/27/20","0","3","28057","1"
"Jackson","3","24","Mississippi","3/27/20","3","21","28059","700"
"Jefferson","0","1","Mississippi","3/27/20","0","1","28063","1"
"Jones","0","1","Mississippi","3/27/20","1","0","28067","0"
"Kemper","0","1","Mississippi","3/27/20","0","1","28069","1"
"Lafayette","1","11","Mississippi","3/27/20","1","10","28071","1000"
"Lamar","1","4","Mississippi","3/27/20","0","4","28073","1"
"Lauderdale","1","10","Mississippi","3/27/20","0","10","28075","1"
"Lawrence","1","5","Mississippi","3/27/20","1","4","28077","400"
"Leake","1","4","Mississippi","3/27/20","0","4","28079","1"
"Lee","2","15","Mississippi","3/27/20","1","14","28081","1400"
"Leflore","1","13","Mississippi","3/27/20","7","6","28083","85.71"
"Lincoln","1","6","Mississippi","3/27/20","0","6","28085","1"
"Lowndes","1","9","Mississippi","3/27/20","0","9","28087","1"
"Madison","3","25","Mississippi","3/27/20","3","22","28089","733.33"
"Marion","0","1","Mississippi","3/27/20","0","1","28091","1"
"Marshall","1","9","Mississippi","3/27/20","1","8","28093","800"
"Monroe","0","3","Mississippi","3/27/20","2","1","28095","50"
"Montgomery","1","4","Mississippi","3/27/20","0","4","28097","1"
"Neshoba","0","1","Mississippi","3/27/20","0","1","28099","1"
"Newton","0","1","Mississippi","3/27/20","0","1","28101","1"
"Noxubee","0","1","Mississippi","3/27/20","0","1","28103","1"
"Oktibbeha","2","12","Mississippi","3/27/20","0","12","28105","1"
"Panola","1","4","Mississippi","3/27/20","0","4","28107","1"
"Pearl River","2","18","Mississippi","3/27/20","7","11","28109","157.14"
"Perry","0","2","Mississippi","3/27/20","1","1","28111","100"
"Pike","2","12","Mississippi","3/27/20","1","11","28113","1100"
"Pontotoc","1","4","Mississippi","3/27/20","0","4","28115","1"
"Prentiss","0","1","Mississippi","3/27/20","0","1","28117","1"
"Quitman","0","3","Mississippi","3/27/20","0","3","28119","1"
"Rankin","4","29","Mississippi","3/27/20","3","26","28121","866.67"
"Scott","1","6","Mississippi","3/27/20","0","6","28123","1"
"Sharkey","0","1","Mississippi","3/27/20","0","1","28125","1"
"Simpson","0","1","Mississippi","3/27/20","0","1","28127","1"
"Smith","0","1","Mississippi","3/27/20","1","0","28129","0"
"Sunflower","1","5","Mississippi","3/27/20","0","5","28133","1"
"Tallahatchie","0","2","Mississippi","3/27/20","0","2","28135","1"
"Tate","1","8","Mississippi","3/27/20","0","8","28137","1"
"Tippah","2","15","Mississippi","3/27/20","3","12","28139","400"
"Tunica","1","6","Mississippi","3/27/20","0","6","28143","1"
"Union","0","3","Mississippi","3/27/20","0","3","28145","1"
"Walthall","0","4","Mississippi","3/27/20","1","3","28147","300"
"Washington","2","11","Mississippi","3/27/20","0","11","28151","1"
"Webster","0","3","Mississippi","3/27/20","1","2","28155","200"
"Wilkinson","1","9","Mississippi","3/27/20","1","8","28157","800"
"Winston","0","3","Mississippi","3/27/20","1","2","28159","200"
"Yalobusha","0","3","Mississippi","3/27/20","0","3","28161","1"
"Yazoo","0","4","Mississippi","3/27/20","1","3","28163","300"
"Adair","0","1","Missouri","3/27/20","0","1","29001","1"
"Atchison","0","1","Missouri","3/27/20","0","1","29005","1"
"Bates","0","1","Missouri","3/27/20","0","1","29013","1"
"Benton","0","1","Missouri","3/27/20","0","1","29015","1"
"Bollinger","0","1","Missouri","3/27/20","0","1","29017","1"
"Boone","4","37","Missouri","3/27/20","8","29","29019","362.5"
"Buchanan","0","2","Missouri","3/27/20","0","2","29021","1"
"Callaway","0","3","Missouri","3/27/20","0","3","29027","1"
"Camden","0","1","Missouri","3/27/20","0","1","29029","1"
"Cape Girardeau","1","5","Missouri","3/27/20","0","5","29031","1"
"Carter","0","1","Missouri","3/27/20","0","1","29035","1"
"Cass","0","8","Missouri","3/27/20","6","2","29037","33.33"
"Chariton","0","1","Missouri","3/27/20","0","1","29041","1"
"Christian","0","3","Missouri","3/27/20","2","1","29043","50"
"Clay","1","9","Missouri","3/27/20","0","9","29047","1"
"Clinton","0","1","Missouri","3/27/20","0","1","29049","1"
"Cole","1","10","Missouri","3/27/20","2","8","29051","400"
"Cooper","0","1","Missouri","3/27/20","0","1","29053","1"
"Dunklin","0","3","Missouri","3/27/20","1","2","29069","200"
"Franklin","1","4","Missouri","3/27/20","0","4","29071","1"
"Greene","3","31","Missouri","3/27/20","8","23","29077","287.5"
"Henry","0","1","Missouri","3/27/20","1","0","29083","0"
"Jackson","5","41","Missouri","3/27/20","8","33","29095","412.5"
"Jasper","0","2","Missouri","3/27/20","0","2","29097","1"
"Jefferson","2","15","Missouri","3/27/20","0","15","29099","1"
"Johnson","1","8","Missouri","3/27/20","0","8","29101","1"
"Kansas City","9","78","Missouri","3/27/20","12","66","00000","550"
"Lafayette","1","4","Missouri","3/27/20","0","4","29107","1"
"Lincoln","0","2","Missouri","3/27/20","0","2","29113","1"
"McDonald","0","1","Missouri","3/27/20","0","1","29119","1"
"Moniteau","0","2","Missouri","3/27/20","0","2","29135","1"
"Montgomery","0","3","Missouri","3/27/20","0","3","29139","1"
"Newton","0","3","Missouri","3/27/20","0","3","29145","1"
"Pemiscot","0","1","Missouri","3/27/20","0","1","29155","1"
"Perry","1","6","Missouri","3/27/20","0","6","29157","1"
"Pettis","0","1","Missouri","3/27/20","0","1","29159","1"
"Platte","1","5","Missouri","3/27/20","0","5","29165","1"
"Pulaski","0","4","Missouri","3/27/20","1","3","29169","300"
"Ralls","0","1","Missouri","3/27/20","0","1","29173","1"
"Randolph","0","1","Missouri","3/27/20","0","1","29175","1"
"Ray","0","1","Missouri","3/27/20","0","1","29177","1"
"Scott","0","1","Missouri","3/27/20","1","0","29201","0"
"Shelby","0","1","Missouri","3/27/20","0","1","29205","1"
"St. Charles","4","32","Missouri","3/27/20","1","31","29183","3100"
"St. Francois","1","4","Missouri","3/27/20","0","4","29187","1"
"St. Louis","41","302","Missouri","3/27/20","14","288","29189","2057.14"
"St. Louis City","13","95","Missouri","3/27/20","7","88","29510","1257.14"
"Stoddard","0","1","Missouri","3/27/20","0","1","29207","1"
"Taney","0","1","Missouri","3/27/20","0","1","29213","1"
"Texas","0","1","Missouri","3/27/20","0","1","29215","1"
"Wright","0","1","Missouri","3/27/20","0","1","29229","1"
"Broadwater","0","2","Montana","3/27/20","1","1","30007","100"
"Cascade","1","6","Montana","3/27/20","0","6","30013","1"
"Flathead","1","6","Montana","3/27/20","2","4","30029","200"
"Gallatin","5","39","Montana","3/27/20","3","36","30031","1200"
"Hill","0","1","Montana","3/27/20","0","1","30041","1"
"Jefferson","0","1","Montana","3/27/20","0","1","30043","1"
"Lake","0","1","Montana","3/27/20","0","1","30047","1"
"Lewis and Clark","1","8","Montana","3/27/20","2","6","30049","300"
"Lincoln","0","1","Montana","3/27/20","0","1","30053","1"
"Madison","0","2","Montana","3/27/20","1","1","30057","100"
"Meagher","0","1","Montana","3/27/20","0","1","30059","1"
"Missoula","1","8","Montana","3/27/20","3","5","30063","166.67"
"Park","0","1","Montana","3/27/20","0","1","30067","1"
"Ravalli","0","1","Montana","3/27/20","0","1","30081","1"
"Roosevelt","0","1","Montana","3/27/20","1","0","30085","0"
"Silver Bow","1","8","Montana","3/27/20","1","7","30093","700"
"Toole","0","2","Montana","3/27/20","0","2","30101","1"
"Yellowstone","2","20","Montana","3/27/20","5","15","30111","300"
"Adams","0","1","Nebraska","3/27/20","1","0","31001","0"
"Buffalo","1","4","Nebraska","3/27/20","0","4","31019","1"
"Cass","0","2","Nebraska","3/27/20","1","1","31025","100"
"Douglas","3","44","Nebraska","3/27/20","22","22","31055","100"
"Gage","0","1","Nebraska","3/27/20","0","1","31067","1"
"Kearney","0","1","Nebraska","3/27/20","0","1","31099","1"
"Knox","0","2","Nebraska","3/27/20","2","0","31107","0"
"Lancaster","0","3","Nebraska","3/27/20","1","2","31109","200"
"Lincoln","0","3","Nebraska","3/27/20","3","0","31111","0"
"Madison","0","1","Nebraska","3/27/20","0","1","31119","1"
"Nemaha","0","1","Nebraska","3/27/20","1","0","31127","0"
"Sarpy","1","10","Nebraska","3/27/20","2","8","31153","400"
"Saunders","0","2","Nebraska","3/27/20","0","2","31155","1"
"Washington","1","5","Nebraska","3/27/20","0","5","31177","1"
"Carson City","0","2","Nevada","3/27/20","2","0","32510","0"
"Clark","45","443","Nevada","3/27/20","126","317","32003","251.59"
"Douglas","0","3","Nevada","3/27/20","0","3","32005","1"
"Elko","0","2","Nevada","3/27/20","1","1","32007","100"
"Humboldt","0","1","Nevada","3/27/20","0","1","32013","1"
"Lyon","0","1","Nevada","3/27/20","0","1","32019","1"
"Nye","0","1","Nevada","3/27/20","0","1","32023","1"
"Washoe","8","67","Nevada","3/27/20","14","53","32031","378.57"
"Belknap","1","8","New Hampshire","3/27/20","0","8","33001","1"
"Carroll","0","7","New Hampshire","3/27/20","5","2","33003","40"
"Cheshire","0","2","New Hampshire","3/27/20","1","1","33005","100"
"Grafton","2","23","New Hampshire","3/27/20","10","13","33009","130"
"Hillsborough","3","31","New Hampshire","3/27/20","11","20","33011","181.82"
"Merrimack","1","7","New Hampshire","3/27/20","2","5","33013","250"
"Rockingham","7","67","New Hampshire","3/27/20","19","48","33015","252.63"
"Strafford","1","7","New Hampshire","3/27/20","0","7","33017","1"
"Sullivan","0","2","New Hampshire","3/27/20","0","2","33019","1"
"Atlantic","2","14","New Jersey","3/27/20","3","11","34001","366.67"
"Bergen","179","1505","New Jersey","3/27/20","249","1256","34003","504.42"
"Burlington","10","88","New Jersey","3/27/20","17","71","34005","417.65"
"Camden","12","95","New Jersey","3/27/20","11","84","34007","763.64"
"Cape May","1","7","New Jersey","3/27/20","1","6","34009","600"
"Cumberland","1","9","New Jersey","3/27/20","1","8","34011","800"
"Essex","108","826","New Jersey","3/27/20","73","753","34013","1031.51"
"Gloucester","5","40","New Jersey","3/27/20","5","35","34015","700"
"Hudson","75","594","New Jersey","3/27/20","66","528","34017","800"
"Hunterdon","6","52","New Jersey","3/27/20","11","41","34019","372.73"
"Mercer","16","131","New Jersey","3/27/20","22","109","34021","495.45"
"Middlesex","81","640","New Jersey","3/27/20","76","564","34023","742.11"
"Monmouth","83","634","New Jersey","3/27/20","53","581","34025","1096.23"
"Morris","51","391","New Jersey","3/27/20","35","356","34027","1017.14"
"Ocean","62","484","New Jersey","3/27/20","49","435","34029","887.76"
"Passaic","62","484","New Jersey","3/27/20","49","435","34031","887.76"
"Salem","0","3","New Jersey","3/27/20","0","3","34033","1"
"Somerset","28","222","New Jersey","3/27/20","28","194","34035","692.86"
"Sussex","9","65","New Jersey","3/27/20","3","62","34037","2066.67"
"Union","68","519","New Jersey","3/27/20","43","476","34039","1106.98"
"Warren","5","38","New Jersey","3/27/20","3","35","34041","1166.67"
"Bernalillo","5","55","New Mexico","3/27/20","23","32","35001","139.13"
"Chaves","1","4","New Mexico","3/27/20","0","4","35005","1"
"Cibola","0","1","New Mexico","3/27/20","0","1","35006","1"
"Curry","0","1","New Mexico","3/27/20","0","1","35009","1"
"Dona Ana","2","16","New Mexico","3/27/20","0","16","35013","1"
"Eddy","0","1","New Mexico","3/27/20","0","1","35015","1"
"Lea","0","1","New Mexico","3/27/20","0","1","35025","1"
"McKinley","0","3","New Mexico","3/27/20","1","2","35031","200"
"Rio Arriba","0","2","New Mexico","3/27/20","0","2","35039","1"
"San Juan","2","14","New Mexico","3/27/20","0","14","35045","1"
"San Miguel","0","1","New Mexico","3/27/20","1","0","35047","0"
"Sandoval","1","10","New Mexico","3/27/20","6","4","35043","66.67"
"Santa Fe","2","22","New Mexico","3/27/20","7","15","35049","214.29"
"Socorro","0","2","New Mexico","3/27/20","2","0","35053","0"
"Taos","0","3","New Mexico","3/27/20","2","1","35055","50"
"Albany","17","187","New York","3/27/20","70","117","36001","167.14"
"Allegany","0","2","New York","3/27/20","2","0","36003","0"
"Broome","2","18","New York","3/27/20","1","17","36007","1700"
"Cayuga","0","2","New York","3/27/20","0","2","36011","1"
"Chautauqua","0","2","New York","3/27/20","0","2","36013","1"
"Chemung","2","11","New York","3/27/20","0","11","36015","1"
"Chenango","0","4","New York","3/27/20","1","3","36017","300"
"Clinton","1","11","New York","3/27/20","3","8","36019","266.67"
"Columbia","3","27","New York","3/27/20","3","24","36021","800"
"Cortland","1","4","New York","3/27/20","0","4","36023","1"
"Delaware","1","8","New York","3/27/20","1","7","36025","700"
"Dutchess","27","225","New York","3/27/20","36","189","36027","525"
"Erie","28","245","New York","3/27/20","47","198","36029","421.28"
"Essex","1","5","New York","3/27/20","1","4","36031","400"
"Franklin","0","2","New York","3/27/20","0","2","36033","1"
"Fulton","0","1","New York","3/27/20","0","1","36035","1"
"Genesee","1","6","New York","3/27/20","1","5","36037","500"
"Greene","1","6","New York","3/27/20","2","4","36039","200"
"Hamilton","0","2","New York","3/27/20","1","1","36041","100"
"Herkimer","1","9","New York","3/27/20","1","8","36043","800"
"Jefferson","1","4","New York","3/27/20","0","4","36045","1"
"Livingston","0","3","New York","3/27/20","0","3","36051","1"
"Madison","2","17","New York","3/27/20","0","17","36053","1"
"Monroe","19","166","New York","3/27/20","36","130","36055","361.11"
"Montgomery","0","5","New York","3/27/20","2","3","36057","150"
"Nassau","558","4657","New York","3/27/20","754","3903","36059","517.64"
"New York","2917","25573","New York","3/27/20","5151","20422","36061","396.47"
"Niagara","3","23","New York","3/27/20","4","19","36063","475"
"Oneida","2","13","New York","3/27/20","2","11","36065","550"
"Onondaga","16","123","New York","3/27/20","13","110","36067","846.15"
"Ontario","2","14","New York","3/27/20","1","13","36069","1300"
"Orange","118","910","New York","3/27/20","84","826","36071","983.33"
"Orleans","0","3","New York","3/27/20","0","3","36073","1"
"Oswego","1","4","New York","3/27/20","0","4","36075","1"
"Otsego","1","5","New York","3/27/20","0","5","36077","1"
"Putnam","14","111","New York","3/27/20","12","99","36079","825"
"Rensselaer","5","44","New York","3/27/20","8","36","36083","450"
"Rockland","194","1457","New York","3/27/20","101","1356","36087","1342.57"
"Saratoga","9","82","New York","3/27/20","21","61","36091","290.48"
"Schenectady","7","66","New York","3/27/20","14","52","36093","371.43"
"Schoharie","0","3","New York","3/27/20","2","1","36095","50"
"St. Lawrence","1","4","New York","3/27/20","0","4","36089","1"
"Steuben","1","12","New York","3/27/20","2","10","36101","500"
"Suffolk","418","3385","New York","3/27/20","459","2926","36103","637.47"
"Sullivan","9","64","New York","3/27/20","1","63","36105","6300"
"Tioga","0","2","New York","3/27/20","1","1","36107","100"
"Tompkins","3","32","New York","3/27/20","11","21","36109","190.91"
"Ulster","13","98","New York","3/27/20","9","89","36111","988.89"
"Warren","1","8","New York","3/27/20","1","7","36113","700"
"Washington","1","6","New York","3/27/20","1","5","36115","500"
"Wayne","1","11","New York","3/27/20","1","10","36117","1000"
"Westchester","871","7187","New York","3/27/20","1091","6096","36119","558.75"
"Wyoming","1","7","New York","3/27/20","2","5","36121","250"
"Alamance","1","5","North Carolina","3/27/20","1","4","37001","400"
"Beaufort","0","3","North Carolina","3/27/20","0","3","37013","1"
"Bertie","0","3","North Carolina","3/27/20","0","3","37015","1"
"Brunswick","1","11","North Carolina","3/27/20","4","7","37019","175"
"Buncombe","2","15","North Carolina","3/27/20","1","14","37021","1400"
"Burke","0","3","North Carolina","3/27/20","0","3","37023","1"
"Cabarrus","3","22","North Carolina","3/27/20","2","20","37025","1000"
"Caldwell","0","3","North Carolina","3/27/20","0","3","37027","1"
"Carteret","1","5","North Carolina","3/27/20","1","4","37031","400"
"Catawba","1","10","North Carolina","3/27/20","1","9","37035","900"
"Chatham","1","11","North Carolina","3/27/20","3","8","37037","266.67"
"Cherokee","1","4","North Carolina","3/27/20","0","4","37039","1"
"Chowan","0","0","North Carolina","3/27/20","1","-1","37041","-100"
"Cleveland","0","2","North Carolina","3/27/20","1","1","37045","100"
"Craven","0","4","North Carolina","3/27/20","2","2","37049","100"
"Cumberland","1","8","North Carolina","3/27/20","2","6","37051","300"
"Dare","0","2","North Carolina","3/27/20","0","2","37055","1"
"Davidson","2","12","North Carolina","3/27/20","1","11","37057","1100"
"Davie","0","2","North Carolina","3/27/20","0","2","37059","1"
"Duplin","0","1","North Carolina","3/27/20","0","1","37061","1"
"Durham","8","93","North Carolina","3/27/20","39","54","37063","138.46"
"Forsyth","2","24","North Carolina","3/27/20","7","17","37067","242.86"
"Franklin","0","5","North Carolina","3/27/20","4","1","37069","25"
"Gaston","2","17","North Carolina","3/27/20","1","16","37071","1600"
"Granville","0","3","North Carolina","3/27/20","0","3","37077","1"
"Guilford","4","31","North Carolina","3/27/20","4","27","37081","675"
"Halifax","0","1","North Carolina","3/27/20","0","1","37083","1"
"Harnett","1","11","North Carolina","3/27/20","6","5","37085","83.33"
"Henderson","1","7","North Carolina","3/27/20","0","7","37089","1"
"Hertford","0","3","North Carolina","3/27/20","0","3","37091","1"
"Hoke","0","2","North Carolina","3/27/20","1","1","37093","100"
"Hyde","0","1","North Carolina","3/27/20","0","1","37095","1"
"Iredell","2","15","North Carolina","3/27/20","2","13","37097","650"
"Jackson","0","1","North Carolina","3/27/20","0","1","37099","1"
"Johnston","1","9","North Carolina","3/27/20","3","6","37101","200"
"Lee","0","2","North Carolina","3/27/20","1","1","37105","100"
"Lenoir","0","3","North Carolina","3/27/20","0","3","37107","1"
"Lincoln","0","1","North Carolina","3/27/20","1","0","37109","0"
"McDowell","0","2","North Carolina","3/27/20","0","2","37111","1"
"Mecklenburg","31","259","North Carolina","3/27/20","43","216","37119","502.33"
"Mitchell","0","1","North Carolina","3/27/20","0","1","37121","1"
"Montgomery","0","3","North Carolina","3/27/20","0","3","37123","1"
"Moore","0","3","North Carolina","3/27/20","2","1","37125","50"
"Nash","1","4","North Carolina","3/27/20","0","4","37127","1"
"New Hanover","2","15","North Carolina","3/27/20","1","14","37129","1400"
"Northampton","0","3","North Carolina","3/27/20","0","3","37131","1"
"Onslow","0","4","North Carolina","3/27/20","1","3","37133","300"
"Orange","3","24","North Carolina","3/27/20","4","20","37135","500"
"Pasquotank","0","1","North Carolina","3/27/20","1","0","37139","0"
"Person","0","1","North Carolina","3/27/20","0","1","37145","1"
"Pitt","1","8","North Carolina","3/27/20","2","6","37147","300"
"Polk","0","1","North Carolina","3/27/20","0","1","37149","1"
"Randolph","1","8","North Carolina","3/27/20","0","8","37151","1"
"Robeson","0","2","North Carolina","3/27/20","0","2","37155","1"
"Rowan","1","12","North Carolina","3/27/20","2","10","37159","500"
"Sampson","0","1","North Carolina","3/27/20","1","0","37163","0"
"Scotland","0","1","North Carolina","3/27/20","0","1","37165","1"
"Surry","0","1","North Carolina","3/27/20","0","1","37171","1"
"Swain","0","1","North Carolina","3/27/20","0","1","37173","1"
"Transylvania","0","3","North Carolina","3/27/20","0","3","37175","1"
"Union","4","34","North Carolina","3/27/20","6","28","37179","466.67"
"Vance","0","2","North Carolina","3/27/20","0","2","37181","1"
"Wake","13","123","North Carolina","3/27/20","32","91","37183","284.38"
"Watauga","0","5","North Carolina","3/27/20","2","3","37189","150"
"Wayne","0","3","North Carolina","3/27/20","1","2","37191","200"
"Wilson","1","7","North Carolina","3/27/20","2","5","37195","250"
"Burleigh","2","25","North Dakota","3/27/20","13","12","38015","92.31"
"Cass","1","11","North Dakota","3/27/20","1","10","38017","1000"
"Dunn","0","1","North Dakota","3/27/20","0","1","38025","1"
"Foster","0","1","North Dakota","3/27/20","0","1","38031","1"
"McHenry","0","1","North Dakota","3/27/20","0","1","38049","1"
"McIntosh","0","1","North Dakota","3/27/20","0","1","38051","1"
"Morton","1","11","North Dakota","3/27/20","7","4","38059","57.14"
"Pierce","0","2","North Dakota","3/27/20","1","1","38069","100"
"Ramsey","0","3","North Dakota","3/27/20","1","2","38071","200"
"Stark","1","7","North Dakota","3/27/20","0","7","38089","1"
"Walsh","0","1","North Dakota","3/27/20","0","1","38099","1"
"Ward","0","4","North Dakota","3/27/20","3","1","38101","33.33"
"Ashland","0","3","Ohio","3/27/20","1","2","39005","200"
"Ashtabula","1","5","Ohio","3/27/20","1","4","39007","400"
"Athens","0","1","Ohio","3/27/20","0","1","39009","1"
"Belmont","1","6","Ohio","3/27/20","2","4","39013","200"
"Butler","2","23","Ohio","3/27/20","12","11","39017","91.67"
"Carroll","0","3","Ohio","3/27/20","0","3","39019","1"
"Champaign","0","2","Ohio","3/27/20","0","2","39021","1"
"Clark","0","2","Ohio","3/27/20","1","1","39023","100"
"Clermont","1","6","Ohio","3/27/20","0","6","39025","1"
"Clinton","0","2","Ohio","3/27/20","0","2","39027","1"
"Columbiana","1","7","Ohio","3/27/20","0","7","39029","1"
"Coshocton","0","4","Ohio","3/27/20","2","2","39031","100"
"Crawford","0","1","Ohio","3/27/20","0","1","39033","1"
"Cuyahoga","37","330","Ohio","3/27/20","69","261","39035","378.26"
"Darke","0","1","Ohio","3/27/20","1","0","39037","0"
"Defiance","1","5","Ohio","3/27/20","1","4","39039","400"
"Delaware","3","20","Ohio","3/27/20","2","18","39041","900"
"Erie","0","3","Ohio","3/27/20","1","2","39043","200"
"Fairfield","1","8","Ohio","3/27/20","0","8","39045","1"
"Fayette","0","1","Ohio","3/27/20","0","1","39047","1"
"Franklin","20","152","Ohio","3/27/20","14","138","39049","985.71"
"Fulton","0","2","Ohio","3/27/20","0","2","39051","1"
"Gallia","0","1","Ohio","3/27/20","0","1","39053","1"
"Geauga","1","10","Ohio","3/27/20","1","9","39055","900"
"Greene","0","3","Ohio","3/27/20","0","3","39057","1"
"Hamilton","8","63","Ohio","3/27/20","7","56","39061","800"
"Hancock","0","2","Ohio","3/27/20","0","2","39063","1"
"Highland","0","1","Ohio","3/27/20","0","1","39071","1"
"Huron","0","3","Ohio","3/27/20","1","2","39077","200"
"Jefferson","0","1","Ohio","3/27/20","0","1","39081","1"
"Knox","0","2","Ohio","3/27/20","0","2","39083","1"
"Lake","3","27","Ohio","3/27/20","3","24","39085","800"
"Lawrence","0","1","Ohio","3/27/20","0","1","39087","1"
"Licking","1","10","Ohio","3/27/20","1","9","39089","900"
"Logan","0","2","Ohio","3/27/20","0","2","39091","1"
"Lorain","7","56","Ohio","3/27/20","10","46","39093","460"
"Lucas","7","48","Ohio","3/27/20","2","46","39095","2300"
"Madison","0","3","Ohio","3/27/20","0","3","39097","1"
"Mahoning","9","68","Ohio","3/27/20","7","61","39099","871.43"
"Marion","1","5","Ohio","3/27/20","1","4","39101","400"
"Medina","4","32","Ohio","3/27/20","6","26","39103","433.33"
"Mercer","0","2","Ohio","3/27/20","0","2","39107","1"
"Miami","4","32","Ohio","3/27/20","2","30","39109","1500"
"Montgomery","3","19","Ohio","3/27/20","1","18","39113","1800"
"Muskingum","0","2","Ohio","3/27/20","0","2","39119","1"
"Pickaway","0","2","Ohio","3/27/20","0","2","39129","1"
"Portage","2","13","Ohio","3/27/20","0","13","39133","1"
"Richland","0","4","Ohio","3/27/20","1","3","39139","300"
"Sandusky","0","1","Ohio","3/27/20","0","1","39143","1"
"Seneca","0","1","Ohio","3/27/20","0","1","39147","1"
"Shelby","0","1","Ohio","3/27/20","0","1","39149","1"
"Stark","2","22","Ohio","3/27/20","6","16","39151","266.67"
"Summit","8","65","Ohio","3/27/20","10","55","39153","550"
"Trumbull","2","17","Ohio","3/27/20","3","14","39155","466.67"
"Tuscarawas","0","3","Ohio","3/27/20","1","2","39157","200"
"Union","0","3","Ohio","3/27/20","1","2","39159","200"
"Warren","1","11","Ohio","3/27/20","2","9","39165","450"
"Washington","0","2","Ohio","3/27/20","0","2","39167","1"
"Wayne","0","3","Ohio","3/27/20","0","3","39169","1"
"Wood","1","8","Ohio","3/27/20","0","8","39173","1"
"Wyandot","0","1","Ohio","3/27/20","0","1","39175","1"
"Adair","0","3","Oklahoma","3/27/20","0","3","40001","1"
"Bryan","0","1","Oklahoma","3/27/20","0","1","40013","1"
"Caddo","0","1","Oklahoma","3/27/20","0","1","40015","1"
"Canadian","1","11","Oklahoma","3/27/20","2","9","40017","450"
"Carter","0","1","Oklahoma","3/27/20","0","1","40019","1"
"Cherokee","0","1","Oklahoma","3/27/20","0","1","40021","1"
"Choctaw","0","1","Oklahoma","3/27/20","0","1","40023","1"
"Cleveland","4","39","Oklahoma","3/27/20","11","28","40027","254.55"
"Comanche","1","6","Oklahoma","3/27/20","0","6","40031","1"
"Craig","0","1","Oklahoma","3/27/20","0","1","40035","1"
"Creek","2","14","Oklahoma","3/27/20","0","14","40037","1"
"Custer","0","3","Oklahoma","3/27/20","1","2","40039","200"
"Delaware","0","2","Oklahoma","3/27/20","0","2","40041","1"
"Garvin","0","2","Oklahoma","3/27/20","1","1","40049","100"
"Grady","0","2","Oklahoma","3/27/20","1","1","40051","100"
"Jackson","0","1","Oklahoma","3/27/20","1","0","40065","0"
"Kay","2","17","Oklahoma","3/27/20","3","14","40071","466.67"
"Latimer","0","1","Oklahoma","3/27/20","0","1","40077","1"
"Lincoln","0","3","Oklahoma","3/27/20","0","3","40081","1"
"Logan","0","3","Oklahoma","3/27/20","1","2","40083","200"
"Mayes","0","2","Oklahoma","3/27/20","0","2","40097","1"
"McClain","0","2","Oklahoma","3/27/20","1","1","40087","100"
"Muskogee","1","5","Oklahoma","3/27/20","0","5","40101","1"
"Noble","0","3","Oklahoma","3/27/20","0","3","40103","1"
"Oklahoma","11","94","Oklahoma","3/27/20","19","75","40109","394.74"
"Okmulgee","0","2","Oklahoma","3/27/20","0","2","40111","1"
"Osage","1","5","Oklahoma","3/27/20","0","5","40113","1"
"Ottawa","0","1","Oklahoma","3/27/20","0","1","40115","1"
"Pawnee","2","14","Oklahoma","3/27/20","1","13","40117","1300"
"Payne","1","7","Oklahoma","3/27/20","1","6","40119","600"
"Pittsburg","0","2","Oklahoma","3/27/20","0","2","40121","1"
"Pontotoc","0","2","Oklahoma","3/27/20","0","2","40123","1"
"Pottawatomie","0","2","Oklahoma","3/27/20","0","2","40125","1"
"Sequoyah","0","1","Oklahoma","3/27/20","0","1","40135","1"
"Stephens","0","1","Oklahoma","3/27/20","0","1","40137","1"
"Tulsa","6","49","Oklahoma","3/27/20","5","44","40143","880"
"Wagoner","1","8","Oklahoma","3/27/20","0","8","40145","1"
"Washington","1","9","Oklahoma","3/27/20","1","8","40147","800"
"Benton","0","6","Oregon","3/27/20","3","3","41003","100"
"Clackamas","3","31","Oregon","3/27/20","10","21","41005","210"
"Clatsop","0","2","Oregon","3/27/20","0","2","41007","1"
"Columbia","0","1","Oregon","3/27/20","0","1","41009","1"
"Deschutes","1","18","Oregon","3/27/20","8","10","41017","125"
"Douglas","0","4","Oregon","3/27/20","1","3","41019","300"
"Grant","0","1","Oregon","3/27/20","1","0","41023","0"
"Hood River","0","1","Oregon","3/27/20","0","1","41027","1"
"Jackson","1","6","Oregon","3/27/20","2","4","41029","200"
"Josephine","1","4","Oregon","3/27/20","0","4","41033","1"
"Klamath","0","2","Oregon","3/27/20","1","1","41035","100"
"Lane","1","10","Oregon","3/27/20","2","8","41039","400"
"Lincoln","0","1","Oregon","3/27/20","0","1","41041","1"
"Linn","1","28","Oregon","3/27/20","18","10","41043","55.56"
"Marion","9","83","Oregon","3/27/20","17","66","41047","388.24"
"Morrow","0","1","Oregon","3/27/20","0","1","41049","1"
"Multnomah","8","67","Oregon","3/27/20","12","55","41051","458.33"
"Polk","1","10","Oregon","3/27/20","1","9","41053","900"
"Tillamook","0","1","Oregon","3/27/20","0","1","41057","1"
"Umatilla","0","3","Oregon","3/27/20","2","1","41059","50"
"Union","0","1","Oregon","3/27/20","1","0","41061","0"
"Wasco","0","2","Oregon","3/27/20","0","2","41065","1"
"Washington","13","122","Oregon","3/27/20","31","91","41067","293.55"
"Yamhill","1","11","Oregon","3/27/20","4","7","41071","175"
"Adams","1","8","Pennsylvania","3/27/20","4","4","42001","100"
"Allegheny","19","158","Pennsylvania","3/27/20","28","130","42003","464.29"
"Armstrong","0","1","Pennsylvania","3/27/20","0","1","42005","1"
"Beaver","2","14","Pennsylvania","3/27/20","3","11","42007","366.67"
"Berks","9","65","Pennsylvania","3/27/20","5","60","42011","1200"
"Blair","0","1","Pennsylvania","3/27/20","0","1","42013","1"
"Bradford","0","2","Pennsylvania","3/27/20","0","2","42015","1"
"Bucks","17","144","Pennsylvania","3/27/20","24","120","42017","500"
"Butler","4","26","Pennsylvania","3/27/20","0","26","42019","1"
"Cambria","0","1","Pennsylvania","3/27/20","0","1","42021","1"
"Carbon","0","2","Pennsylvania","3/27/20","0","2","42025","1"
"Centre","1","11","Pennsylvania","3/27/20","1","10","42027","1000"
"Chester","13","107","Pennsylvania","3/27/20","17","90","42029","529.41"
"Clearfield","0","2","Pennsylvania","3/27/20","0","2","42033","1"
"Columbia","0","3","Pennsylvania","3/27/20","0","3","42037","1"
"Crawford","0","1","Pennsylvania","3/27/20","0","1","42039","1"
"Cumberland","1","16","Pennsylvania","3/27/20","11","5","42041","45.45"
"Dauphin","3","18","Pennsylvania","3/27/20","0","18","42043","1"
"Delaware","23","185","Pennsylvania","3/27/20","23","162","42045","704.35"
"Erie","1","7","Pennsylvania","3/27/20","1","6","42049","600"
"Fayette","1","9","Pennsylvania","3/27/20","0","9","42051","1"
"Franklin","1","5","Pennsylvania","3/27/20","1","4","42055","400"
"Greene","1","4","Pennsylvania","3/27/20","0","4","42059","1"
"Indiana","0","2","Pennsylvania","3/27/20","0","2","42063","1"
"Juniata","0","1","Pennsylvania","3/27/20","0","1","42067","1"
"Lackawanna","4","35","Pennsylvania","3/27/20","4","31","42069","775"
"Lancaster","4","33","Pennsylvania","3/27/20","2","31","42071","1550"
"Lawrence","1","4","Pennsylvania","3/27/20","0","4","42073","1"
"Lebanon","2","12","Pennsylvania","3/27/20","1","11","42075","1100"
"Lehigh","13","93","Pennsylvania","3/27/20","2","91","42077","4550"
"Luzerne","8","55","Pennsylvania","3/27/20","2","53","42079","2650"
"Lycoming","0","2","Pennsylvania","3/27/20","0","2","42081","1"
"Mercer","1","4","Pennsylvania","3/27/20","0","4","42085","1"
"Monroe","11","98","Pennsylvania","3/27/20","19","79","42089","415.79"
"Montgomery","44","374","Pennsylvania","3/27/20","68","306","42091","450"
"Montour","1","4","Pennsylvania","3/27/20","0","4","42093","1"
"Northampton","10","79","Pennsylvania","3/27/20","10","69","42095","690"
"Philadelphia","81","637","Pennsylvania","3/27/20","67","570","42101","850.75"
"Pike","3","23","Pennsylvania","3/27/20","3","20","42103","666.67"
"Potter","0","1","Pennsylvania","3/27/20","1","0","42105","0"
"Schuylkill","2","13","Pennsylvania","3/27/20","0","13","42107","1"
"Somerset","0","2","Pennsylvania","3/27/20","0","2","42111","1"
"Susquehanna","0","1","Pennsylvania","3/27/20","0","1","42115","1"
"Union","0","1","Pennsylvania","3/27/20","0","1","42119","1"
"Warren","0","1","Pennsylvania","3/27/20","0","1","42123","1"
"Washington","2","14","Pennsylvania","3/27/20","3","11","42125","366.67"
"Wayne","1","6","Pennsylvania","3/27/20","1","5","42127","500"
"Westmoreland","4","30","Pennsylvania","3/27/20","4","26","42129","650"
"York","3","30","Pennsylvania","3/27/20","6","24","42133","400"
"","9","79","Puerto Rico","3/27/20","14","65",,"464.29"
"Bristol","1","6","Rhode Island","3/27/20","0","6","44001","1"
"Kent","1","9","Rhode Island","3/27/20","0","9","44003","1"
"Newport","2","12","Rhode Island","3/27/20","0","12","44005","1"
"Providence","7","91","Rhode Island","3/27/20","44","47","44007","106.82"
"Washington","2","14","Rhode Island","3/27/20","0","14","44009","1"
"Abbeville","0","4","South Carolina","3/27/20","1","3","45001","300"
"Aiken","1","6","South Carolina","3/27/20","1","5","45003","500"
"Anderson","2","21","South Carolina","3/27/20","6","15","45007","250"
"Beaufort","4","35","South Carolina","3/27/20","8","27","45013","337.5"
"Berkeley","1","10","South Carolina","3/27/20","1","9","45015","900"
"Calhoun","0","1","South Carolina","3/27/20","1","0","45017","0"
"Charleston","12","92","South Carolina","3/27/20","6","86","45019","1433.33"
"Chester","0","1","South Carolina","3/27/20","0","1","45023","1"
"Chesterfield","1","4","South Carolina","3/27/20","0","4","45025","1"
"Clarendon","1","6","South Carolina","3/27/20","1","5","45027","500"
"Colleton","0","2","South Carolina","3/27/20","0","2","45029","1"
"Darlington","1","8","South Carolina","3/27/20","1","7","45031","700"
"Dillon","0","1","South Carolina","3/27/20","0","1","45033","1"
"Dorchester","1","9","South Carolina","3/27/20","1","8","45035","800"
"Edgefield","0","1","South Carolina","3/27/20","0","1","45037","1"
"Fairfield","0","4","South Carolina","3/27/20","1","3","45039","300"
"Florence","1","11","South Carolina","3/27/20","1","10","45041","1000"
"Georgetown","0","3","South Carolina","3/27/20","0","3","45043","1"
"Greenville","6","51","South Carolina","3/27/20","12","39","45045","325"
"Greenwood","0","2","South Carolina","3/27/20","0","2","45047","1"
"Horry","2","24","South Carolina","3/27/20","8","16","45051","200"
"Jasper","0","3","South Carolina","3/27/20","0","3","45053","1"
"Kershaw","5","70","South Carolina","3/27/20","36","34","45055","94.44"
"Lancaster","1","8","South Carolina","3/27/20","3","5","45057","166.67"
"Lee","0","2","South Carolina","3/27/20","1","1","45061","100"
"Lexington","2","25","South Carolina","3/27/20","8","17","45063","212.5"
"Marion","0","1","South Carolina","3/27/20","0","1","45067","1"
"Marlboro","0","1","South Carolina","3/27/20","0","1","45069","1"
"Newberry","0","1","South Carolina","3/27/20","0","1","45071","1"
"Oconee","0","3","South Carolina","3/27/20","0","3","45073","1"
"Orangeburg","1","12","South Carolina","3/27/20","2","10","45075","500"
"Pickens","1","7","South Carolina","3/27/20","1","6","45077","600"
"Richland","6","65","South Carolina","3/27/20","22","43","45079","195.45"
"Saluda","0","1","South Carolina","3/27/20","1","0","45081","0"
"Spartanburg","2","16","South Carolina","3/27/20","1","15","45083","1500"
"Sumter","1","10","South Carolina","3/27/20","1","9","45085","900"
"Union","0","1","South Carolina","3/27/20","0","1","45087","1"
"Williamsburg","0","1","South Carolina","3/27/20","0","1","45089","1"
"York","3","19","South Carolina","3/27/20","1","18","45091","1800"
"Aurora","0","1","South Dakota","3/27/20","0","1","46003","1"
"Beadle","2","16","South Dakota","3/27/20","4","12","46005","300"
"Bon Homme","0","1","South Dakota","3/27/20","1","0","46009","0"
"Brookings","0","1","South Dakota","3/27/20","0","1","46011","1"
"Brown","0","2","South Dakota","3/27/20","0","2","46013","1"
"Charles Mix","0","1","South Dakota","3/27/20","1","0","46023","0"
"Codington","0","1","South Dakota","3/27/20","0","1","46029","1"
"Davison","0","2","South Dakota","3/27/20","1","1","46035","100"
"Faulk","0","1","South Dakota","3/27/20","0","1","46049","1"
"Hughes","0","1","South Dakota","3/27/20","0","1","46065","1"
"Lawrence","0","2","South Dakota","3/27/20","0","2","46081","1"
"Lincoln","0","2","South Dakota","3/27/20","0","2","46083","1"
"Lyman","0","1","South Dakota","3/27/20","0","1","46085","1"
"McCook","0","2","South Dakota","3/27/20","1","1","46087","100"
"Meade","0","1","South Dakota","3/27/20","0","1","46093","1"
"Minnehaha","2","18","South Dakota","3/27/20","5","13","46099","260"
"Pennington","0","3","South Dakota","3/27/20","1","2","46103","200"
"Todd","0","1","South Dakota","3/27/20","0","1","46121","1"
"Union","0","1","South Dakota","3/27/20","0","1","46127","1"
"Anderson","0","4","Tennessee","3/27/20","1","3","47001","300"
"Bedford","0","1","Tennessee","3/27/20","0","1","47003","1"
"Benton","0","2","Tennessee","3/27/20","0","2","47005","1"
"Blount","1","6","Tennessee","3/27/20","1","5","47009","500"
"Bradley","1","6","Tennessee","3/27/20","1","5","47011","500"
"Campbell","0","4","Tennessee","3/27/20","1","3","47013","300"
"Cannon","0","2","Tennessee","3/27/20","0","2","47015","1"
"Carroll","0","4","Tennessee","3/27/20","1","3","47017","300"
"Cheatham","1","7","Tennessee","3/27/20","2","5","47021","250"
"Chester","0","2","Tennessee","3/27/20","0","2","47023","1"
"Claiborne","0","2","Tennessee","3/27/20","0","2","47025","1"
"Cocke","0","1","Tennessee","3/27/20","0","1","47029","1"
"Cumberland","1","6","Tennessee","3/27/20","2","4","47035","200"
"Davidson","30","312","Tennessee","3/27/20","101","211","47037","208.91"
"Dickson","1","9","Tennessee","3/27/20","1","8","47043","800"
"Dyer","0","3","Tennessee","3/27/20","1","2","47045","200"
"Fayette","0","3","Tennessee","3/27/20","1","2","47047","200"
"Franklin","0","3","Tennessee","3/27/20","0","3","47051","1"
"Gibson","0","2","Tennessee","3/27/20","0","2","47053","1"
"Greene","1","8","Tennessee","3/27/20","1","7","47059","700"
"Grundy","0","1","Tennessee","3/27/20","0","1","47061","1"
"Hamblen","0","2","Tennessee","3/27/20","0","2","47063","1"
"Hamilton","4","30","Tennessee","3/27/20","5","25","47065","500"
"Hardin","0","1","Tennessee","3/27/20","0","1","47071","1"
"Hawkins","0","2","Tennessee","3/27/20","0","2","47073","1"
"Houston","0","2","Tennessee","3/27/20","0","2","47083","1"
"Jefferson","1","5","Tennessee","3/27/20","1","4","47089","400"
"Knox","4","31","Tennessee","3/27/20","2","29","47093","1450"
"Lewis","0","2","Tennessee","3/27/20","0","2","47101","1"
"Lincoln","0","1","Tennessee","3/27/20","0","1","47103","1"
"Loudon","1","6","Tennessee","3/27/20","0","6","47105","1"
"Macon","0","1","Tennessee","3/27/20","0","1","47111","1"
"Madison","0","3","Tennessee","3/27/20","0","3","47113","1"
"Marion","0","2","Tennessee","3/27/20","0","2","47115","1"
"Maury","1","7","Tennessee","3/27/20","0","7","47119","1"
"McMinn","0","3","Tennessee","3/27/20","0","3","47107","1"
"Meigs","0","1","Tennessee","3/27/20","0","1","47121","1"
"Monroe","0","2","Tennessee","3/27/20","0","2","47123","1"
"Montgomery","1","9","Tennessee","3/27/20","1","8","47125","800"
"Out of TN","20","141","Tennessee","3/27/20","0","141","80047","1"
"Overton","0","1","Tennessee","3/27/20","0","1","47133","1"
"Perry","0","2","Tennessee","3/27/20","0","2","47135","1"
"Putnam","2","13","Tennessee","3/27/20","0","13","47141","1"
"Roane","0","1","Tennessee","3/27/20","0","1","47145","1"
"Robertson","3","22","Tennessee","3/27/20","1","21","47147","2100"
"Rutherford","5","39","Tennessee","3/27/20","1","38","47149","3800"
"Scott","0","2","Tennessee","3/27/20","0","2","47151","1"
"Sevier","1","6","Tennessee","3/27/20","1","5","47155","500"
"Shelby","31","223","Tennessee","3/27/20","4","219","47157","5475"
"Smith","0","1","Tennessee","3/27/20","0","1","47159","1"
"Sullivan","1","6","Tennessee","3/27/20","1","5","47163","500"
"Sumner","7","58","Tennessee","3/27/20","11","47","47165","427.27"
"Tipton","1","10","Tennessee","3/27/20","0","10","47167","1"
"Unicoi","0","1","Tennessee","3/27/20","0","1","47171","1"
"Washington","1","10","Tennessee","3/27/20","2","8","47179","400"
"White","0","1","Tennessee","3/27/20","0","1","47185","1"
"Williamson","8","91","Tennessee","3/27/20","35","56","47187","160"
"Wilson","3","20","Tennessee","3/27/20","1","19","47189","1900"
"Angelina","0","2","Texas","3/27/20","0","2","48005","1"
"Atascosa","0","2","Texas","3/27/20","0","2","48013","1"
"Austin","0","1","Texas","3/27/20","0","1","48015","1"
"Bastrop","0","2","Texas","3/27/20","0","2","48021","1"
"Bell","3","25","Texas","3/27/20","7","18","48027","257.14"
"Bexar","12","113","Texas","3/27/20","29","84","48029","289.66"
"Blanco","0","1","Texas","3/27/20","0","1","48031","1"
"Bowie","0","2","Texas","3/27/20","1","1","48037","100"
"Brazoria","4","39","Texas","3/27/20","10","29","48039","290"
"Brazos","4","31","Texas","3/27/20","6","25","48041","416.67"
"Brown","0","3","Texas","3/27/20","2","1","48049","50"
"Burnet","0","1","Texas","3/27/20","0","1","48053","1"
"Calhoun","0","3","Texas","3/27/20","0","3","48057","1"
"Cameron","2","13","Texas","3/27/20","1","12","48061","1200"
"Cass","0","1","Texas","3/27/20","0","1","48067","1"
"Castro","1","7","Texas","3/27/20","1","6","48069","600"
"Chambers","0","2","Texas","3/27/20","0","2","48071","1"
"Cherokee","0","1","Texas","3/27/20","0","1","48073","1"
"Collin","9","87","Texas","3/27/20","27","60","48085","222.22"
"Comal","1","9","Texas","3/27/20","2","7","48091","350"
"Coryell","0","1","Texas","3/27/20","0","1","48099","1"
"Crane","0","1","Texas","3/27/20","1","0","48103","0"
"Dallas","42","367","Texas","3/27/20","74","293","48113","395.95"
"Dawson","0","1","Texas","3/27/20","0","1","48115","1"
"Deaf Smith","0","2","Texas","3/27/20","0","2","48117","1"
"Denton","17","137","Texas","3/27/20","15","122","48121","813.33"
"DeWitt","0","3","Texas","3/27/20","1","2","48123","200"
"Eastland","1","4","Texas","3/27/20","0","4","48133","1"
"El Paso","3","28","Texas","3/27/20","6","22","48141","366.67"
"Ellis","1","10","Texas","3/27/20","1","9","48139","900"
"Erath","0","1","Texas","3/27/20","0","1","48143","1"
"Falls","0","1","Texas","3/27/20","0","1","48145","1"
"Fannin","0","1","Texas","3/27/20","1","0","48147","0"
"Fayette","0","1","Texas","3/27/20","1","0","48149","0"
"Fort Bend","11","101","Texas","3/27/20","24","77","48157","320.83"
"Gaines","0","1","Texas","3/27/20","0","1","48165","1"
"Galveston","5","40","Texas","3/27/20","6","34","48167","566.67"
"Grayson","0","2","Texas","3/27/20","0","2","48181","1"
"Gregg","0","4","Texas","3/27/20","1","3","48183","300"
"Grimes","0","2","Texas","3/27/20","1","1","48185","100"
"Guadalupe","1","8","Texas","3/27/20","1","7","48187","700"
"Hale","0","1","Texas","3/27/20","0","1","48189","1"
"Hardin","1","4","Texas","3/27/20","0","4","48199","1"
"Harris","25","229","Texas","3/27/20","55","174","48201","316.36"
"Harrison","0","1","Texas","3/27/20","0","1","48203","1"
"Hays","1","13","Texas","3/27/20","6","7","48209","116.67"
"Hidalgo","2","11","Texas","3/27/20","0","11","48215","1"
"Hockley","1","7","Texas","3/27/20","1","6","48219","600"
"Hood","0","2","Texas","3/27/20","0","2","48221","1"
"Hopkins","0","1","Texas","3/27/20","0","1","48223","1"
"Hunt","0","1","Texas","3/27/20","0","1","48231","1"
"Jackson","0","1","Texas","3/27/20","0","1","48239","1"
"Jefferson","1","8","Texas","3/27/20","1","7","48245","700"
"Johnson","1","6","Texas","3/27/20","1","5","48251","500"
"Karnes","0","1","Texas","3/27/20","0","1","48255","1"
"Kaufman","0","2","Texas","3/27/20","0","2","48257","1"
"Kendall","0","4","Texas","3/27/20","1","3","48259","300"
"Lamar","0","1","Texas","3/27/20","1","0","48277","0"
"Lamb","0","1","Texas","3/27/20","0","1","48279","1"
"Lavaca","0","1","Texas","3/27/20","1","0","48285","0"
"Liberty","0","2","Texas","3/27/20","0","2","48291","1"
"Limestone","0","1","Texas","3/27/20","0","1","48293","1"
"Llano","0","2","Texas","3/27/20","0","2","48299","1"
"Lubbock","4","29","Texas","3/27/20","2","27","48303","1350"
"Martin","0","1","Texas","3/27/20","0","1","48317","1"
"Matagorda","1","10","Texas","3/27/20","3","7","48321","233.33"
"Maverick","0","1","Texas","3/27/20","0","1","48323","1"
"McLennan","3","33","Texas","3/27/20","13","20","48309","153.85"
"Medina","0","3","Texas","3/27/20","0","3","48325","1"
"Midland","1","7","Texas","3/27/20","1","6","48329","600"
"Milam","0","2","Texas","3/27/20","1","1","48331","100"
"Montague","0","1","Texas","3/27/20","0","1","48337","1"
"Montgomery","5","47","Texas","3/27/20","10","37","48339","370"
"Morris","0","1","Texas","3/27/20","0","1","48343","1"
"Nacogdoches","0","1","Texas","3/27/20","0","1","48347","1"
"Navarro","0","1","Texas","3/27/20","0","1","48349","1"
"Nueces","3","18","Texas","3/27/20","0","18","48355","1"
"Oldham","0","2","Texas","3/27/20","1","1","48359","100"
"Orange","0","1","Texas","3/27/20","0","1","48361","1"
"Parker","0","2","Texas","3/27/20","0","2","48367","1"
"Potter","0","3","Texas","3/27/20","0","3","48375","1"
"Randall","0","3","Texas","3/27/20","2","1","48381","50"
"Reeves","0","1","Texas","3/27/20","0","1","48389","1"
"Robertson","0","1","Texas","3/27/20","0","1","48395","1"
"Rockwall","0","3","Texas","3/27/20","0","3","48397","1"
"Rusk","0","2","Texas","3/27/20","1","1","48401","100"
"San Patricio","0","2","Texas","3/27/20","0","2","48409","1"
"Shelby","0","1","Texas","3/27/20","0","1","48419","1"
"Smith","3","27","Texas","3/27/20","5","22","48423","440"
"Starr","0","2","Texas","3/27/20","0","2","48427","1"
"Swisher","0","1","Texas","3/27/20","0","1","48437","1"
"Tarrant","12","114","Texas","3/27/20","29","85","48439","293.1"
"Taylor","0","2","Texas","3/27/20","0","2","48441","1"
"Terry","1","4","Texas","3/27/20","0","4","48445","1"
"Tom Green","0","2","Texas","3/27/20","0","2","48451","1"
"Travis","15","160","Texas","3/27/20","58","102","48453","175.86"
"Uvalde","0","1","Texas","3/27/20","0","1","48463","1"
"Val Verde","0","3","Texas","3/27/20","0","3","48465","1"
"Van Zandt","0","1","Texas","3/27/20","1","0","48467","0"
"Victoria","0","3","Texas","3/27/20","0","3","48469","1"
"Walker","0","2","Texas","3/27/20","0","2","48471","1"
"Washington","0","3","Texas","3/27/20","0","3","48477","1"
"Webb","3","19","Texas","3/27/20","1","18","48479","1800"
"Wharton","0","3","Texas","3/27/20","0","3","48481","1"
"Wichita","2","15","Texas","3/27/20","4","11","48485","275"
"Willacy","0","1","Texas","3/27/20","0","1","48489","1"
"Williamson","4","34","Texas","3/27/20","8","26","48491","325"
"Wilson","0","1","Texas","3/27/20","0","1","48493","1"
"Yoakum","0","1","Texas","3/27/20","0","1","48501","1"
"Young","0","1","Texas","3/27/20","0","1","48503","1"
"Bear River","0","0","Utah","3/27/20","1","-1","00000","-100"
"Cache","0","0","Utah","3/27/20","2","-2","49005","-100"
"Davis","5","50","Utah","3/27/20","12","38","49011","316.67"
"Out of UT","2","14","Utah","3/27/20","0","14","80049","1"
"Salt Lake","25","218","Utah","3/27/20","44","174","49035","395.45"
"Summit","11","102","Utah","3/27/20","28","74","49043","264.29"
"Tooele","0","5","Utah","3/27/20","2","3","49045","150"
"Utah","3","26","Utah","3/27/20","2","24","49049","1200"
"Wasatch","3","28","Utah","3/27/20","4","24","49051","600"
"Washington","1","9","Utah","3/27/20","0","9","49053","1"
"Weber-Morgan","3","20","Utah","3/27/20","0","20","00000","1"
"Addison","2","13","Vermont","3/27/20","1","12","50001","1200"
"Bennington","2","15","Vermont","3/27/20","3","12","50003","400"
"Caledonia","0","2","Vermont","3/27/20","0","2","50005","1"
"Chittenden","12","90","Vermont","3/27/20","9","81","50007","900"
"Franklin","1","6","Vermont","3/27/20","0","6","50011","1"
"Lamoille","1","6","Vermont","3/27/20","0","6","50015","1"
"Orange","0","3","Vermont","3/27/20","1","2","50017","200"
"Orleans","1","4","Vermont","3/27/20","0","4","50019","1"
"Rutland","1","5","Vermont","3/27/20","0","5","50021","1"
"Washington","1","9","Vermont","3/27/20","1","8","50023","800"
"Windham","1","7","Vermont","3/27/20","0","7","50025","1"
"Windsor","2","18","Vermont","3/27/20","3","15","50027","500"
"","2","19","Virgin Islands","3/27/20","3","16",,"533.33"
"Accomack","0","2","Virginia","3/27/20","1","1","51001","100"
"Albemarle","1","8","Virginia","3/27/20","1","7","51003","700"
"Alexandria","2","18","Virginia","3/27/20","3","15","51510","500"
"Amelia","0","1","Virginia","3/27/20","0","1","51007","1"
"Amherst","0","1","Virginia","3/27/20","0","1","51009","1"
"Arlington","7","63","Virginia","3/27/20","17","46","51013","270.59"
"Bedford","0","3","Virginia","3/27/20","0","3","51019","1"
"Botetourt","0","1","Virginia","3/27/20","1","0","51023","0"
"Bristol","0","1","Virginia","3/27/20","0","1","51520","1"
"Charles City","0","1","Virginia","3/27/20","1","0","51036","0"
"Charlottesville","1","11","Virginia","3/27/20","3","8","51540","266.67"
"Chesapeake","1","5","Virginia","3/27/20","0","5","51550","1"
"Chesterfield","1","12","Virginia","3/27/20","6","6","51041","100"
"Culpeper","0","2","Virginia","3/27/20","0","2","51047","1"
"Danville","1","4","Virginia","3/27/20","0","4","51590","1"
"Fairfax","15","124","Virginia","3/27/20","16","108","51059","675"
"Fauquier","1","4","Virginia","3/27/20","0","4","51061","1"
"Fluvanna","0","3","Virginia","3/27/20","0","3","51065","1"
"Franklin","0","1","Virginia","3/27/20","1","0","51067","0"
"Frederick","1","4","Virginia","3/27/20","0","4","51069","1"
"Fredericksburg","0","1","Virginia","3/27/20","0","1","51630","1"
"Galax","0","1","Virginia","3/27/20","0","1","51640","1"
"Gloucester","0","3","Virginia","3/27/20","1","2","51073","200"
"Goochland","0","3","Virginia","3/27/20","1","2","51075","200"
"Greene","0","1","Virginia","3/27/20","0","1","51079","1"
"Halifax","0","1","Virginia","3/27/20","0","1","51083","1"
"Hampton","1","5","Virginia","3/27/20","0","5","51650","1"
"Hanover","0","2","Virginia","3/27/20","1","1","51085","100"
"Harrisonburg","1","5","Virginia","3/27/20","1","4","51660","400"
"Henrico","4","28","Virginia","3/27/20","3","25","51087","833.33"
"Isle of Wight","0","2","Virginia","3/27/20","0","2","51093","1"
"James City","5","55","Virginia","3/27/20","19","36","51095","189.47"
"King George","0","1","Virginia","3/27/20","0","1","51099","1"
"Lee","0","2","Virginia","3/27/20","0","2","51105","1"
"Loudoun","5","43","Virginia","3/27/20","9","34","51107","377.78"
"Louisa","1","5","Virginia","3/27/20","0","5","51109","1"
"Lynchburg","0","2","Virginia","3/27/20","0","2","51680","1"
"Madison","0","2","Virginia","3/27/20","0","2","51113","1"
"Mathews","0","1","Virginia","3/27/20","0","1","51115","1"
"Mecklenburg","0","4","Virginia","3/27/20","1","3","51117","300"
"Montgomery","0","1","Virginia","3/27/20","0","1","51121","1"
"Nelson","0","1","Virginia","3/27/20","0","1","51125","1"
"Newport News","2","12","Virginia","3/27/20","1","11","51700","1100"
"Norfolk","1","8","Virginia","3/27/20","1","7","51710","700"
"Northampton","0","1","Virginia","3/27/20","0","1","51131","1"
"Northumberland","0","2","Virginia","3/27/20","0","2","51133","1"
"Nottoway","0","1","Virginia","3/27/20","0","1","51135","1"
"Orange","0","1","Virginia","3/27/20","0","1","51137","1"
"Pittsylvania","0","1","Virginia","3/27/20","0","1","51143","1"
"Poquoson","0","1","Virginia","3/27/20","0","1","51735","1"
"Portsmouth","0","3","Virginia","3/27/20","0","3","51740","1"
"Prince Edward","0","2","Virginia","3/27/20","1","1","51147","100"
"Prince George","0","2","Virginia","3/27/20","0","2","51149","1"
"Prince William","5","44","Virginia","3/27/20","12","32","51153","266.67"
"Radford","0","1","Virginia","3/27/20","0","1","51750","1"
"Richmond City","2","17","Virginia","3/27/20","5","12","51760","240"
"Roanoke","0","1","Virginia","3/27/20","0","1","51161","1"
"Roanoke City","0","1","Virginia","3/27/20","0","1","51770","1"
"Rockbridge","0","2","Virginia","3/27/20","1","1","51163","100"
"Rockingham","1","4","Virginia","3/27/20","0","4","51165","1"
"Shenandoah","0","3","Virginia","3/27/20","0","3","51171","1"
"Southampton","0","1","Virginia","3/27/20","0","1","51175","1"
"Spotsylvania","0","3","Virginia","3/27/20","1","2","51177","200"
"Stafford","1","11","Virginia","3/27/20","2","9","51179","450"
"Suffolk","0","1","Virginia","3/27/20","1","0","51800","0"
"Virginia Beach","3","29","Virginia","3/27/20","5","24","51810","480"
"Warren","0","2","Virginia","3/27/20","0","2","51187","1"
"Washington","0","1","Virginia","3/27/20","0","1","51191","1"
"Williamsburg","0","5","Virginia","3/27/20","4","1","51830","25"
"York","1","9","Virginia","3/27/20","3","6","51199","200"
"Adams","0","3","Washington","3/27/20","0","3","53001","1"
"Benton","6","42","Washington","3/27/20","3","39","53005","1300"
"Chelan","1","12","Washington","3/27/20","2","10","53007","500"
"Clallam","1","5","Washington","3/27/20","1","4","53009","400"
"Clark","10","76","Washington","3/27/20","6","70","53011","1166.67"
"Columbia","0","1","Washington","3/27/20","1","0","53013","0"
"Cowlitz","1","7","Washington","3/27/20","1","6","53015","600"
"Douglas","1","5","Washington","3/27/20","0","5","53017","1"
"Ferry","0","1","Washington","3/27/20","0","1","53019","1"
"Franklin","1","12","Washington","3/27/20","2","10","53021","500"
"Grant","4","39","Washington","3/27/20","8","31","53025","387.5"
"Grays Harbor","0","1","Washington","3/27/20","1","0","53027","0"
"Island","6","64","Washington","3/27/20","19","45","53029","236.84"
"Jefferson","1","11","Washington","3/27/20","4","7","53031","175"
"King","112","1577","Washington","3/27/20","793","784","53033","98.87"
"Kitsap","3","33","Washington","3/27/20","12","21","53035","175"
"Kittitas","1","8","Washington","3/27/20","4","4","53037","100"
"Klickitat","1","7","Washington","3/27/20","2","5","53039","250"
"Lewis","1","5","Washington","3/27/20","1","4","53041","400"
"Lincoln","0","1","Washington","3/27/20","1","0","53043","0"
"Mason","0","2","Washington","3/27/20","1","1","53045","100"
"Okanogan","0","1","Washington","3/27/20","0","1","53047","1"
"Pierce","21","231","Washington","3/27/20","83","148","53053","178.31"
"San Juan","0","2","Washington","3/27/20","0","2","53055","1"
"Skagit","8","78","Washington","3/27/20","25","53","53057","212"
"Snohomish","75","912","Washington","3/27/20","385","527","53061","136.88"
"Spokane","10","83","Washington","3/27/20","11","72","53063","654.55"
"Stevens","0","2","Washington","3/27/20","0","2","53065","1"
"Thurston","2","24","Washington","3/27/20","8","16","53067","200"
"Walla Walla","0","2","Washington","3/27/20","0","2","53071","1"
"Whatcom","12","92","Washington","3/27/20","10","82","53073","820"
"Whitman","1","5","Washington","3/27/20","0","5","53075","1"
"Yakima","8","66","Washington","3/27/20","10","56","53077","560"
"Berkeley","1","4","West Virginia","3/27/20","0","4","54003","1"
"Harrison","1","4","West Virginia","3/27/20","0","4","54033","1"
"Jackson","1","5","West Virginia","3/27/20","1","4","54035","400"
"Jefferson","0","4","West Virginia","3/27/20","2","2","54037","100"
"Kanawha","2","15","West Virginia","3/27/20","1","14","54039","1400"
"Logan","0","1","West Virginia","3/27/20","0","1","54045","1"
"Marion","0","2","West Virginia","3/27/20","0","2","54049","1"
"Marshall","0","3","West Virginia","3/27/20","0","3","54051","1"
"Mason","0","1","West Virginia","3/27/20","0","1","54053","1"
"Mercer","0","2","West Virginia","3/27/20","1","1","54055","100"
"Monongalia","3","24","West Virginia","3/27/20","1","23","54061","2300"
"Ohio","0","1","West Virginia","3/27/20","0","1","54069","1"
"Preston","0","1","West Virginia","3/27/20","0","1","54077","1"
"Putnam","0","2","West Virginia","3/27/20","0","2","54079","1"
"Raleigh","0","2","West Virginia","3/27/20","0","2","54081","1"
"Tucker","0","2","West Virginia","3/27/20","2","0","54093","0"
"Upshur","0","1","West Virginia","3/27/20","0","1","54097","1"
"Wood","0","2","West Virginia","3/27/20","0","2","54107","1"
"Bayfield","0","2","Wisconsin","3/27/20","1","1","55007","100"
"Brown","0","5","Wisconsin","3/27/20","2","3","55009","150"
"Calumet","0","1","Wisconsin","3/27/20","1","0","55015","0"
"Chippewa","0","3","Wisconsin","3/27/20","1","2","55017","200"
"Clark","0","2","Wisconsin","3/27/20","0","2","55019","1"
"Columbia","0","6","Wisconsin","3/27/20","5","1","55021","20"
"Dane","18","158","Wisconsin","3/27/20","32","126","55025","393.75"
"Dodge","1","6","Wisconsin","3/27/20","0","6","55027","1"
"Douglas","1","5","Wisconsin","3/27/20","1","4","55031","400"
"Dunn","0","2","Wisconsin","3/27/20","1","1","55033","100"
"Eau Claire","1","7","Wisconsin","3/27/20","3","4","55035","133.33"
"Fond du Lac","1","18","Wisconsin","3/27/20","14","4","55039","28.57"
"Grant","0","1","Wisconsin","3/27/20","0","1","55043","1"
"Green","0","3","Wisconsin","3/27/20","1","2","55045","200"
"Iowa","0","3","Wisconsin","3/27/20","0","3","55049","1"
"Iron","0","1","Wisconsin","3/27/20","0","1","55051","1"
"Jefferson","1","6","Wisconsin","3/27/20","1","5","55055","500"
"Juneau","0","2","Wisconsin","3/27/20","0","2","55057","1"
"Kenosha","3","23","Wisconsin","3/27/20","4","19","55059","475"
"La Crosse","1","14","Wisconsin","3/27/20","4","10","55063","250"
"Marathon","0","1","Wisconsin","3/27/20","1","0","55073","0"
"Marinette","0","1","Wisconsin","3/27/20","0","1","55075","1"
"Milwaukee","45","411","Wisconsin","3/27/20","95","316","55079","332.63"
"Monroe","0","1","Wisconsin","3/27/20","0","1","55081","1"
"Outagamie","0","4","Wisconsin","3/27/20","2","2","55087","100"
"Ozaukee","3","30","Wisconsin","3/27/20","7","23","55089","328.57"
"Pierce","0","4","Wisconsin","3/27/20","1","3","55093","300"
"Portage","0","1","Wisconsin","3/27/20","0","1","55097","1"
"Racine","1","9","Wisconsin","3/27/20","3","6","55101","200"
"Rock","1","12","Wisconsin","3/27/20","2","10","55105","500"
"Sauk","1","8","Wisconsin","3/27/20","2","6","55111","300"
"Sheboygan","0","7","Wisconsin","3/27/20","6","1","55117","16.67"
"St. Croix","0","4","Wisconsin","3/27/20","2","2","55109","100"
"Vilas","0","2","Wisconsin","3/27/20","0","2","55125","1"
"Walworth","0","5","Wisconsin","3/27/20","3","2","55127","66.67"
"Washington","3","27","Wisconsin","3/27/20","3","24","55131","800"
"Waukesha","7","61","Wisconsin","3/27/20","15","46","55133","306.67"
"Waupaca","0","1","Wisconsin","3/27/20","0","1","55135","1"
"Winnebago","0","6","Wisconsin","3/27/20","5","1","55139","20"
"Wood","0","2","Wisconsin","3/27/20","1","1","55141","100"
"Albany","0","1","Wyoming","3/27/20","0","1","56001","1"
"Campbell","0","1","Wyoming","3/27/20","1","0","56005","0"
"Carbon","0","3","Wyoming","3/27/20","0","3","56007","1"
"Fremont","1","17","Wyoming","3/27/20","9","8","56013","88.89"
"Goshen","0","1","Wyoming","3/27/20","0","1","56015","1"
"Johnson","1","4","Wyoming","3/27/20","0","4","56019","1"
"Laramie","2","17","Wyoming","3/27/20","4","13","56021","325"
"Natrona","1","8","Wyoming","3/27/20","0","8","56025","1"
"Park","0","1","Wyoming","3/27/20","1","0","56029","0"
"Sheridan","0","5","Wyoming","3/27/20","4","1","56033","25"
"Sweetwater","0","1","Wyoming","3/27/20","0","1","56037","1"
"Teton","1","10","Wyoming","3/27/20","2","8","56039","400"
"Washakie","0","1","Wyoming","3/27/20","0","1","56043","1"
