"Locality","DailyAvgNewCasesPast7Days","TotalCases","State","Date","TotalCases7DaysAgo","NewCasesPast7Days","FIPS-Code","PercentIncreaseTotalCasesPast7Days"
"Autauga","1","12","Alabama","4/7/20","7","5","01001","71.43"
"Baldwin","3","42","Alabama","4/7/20","19","23","01003","121.05"
"Barbour","0","3","Alabama","4/7/20","0","3","01005","1"
"Bibb","1","8","Alabama","4/7/20","3","5","01007","166.67"
"Blount","1","10","Alabama","4/7/20","5","5","01009","100"
"Bullock","0","2","Alabama","4/7/20","3","-1","01011","-33.33"
"Butler","0","2","Alabama","4/7/20","1","1","01013","100"
"Calhoun","5","41","Alabama","4/7/20","9","32","01015","355.56"
"Chambers","9","101","Alabama","4/7/20","36","65","01017","180.56"
"Cherokee","1","6","Alabama","4/7/20","2","4","01019","200"
"Chilton","1","20","Alabama","4/7/20","11","9","01021","81.82"
"Choctaw","0","6","Alabama","4/7/20","3","3","01023","100"
"Clarke","1","10","Alabama","4/7/20","0","10","01025","1"
"Clay","1","9","Alabama","4/7/20","2","7","01027","350"
"Cleburne","1","9","Alabama","4/7/20","5","4","01029","80"
"Coffee","1","8","Alabama","4/7/20","0","8","01031","1"
"Colbert","0","7","Alabama","4/7/20","4","3","01033","75"
"Conecuh","0","2","Alabama","4/7/20","0","2","01035","1"
"Coosa","1","9","Alabama","4/7/20","4","5","01037","125"
"Covington","0","5","Alabama","4/7/20","2","3","01039","150"
"Crenshaw","0","2","Alabama","4/7/20","1","1","01041","100"
"Cullman","2","21","Alabama","4/7/20","8","13","01043","162.5"
"Dale","1","4","Alabama","4/7/20","0","4","01045","1"
"Dallas","1","7","Alabama","4/7/20","2","5","01047","250"
"DeKalb","1","14","Alabama","4/7/20","4","10","01049","250"
"Elmore","1","22","Alabama","4/7/20","13","9","01051","69.23"
"Escambia","0","3","Alabama","4/7/20","1","2","01053","200"
"Etowah","5","43","Alabama","4/7/20","8","35","01055","437.5"
"Fayette","0","1","Alabama","4/7/20","1","0","01057","0"
"Franklin","1","7","Alabama","4/7/20","3","4","01059","133.33"
"Greene","1","10","Alabama","4/7/20","3","7","01063","233.33"
"Hale","1","7","Alabama","4/7/20","1","6","01065","600"
"Henry","1","4","Alabama","4/7/20","0","4","01067","1"
"Houston","2","25","Alabama","4/7/20","9","16","01069","177.78"
"Jackson","1","18","Alabama","4/7/20","8","10","01071","125"
"Jefferson","27","457","Alabama","4/7/20","270","187","01073","69.26"
"Lamar","1","5","Alabama","4/7/20","1","4","01075","400"
"Lauderdale","1","18","Alabama","4/7/20","12","6","01077","50"
"Lawrence","1","8","Alabama","4/7/20","3","5","01079","166.67"
"Lee","8","128","Alabama","4/7/20","75","53","01081","70.67"
"Limestone","1","32","Alabama","4/7/20","22","10","01083","45.45"
"Lowndes","1","8","Alabama","4/7/20","1","7","01085","700"
"Macon","1","6","Alabama","4/7/20","1","5","01087","500"
"Madison","7","150","Alabama","4/7/20","99","51","01089","51.52"
"Marengo","1","14","Alabama","4/7/20","4","10","01091","250"
"Marion","2","21","Alabama","4/7/20","9","12","01093","133.33"
"Marshall","5","39","Alabama","4/7/20","7","32","01095","457.14"
"Mobile","21","201","Alabama","4/7/20","52","149","01097","286.54"
"Monroe","1","5","Alabama","4/7/20","1","4","01099","400"
"Montgomery","6","74","Alabama","4/7/20","29","45","01101","155.17"
"Morgan","1","30","Alabama","4/7/20","20","10","01103","50"
"Perry","0","1","Alabama","4/7/20","0","1","01105","1"
"Pickens","1","14","Alabama","4/7/20","4","10","01107","250"
"Pike","1","14","Alabama","4/7/20","4","10","01109","250"
"Randolph","2","13","Alabama","4/7/20","2","11","01111","550"
"Russell","2","12","Alabama","4/7/20","1","11","01113","1100"
"Shelby","10","158","Alabama","4/7/20","88","70","01117","79.55"
"St. Clair","2","30","Alabama","4/7/20","15","15","01115","100"
"Sumter","2","15","Alabama","4/7/20","1","14","01119","1400"
"Talladega","2","20","Alabama","4/7/20","7","13","01121","185.71"
"Tallapoosa","3","33","Alabama","4/7/20","12","21","01123","175"
"Tuscaloosa","7","77","Alabama","4/7/20","29","48","01125","165.52"
"Walker","4","63","Alabama","4/7/20","32","31","01127","96.88"
"Washington","1","7","Alabama","4/7/20","3","4","01129","133.33"
"Wilcox","1","13","Alabama","4/7/20","3","10","01131","333.33"
"Winston","0","3","Alabama","4/7/20","2","1","01133","50"
"Anchorage","5","98","Alaska","4/7/20","61","37","02020","60.66"
"Bethel","0","1","Alaska","4/7/20","0","1","02050","1"
"Fairbanks North Star","5","65","Alaska","4/7/20","30","35","02090","116.67"
"Juneau","1","14","Alaska","4/7/20","5","9","02110","180"
"Kenai Peninsula","1","13","Alaska","4/7/20","7","6","02122","85.71"
"Ketchikan Gateway","0","14","Alaska","4/7/20","13","1","02130","7.69"
"Matanuska-Susitna","0","4","Alaska","4/7/20","3","1","02170","33.33"
"Petersburg","0","2","Alaska","4/7/20","0","2","02195","1"
"Southeast Fairbanks","0","1","Alaska","4/7/20","0","1","02240","1"
"Yukon-Koyukuk","0","1","Alaska","4/7/20","0","1","02290","1"
"Apache","2","28","Arizona","4/7/20","16","12","04001","75"
"Cochise","1","9","Arizona","4/7/20","4","5","04003","125"
"Coconino","14","179","Arizona","4/7/20","81","98","04005","120.99"
"Gila","0","3","Arizona","4/7/20","1","2","04007","200"
"Graham","0","2","Arizona","4/7/20","2","0","04009","0"
"Greenlee","0","1","Arizona","4/7/20","1","0","04011","0"
"La Paz","0","3","Arizona","4/7/20","2","1","04012","50"
"Maricopa","101","1495","Arizona","4/7/20","788","707","04013","89.72"
"Mohave","2","23","Arizona","4/7/20","7","16","04015","228.57"
"Navajo","19","222","Arizona","4/7/20","91","131","04017","143.96"
"Pima","30","415","Arizona","4/7/20","202","213","04019","105.45"
"Pinal","8","120","Arizona","4/7/20","62","58","04021","93.55"
"Santa Cruz","0","5","Arizona","4/7/20","2","3","04023","150"
"Yavapai","5","57","Arizona","4/7/20","21","36","04025","171.43"
"Yuma","1","13","Arizona","4/7/20","9","4","04027","44.44"
"Arkansas","0","1","Arkansas","4/7/20","1","0","05001","0"
"Ashley","1","5","Arkansas","4/7/20","1","4","05003","400"
"Baxter","0","1","Arkansas","4/7/20","1","0","05005","0"
"Benton","1","42","Arkansas","4/7/20","38","4","05007","10.53"
"Boone","0","1","Arkansas","4/7/20","1","0","05009","0"
"Bradley","0","5","Arkansas","4/7/20","4","1","05011","25"
"Carroll","0","1","Arkansas","4/7/20","0","1","05015","1"
"Chicot","0","2","Arkansas","4/7/20","1","1","05017","100"
"Clark","0","27","Arkansas","4/7/20","24","3","05019","12.5"
"Clay","0","1","Arkansas","4/7/20","0","1","05021","1"
"Cleburne","1","66","Arkansas","4/7/20","61","5","05023","8.2"
"Cleveland","0","7","Arkansas","4/7/20","5","2","05025","40"
"Columbia","0","1","Arkansas","4/7/20","1","0","05027","0"
"Conway","0","1","Arkansas","4/7/20","1","0","05029","0"
"Craighead","2","22","Arkansas","4/7/20","8","14","05031","175"
"Crawford","0","1","Arkansas","4/7/20","1","0","05033","0"
"Crittenden","6","58","Arkansas","4/7/20","17","41","05035","241.18"
"Cross","1","5","Arkansas","4/7/20","1","4","05037","400"
"Dallas","0","1","Arkansas","4/7/20","0","1","05039","1"
"Desha","0","5","Arkansas","4/7/20","2","3","05041","150"
"Drew","1","5","Arkansas","4/7/20","1","4","05043","400"
"Faulkner","2","52","Arkansas","4/7/20","36","16","05045","44.44"
"Franklin","0","1","Arkansas","4/7/20","0","1","05047","1"
"Garland","2","46","Arkansas","4/7/20","31","15","05051","48.39"
"Grant","0","3","Arkansas","4/7/20","3","0","05053","0"
"Greene","0","1","Arkansas","4/7/20","1","0","05055","0"
"Hempstead","0","1","Arkansas","4/7/20","1","0","05057","0"
"Hot Spring","1","7","Arkansas","4/7/20","1","6","05059","600"
"Howard","1","5","Arkansas","4/7/20","1","4","05061","400"
"Independence","0","5","Arkansas","4/7/20","3","2","05063","66.67"
"Izard","0","1","Arkansas","4/7/20","0","1","05065","1"
"Jefferson","5","69","Arkansas","4/7/20","33","36","05069","109.09"
"Johnson","1","11","Arkansas","4/7/20","1","10","05071","1000"
"Lafayette","0","1","Arkansas","4/7/20","0","1","05073","1"
"Lawrence","0","1","Arkansas","4/7/20","1","0","05075","0"
"Lee","0","1","Arkansas","4/7/20","0","1","05077","1"
"Lincoln","1","10","Arkansas","4/7/20","6","4","05079","66.67"
"Logan","0","1","Arkansas","4/7/20","0","1","05083","1"
"Lonoke","3","23","Arkansas","4/7/20","1","22","05085","2200"
"Miller","2","13","Arkansas","4/7/20","0","13","05091","1"
"Mississippi","0","1","Arkansas","4/7/20","0","1","05093","1"
"Monroe","0","1","Arkansas","4/7/20","0","1","05095","1"
"Nevada","0","1","Arkansas","4/7/20","1","0","05099","0"
"Newton","0","1","Arkansas","4/7/20","1","0","05101","0"
"Ouachita","0","1","Arkansas","4/7/20","0","1","05103","1"
"Perry","0","1","Arkansas","4/7/20","1","0","05105","0"
"Phillips","0","1","Arkansas","4/7/20","0","1","05107","1"
"Pike","0","1","Arkansas","4/7/20","1","0","05109","0"
"Poinsett","0","6","Arkansas","4/7/20","5","1","05111","20"
"Polk","1","5","Arkansas","4/7/20","1","4","05113","400"
"Pope","2","17","Arkansas","4/7/20","5","12","05115","240"
"Prairie","0","1","Arkansas","4/7/20","0","1","05117","1"
"Pulaski","10","175","Arkansas","4/7/20","102","73","05119","71.57"
"Randolph","0","1","Arkansas","4/7/20","1","0","05121","0"
"Saline","3","33","Arkansas","4/7/20","10","23","05125","230"
"Scott","0","1","Arkansas","4/7/20","0","1","05127","1"
"Searcy","1","6","Arkansas","4/7/20","2","4","05129","200"
"Sebastian","0","8","Arkansas","4/7/20","7","1","05131","14.29"
"Sevier","1","6","Arkansas","4/7/20","1","5","05133","500"
"Sharp","0","1","Arkansas","4/7/20","0","1","05135","1"
"St. Francis","4","27","Arkansas","4/7/20","1","26","05123","2600"
"Stone","0","5","Arkansas","4/7/20","5","0","05137","0"
"Union","1","13","Arkansas","4/7/20","8","5","05139","62.5"
"Van Buren","0","21","Arkansas","4/7/20","19","2","05141","10.53"
"Washington","1","29","Arkansas","4/7/20","19","10","05143","52.63"
"White","2","27","Arkansas","4/7/20","10","17","05145","170"
"Woodruff","0","1","Arkansas","4/7/20","1","0","05147","0"
"Yell","0","1","Arkansas","4/7/20","0","1","05149","1"
"Alameda","46","634","California","4/7/20","313","321","06001","102.56"
"Alpine","0","1","California","4/7/20","0","1","06003","1"
"Amador","0","3","California","4/7/20","2","1","06005","50"
"Butte","1","12","California","4/7/20","8","4","06007","50"
"Calaveras","0","5","California","4/7/20","3","2","06009","66.67"
"Colusa","0","2","California","4/7/20","1","1","06011","100"
"Contra Costa","33","442","California","4/7/20","212","230","06013","108.49"
"Del Norte","0","2","California","4/7/20","0","2","06015","1"
"El Dorado","1","22","California","4/7/20","15","7","06017","46.67"
"Fresno","10","124","California","4/7/20","53","71","06019","133.96"
"Glenn","0","2","California","4/7/20","2","0","06021","0"
"Humboldt","4","49","California","4/7/20","21","28","06023","133.33"
"Imperial","5","68","California","4/7/20","33","35","06025","106.06"
"Inyo","0","11","California","4/7/20","8","3","06027","37.5"
"Kern","24","252","California","4/7/20","83","169","06029","203.61"
"Kings","0","5","California","4/7/20","3","2","06031","66.67"
"Lake","0","1","California","4/7/20","0","1","06033","1"
"Los Angeles","560","6936","California","4/7/20","3019","3917","06037","129.74"
"Madera","1","28","California","4/7/20","21","7","06039","33.33"
"Marin","6","143","California","4/7/20","99","44","06041","44.44"
"Mendocino","0","4","California","4/7/20","4","0","06045","0"
"Merced","3","29","California","4/7/20","10","19","06047","190"
"Mono","1","19","California","4/7/20","13","6","06051","46.15"
"Monterey","3","62","California","4/7/20","40","22","06053","55"
"Napa","1","22","California","4/7/20","14","8","06055","57.14"
"Nevada","2","32","California","4/7/20","21","11","06057","52.38"
"Orange","61","931","California","4/7/20","502","429","06059","85.46"
"Placer","7","106","California","4/7/20","57","49","06061","85.96"
"Plumas","0","3","California","4/7/20","0","3","06063","1"
"Riverside","92","1016","California","4/7/20","371","645","06065","173.85"
"Sacramento","43","525","California","4/7/20","224","301","06067","134.38"
"San Benito","1","23","California","4/7/20","17","6","06069","35.29"
"San Bernardino","58","530","California","4/7/20","125","405","06071","324"
"San Diego","114","1404","California","4/7/20","603","801","06073","132.84"
"San Francisco","32","622","California","4/7/20","397","225","06075","56.68"
"San Joaquin","12","217","California","4/7/20","136","81","06077","59.56"
"San Luis Obispo","2","95","California","4/7/20","80","15","06079","18.75"
"San Mateo","40","589","California","4/7/20","309","280","06081","90.61"
"Santa Barbara","15","192","California","4/7/20","88","104","06083","118.18"
"Santa Clara","56","1285","California","4/7/20","890","395","06085","44.38"
"Santa Cruz","4","76","California","4/7/20","45","31","06087","68.89"
"Shasta","2","21","California","4/7/20","6","15","06089","250"
"Siskiyou","0","4","California","4/7/20","3","1","06093","33.33"
"Solano","6","88","California","4/7/20","43","45","06095","104.65"
"Sonoma","5","111","California","4/7/20","73","38","06097","52.05"
"Stanislaus","7","81","California","4/7/20","33","48","06099","145.45"
"Sutter","1","16","California","4/7/20","9","7","06101","77.78"
"Tehama","0","1","California","4/7/20","0","1","06103","1"
"Tulare","16","157","California","4/7/20","43","114","06107","265.12"
"Tuolumne","0","2","California","4/7/20","2","0","06109","0"
"Ventura","17","243","California","4/7/20","126","117","06111","92.86"
"Yolo","4","50","California","4/7/20","24","26","06113","108.33"
"Yuba","1","11","California","4/7/20","6","5","06115","83.33"
"Adams","30","388","Colorado","4/7/20","181","207","08001","114.36"
"Alamosa","0","4","Colorado","4/7/20","1","3","08003","300"
"Arapahoe","55","718","Colorado","4/7/20","333","385","08005","115.62"
"Archuleta","1","6","Colorado","4/7/20","1","5","08007","500"
"Baca","1","9","Colorado","4/7/20","3","6","08009","200"
"Boulder","14","206","Colorado","4/7/20","107","99","08013","92.52"
"Broomfield","4","50","Colorado","4/7/20","20","30","08014","150"
"Chaffee","1","22","Colorado","4/7/20","17","5","08015","29.41"
"Clear Creek","0","7","Colorado","4/7/20","4","3","08019","75"
"Costilla","0","3","Colorado","4/7/20","3","0","08023","0"
"Crowley","0","1","Colorado","4/7/20","1","0","08025","0"
"Custer","0","2","Colorado","4/7/20","0","2","08027","1"
"Delta","1","5","Colorado","4/7/20","1","4","08029","400"
"Denver","49","884","Colorado","4/7/20","539","345","08031","64.01"
"Douglas","13","232","Colorado","4/7/20","141","91","08035","64.54"
"Eagle","21","372","Colorado","4/7/20","227","145","08037","63.88"
"El Paso","24","457","Colorado","4/7/20","286","171","08041","59.79"
"Elbert","1","9","Colorado","4/7/20","5","4","08039","80"
"Fremont","0","4","Colorado","4/7/20","2","2","08043","100"
"Garfield","2","48","Colorado","4/7/20","33","15","08045","45.45"
"Grand","0","4","Colorado","4/7/20","4","0","08049","0"
"Gunnison","2","95","Colorado","4/7/20","82","13","08051","15.85"
"Hinsdale","0","1","Colorado","4/7/20","1","0","08053","0"
"Huerfano","0","1","Colorado","4/7/20","1","0","08055","0"
"Jefferson","39","579","Colorado","4/7/20","304","275","08059","90.46"
"Kit Carson","0","5","Colorado","4/7/20","2","3","08063","150"
"La Plata","2","34","Colorado","4/7/20","23","11","08067","47.83"
"Lake","0","3","Colorado","4/7/20","1","2","08065","200"
"Larimer","9","161","Colorado","4/7/20","99","62","08069","62.63"
"Las Animas","0","1","Colorado","4/7/20","0","1","08071","1"
"Lincoln","0","1","Colorado","4/7/20","1","0","08073","0"
"Logan","1","13","Colorado","4/7/20","6","7","08075","116.67"
"Mesa","2","27","Colorado","4/7/20","14","13","08077","92.86"
"Mineral","0","2","Colorado","4/7/20","2","0","08079","0"
"Moffat","0","3","Colorado","4/7/20","4","-1","08081","-25"
"Montezuma","1","8","Colorado","4/7/20","1","7","08083","700"
"Montrose","3","35","Colorado","4/7/20","13","22","08085","169.23"
"Morgan","3","23","Colorado","4/7/20","4","19","08087","475"
"Otero","0","4","Colorado","4/7/20","3","1","08089","33.33"
"Ouray","0","3","Colorado","4/7/20","0","3","08091","1"
"Park","0","5","Colorado","4/7/20","3","2","08093","66.67"
"Phillips","0","3","Colorado","4/7/20","1","2","08095","200"
"Pitkin","1","39","Colorado","4/7/20","30","9","08097","30"
"Pueblo","3","44","Colorado","4/7/20","21","23","08101","109.52"
"Rio Blanco","0","1","Colorado","4/7/20","0","1","08103","1"
"Rio Grande","0","5","Colorado","4/7/20","5","0","08105","0"
"Routt","2","32","Colorado","4/7/20","17","15","08107","88.24"
"Saguache","0","3","Colorado","4/7/20","1","2","08109","200"
"San Miguel","1","10","Colorado","4/7/20","4","6","08113","150"
"Summit","5","53","Colorado","4/7/20","20","33","08117","165"
"Teller","1","12","Colorado","4/7/20","7","5","08119","71.43"
"Washington","0","1","Colorado","4/7/20","1","0","08121","0"
"Weld","40","537","Colorado","4/7/20","255","282","08123","110.59"
"Yuma","0","2","Colorado","4/7/20","2","0","08125","0"
"Fairfield","324","4136","Connecticut","4/7/20","1870","2266","09001","121.18"
"Hartford","93","1045","Connecticut","4/7/20","393","652","09003","165.9"
"Litchfield","19","255","Connecticut","4/7/20","121","134","09005","110.74"
"Middlesex","13","150","Connecticut","4/7/20","56","94","09007","167.86"
"New Haven","164","1664","Connecticut","4/7/20","517","1147","09009","221.86"
"New London","8","85","Connecticut","4/7/20","27","58","09011","214.81"
"Tolland","8","111","Connecticut","4/7/20","56","55","09013","98.21"
"Windham","5","43","Connecticut","4/7/20","11","32","09015","290.91"
"Kent","16","147","Delaware","4/7/20","34","113","10001","332.35"
"New Castle","53","571","Delaware","4/7/20","197","374","10003","189.85"
"Sussex","17","210","Delaware","4/7/20","88","122","10005","138.64"
"","0","49","Diamond Princess","4/7/20","49","0",,"0"
"District of Columbia","102","1211","District of Columbia","4/7/20","495","716","11001","144.65"
"Alachua","7","139","Florida","4/7/20","87","52","12001","59.77"
"Baker","1","15","Florida","4/7/20","9","6","12003","66.67"
"Bay","2","25","Florida","4/7/20","8","17","12005","212.5"
"Bradford","1","11","Florida","4/7/20","2","9","12007","450"
"Brevard","9","98","Florida","4/7/20","37","61","12009","164.86"
"Broward","144","2230","Florida","4/7/20","1219","1011","12011","82.94"
"Calhoun","0","3","Florida","4/7/20","1","2","12013","200"
"Charlotte","6","67","Florida","4/7/20","24","43","12015","179.17"
"Citrus","5","51","Florida","4/7/20","19","32","12017","168.42"
"Clay","7","88","Florida","4/7/20","41","47","12019","114.63"
"Collier","18","271","Florida","4/7/20","146","125","12021","85.62"
"Columbia","2","16","Florida","4/7/20","3","13","12023","433.33"
"DeSoto","1","16","Florida","4/7/20","7","9","12027","128.57"
"Dixie","0","1","Florida","4/7/20","0","1","12029","1"
"Duval","45","521","Florida","4/7/20","207","314","12031","151.69"
"Escambia","11","168","Florida","4/7/20","94","74","12033","78.72"
"Flagler","2","35","Florida","4/7/20","18","17","12035","94.44"
"Franklin","0","2","Florida","4/7/20","0","2","12037","1"
"Gadsden","1","6","Florida","4/7/20","1","5","12039","500"
"Gilchrist","0","1","Florida","4/7/20","0","1","12041","1"
"Glades","0","4","Florida","4/7/20","3","1","12043","33.33"
"Gulf","0","1","Florida","4/7/20","0","1","12045","1"
"Hamilton","0","1","Florida","4/7/20","0","1","12047","1"
"Hardee","0","2","Florida","4/7/20","0","2","12049","1"
"Hendry","1","9","Florida","4/7/20","4","5","12051","125"
"Hernando","4","51","Florida","4/7/20","24","27","12053","112.5"
"Highlands","3","37","Florida","4/7/20","17","20","12055","117.65"
"Hillsborough","43","608","Florida","4/7/20","305","303","12057","99.34"
"Holmes","0","2","Florida","4/7/20","1","1","12059","100"
"Indian River","4","62","Florida","4/7/20","33","29","12061","87.88"
"Jackson","0","4","Florida","4/7/20","2","2","12063","100"
"Jefferson","1","4","Florida","4/7/20","0","4","12065","1"
"Lake","7","116","Florida","4/7/20","66","50","12069","75.76"
"Lee","33","434","Florida","4/7/20","206","228","12071","110.68"
"Leon","6","68","Florida","4/7/20","26","42","12073","161.54"
"Levy","0","5","Florida","4/7/20","2","3","12075","150"
"Madison","2","11","Florida","4/7/20","0","11","12079","1"
"Manatee","16","162","Florida","4/7/20","53","109","12081","205.66"
"Marion","5","63","Florida","4/7/20","25","38","12083","152"
"Martin","10","98","Florida","4/7/20","28","70","12085","250"
"Miami-Dade","411","4997","Florida","4/7/20","2123","2874","12086","135.37"
"Monroe","3","49","Florida","4/7/20","27","22","12087","81.48"
"Nassau","2","26","Florida","4/7/20","10","16","12089","160"
"Okaloosa","4","69","Florida","4/7/20","39","30","12091","76.92"
"Okeechobee","1","4","Florida","4/7/20","0","4","12093","1"
"Orange","56","763","Florida","4/7/20","373","390","12095","104.56"
"Osceola","21","254","Florida","4/7/20","110","144","12097","130.91"
"Palm Beach","84","1136","Florida","4/7/20","551","585","12099","106.17"
"Pasco","11","120","Florida","4/7/20","40","80","12101","200"
"Pinellas","30","380","Florida","4/7/20","167","213","12103","127.54"
"Polk","18","197","Florida","4/7/20","73","124","12105","169.86"
"Putnam","1","19","Florida","4/7/20","13","6","12107","46.15"
"Santa Rosa","3","65","Florida","4/7/20","44","21","12113","47.73"
"Sarasota","14","172","Florida","4/7/20","76","96","12115","126.32"
"Seminole","14","202","Florida","4/7/20","103","99","12117","96.12"
"St. Johns","10","151","Florida","4/7/20","79","72","12109","91.14"
"St. Lucie","11","118","Florida","4/7/20","38","80","12111","210.53"
"Sumter","5","84","Florida","4/7/20","51","33","12119","64.71"
"Suwannee","4","32","Florida","4/7/20","3","29","12121","966.67"
"Taylor","0","1","Florida","4/7/20","0","1","12123","1"
"Union","0","2","Florida","4/7/20","1","1","12125","100"
"Volusia","12","162","Florida","4/7/20","80","82","12127","102.5"
"Wakulla","1","6","Florida","4/7/20","1","5","12129","500"
"Walton","1","26","Florida","4/7/20","18","8","12131","44.44"
"Washington","0","2","Florida","4/7/20","1","1","12133","100"
"Appling","1","6","Georgia","4/7/20","2","4","13001","200"
"Atkinson","1","4","Georgia","4/7/20","0","4","13003","1"
"Bacon","1","10","Georgia","4/7/20","2","8","13005","400"
"Baker","1","9","Georgia","4/7/20","4","5","13007","125"
"Baldwin","3","26","Georgia","4/7/20","4","22","13009","550"
"Banks","0","3","Georgia","4/7/20","3","0","13011","0"
"Barrow","3","40","Georgia","4/7/20","18","22","13013","122.22"
"Bartow","8","187","Georgia","4/7/20","131","56","13015","42.75"
"Ben Hill","0","6","Georgia","4/7/20","3","3","13017","100"
"Berrien","0","4","Georgia","4/7/20","1","3","13019","300"
"Bibb","3","42","Georgia","4/7/20","20","22","13021","110"
"Bleckley","0","1","Georgia","4/7/20","1","0","13023","0"
"Brantley","0","3","Georgia","4/7/20","0","3","13025","1"
"Brooks","1","6","Georgia","4/7/20","2","4","13027","200"
"Bryan","3","26","Georgia","4/7/20","7","19","13029","271.43"
"Bulloch","1","10","Georgia","4/7/20","2","8","13031","400"
"Burke","1","14","Georgia","4/7/20","8","6","13033","75"
"Butts","2","17","Georgia","4/7/20","6","11","13035","183.33"
"Calhoun","3","28","Georgia","4/7/20","9","19","13037","211.11"
"Camden","2","16","Georgia","4/7/20","4","12","13039","300"
"Candler","0","4","Georgia","4/7/20","1","3","13043","300"
"Carroll","8","177","Georgia","4/7/20","123","54","13045","43.9"
"Catoosa","1","7","Georgia","4/7/20","3","4","13047","133.33"
"Charlton","0","3","Georgia","4/7/20","1","2","13049","200"
"Chatham","13","117","Georgia","4/7/20","26","91","13051","350"
"Chattahoochee","0","2","Georgia","4/7/20","1","1","13053","100"
"Chattooga","0","4","Georgia","4/7/20","3","1","13055","33.33"
"Cherokee","10","144","Georgia","4/7/20","76","68","13057","89.47"
"Clarke","4","77","Georgia","4/7/20","50","27","13059","54"
"Clay","1","10","Georgia","4/7/20","4","6","13061","150"
"Clayton","23","266","Georgia","4/7/20","104","162","13063","155.77"
"Clinch","0","3","Georgia","4/7/20","1","2","13065","200"
"Cobb","39","550","Georgia","4/7/20","279","271","13067","97.13"
"Coffee","4","38","Georgia","4/7/20","11","27","13069","245.45"
"Colquitt","7","69","Georgia","4/7/20","18","51","13071","283.33"
"Columbia","3","46","Georgia","4/7/20","24","22","13073","91.67"
"Cook","0","3","Georgia","4/7/20","1","2","13075","200"
"Coweta","5","79","Georgia","4/7/20","41","38","13077","92.68"
"Crawford","0","2","Georgia","4/7/20","0","2","13079","1"
"Crisp","4","46","Georgia","4/7/20","15","31","13081","206.67"
"Dade","0","1","Georgia","4/7/20","1","0","13083","0"
"Dawson","1","20","Georgia","4/7/20","10","10","13085","100"
"Decatur","1","17","Georgia","4/7/20","7","10","13087","142.86"
"DeKalb","44","645","Georgia","4/7/20","335","310","13089","92.54"
"Dodge","1","8","Georgia","4/7/20","2","6","13091","300"
"Dooly","3","28","Georgia","4/7/20","6","22","13093","366.67"
"Dougherty","68","939","Georgia","4/7/20","462","477","13095","103.25"
"Douglas","9","111","Georgia","4/7/20","50","61","13097","122"
"Early","9","92","Georgia","4/7/20","28","64","13099","228.57"
"Echols","0","1","Georgia","4/7/20","0","1","13101","1"
"Effingham","2","17","Georgia","4/7/20","4","13","13103","325"
"Elbert","0","2","Georgia","4/7/20","0","2","13105","1"
"Emanuel","0","3","Georgia","4/7/20","1","2","13107","200"
"Fannin","1","10","Georgia","4/7/20","5","5","13111","100"
"Fayette","5","79","Georgia","4/7/20","45","34","13113","75.56"
"Floyd","8","89","Georgia","4/7/20","35","54","13115","154.29"
"Forsyth","7","94","Georgia","4/7/20","47","47","13117","100"
"Franklin","0","3","Georgia","4/7/20","4","-1","13119","-25"
"Fulton","79","1124","Georgia","4/7/20","570","554","13121","97.19"
"Gilmer","0","3","Georgia","4/7/20","1","2","13123","200"
"Glynn","2","29","Georgia","4/7/20","17","12","13127","70.59"
"Gordon","1","25","Georgia","4/7/20","16","9","13129","56.25"
"Grady","1","5","Georgia","4/7/20","1","4","13131","400"
"Greene","2","21","Georgia","4/7/20","7","14","13133","200"
"Gwinnett","41","525","Georgia","4/7/20","238","287","13135","120.59"
"Habersham","1","6","Georgia","4/7/20","2","4","13137","200"
"Hall","19","196","Georgia","4/7/20","66","130","13139","196.97"
"Hancock","0","1","Georgia","4/7/20","0","1","13141","1"
"Haralson","2","15","Georgia","4/7/20","4","11","13143","275"
"Harris","1","12","Georgia","4/7/20","4","8","13145","200"
"Hart","0","3","Georgia","4/7/20","4","-1","13147","-25"
"Heard","0","3","Georgia","4/7/20","1","2","13149","200"
"Henry","17","194","Georgia","4/7/20","78","116","13151","148.72"
"Houston","7","79","Georgia","4/7/20","29","50","13153","172.41"
"Irwin","1","9","Georgia","4/7/20","3","6","13155","200"
"Jackson","2","21","Georgia","4/7/20","8","13","13157","162.5"
"Jasper","1","6","Georgia","4/7/20","2","4","13159","200"
"Jeff Davis","0","1","Georgia","4/7/20","0","1","13161","1"
"Jefferson","0","4","Georgia","4/7/20","2","2","13163","100"
"Jenkins","1","7","Georgia","4/7/20","1","6","13165","600"
"Johnson","1","6","Georgia","4/7/20","1","5","13167","500"
"Jones","1","7","Georgia","4/7/20","3","4","13169","133.33"
"Lamar","2","15","Georgia","4/7/20","3","12","13171","400"
"Lanier","1","5","Georgia","4/7/20","0","5","13173","1"
"Laurens","1","22","Georgia","4/7/20","13","9","13175","69.23"
"Lee","15","195","Georgia","4/7/20","89","106","13177","119.1"
"Liberty","1","12","Georgia","4/7/20","5","7","13179","140"
"Lincoln","0","5","Georgia","4/7/20","4","1","13181","25"
"Long","0","1","Georgia","4/7/20","1","0","13183","0"
"Lowndes","3","44","Georgia","4/7/20","21","23","13185","109.52"
"Lumpkin","0","9","Georgia","4/7/20","8","1","13187","12.5"
"Macon","1","8","Georgia","4/7/20","2","6","13193","300"
"Madison","1","9","Georgia","4/7/20","3","6","13195","200"
"Marion","0","3","Georgia","4/7/20","0","3","13197","1"
"McDuffie","1","13","Georgia","4/7/20","3","10","13189","333.33"
"McIntosh","0","3","Georgia","4/7/20","1","2","13191","200"
"Meriwether","2","17","Georgia","4/7/20","6","11","13199","183.33"
"Miller","2","15","Georgia","4/7/20","4","11","13201","275"
"Mitchell","8","90","Georgia","4/7/20","31","59","13205","190.32"
"Monroe","1","13","Georgia","4/7/20","4","9","13207","225"
"Morgan","1","8","Georgia","4/7/20","2","6","13211","300"
"Murray","1","11","Georgia","4/7/20","4","7","13213","175"
"Muscogee","5","53","Georgia","4/7/20","20","33","13215","165"
"Newton","5","65","Georgia","4/7/20","31","34","13217","109.68"
"Oconee","2","32","Georgia","4/7/20","15","17","13219","113.33"
"Oglethorpe","0","2","Georgia","4/7/20","1","1","13221","100"
"Paulding","4","60","Georgia","4/7/20","30","30","13223","100"
"Peach","1","16","Georgia","4/7/20","7","9","13225","128.57"
"Pickens","1","10","Georgia","4/7/20","6","4","13227","66.67"
"Pierce","4","28","Georgia","4/7/20","3","25","13229","833.33"
"Pike","1","10","Georgia","4/7/20","2","8","13231","400"
"Polk","1","20","Georgia","4/7/20","15","5","13233","33.33"
"Pulaski","1","8","Georgia","4/7/20","3","5","13235","166.67"
"Putnam","1","5","Georgia","4/7/20","0","5","13237","1"
"Quitman","0","3","Georgia","4/7/20","0","3","13239","1"
"Rabun","0","5","Georgia","4/7/20","2","3","13241","150"
"Randolph","11","81","Georgia","4/7/20","5","76","13243","1520"
"Richmond","5","74","Georgia","4/7/20","40","34","13245","85"
"Rockdale","7","85","Georgia","4/7/20","36","49","13247","136.11"
"Schley","1","10","Georgia","4/7/20","5","5","13249","100"
"Screven","0","3","Georgia","4/7/20","1","2","13251","200"
"Seminole","1","12","Georgia","4/7/20","8","4","13253","50"
"Spalding","5","50","Georgia","4/7/20","13","37","13255","284.62"
"Stephens","1","11","Georgia","4/7/20","4","7","13257","175"
"Stewart","0","3","Georgia","4/7/20","1","2","13259","200"
"Sumter","16","147","Georgia","4/7/20","33","114","13261","345.45"
"Talbot","1","6","Georgia","4/7/20","1","5","13263","500"
"Tattnall","0","3","Georgia","4/7/20","2","1","13267","50"
"Taylor","0","5","Georgia","4/7/20","2","3","13269","150"
"Telfair","1","4","Georgia","4/7/20","0","4","13271","1"
"Terrell","7","87","Georgia","4/7/20","40","47","13273","117.5"
"Thomas","4","37","Georgia","4/7/20","9","28","13275","311.11"
"Tift","3","43","Georgia","4/7/20","19","24","13277","126.32"
"Toombs","1","8","Georgia","4/7/20","3","5","13279","166.67"
"Towns","0","2","Georgia","4/7/20","0","2","13281","1"
"Treutlen","0","1","Georgia","4/7/20","0","1","13283","1"
"Troup","4","46","Georgia","4/7/20","16","30","13285","187.5"
"Turner","2","16","Georgia","4/7/20","3","13","13287","433.33"
"Twiggs","0","2","Georgia","4/7/20","2","0","13289","0"
"Union","0","3","Georgia","4/7/20","0","3","13291","1"
"Upson","3","28","Georgia","4/7/20","5","23","13293","460"
"Walker","1","4","Georgia","4/7/20","0","4","13295","1"
"Walton","3","24","Georgia","4/7/20","6","18","13297","300"
"Ware","4","37","Georgia","4/7/20","9","28","13299","311.11"
"Warren","0","6","Georgia","4/7/20","3","3","13301","100"
"Washington","1","11","Georgia","4/7/20","2","9","13303","450"
"Wayne","0","3","Georgia","4/7/20","0","3","13305","1"
"Webster","0","4","Georgia","4/7/20","1","3","13307","300"
"Wheeler","0","1","Georgia","4/7/20","1","0","13309","0"
"White","1","9","Georgia","4/7/20","3","6","13311","200"
"Whitfield","2","21","Georgia","4/7/20","10","11","13313","110"
"Wilcox","0","2","Georgia","4/7/20","1","1","13315","100"
"Wilkes","0","5","Georgia","4/7/20","2","3","13317","150"
"Wilkinson","0","3","Georgia","4/7/20","1","2","13319","200"
"Worth","4","55","Georgia","4/7/20","29","26","13321","89.66"
"","0","103","Grand Princess","4/7/20","103","0",,"0"
"","7","121","Guam","4/7/20","69","52",,"75.36"
"Hawaii","1","23","Hawaii","4/7/20","15","8","15001","53.33"
"Honolulu","25","312","Hawaii","4/7/20","139","173","15003","124.46"
"Kauai","1","18","Hawaii","4/7/20","12","6","15007","50"
"Maui","3","48","Hawaii","4/7/20","25","23","15009","92"
"Out of HI","0","2","Hawaii","4/7/20","0","2","80015","1"
"Ada","32","419","Idaho","4/7/20","195","224","16001","114.87"
"Adams","0","1","Idaho","4/7/20","0","1","16003","1"
"Bannock","0","5","Idaho","4/7/20","4","1","16005","25"
"Bingham","0","2","Idaho","4/7/20","2","0","16011","0"
"Blaine","33","423","Idaho","4/7/20","192","231","16013","120.31"
"Bonner","0","3","Idaho","4/7/20","1","2","16017","200"
"Bonneville","1","6","Idaho","4/7/20","2","4","16019","200"
"Camas","0","1","Idaho","4/7/20","1","0","16025","0"
"Canyon","8","104","Idaho","4/7/20","48","56","16027","116.67"
"Caribou","0","1","Idaho","4/7/20","0","1","16029","1"
"Cassia","1","5","Idaho","4/7/20","1","4","16031","400"
"Custer","0","2","Idaho","4/7/20","1","1","16037","100"
"Elmore","2","12","Idaho","4/7/20","1","11","16039","1100"
"Fremont","0","2","Idaho","4/7/20","1","1","16043","100"
"Gem","1","8","Idaho","4/7/20","4","4","16045","100"
"Gooding","0","3","Idaho","4/7/20","0","3","16047","1"
"Idaho","0","3","Idaho","4/7/20","1","2","16049","200"
"Jefferson","0","4","Idaho","4/7/20","2","2","16051","100"
"Jerome","2","18","Idaho","4/7/20","2","16","16053","800"
"Kootenai","2","43","Idaho","4/7/20","29","14","16055","48.28"
"Latah","0","2","Idaho","4/7/20","0","2","16057","1"
"Lincoln","1","12","Idaho","4/7/20","2","10","16063","500"
"Madison","0","4","Idaho","4/7/20","5","-1","16065","-20"
"Minidoka","0","3","Idaho","4/7/20","1","2","16067","200"
"Nez Perce","1","15","Idaho","4/7/20","9","6","16069","66.67"
"Owyhee","0","2","Idaho","4/7/20","1","1","16073","100"
"Payette","1","6","Idaho","4/7/20","1","5","16075","500"
"Teton","0","5","Idaho","4/7/20","2","3","16081","150"
"Twin Falls","7","53","Idaho","4/7/20","5","48","16083","960"
"Valley","0","2","Idaho","4/7/20","2","0","16085","0"
"Washington","0","1","Idaho","4/7/20","0","1","16087","1"
"Adams","1","9","Illinois","4/7/20","2","7","17001","350"
"Bond","0","3","Illinois","4/7/20","2","1","17005","50"
"Boone","1","6","Illinois","4/7/20","0","6","17007","1"
"Bureau","0","4","Illinois","4/7/20","1","3","17011","300"
"Calhoun","0","1","Illinois","4/7/20","0","1","17013","1"
"Carroll","0","5","Illinois","4/7/20","2","3","17015","150"
"Champaign","6","65","Illinois","4/7/20","26","39","17019","150"
"Christian","1","23","Illinois","4/7/20","13","10","17021","76.92"
"Clark","0","4","Illinois","4/7/20","1","3","17023","300"
"Clinton","1","11","Illinois","4/7/20","7","4","17027","57.14"
"Coles","0","1","Illinois","4/7/20","0","1","17029","1"
"Cook","716","9509","Illinois","4/7/20","4496","5013","17031","111.5"
"Crawford","0","4","Illinois","4/7/20","1","3","17033","300"
"Cumberland","0","1","Illinois","4/7/20","1","0","17035","0"
"De Witt","0","2","Illinois","4/7/20","0","2","17039","1"
"DeKalb","2","26","Illinois","4/7/20","9","17","17037","188.89"
"Douglas","1","10","Illinois","4/7/20","3","7","17041","233.33"
"DuPage","63","795","Illinois","4/7/20","356","439","17043","123.31"
"Effingham","0","1","Illinois","4/7/20","0","1","17049","1"
"Fayette","0","3","Illinois","4/7/20","1","2","17051","200"
"Ford","1","5","Illinois","4/7/20","1","4","17053","400"
"Franklin","0","2","Illinois","4/7/20","1","1","17055","100"
"Gallatin","0","1","Illinois","4/7/20","0","1","17059","1"
"Grundy","1","10","Illinois","4/7/20","4","6","17063","150"
"Henry","2","13","Illinois","4/7/20","2","11","17073","550"
"Iroquois","1","7","Illinois","4/7/20","2","5","17075","250"
"Jackson","2","20","Illinois","4/7/20","4","16","17077","400"
"Jasper","0","3","Illinois","4/7/20","0","3","17079","1"
"Jefferson","0","3","Illinois","4/7/20","0","3","17081","1"
"Jersey","1","4","Illinois","4/7/20","0","4","17083","1"
"Jo Daviess","1","6","Illinois","4/7/20","1","5","17085","500"
"Kane","18","255","Illinois","4/7/20","128","127","17089","99.22"
"Kankakee","9","107","Illinois","4/7/20","42","65","17091","154.76"
"Kendall","6","61","Illinois","4/7/20","19","42","17093","221.05"
"Knox","0","1","Illinois","4/7/20","1","0","17095","0"
"Lake","76","923","Illinois","4/7/20","389","534","17097","137.28"
"LaSalle","1","12","Illinois","4/7/20","5","7","17099","140"
"Lawrence","0","2","Illinois","4/7/20","0","2","17101","1"
"Lee","0","3","Illinois","4/7/20","0","3","17103","1"
"Livingston","1","10","Illinois","4/7/20","3","7","17105","233.33"
"Logan","0","2","Illinois","4/7/20","0","2","17107","1"
"Macon","1","12","Illinois","4/7/20","2","10","17115","500"
"Macoupin","1","8","Illinois","4/7/20","0","8","17117","1"
"Madison","7","63","Illinois","4/7/20","16","47","17119","293.75"
"Marion","0","3","Illinois","4/7/20","2","1","17121","50"
"Marshall","0","1","Illinois","4/7/20","1","0","17123","0"
"Mason","0","3","Illinois","4/7/20","0","3","17125","1"
"Massac","0","2","Illinois","4/7/20","0","2","17127","1"
"McHenry","13","156","Illinois","4/7/20","63","93","17111","147.62"
"McLean","5","57","Illinois","4/7/20","19","38","17113","200"
"Menard","0","2","Illinois","4/7/20","1","1","17129","100"
"Mercer","0","2","Illinois","4/7/20","0","2","17131","1"
"Monroe","1","12","Illinois","4/7/20","3","9","17133","300"
"Montgomery","0","3","Illinois","4/7/20","2","1","17135","50"
"Morgan","1","8","Illinois","4/7/20","4","4","17137","100"
"Moultrie","0","2","Illinois","4/7/20","0","2","17139","1"
"Ogle","1","10","Illinois","4/7/20","0","10","17141","1"
"Peoria","1","13","Illinois","4/7/20","8","5","17143","62.5"
"Piatt","1","4","Illinois","4/7/20","0","4","17147","1"
"Pike","0","1","Illinois","4/7/20","0","1","17149","1"
"Randolph","4","29","Illinois","4/7/20","3","26","17157","866.67"
"Richland","0","1","Illinois","4/7/20","0","1","17159","1"
"Rock Island","6","54","Illinois","4/7/20","11","43","17161","390.91"
"Saline","0","2","Illinois","4/7/20","1","1","17165","100"
"Sangamon","3","32","Illinois","4/7/20","14","18","17167","128.57"
"Shelby","0","2","Illinois","4/7/20","0","2","17173","1"
"St. Clair","9","109","Illinois","4/7/20","43","66","17163","153.49"
"Stephenson","0","6","Illinois","4/7/20","3","3","17177","100"
"Tazewell","2","15","Illinois","4/7/20","4","11","17179","275"
"Vermilion","1","5","Illinois","4/7/20","0","5","17183","1"
"Wabash","0","1","Illinois","4/7/20","0","1","17185","1"
"Washington","0","2","Illinois","4/7/20","1","1","17189","100"
"Whiteside","2","21","Illinois","4/7/20","5","16","17195","320"
"Will","87","840","Illinois","4/7/20","228","612","17197","268.42"
"Williamson","1","8","Illinois","4/7/20","1","7","17199","700"
"Winnebago","6","59","Illinois","4/7/20","15","44","17201","293.33"
"Woodford","1","7","Illinois","4/7/20","3","4","17203","133.33"
"Adams","0","2","Indiana","4/7/20","1","1","18001","100"
"Allen","9","90","Indiana","4/7/20","30","60","18003","200"
"Bartholomew","6","55","Indiana","4/7/20","13","42","18005","323.08"
"Blackford","1","4","Indiana","4/7/20","0","4","18009","1"
"Boone","7","74","Indiana","4/7/20","22","52","18011","236.36"
"Brown","1","8","Indiana","4/7/20","3","5","18013","166.67"
"Carroll","0","3","Indiana","4/7/20","2","1","18015","50"
"Cass","2","12","Indiana","4/7/20","1","11","18017","1100"
"Clark","7","82","Indiana","4/7/20","33","49","18019","148.48"
"Clay","1","7","Indiana","4/7/20","1","6","18021","600"
"Clinton","1","5","Indiana","4/7/20","1","4","18023","400"
"Crawford","1","9","Indiana","4/7/20","1","8","18025","800"
"Daviess","1","4","Indiana","4/7/20","0","4","18027","1"
"Dearborn","4","41","Indiana","4/7/20","14","27","18029","192.86"
"Decatur","6","90","Indiana","4/7/20","47","43","18031","91.49"
"DeKalb","0","4","Indiana","4/7/20","1","3","18033","300"
"Delaware","3","40","Indiana","4/7/20","18","22","18035","122.22"
"Dubois","1","7","Indiana","4/7/20","3","4","18037","133.33"
"Elkhart","3","43","Indiana","4/7/20","20","23","18039","115"
"Fayette","1","18","Indiana","4/7/20","9","9","18041","100"
"Floyd","8","74","Indiana","4/7/20","21","53","18043","252.38"
"Fountain","0","2","Indiana","4/7/20","1","1","18045","100"
"Franklin","4","60","Indiana","4/7/20","35","25","18047","71.43"
"Fulton","0","3","Indiana","4/7/20","1","2","18049","200"
"Gibson","0","4","Indiana","4/7/20","4","0","18051","0"
"Grant","2","20","Indiana","4/7/20","7","13","18053","185.71"
"Greene","1","11","Indiana","4/7/20","2","9","18055","450"
"Hamilton","34","363","Indiana","4/7/20","127","236","18057","185.83"
"Hancock","9","89","Indiana","4/7/20","26","63","18059","242.31"
"Harrison","5","48","Indiana","4/7/20","15","33","18061","220"
"Hendricks","22","225","Indiana","4/7/20","70","155","18063","221.43"
"Henry","2","16","Indiana","4/7/20","1","15","18065","1500"
"Howard","3","37","Indiana","4/7/20","16","21","18067","131.25"
"Huntington","1","6","Indiana","4/7/20","2","4","18069","200"
"Jackson","5","40","Indiana","4/7/20","8","32","18071","400"
"Jasper","1","14","Indiana","4/7/20","8","6","18073","75"
"Jay","0","3","Indiana","4/7/20","0","3","18075","1"
"Jefferson","1","6","Indiana","4/7/20","1","5","18077","500"
"Jennings","4","41","Indiana","4/7/20","15","26","18079","173.33"
"Johnson","16","212","Indiana","4/7/20","101","111","18081","109.9"
"Knox","1","9","Indiana","4/7/20","2","7","18083","350"
"Kosciusko","1","14","Indiana","4/7/20","5","9","18085","180"
"LaGrange","1","6","Indiana","4/7/20","2","4","18087","200"
"Lake","39","418","Indiana","4/7/20","146","272","18089","186.3"
"LaPorte","2","25","Indiana","4/7/20","8","17","18091","212.5"
"Lawrence","5","44","Indiana","4/7/20","9","35","18093","388.89"
"Madison","14","137","Indiana","4/7/20","38","99","18095","260.53"
"Marion","168","2141","Indiana","4/7/20","964","1177","18097","122.1"
"Marshall","1","10","Indiana","4/7/20","3","7","18099","233.33"
"Martin","0","1","Indiana","4/7/20","0","1","18101","1"
"Miami","1","9","Indiana","4/7/20","3","6","18103","200"
"Monroe","3","54","Indiana","4/7/20","30","24","18105","80"
"Montgomery","1","16","Indiana","4/7/20","6","10","18107","166.67"
"Morgan","7","79","Indiana","4/7/20","32","47","18109","146.88"
"Newton","1","6","Indiana","4/7/20","1","5","18111","500"
"Noble","1","11","Indiana","4/7/20","2","9","18113","450"
"Ohio","0","1","Indiana","4/7/20","1","0","18115","0"
"Orange","2","14","Indiana","4/7/20","3","11","18117","366.67"
"Owen","1","17","Indiana","4/7/20","11","6","18119","54.55"
"Parke","1","6","Indiana","4/7/20","0","6","18121","1"
"Porter","9","84","Indiana","4/7/20","21","63","18127","300"
"Posey","0","5","Indiana","4/7/20","4","1","18129","25"
"Pulaski","0","1","Indiana","4/7/20","0","1","18131","1"
"Putnam","3","25","Indiana","4/7/20","7","18","18133","257.14"
"Randolph","1","7","Indiana","4/7/20","3","4","18135","133.33"
"Ripley","6","76","Indiana","4/7/20","31","45","18137","145.16"
"Rush","1","14","Indiana","4/7/20","4","10","18139","250"
"Scott","1","8","Indiana","4/7/20","1","7","18143","700"
"Shelby","5","51","Indiana","4/7/20","15","36","18145","240"
"Spencer","0","1","Indiana","4/7/20","0","1","18147","1"
"St. Joseph","11","129","Indiana","4/7/20","49","80","18141","163.27"
"Starke","1","5","Indiana","4/7/20","1","4","18149","400"
"Steuben","1","9","Indiana","4/7/20","1","8","18151","800"
"Sullivan","0","3","Indiana","4/7/20","2","1","18153","50"
"Switzerland","1","11","Indiana","4/7/20","3","8","18155","266.67"
"Tippecanoe","3","36","Indiana","4/7/20","14","22","18157","157.14"
"Tipton","1","8","Indiana","4/7/20","4","4","18159","100"
"Union","0","3","Indiana","4/7/20","0","3","18161","1"
"Vanderburgh","3","41","Indiana","4/7/20","18","23","18163","127.78"
"Vermillion","0","2","Indiana","4/7/20","0","2","18165","1"
"Vigo","2","25","Indiana","4/7/20","8","17","18167","212.5"
"Wabash","1","5","Indiana","4/7/20","1","4","18169","400"
"Warren","0","2","Indiana","4/7/20","2","0","18171","0"
"Warrick","2","23","Indiana","4/7/20","8","15","18173","187.5"
"Washington","2","20","Indiana","4/7/20","6","14","18175","233.33"
"Wayne","2","13","Indiana","4/7/20","2","11","18177","550"
"Wells","0","2","Indiana","4/7/20","2","0","18179","0"
"White","0","3","Indiana","4/7/20","2","1","18181","50"
"Whitley","1","8","Indiana","4/7/20","2","6","18183","300"
"Adair","0","1","Iowa","4/7/20","1","0","19001","0"
"Allamakee","1","17","Iowa","4/7/20","7","10","19005","142.86"
"Appanoose","0","1","Iowa","4/7/20","1","0","19007","0"
"Audubon","0","1","Iowa","4/7/20","1","0","19009","0"
"Benton","1","11","Iowa","4/7/20","7","4","19011","57.14"
"Black Hawk","1","15","Iowa","4/7/20","7","8","19013","114.29"
"Boone","0","3","Iowa","4/7/20","1","2","19015","200"
"Bremer","0","2","Iowa","4/7/20","0","2","19017","1"
"Buchanan","0","5","Iowa","4/7/20","2","3","19019","150"
"Butler","0","1","Iowa","4/7/20","1","0","19023","0"
"Carroll","0","1","Iowa","4/7/20","1","0","19027","0"
"Cedar","1","13","Iowa","4/7/20","9","4","19031","44.44"
"Cerro Gordo","1","12","Iowa","4/7/20","7","5","19033","71.43"
"Chickasaw","0","1","Iowa","4/7/20","0","1","19037","1"
"Clarke","0","1","Iowa","4/7/20","0","1","19039","1"
"Clay","0","2","Iowa","4/7/20","0","2","19041","1"
"Clayton","1","5","Iowa","4/7/20","1","4","19043","400"
"Clinton","2","17","Iowa","4/7/20","5","12","19045","240"
"Crawford","1","5","Iowa","4/7/20","1","4","19047","400"
"Dallas","1","35","Iowa","4/7/20","25","10","19049","40"
"Delaware","0","1","Iowa","4/7/20","0","1","19055","1"
"Des Moines","0","3","Iowa","4/7/20","1","2","19057","200"
"Dickinson","0","1","Iowa","4/7/20","1","0","19059","0"
"Dubuque","1","28","Iowa","4/7/20","21","7","19061","33.33"
"Fayette","0","3","Iowa","4/7/20","2","1","19065","50"
"Franklin","0","1","Iowa","4/7/20","0","1","19069","1"
"Grundy","0","1","Iowa","4/7/20","0","1","19075","1"
"Guthrie","0","1","Iowa","4/7/20","1","0","19077","0"
"Hamilton","0","2","Iowa","4/7/20","0","2","19079","1"
"Hancock","0","3","Iowa","4/7/20","3","0","19081","0"
"Hardin","0","1","Iowa","4/7/20","1","0","19083","0"
"Harrison","0","10","Iowa","4/7/20","9","1","19085","11.11"
"Henry","1","13","Iowa","4/7/20","3","10","19087","333.33"
"Howard","0","1","Iowa","4/7/20","0","1","19089","1"
"Iowa","0","6","Iowa","4/7/20","4","2","19095","50"
"Jackson","0","4","Iowa","4/7/20","1","3","19097","300"
"Jasper","0","8","Iowa","4/7/20","6","2","19099","33.33"
"Jefferson","0","3","Iowa","4/7/20","0","3","19101","1"
"Johnson","9","134","Iowa","4/7/20","73","61","19103","83.56"
"Jones","0","6","Iowa","4/7/20","4","2","19105","50"
"Keokuk","0","2","Iowa","4/7/20","2","0","19107","0"
"Kossuth","0","1","Iowa","4/7/20","1","0","19109","0"
"Lee","0","1","Iowa","4/7/20","0","1","19111","1"
"Linn","14","186","Iowa","4/7/20","90","96","19113","106.67"
"Louisa","3","20","Iowa","4/7/20","0","20","19115","1"
"Lyon","0","2","Iowa","4/7/20","0","2","19119","1"
"Madison","0","1","Iowa","4/7/20","0","1","19121","1"
"Mahaska","0","4","Iowa","4/7/20","2","2","19123","100"
"Marion","0","2","Iowa","4/7/20","0","2","19125","1"
"Marshall","1","14","Iowa","4/7/20","8","6","19127","75"
"Mills","0","1","Iowa","4/7/20","0","1","19129","1"
"Mitchell","0","2","Iowa","4/7/20","0","2","19131","1"
"Monona","0","6","Iowa","4/7/20","5","1","19133","20"
"Montgomery","0","1","Iowa","4/7/20","1","0","19137","0"
"Muscatine","5","51","Iowa","4/7/20","16","35","19139","218.75"
"O'Brien","0","3","Iowa","4/7/20","0","3","19141","1"
"Page","0","3","Iowa","4/7/20","2","1","19145","50"
"Plymouth","1","4","Iowa","4/7/20","0","4","19149","1"
"Polk","7","127","Iowa","4/7/20","76","51","19153","67.11"
"Pottawattamie","1","9","Iowa","4/7/20","4","5","19155","125"
"Poweshiek","0","6","Iowa","4/7/20","5","1","19157","20"
"Scott","7","66","Iowa","4/7/20","18","48","19163","266.67"
"Shelby","0","6","Iowa","4/7/20","3","3","19165","100"
"Sioux","1","7","Iowa","4/7/20","3","4","19167","133.33"
"Story","1","6","Iowa","4/7/20","2","4","19169","200"
"Tama","4","42","Iowa","4/7/20","11","31","19171","281.82"
"Taylor","0","1","Iowa","4/7/20","1","0","19173","0"
"Van Buren","1","6","Iowa","4/7/20","1","5","19177","500"
"Wapello","0","2","Iowa","4/7/20","1","1","19179","100"
"Warren","1","12","Iowa","4/7/20","3","9","19181","300"
"Washington","5","57","Iowa","4/7/20","24","33","19183","137.5"
"Webster","0","1","Iowa","4/7/20","1","0","19187","0"
"Winnebago","0","1","Iowa","4/7/20","0","1","19189","1"
"Winneshiek","0","4","Iowa","4/7/20","3","1","19191","33.33"
"Woodbury","1","9","Iowa","4/7/20","4","5","19193","125"
"Wright","0","1","Iowa","4/7/20","1","0","19197","0"
"Atchison","0","2","Kansas","4/7/20","1","1","20005","100"
"Barber","0","1","Kansas","4/7/20","0","1","20007","1"
"Barton","0","3","Kansas","4/7/20","1","2","20009","200"
"Bourbon","1","7","Kansas","4/7/20","3","4","20011","133.33"
"Butler","1","8","Kansas","4/7/20","3","5","20015","166.67"
"Chautauqua","0","3","Kansas","4/7/20","1","2","20019","200"
"Cherokee","0","5","Kansas","4/7/20","3","2","20021","66.67"
"Clay","0","1","Kansas","4/7/20","1","0","20027","0"
"Cloud","0","2","Kansas","4/7/20","0","2","20029","1"
"Coffey","3","32","Kansas","4/7/20","14","18","20031","128.57"
"Cowley","0","1","Kansas","4/7/20","0","1","20035","1"
"Crawford","0","6","Kansas","4/7/20","5","1","20037","20"
"Doniphan","0","1","Kansas","4/7/20","1","0","20043","0"
"Douglas","2","38","Kansas","4/7/20","24","14","20045","58.33"
"Finney","1","11","Kansas","4/7/20","1","10","20055","1000"
"Ford","0","1","Kansas","4/7/20","1","0","20057","0"
"Franklin","0","10","Kansas","4/7/20","7","3","20059","42.86"
"Geary","1","4","Kansas","4/7/20","0","4","20061","1"
"Gove","0","1","Kansas","4/7/20","1","0","20063","0"
"Greenwood","0","1","Kansas","4/7/20","0","1","20073","1"
"Harvey","0","4","Kansas","4/7/20","1","3","20079","300"
"Jackson","0","1","Kansas","4/7/20","1","0","20085","0"
"Jefferson","0","3","Kansas","4/7/20","1","2","20087","200"
"Jewell","0","1","Kansas","4/7/20","0","1","20089","1"
"Johnson","12","219","Kansas","4/7/20","134","85","20091","63.43"
"Labette","1","8","Kansas","4/7/20","1","7","20099","700"
"Leavenworth","3","43","Kansas","4/7/20","24","19","20103","79.17"
"Linn","0","5","Kansas","4/7/20","5","0","20107","0"
"Lyon","2","25","Kansas","4/7/20","11","14","20111","127.27"
"Marion","0","3","Kansas","4/7/20","0","3","20115","1"
"McPherson","1","10","Kansas","4/7/20","3","7","20113","233.33"
"Miami","0","2","Kansas","4/7/20","0","2","20121","1"
"Mitchell","0","2","Kansas","4/7/20","2","0","20123","0"
"Montgomery","1","9","Kansas","4/7/20","5","4","20125","80"
"Morris","0","2","Kansas","4/7/20","2","0","20127","0"
"Morton","0","1","Kansas","4/7/20","0","1","20129","1"
"Neosho","0","1","Kansas","4/7/20","1","0","20133","0"
"Osage","0","3","Kansas","4/7/20","3","0","20139","0"
"Osborne","0","2","Kansas","4/7/20","0","2","20141","1"
"Ottawa","0","3","Kansas","4/7/20","1","2","20143","200"
"Pottawatomie","0","3","Kansas","4/7/20","2","1","20149","50"
"Pratt","0","1","Kansas","4/7/20","0","1","20151","1"
"Reno","1","11","Kansas","4/7/20","7","4","20155","57.14"
"Republic","0","2","Kansas","4/7/20","0","2","20157","1"
"Riley","2","17","Kansas","4/7/20","2","15","20161","750"
"Saline","1","7","Kansas","4/7/20","1","6","20169","600"
"Scott","0","1","Kansas","4/7/20","0","1","20171","1"
"Sedgwick","11","134","Kansas","4/7/20","58","76","20173","131.03"
"Seward","0","1","Kansas","4/7/20","0","1","20175","1"
"Shawnee","4","47","Kansas","4/7/20","17","30","20177","176.47"
"Stafford","0","1","Kansas","4/7/20","1","0","20185","0"
"Stevens","0","1","Kansas","4/7/20","2","-1","20189","-50"
"Sumner","0","2","Kansas","4/7/20","1","1","20191","100"
"Wabaunsee","0","1","Kansas","4/7/20","0","1","20197","1"
"Woodson","0","3","Kansas","4/7/20","2","1","20207","50"
"Wyandotte","17","195","Kansas","4/7/20","79","116","20209","146.84"
"Adair","0","3","Kentucky","4/7/20","0","3","21001","1"
"Allen","0","2","Kentucky","4/7/20","2","0","21003","0"
"Anderson","0","3","Kentucky","4/7/20","2","1","21005","50"
"Barren","0","1","Kentucky","4/7/20","1","0","21009","0"
"Bath","0","1","Kentucky","4/7/20","0","1","21011","1"
"Boone","2","21","Kentucky","4/7/20","8","13","21015","162.5"
"Bourbon","0","4","Kentucky","4/7/20","2","2","21017","100"
"Boyd","2","15","Kentucky","4/7/20","4","11","21019","275"
"Boyle","0","7","Kentucky","4/7/20","4","3","21021","75"
"Bracken","0","1","Kentucky","4/7/20","1","0","21023","0"
"Breathitt","0","1","Kentucky","4/7/20","2","-1","21025","-50"
"Breckinridge","0","2","Kentucky","4/7/20","2","0","21027","0"
"Bullitt","1","11","Kentucky","4/7/20","6","5","21029","83.33"
"Butler","0","1","Kentucky","4/7/20","1","0","21031","0"
"Caldwell","0","2","Kentucky","4/7/20","0","2","21033","1"
"Calloway","0","5","Kentucky","4/7/20","3","2","21035","66.67"
"Campbell","1","13","Kentucky","4/7/20","8","5","21037","62.5"
"Carroll","0","2","Kentucky","4/7/20","2","0","21041","0"
"Carter","0","1","Kentucky","4/7/20","0","1","21043","1"
"Christian","4","32","Kentucky","4/7/20","7","25","21047","357.14"
"Clark","0","11","Kentucky","4/7/20","8","3","21049","37.5"
"Clinton","0","1","Kentucky","4/7/20","0","1","21053","1"
"Crittenden","0","2","Kentucky","4/7/20","0","2","21055","1"
"Cumberland","0","1","Kentucky","4/7/20","0","1","21057","1"
"Daviess","3","58","Kentucky","4/7/20","34","24","21059","70.59"
"Edmonson","0","5","Kentucky","4/7/20","2","3","21061","150"
"Fayette","2","123","Kentucky","4/7/20","110","13","21067","11.82"
"Franklin","0","7","Kentucky","4/7/20","6","1","21073","16.67"
"Grant","0","2","Kentucky","4/7/20","1","1","21081","100"
"Graves","0","2","Kentucky","4/7/20","0","2","21083","1"
"Grayson","0","2","Kentucky","4/7/20","2","0","21085","0"
"Greenup","0","2","Kentucky","4/7/20","0","2","21089","1"
"Hancock","0","1","Kentucky","4/7/20","1","0","21091","0"
"Hardin","0","9","Kentucky","4/7/20","6","3","21093","50"
"Harrison","0","12","Kentucky","4/7/20","11","1","21097","9.09"
"Henderson","0","6","Kentucky","4/7/20","5","1","21101","20"
"Henry","0","2","Kentucky","4/7/20","0","2","21103","1"
"Hopkins","3","36","Kentucky","4/7/20","17","19","21107","111.76"
"Jefferson","16","319","Kentucky","4/7/20","206","113","21111","54.85"
"Jessamine","0","16","Kentucky","4/7/20","13","3","21113","23.08"
"Johnson","0","1","Kentucky","4/7/20","0","1","21115","1"
"Kenton","2","36","Kentucky","4/7/20","20","16","21117","80"
"Larue","0","3","Kentucky","4/7/20","1","2","21123","200"
"Laurel","0","2","Kentucky","4/7/20","2","0","21125","0"
"Lawrence","0","1","Kentucky","4/7/20","1","0","21127","0"
"Leslie","0","1","Kentucky","4/7/20","0","1","21131","1"
"Lewis","0","2","Kentucky","4/7/20","1","1","21135","100"
"Logan","0","4","Kentucky","4/7/20","3","1","21141","33.33"
"Lyon","0","4","Kentucky","4/7/20","1","3","21143","300"
"Madison","0","12","Kentucky","4/7/20","10","2","21151","20"
"Marion","0","3","Kentucky","4/7/20","1","2","21155","200"
"Marshall","1","5","Kentucky","4/7/20","1","4","21157","400"
"Martin","0","1","Kentucky","4/7/20","1","0","21159","0"
"Mason","0","2","Kentucky","4/7/20","1","1","21161","100"
"McCracken","1","13","Kentucky","4/7/20","8","5","21145","62.5"
"McCreary","0","1","Kentucky","4/7/20","1","0","21147","0"
"McLean","0","1","Kentucky","4/7/20","1","0","21149","0"
"Meade","0","2","Kentucky","4/7/20","0","2","21163","1"
"Menifee","0","3","Kentucky","4/7/20","2","1","21165","50"
"Mercer","0","4","Kentucky","4/7/20","2","2","21167","100"
"Montgomery","1","6","Kentucky","4/7/20","2","4","21173","200"
"Muhlenberg","2","27","Kentucky","4/7/20","10","17","21177","170"
"Nelson","0","4","Kentucky","4/7/20","3","1","21179","33.33"
"Nicholas","0","1","Kentucky","4/7/20","1","0","21181","0"
"Ohio","0","1","Kentucky","4/7/20","0","1","21183","1"
"Oldham","0","8","Kentucky","4/7/20","6","2","21185","33.33"
"Pendleton","0","2","Kentucky","4/7/20","1","1","21191","100"
"Perry","0","3","Kentucky","4/7/20","0","3","21193","1"
"Pike","0","1","Kentucky","4/7/20","0","1","21195","1"
"Powell","0","1","Kentucky","4/7/20","1","0","21197","0"
"Pulaski","1","13","Kentucky","4/7/20","8","5","21199","62.5"
"Rockcastle","0","4","Kentucky","4/7/20","1","3","21203","300"
"Russell","0","1","Kentucky","4/7/20","0","1","21207","1"
"Scott","1","14","Kentucky","4/7/20","6","8","21209","133.33"
"Shelby","1","8","Kentucky","4/7/20","2","6","21211","300"
"Simpson","1","13","Kentucky","4/7/20","9","4","21213","44.44"
"Spencer","0","2","Kentucky","4/7/20","2","0","21215","0"
"Taylor","0","2","Kentucky","4/7/20","2","0","21217","0"
"Union","0","2","Kentucky","4/7/20","2","0","21225","0"
"Warren","1","21","Kentucky","4/7/20","13","8","21227","61.54"
"Washington","0","2","Kentucky","4/7/20","1","1","21229","100"
"Wayne","0","4","Kentucky","4/7/20","3","1","21231","33.33"
"Webster","0","3","Kentucky","4/7/20","2","1","21233","50"
"Woodford","0","8","Kentucky","4/7/20","5","3","21239","60"
"Acadia","6","82","Louisiana","4/7/20","39","43","22001","110.26"
"Allen","6","58","Louisiana","4/7/20","15","43","22003","286.67"
"Ascension","28","358","Louisiana","4/7/20","161","197","22005","122.36"
"Assumption","9","84","Louisiana","4/7/20","20","64","22007","320"
"Avoyelles","4","45","Louisiana","4/7/20","19","26","22009","136.84"
"Beauregard","3","23","Louisiana","4/7/20","5","18","22011","360"
"Bienville","2","17","Louisiana","4/7/20","6","11","22013","183.33"
"Bossier","12","146","Louisiana","4/7/20","63","83","22015","131.75"
"Caddo","73","756","Louisiana","4/7/20","242","514","22017","212.4"
"Calcasieu","17","186","Louisiana","4/7/20","65","121","22019","186.15"
"Caldwell","2","13","Louisiana","4/7/20","0","13","22021","1"
"Cameron","0","1","Louisiana","4/7/20","0","1","22023","1"
"Catahoula","1","13","Louisiana","4/7/20","3","10","22025","333.33"
"Claiborne","3","30","Louisiana","4/7/20","8","22","22027","275"
"Concordia","1","11","Louisiana","4/7/20","3","8","22029","266.67"
"De Soto","8","89","Louisiana","4/7/20","30","59","22031","196.67"
"East Baton Rouge","95","892","Louisiana","4/7/20","228","664","22033","291.23"
"East Carroll","0","1","Louisiana","4/7/20","1","0","22035","0"
"East Feliciana","4","39","Louisiana","4/7/20","9","30","22037","333.33"
"Evangeline","2","23","Louisiana","4/7/20","10","13","22039","130"
"Franklin","3","28","Louisiana","4/7/20","5","23","22041","460"
"Grant","1","10","Louisiana","4/7/20","2","8","22043","400"
"Iberia","8","89","Louisiana","4/7/20","36","53","22045","147.22"
"Iberville","18","160","Louisiana","4/7/20","35","125","22047","357.14"
"Jackson","0","5","Louisiana","4/7/20","3","2","22049","66.67"
"Jefferson","390","3922","Louisiana","4/7/20","1193","2729","22051","228.75"
"Jefferson Davis","3","25","Louisiana","4/7/20","5","20","22053","400"
"Lafayette","22","272","Louisiana","4/7/20","118","154","22055","130.51"
"Lafourche","35","322","Louisiana","4/7/20","74","248","22057","335.14"
"LaSalle","1","6","Louisiana","4/7/20","2","4","22059","200"
"Lincoln","1","22","Louisiana","4/7/20","12","10","22061","83.33"
"Livingston","10","94","Louisiana","4/7/20","23","71","22063","308.7"
"Madison","0","2","Louisiana","4/7/20","1","1","22065","100"
"Morehouse","3","20","Louisiana","4/7/20","2","18","22067","900"
"Natchitoches","3","24","Louisiana","4/7/20","2","22","22069","1100"
"Orleans","444","4942","Louisiana","4/7/20","1834","3108","22071","169.47"
"Ouachita","30","264","Louisiana","4/7/20","57","207","22073","363.16"
"Plaquemines","11","115","Louisiana","4/7/20","37","78","22075","210.81"
"Pointe Coupee","3","26","Louisiana","4/7/20","7","19","22077","271.43"
"Rapides","10","129","Louisiana","4/7/20","58","71","22079","122.41"
"Red River","0","2","Louisiana","4/7/20","1","1","22081","100"
"Richland","2","13","Louisiana","4/7/20","2","11","22083","550"
"Sabine","1","7","Louisiana","4/7/20","2","5","22085","250"
"St. Bernard","31","289","Louisiana","4/7/20","71","218","22087","307.04"
"St. Charles","34","310","Louisiana","4/7/20","71","239","22089","336.62"
"St. Helena","1","10","Louisiana","4/7/20","1","9","22091","900"
"St. James","14","176","Louisiana","4/7/20","77","99","22093","128.57"
"St. John the Baptist","44","415","Louisiana","4/7/20","104","311","22095","299.04"
"St. Landry","4","60","Louisiana","4/7/20","31","29","22097","93.55"
"St. Martin","10","101","Louisiana","4/7/20","32","69","22099","215.62"
"St. Mary","8","76","Louisiana","4/7/20","22","54","22101","245.45"
"St. Tammany","69","700","Louisiana","4/7/20","220","480","22103","218.18"
"Tangipahoa","30","238","Louisiana","4/7/20","25","213","22105","852"
"Terrebonne","22","194","Louisiana","4/7/20","40","154","22109","385"
"Union","3","33","Louisiana","4/7/20","9","24","22111","266.67"
"Vermilion","2","19","Louisiana","4/7/20","8","11","22113","137.5"
"Vernon","1","11","Louisiana","4/7/20","3","8","22115","266.67"
"Washington","10","100","Louisiana","4/7/20","28","72","22117","257.14"
"Webster","5","50","Louisiana","4/7/20","17","33","22119","194.12"
"West Baton Rouge","6","52","Louisiana","4/7/20","13","39","22121","300"
"West Carroll","0","1","Louisiana","4/7/20","0","1","22123","1"
"West Feliciana","4","31","Louisiana","4/7/20","4","27","22125","675"
"Winn","0","3","Louisiana","4/7/20","1","2","22127","200"
"Androscoggin","2","23","Maine","4/7/20","11","12","23001","109.09"
"Aroostook","0","2","Maine","4/7/20","0","2","23003","1"
"Cumberland","12","253","Maine","4/7/20","169","84","23005","49.7"
"Franklin","0","5","Maine","4/7/20","2","3","23007","150"
"Hancock","0","2","Maine","4/7/20","0","2","23009","1"
"Kennebec","2","26","Maine","4/7/20","12","14","23011","116.67"
"Knox","1","9","Maine","4/7/20","5","4","23013","80"
"Lincoln","0","9","Maine","4/7/20","8","1","23015","12.5"
"Oxford","0","12","Maine","4/7/20","9","3","23017","33.33"
"Penobscot","3","31","Maine","4/7/20","12","19","23019","158.33"
"Sagadahoc","1","13","Maine","4/7/20","7","6","23023","85.71"
"Somerset","0","4","Maine","4/7/20","1","3","23025","300"
"Waldo","0","5","Maine","4/7/20","2","3","23027","150"
"Washington","0","1","Maine","4/7/20","0","1","23029","1"
"York","8","115","Maine","4/7/20","59","56","23031","94.92"
"Allegany","1","7","Maryland","4/7/20","0","7","24001","1"
"Anne Arundel","35","370","Maryland","4/7/20","127","243","24003","191.34"
"Baltimore","61","652","Maryland","4/7/20","227","425","24005","187.22"
"Baltimore City","39","459","Maryland","4/7/20","187","272","24510","145.45"
"Calvert","4","41","Maryland","4/7/20","15","26","24009","173.33"
"Caroline","1","11","Maryland","4/7/20","4","7","24011","175"
"Carroll","10","159","Maryland","4/7/20","92","67","24013","72.83"
"Cecil","4","41","Maryland","4/7/20","14","27","24015","192.86"
"Charles","14","136","Maryland","4/7/20","40","96","24017","240"
"Dorchester","0","3","Maryland","4/7/20","0","3","24019","1"
"Frederick","17","151","Maryland","4/7/20","33","118","24021","357.58"
"Garrett","0","3","Maryland","4/7/20","3","0","24023","0"
"Harford","5","59","Maryland","4/7/20","25","34","24025","136"
"Howard","17","236","Maryland","4/7/20","117","119","24027","101.71"
"Kent","1","8","Maryland","4/7/20","3","5","24029","166.67"
"Montgomery","69","871","Maryland","4/7/20","388","483","24031","124.48"
"Prince George's","97","1020","Maryland","4/7/20","341","679","24033","199.12"
"Queen Anne's","2","15","Maryland","4/7/20","4","11","24035","275"
"Somerset","0","4","Maryland","4/7/20","1","3","24039","300"
"St. Mary's","4","46","Maryland","4/7/20","15","31","24037","206.67"
"Talbot","1","8","Maryland","4/7/20","3","5","24041","166.67"
"Washington","5","44","Maryland","4/7/20","11","33","24043","300"
"Wicomico","1","17","Maryland","4/7/20","7","10","24045","142.86"
"Worcester","1","10","Maryland","4/7/20","3","7","24047","233.33"
"Barnstable","31","405","Massachusetts","4/7/20","191","214","25001","112.04"
"Berkshire","15","278","Massachusetts","4/7/20","171","107","25003","62.57"
"Bristol","66","768","Massachusetts","4/7/20","306","462","25005","150.98"
"Dukes and Nantucket","1","18","Massachusetts","4/7/20","8","10","00000","125"
"Essex","151","1841","Massachusetts","4/7/20","784","1057","25009","134.82"
"Franklin","8","118","Massachusetts","4/7/20","61","57","25011","93.44"
"Hampden","92","997","Massachusetts","4/7/20","354","643","25013","181.64"
"Hampshire","13","158","Massachusetts","4/7/20","69","89","25015","128.99"
"Middlesex","264","3187","Massachusetts","4/7/20","1340","1847","25017","137.84"
"Norfolk","122","1592","Massachusetts","4/7/20","738","854","25021","115.72"
"Plymouth","105","1194","Massachusetts","4/7/20","459","735","25023","160.13"
"Suffolk","267","3245","Massachusetts","4/7/20","1373","1872","25025","136.34"
"Worcester","106","1172","Massachusetts","4/7/20","433","739","25027","170.67"
"Allegan","2","20","Michigan","4/7/20","3","17","26005","566.67"
"Antrim","0","7","Michigan","4/7/20","4","3","26009","75"
"Arenac","0","3","Michigan","4/7/20","1","2","26011","200"
"Barry","1","9","Michigan","4/7/20","4","5","26015","125"
"Bay","3","35","Michigan","4/7/20","11","24","26017","218.18"
"Berrien","7","130","Michigan","4/7/20","78","52","26021","66.67"
"Branch","2","17","Michigan","4/7/20","2","15","26023","750"
"Calhoun","4","48","Michigan","4/7/20","19","29","26025","152.63"
"Cass","1","13","Michigan","4/7/20","8","5","26027","62.5"
"Charlevoix","1","8","Michigan","4/7/20","4","4","26029","100"
"Cheboygan","1","11","Michigan","4/7/20","2","9","26031","450"
"Chippewa","0","1","Michigan","4/7/20","1","0","26033","0"
"Clare","0","2","Michigan","4/7/20","1","1","26035","100"
"Clinton","7","77","Michigan","4/7/20","27","50","26037","185.19"
"Crawford","1","5","Michigan","4/7/20","1","4","26039","400"
"Delta","1","8","Michigan","4/7/20","1","7","26041","700"
"Dickinson","0","2","Michigan","4/7/20","0","2","26043","1"
"Eaton","6","64","Michigan","4/7/20","22","42","26045","190.91"
"Emmet","1","15","Michigan","4/7/20","5","10","26047","200"
"Genesee","66","654","Michigan","4/7/20","190","464","26049","244.21"
"Gladwin","0","4","Michigan","4/7/20","2","2","26051","100"
"Gogebic","0","3","Michigan","4/7/20","2","1","26053","50"
"Grand Traverse","1","15","Michigan","4/7/20","7","8","26055","114.29"
"Gratiot","0","6","Michigan","4/7/20","3","3","26057","100"
"Hillsdale","6","56","Michigan","4/7/20","14","42","26059","300"
"Houghton","0","1","Michigan","4/7/20","1","0","26061","0"
"Huron","0","5","Michigan","4/7/20","3","2","26063","66.67"
"Ingham","15","198","Michigan","4/7/20","96","102","26065","106.25"
"Ionia","1","9","Michigan","4/7/20","4","5","26067","125"
"Iosco","1","5","Michigan","4/7/20","1","4","26069","400"
"Isabella","3","29","Michigan","4/7/20","6","23","26073","383.33"
"Jackson","10","125","Michigan","4/7/20","53","72","26075","135.85"
"Kalamazoo","7","72","Michigan","4/7/20","26","46","26077","176.92"
"Kalkaska","1","11","Michigan","4/7/20","7","4","26079","57.14"
"Kent","12","195","Michigan","4/7/20","111","84","26081","75.68"
"Lapeer","7","60","Michigan","4/7/20","11","49","26087","445.45"
"Leelanau","0","3","Michigan","4/7/20","1","2","26089","200"
"Lenawee","2","35","Michigan","4/7/20","19","16","26091","84.21"
"Livingston","13","187","Michigan","4/7/20","94","93","26093","98.94"
"Luce","0","1","Michigan","4/7/20","0","1","26095","1"
"Mackinac","0","3","Michigan","4/7/20","0","3","26097","1"
"Macomb","223","2419","Michigan","4/7/20","855","1564","26099","182.92"
"Manistee","1","10","Michigan","4/7/20","1","9","26101","900"
"Marquette","2","19","Michigan","4/7/20","4","15","26103","375"
"Mason","0","2","Michigan","4/7/20","1","1","26105","100"
"Mecosta","1","9","Michigan","4/7/20","3","6","26107","200"
"Midland","3","33","Michigan","4/7/20","15","18","26111","120"
"Missaukee","0","1","Michigan","4/7/20","1","0","26113","0"
"Monroe","11","129","Michigan","4/7/20","49","80","26115","163.27"
"Montcalm","2","17","Michigan","4/7/20","6","11","26117","183.33"
"Muskegon","3","41","Michigan","4/7/20","18","23","26121","127.78"
"Newaygo","0","3","Michigan","4/7/20","1","2","26123","200"
"Oakland","321","4014","Michigan","4/7/20","1764","2250","26125","127.55"
"Oceana","0","3","Michigan","4/7/20","2","1","26127","50"
"Ogemaw","0","4","Michigan","4/7/20","2","2","26129","100"
"Osceola","0","5","Michigan","4/7/20","2","3","26133","150"
"Oscoda","0","2","Michigan","4/7/20","2","0","26135","0"
"Otsego","2","30","Michigan","4/7/20","19","11","26137","57.89"
"Ottawa","5","68","Michigan","4/7/20","34","34","26139","100"
"Out of MI","14","118","Michigan","4/7/20","20","98","80026","490"
"Presque Isle","0","1","Michigan","4/7/20","0","1","26141","1"
"Roscommon","1","6","Michigan","4/7/20","1","5","26143","500"
"Saginaw","15","153","Michigan","4/7/20","51","102","26145","200"
"Sanilac","1","17","Michigan","4/7/20","7","10","26151","142.86"
"Schoolcraft","0","0","Michigan","4/7/20","1","-1","26153","-100"
"Shiawassee","2","26","Michigan","4/7/20","9","17","26155","188.89"
"St. Clair","15","147","Michigan","4/7/20","40","107","26147","267.5"
"St. Joseph","1","14","Michigan","4/7/20","4","10","26149","250"
"Tuscola","2","26","Michigan","4/7/20","9","17","26157","188.89"
"Van Buren","2","25","Michigan","4/7/20","8","17","26159","212.5"
"Washtenaw","41","618","Michigan","4/7/20","330","288","26161","87.27"
"Wayne","766","9115","Michigan","4/7/20","3752","5363","26163","142.94"
"Wexford","1","8","Michigan","4/7/20","2","6","26165","300"
"Anoka","3","42","Minnesota","4/7/20","23","19","27003","82.61"
"Beltrami","0","6","Minnesota","4/7/20","4","2","27007","50"
"Benton","0","1","Minnesota","4/7/20","1","0","27009","0"
"Big Stone","0","1","Minnesota","4/7/20","1","0","27011","0"
"Blue Earth","2","22","Minnesota","4/7/20","9","13","27013","144.44"
"Brown","1","7","Minnesota","4/7/20","2","5","27015","250"
"Carlton","2","13","Minnesota","4/7/20","1","12","27017","1200"
"Carver","0","10","Minnesota","4/7/20","10","0","27019","0"
"Cass","0","3","Minnesota","4/7/20","1","2","27021","200"
"Chisago","0","5","Minnesota","4/7/20","3","2","27025","66.67"
"Clay","2","19","Minnesota","4/7/20","6","13","27027","216.67"
"Clearwater","0","2","Minnesota","4/7/20","2","0","27029","0"
"Cottonwood","0","5","Minnesota","4/7/20","2","3","27033","150"
"Crow Wing","1","9","Minnesota","4/7/20","0","9","27035","1"
"Dakota","3","71","Minnesota","4/7/20","47","24","27037","51.06"
"Dodge","0","11","Minnesota","4/7/20","8","3","27039","37.5"
"Douglas","0","1","Minnesota","4/7/20","1","0","27041","0"
"Faribault","0","3","Minnesota","4/7/20","2","1","27043","50"
"Fillmore","0","10","Minnesota","4/7/20","8","2","27045","25"
"Freeborn","2","14","Minnesota","4/7/20","0","14","27047","1"
"Goodhue","1","12","Minnesota","4/7/20","3","9","27049","300"
"Hennepin","15","310","Minnesota","4/7/20","204","106","27053","51.96"
"Houston","0","1","Minnesota","4/7/20","0","1","27055","1"
"Isanti","0","4","Minnesota","4/7/20","2","2","27059","100"
"Itasca","0","2","Minnesota","4/7/20","1","1","27061","100"
"Jackson","0","1","Minnesota","4/7/20","1","0","27063","0"
"Kandiyohi","0","2","Minnesota","4/7/20","2","0","27067","0"
"Koochiching","0","1","Minnesota","4/7/20","0","1","27071","1"
"Lac qui Parle","0","1","Minnesota","4/7/20","1","0","27073","0"
"Le Sueur","1","20","Minnesota","4/7/20","15","5","27079","33.33"
"Lincoln","0","2","Minnesota","4/7/20","1","1","27081","100"
"Lyon","0","4","Minnesota","4/7/20","1","3","27083","300"
"Mahnomen","0","1","Minnesota","4/7/20","1","0","27087","0"
"Martin","1","34","Minnesota","4/7/20","25","9","27091","36"
"McLeod","0","1","Minnesota","4/7/20","0","1","27085","1"
"Meeker","0","1","Minnesota","4/7/20","1","0","27093","0"
"Mower","1","18","Minnesota","4/7/20","13","5","27099","38.46"
"Murray","0","1","Minnesota","4/7/20","0","1","27101","1"
"Nicollet","0","4","Minnesota","4/7/20","3","1","27103","33.33"
"Olmsted","7","103","Minnesota","4/7/20","53","50","27109","94.34"
"Otter Tail","0","2","Minnesota","4/7/20","1","1","27111","100"
"Pipestone","0","1","Minnesota","4/7/20","0","1","27117","1"
"Polk","0","1","Minnesota","4/7/20","0","1","27119","1"
"Ramsey","6","101","Minnesota","4/7/20","56","45","27123","80.36"
"Redwood","0","1","Minnesota","4/7/20","0","1","27127","1"
"Renville","0","2","Minnesota","4/7/20","1","1","27129","100"
"Rice","0","4","Minnesota","4/7/20","3","1","27131","33.33"
"Scott","1","16","Minnesota","4/7/20","10","6","27139","60"
"Sherburne","0","10","Minnesota","4/7/20","8","2","27141","25"
"Sibley","0","1","Minnesota","4/7/20","1","0","27143","0"
"St. Louis","1","17","Minnesota","4/7/20","12","5","27137","41.67"
"Stearns","0","6","Minnesota","4/7/20","5","1","27145","20"
"Steele","0","8","Minnesota","4/7/20","6","2","27147","33.33"
"Swift","0","1","Minnesota","4/7/20","0","1","27151","1"
"Traverse","0","2","Minnesota","4/7/20","2","0","27155","0"
"Wabasha","0","6","Minnesota","4/7/20","6","0","27157","0"
"Waseca","0","3","Minnesota","4/7/20","3","0","27161","0"
"Washington","4","68","Minnesota","4/7/20","39","29","27163","74.36"
"Watonwan","0","4","Minnesota","4/7/20","1","3","27165","300"
"Wilkin","0","2","Minnesota","4/7/20","1","1","27167","100"
"Winona","1","16","Minnesota","4/7/20","10","6","27169","60"
"Wright","1","12","Minnesota","4/7/20","6","6","27171","100"
"Yellow Medicine","0","1","Minnesota","4/7/20","0","1","27173","1"
"Adams","2","24","Mississippi","4/7/20","10","14","28001","140"
"Alcorn","0","6","Mississippi","4/7/20","3","3","28003","100"
"Amite","0","7","Mississippi","4/7/20","4","3","28005","75"
"Attala","1","15","Mississippi","4/7/20","10","5","28007","50"
"Benton","0","5","Mississippi","4/7/20","4","1","28009","25"
"Bolivar","5","54","Mississippi","4/7/20","22","32","28011","145.45"
"Calhoun","1","10","Mississippi","4/7/20","3","7","28013","233.33"
"Carroll","1","7","Mississippi","4/7/20","1","6","28015","600"
"Chickasaw","0","15","Mississippi","4/7/20","13","2","28017","15.38"
"Choctaw","0","9","Mississippi","4/7/20","6","3","28019","50"
"Claiborne","0","3","Mississippi","4/7/20","1","2","28021","200"
"Clarke","1","10","Mississippi","4/7/20","4","6","28023","150"
"Clay","1","10","Mississippi","4/7/20","4","6","28025","150"
"Coahoma","1","30","Mississippi","4/7/20","21","9","28027","42.86"
"Copiah","1","17","Mississippi","4/7/20","9","8","28029","88.89"
"Covington","1","7","Mississippi","4/7/20","2","5","28031","250"
"DeSoto","8","140","Mississippi","4/7/20","84","56","28033","66.67"
"Forrest","5","59","Mississippi","4/7/20","21","38","28035","180.95"
"Franklin","0","5","Mississippi","4/7/20","3","2","28037","66.67"
"George","0","5","Mississippi","4/7/20","3","2","28039","66.67"
"Greene","0","1","Mississippi","4/7/20","0","1","28041","1"
"Grenada","1","8","Mississippi","4/7/20","3","5","28043","166.67"
"Hancock","2","31","Mississippi","4/7/20","16","15","28045","93.75"
"Harrison","6","89","Mississippi","4/7/20","45","44","28047","97.78"
"Hinds","11","169","Mississippi","4/7/20","90","79","28049","87.78"
"Holmes","1","25","Mississippi","4/7/20","15","10","28051","66.67"
"Humphreys","0","5","Mississippi","4/7/20","3","2","28053","66.67"
"Itawamba","0","5","Mississippi","4/7/20","3","2","28057","66.67"
"Jackson","10","108","Mississippi","4/7/20","40","68","28059","170"
"Jasper","1","4","Mississippi","4/7/20","0","4","28061","1"
"Jefferson","0","3","Mississippi","4/7/20","1","2","28063","200"
"Jones","1","14","Mississippi","4/7/20","6","8","28067","133.33"
"Kemper","1","10","Mississippi","4/7/20","1","9","28069","900"
"Lafayette","1","25","Mississippi","4/7/20","15","10","28071","66.67"
"Lamar","2","18","Mississippi","4/7/20","5","13","28073","260"
"Lauderdale","6","78","Mississippi","4/7/20","35","43","28075","122.86"
"Lawrence","0","5","Mississippi","4/7/20","5","0","28077","0"
"Leake","1","15","Mississippi","4/7/20","5","10","28079","200"
"Lee","2","38","Mississippi","4/7/20","24","14","28081","58.33"
"Leflore","1","26","Mississippi","4/7/20","19","7","28083","36.84"
"Lincoln","1","21","Mississippi","4/7/20","11","10","28085","90.91"
"Lowndes","1","16","Mississippi","4/7/20","11","5","28087","45.45"
"Madison","6","82","Mississippi","4/7/20","42","40","28089","95.24"
"Marion","1","13","Mississippi","4/7/20","5","8","28091","160"
"Marshall","1","24","Mississippi","4/7/20","14","10","28093","71.43"
"Monroe","2","18","Mississippi","4/7/20","6","12","28095","200"
"Montgomery","1","12","Mississippi","4/7/20","7","5","28097","71.43"
"Neshoba","1","12","Mississippi","4/7/20","4","8","28099","200"
"Newton","1","7","Mississippi","4/7/20","2","5","28101","250"
"Noxubee","0","5","Mississippi","4/7/20","3","2","28103","66.67"
"Oktibbeha","2","29","Mississippi","4/7/20","17","12","28105","70.59"
"Panola","2","19","Mississippi","4/7/20","7","12","28107","171.43"
"Pearl River","4","56","Mississippi","4/7/20","30","26","28109","86.67"
"Perry","2","14","Mississippi","4/7/20","3","11","28111","366.67"
"Pike","2","31","Mississippi","4/7/20","17","14","28113","82.35"
"Pontotoc","1","12","Mississippi","4/7/20","5","7","28115","140"
"Prentiss","1","10","Mississippi","4/7/20","4","6","28117","150"
"Quitman","1","9","Mississippi","4/7/20","3","6","28119","200"
"Rankin","5","78","Mississippi","4/7/20","40","38","28121","95"
"Scott","3","32","Mississippi","4/7/20","10","22","28123","220"
"Sharkey","0","3","Mississippi","4/7/20","1","2","28125","200"
"Simpson","1","7","Mississippi","4/7/20","2","5","28127","250"
"Smith","1","11","Mississippi","4/7/20","1","10","28129","1000"
"Stone","0","3","Mississippi","4/7/20","0","3","28131","1"
"Sunflower","2","25","Mississippi","4/7/20","11","14","28133","127.27"
"Tallahatchie","0","3","Mississippi","4/7/20","2","1","28135","50"
"Tate","1","18","Mississippi","4/7/20","11","7","28137","63.64"
"Tippah","1","36","Mississippi","4/7/20","26","10","28139","38.46"
"Tishomingo","0","1","Mississippi","4/7/20","1","0","28141","0"
"Tunica","1","17","Mississippi","4/7/20","12","5","28143","41.67"
"Union","0","6","Mississippi","4/7/20","3","3","28145","100"
"Walthall","1","14","Mississippi","4/7/20","5","9","28147","180"
"Warren","1","7","Mississippi","4/7/20","1","6","28149","600"
"Washington","3","40","Mississippi","4/7/20","20","20","28151","100"
"Wayne","1","5","Mississippi","4/7/20","0","5","28153","1"
"Webster","1","12","Mississippi","4/7/20","5","7","28155","140"
"Wilkinson","3","32","Mississippi","4/7/20","14","18","28157","128.57"
"Winston","1","17","Mississippi","4/7/20","7","10","28159","142.86"
"Yalobusha","1","11","Mississippi","4/7/20","6","5","28161","83.33"
"Yazoo","3","32","Mississippi","4/7/20","9","23","28163","255.56"
"Adair","1","11","Missouri","4/7/20","2","9","29001","450"
"Atchison","0","1","Missouri","4/7/20","1","0","29005","0"
"Barry","0","1","Missouri","4/7/20","1","0","29009","0"
"Bates","0","3","Missouri","4/7/20","1","2","29013","200"
"Benton","0","3","Missouri","4/7/20","2","1","29015","50"
"Bollinger","0","2","Missouri","4/7/20","1","1","29017","100"
"Boone","2","77","Missouri","4/7/20","64","13","29019","20.31"
"Buchanan","1","14","Missouri","4/7/20","5","9","29021","180"
"Butler","1","5","Missouri","4/7/20","0","5","29023","1"
"Caldwell","0","1","Missouri","4/7/20","0","1","29025","1"
"Callaway","1","19","Missouri","4/7/20","14","5","29027","35.71"
"Camden","2","24","Missouri","4/7/20","12","12","29029","100"
"Cape Girardeau","1","20","Missouri","4/7/20","15","5","29031","33.33"
"Carter","0","3","Missouri","4/7/20","4","-1","29035","-25"
"Cass","2","25","Missouri","4/7/20","14","11","29037","78.57"
"Cedar","0","7","Missouri","4/7/20","5","2","29039","40"
"Chariton","0","4","Missouri","4/7/20","4","0","29041","0"
"Christian","1","17","Missouri","4/7/20","12","5","29043","41.67"
"Clark","0","1","Missouri","4/7/20","0","1","29045","1"
"Clay","3","37","Missouri","4/7/20","16","21","29047","131.25"
"Clinton","1","8","Missouri","4/7/20","4","4","29049","100"
"Cole","1","32","Missouri","4/7/20","25","7","29051","28"
"Cooper","0","2","Missouri","4/7/20","2","0","29053","0"
"Crawford","0","3","Missouri","4/7/20","1","2","29055","200"
"Dallas","0","1","Missouri","4/7/20","0","1","29059","1"
"DeKalb","0","1","Missouri","4/7/20","0","1","29063","1"
"Dunklin","0","8","Missouri","4/7/20","6","2","29069","33.33"
"Franklin","3","35","Missouri","4/7/20","13","22","29071","169.23"
"Gasconade","0","2","Missouri","4/7/20","0","2","29073","1"
"Gentry","0","1","Missouri","4/7/20","0","1","29075","1"
"Greene","3","72","Missouri","4/7/20","48","24","29077","50"
"Harrison","0","4","Missouri","4/7/20","1","3","29081","300"
"Henry","0","2","Missouri","4/7/20","1","1","29083","100"
"Howard","0","1","Missouri","4/7/20","0","1","29089","1"
"Howell","1","4","Missouri","4/7/20","0","4","29091","1"
"Jackson","12","162","Missouri","4/7/20","77","85","29095","110.39"
"Jasper","1","15","Missouri","4/7/20","7","8","29097","114.29"
"Jefferson","9","92","Missouri","4/7/20","30","62","29099","206.67"
"Johnson","2","33","Missouri","4/7/20","19","14","29101","73.68"
"Kansas City","16","234","Missouri","4/7/20","119","115","00000","96.64"
"Lafayette","1","28","Missouri","4/7/20","19","9","29107","47.37"
"Lincoln","2","24","Missouri","4/7/20","7","17","29113","242.86"
"Linn","0","3","Missouri","4/7/20","0","3","29115","1"
"Livingston","0","1","Missouri","4/7/20","1","0","29117","0"
"Macon","0","2","Missouri","4/7/20","3","-1","29121","-33.33"
"Madison","0","1","Missouri","4/7/20","0","1","29123","1"
"Maries","0","2","Missouri","4/7/20","1","1","29125","100"
"McDonald","0","3","Missouri","4/7/20","2","1","29119","50"
"Moniteau","0","4","Missouri","4/7/20","2","2","29135","100"
"Montgomery","0","5","Missouri","4/7/20","2","3","29139","150"
"Morgan","0","1","Missouri","4/7/20","1","0","29141","0"
"New Madrid","1","5","Missouri","4/7/20","0","5","29143","1"
"Newton","0","6","Missouri","4/7/20","5","1","29145","20"
"Nodaway","0","2","Missouri","4/7/20","0","2","29147","1"
"Oregon","0","1","Missouri","4/7/20","0","1","29149","1"
"Osage","0","4","Missouri","4/7/20","1","3","29151","300"
"Pemiscot","0","3","Missouri","4/7/20","2","1","29155","50"
"Perry","2","28","Missouri","4/7/20","14","14","29157","100"
"Pettis","0","3","Missouri","4/7/20","1","2","29159","200"
"Phelps","0","1","Missouri","4/7/20","0","1","29161","1"
"Pike","0","4","Missouri","4/7/20","1","3","29163","300"
"Platte","1","17","Missouri","4/7/20","9","8","29165","88.89"
"Polk","0","1","Missouri","4/7/20","0","1","29167","1"
"Pulaski","1","12","Missouri","4/7/20","7","5","29169","71.43"
"Ralls","0","1","Missouri","4/7/20","1","0","29173","0"
"Randolph","1","7","Missouri","4/7/20","2","5","29175","250"
"Ray","1","7","Missouri","4/7/20","1","6","29177","600"
"Reynolds","0","2","Missouri","4/7/20","2","0","29179","0"
"Ripley","0","2","Missouri","4/7/20","2","0","29181","0"
"Saline","1","5","Missouri","4/7/20","0","5","29195","1"
"Scotland","0","1","Missouri","4/7/20","0","1","29199","1"
"Scott","1","10","Missouri","4/7/20","6","4","29201","66.67"
"Shelby","0","1","Missouri","4/7/20","1","0","29205","0"
"St. Charles","24","237","Missouri","4/7/20","71","166","29183","233.8"
"St. Francois","2","19","Missouri","4/7/20","5","14","29187","280"
"St. Louis","103","1364","Missouri","4/7/20","640","724","29189","113.12"
"St. Louis City","40","476","Missouri","4/7/20","195","281","29510","144.1"
"Ste. Genevieve","1","6","Missouri","4/7/20","2","4","29186","200"
"Stoddard","1","8","Missouri","4/7/20","3","5","29207","166.67"
"Stone","0","3","Missouri","4/7/20","1","2","29209","200"
"Taney","1","7","Missouri","4/7/20","2","5","29213","250"
"Texas","0","0","Missouri","4/7/20","1","-1","29215","-100"
"Warren","1","11","Missouri","4/7/20","5","6","29219","120"
"Webster","0","3","Missouri","4/7/20","2","1","29225","50"
"Worth","0","1","Missouri","4/7/20","0","1","29227","1"
"Wright","0","7","Missouri","4/7/20","4","3","29229","75"
"Beaverhead","0","1","Montana","4/7/20","0","1","30001","1"
"Broadwater","0","4","Montana","4/7/20","3","1","30007","33.33"
"Carbon","0","2","Montana","4/7/20","0","2","30009","1"
"Cascade","0","11","Montana","4/7/20","9","2","30013","22.22"
"Deer Lodge","0","3","Montana","4/7/20","3","0","30023","0"
"Flathead","3","31","Montana","4/7/20","11","20","30029","181.82"
"Gallatin","6","118","Montana","4/7/20","74","44","30031","59.46"
"Glacier","0","1","Montana","4/7/20","0","1","30035","1"
"Hill","0","1","Montana","4/7/20","1","0","30041","0"
"Jefferson","0","2","Montana","4/7/20","2","0","30043","0"
"Lake","0","5","Montana","4/7/20","3","2","30047","66.67"
"Lewis and Clark","0","15","Montana","4/7/20","12","3","30049","25"
"Liberty","0","1","Montana","4/7/20","0","1","30051","1"
"Lincoln","0","7","Montana","4/7/20","5","2","30053","40"
"Madison","0","9","Montana","4/7/20","6","3","30057","50"
"Meagher","0","1","Montana","4/7/20","1","0","30059","0"
"Missoula","1","24","Montana","4/7/20","14","10","30063","71.43"
"Musselshell","0","1","Montana","4/7/20","1","0","30065","0"
"Park","0","6","Montana","4/7/20","3","3","30067","100"
"Ravalli","0","2","Montana","4/7/20","1","1","30081","100"
"Roosevelt","0","1","Montana","4/7/20","1","0","30085","0"
"Silver Bow","0","11","Montana","4/7/20","10","1","30093","10"
"Toole","1","15","Montana","4/7/20","7","8","30101","114.29"
"Yellowstone","2","47","Montana","4/7/20","31","16","30111","51.61"
"Adams","2","15","Nebraska","4/7/20","3","12","31001","400"
"Antelope","0","1","Nebraska","4/7/20","1","0","31003","0"
"Buffalo","2","23","Nebraska","4/7/20","6","17","31019","283.33"
"Cass","0","2","Nebraska","4/7/20","2","0","31025","0"
"Cherry","0","1","Nebraska","4/7/20","0","1","31031","1"
"Cheyenne","0","1","Nebraska","4/7/20","0","1","31033","1"
"Colfax","0","3","Nebraska","4/7/20","0","3","31037","1"
"Cuming","0","2","Nebraska","4/7/20","0","2","31039","1"
"Custer","0","1","Nebraska","4/7/20","0","1","31041","1"
"Dawson","0","1","Nebraska","4/7/20","1","0","31047","0"
"Dodge","1","7","Nebraska","4/7/20","3","4","31053","133.33"
"Douglas","11","159","Nebraska","4/7/20","85","74","31055","87.06"
"Gage","3","23","Nebraska","4/7/20","0","23","31067","1"
"Gosper","0","1","Nebraska","4/7/20","1","0","31073","0"
"Hall","7","58","Nebraska","4/7/20","8","50","31079","625"
"Hamilton","1","7","Nebraska","4/7/20","0","7","31081","1"
"Kearney","0","2","Nebraska","4/7/20","1","1","31099","100"
"Kimball","1","9","Nebraska","4/7/20","0","9","31105","1"
"Knox","0","2","Nebraska","4/7/20","2","0","31107","0"
"Lancaster","4","34","Nebraska","4/7/20","8","26","31109","325"
"Lincoln","2","16","Nebraska","4/7/20","5","11","31111","220"
"Logan","0","1","Nebraska","4/7/20","0","1","31113","1"
"Madison","0","5","Nebraska","4/7/20","2","3","31119","150"
"Merrick","0","2","Nebraska","4/7/20","0","2","31121","1"
"Nemaha","0","1","Nebraska","4/7/20","1","0","31127","0"
"Otoe","0","1","Nebraska","4/7/20","0","1","31131","1"
"Phelps","0","1","Nebraska","4/7/20","0","1","31137","1"
"Platte","1","5","Nebraska","4/7/20","1","4","31141","400"
"Sarpy","2","29","Nebraska","4/7/20","16","13","31153","81.25"
"Saunders","0","4","Nebraska","4/7/20","2","2","31155","100"
"Scotts Bluff","1","6","Nebraska","4/7/20","1","5","31157","500"
"Seward","0","1","Nebraska","4/7/20","0","1","31159","1"
"Stanton","0","1","Nebraska","4/7/20","0","1","31167","1"
"Washington","0","20","Nebraska","4/7/20","19","1","31177","5.26"
"York","0","1","Nebraska","4/7/20","1","0","31185","0"
"Carson City","1","11","Nevada","4/7/20","5","6","32510","120"
"Clark","124","1734","Nevada","4/7/20","869","865","32003","99.54"
"Douglas","0","7","Nevada","4/7/20","6","1","32005","16.67"
"Elko","0","8","Nevada","4/7/20","5","3","32007","60"
"Humboldt","1","11","Nevada","4/7/20","3","8","32013","266.67"
"Lyon","0","3","Nevada","4/7/20","1","2","32019","200"
"Nye","1","7","Nevada","4/7/20","1","6","32023","600"
"Washoe","27","309","Nevada","4/7/20","121","188","32031","155.37"
"White Pine","0","1","Nevada","4/7/20","1","0","32033","0"
"Belknap","1","18","New Hampshire","4/7/20","12","6","33001","50"
"Carroll","1","19","New Hampshire","4/7/20","12","7","33003","58.33"
"Cheshire","1","13","New Hampshire","4/7/20","4","9","33005","225"
"Coos","0","1","New Hampshire","4/7/20","0","1","33007","1"
"Grafton","1","41","New Hampshire","4/7/20","34","7","33009","20.59"
"Hillsborough","25","272","New Hampshire","4/7/20","99","173","33011","174.75"
"Merrimack","4","52","New Hampshire","4/7/20","27","25","33013","92.59"
"Rockingham","16","246","New Hampshire","4/7/20","137","109","33015","79.56"
"Strafford","3","46","New Hampshire","4/7/20","28","18","33017","64.29"
"Sullivan","0","6","New Hampshire","4/7/20","4","2","33019","50"
"Atlantic","16","144","New Jersey","4/7/20","31","113","34001","364.52"
"Bergen","661","7533","New Jersey","4/7/20","2909","4624","34003","158.95"
"Burlington","76","733","New Jersey","4/7/20","202","531","34005","262.87"
"Camden","73","736","New Jersey","4/7/20","228","508","34007","222.81"
"Cape May","12","94","New Jersey","4/7/20","12","82","34009","683.33"
"Cumberland","8","71","New Jersey","4/7/20","18","53","34011","294.44"
"Essex","454","5078","New Jersey","4/7/20","1900","3178","34013","167.26"
"Gloucester","28","311","New Jersey","4/7/20","114","197","34015","172.81"
"Hudson","478","4949","New Jersey","4/7/20","1606","3343","34017","208.16"
"Hunterdon","20","234","New Jersey","4/7/20","97","137","34019","141.24"
"Mercer","81","837","New Jersey","4/7/20","268","569","34021","212.31"
"Middlesex","349","3717","New Jersey","4/7/20","1277","2440","34023","191.07"
"Monmouth","233","2770","New Jersey","4/7/20","1140","1630","34025","142.98"
"Morris","200","2239","New Jersey","4/7/20","841","1398","34027","166.23"
"Ocean","231","2641","New Jersey","4/7/20","1022","1619","34029","158.41"
"Passaic","401","4104","New Jersey","4/7/20","1294","2810","34031","217.16"
"Salem","3","31","New Jersey","4/7/20","12","19","34033","158.33"
"Somerset","89","1033","New Jersey","4/7/20","413","620","34035","150.12"
"Sussex","28","331","New Jersey","4/7/20","132","199","34037","150.76"
"Union","421","4368","New Jersey","4/7/20","1418","2950","34039","208.04"
"Warren","26","255","New Jersey","4/7/20","76","179","34041","235.53"
"Bernalillo","25","307","New Mexico","4/7/20","129","178","35001","137.98"
"Catron","0","1","New Mexico","4/7/20","0","1","35003","1"
"Chaves","1","15","New Mexico","4/7/20","10","5","35005","50"
"Cibola","2","15","New Mexico","4/7/20","2","13","35006","650"
"Curry","1","8","New Mexico","4/7/20","3","5","35009","166.67"
"Dona Ana","2","35","New Mexico","4/7/20","18","17","35013","94.44"
"Eddy","0","4","New Mexico","4/7/20","4","0","35015","0"
"Grant","1","4","New Mexico","4/7/20","0","4","35017","1"
"Lea","0","2","New Mexico","4/7/20","2","0","35025","0"
"Lincoln","0","1","New Mexico","4/7/20","0","1","35027","1"
"Los Alamos","0","2","New Mexico","4/7/20","0","2","35028","1"
"McKinley","6","55","New Mexico","4/7/20","16","39","35031","243.75"
"Otero","0","3","New Mexico","4/7/20","0","3","35035","1"
"Rio Arriba","0","6","New Mexico","4/7/20","4","2","35039","50"
"Roosevelt","0","1","New Mexico","4/7/20","1","0","35041","0"
"San Juan","11","107","New Mexico","4/7/20","32","75","35045","234.38"
"San Miguel","0","1","New Mexico","4/7/20","1","0","35047","0"
"Sandoval","14","128","New Mexico","4/7/20","29","99","35043","341.38"
"Santa Fe","3","66","New Mexico","4/7/20","42","24","35049","57.14"
"Socorro","0","5","New Mexico","4/7/20","3","2","35053","66.67"
"Taos","0","14","New Mexico","4/7/20","11","3","35055","27.27"
"Torrance","1","7","New Mexico","4/7/20","3","4","35057","133.33"
"Valencia","0","7","New Mexico","4/7/20","5","2","35061","40"
"Albany","15","333","New York","4/7/20","226","107","36001","47.35"
"Allegany","1","17","New York","4/7/20","9","8","36003","88.89"
"Broome","7","86","New York","4/7/20","38","48","36007","126.32"
"Cattaraugus","1","13","New York","4/7/20","6","7","36009","116.67"
"Cayuga","1","14","New York","4/7/20","4","10","36011","250"
"Chautauqua","2","18","New York","4/7/20","7","11","36013","157.14"
"Chemung","4","49","New York","4/7/20","20","29","36015","145"
"Chenango","5","51","New York","4/7/20","19","32","36017","168.42"
"Clinton","2","37","New York","4/7/20","21","16","36019","76.19"
"Columbia","5","72","New York","4/7/20","36","36","36021","100"
"Cortland","1","16","New York","4/7/20","10","6","36023","60"
"Delaware","3","36","New York","4/7/20","16","20","36025","125"
"Dutchess","109","1249","New York","4/7/20","484","765","36027","158.06"
"Erie","105","1234","New York","4/7/20","499","735","36029","147.29"
"Essex","1","9","New York","4/7/20","5","4","36031","80"
"Franklin","1","10","New York","4/7/20","6","4","36033","66.67"
"Fulton","2","13","New York","4/7/20","1","12","36035","1200"
"Genesee","3","33","New York","4/7/20","11","22","36037","200"
"Greene","2","24","New York","4/7/20","10","14","36039","140"
"Hamilton","0","2","New York","4/7/20","2","0","36041","0"
"Herkimer","2","27","New York","4/7/20","12","15","36043","125"
"Jefferson","4","39","New York","4/7/20","11","28","36045","254.55"
"Lewis","1","6","New York","4/7/20","2","4","36049","200"
"Livingston","1","24","New York","4/7/20","15","9","36051","60"
"Madison","6","92","New York","4/7/20","49","43","36053","87.76"
"Monroe","48","596","New York","4/7/20","257","339","36055","131.91"
"Montgomery","2","18","New York","4/7/20","6","12","36057","200"
"Nassau","1152","16610","New York","4/7/20","8544","8066","36059","94.41"
"New York","4822","76876","New York","4/7/20","43119","33757","36061","78.29"
"Niagara","12","126","New York","4/7/20","41","85","36063","207.32"
"Oneida","12","118","New York","4/7/20","34","84","36065","247.06"
"Onondaga","21","397","New York","4/7/20","249","148","36067","59.44"
"Ontario","2","33","New York","4/7/20","20","13","36069","65"
"Orange","325","3829","New York","4/7/20","1556","2273","36071","146.08"
"Orleans","1","15","New York","4/7/20","5","10","36073","200"
"Oswego","3","34","New York","4/7/20","15","19","36075","126.67"
"Otsego","2","34","New York","4/7/20","17","17","36077","100"
"Putnam","34","402","New York","4/7/20","167","235","36079","140.72"
"Rensselaer","5","88","New York","4/7/20","54","34","36083","62.96"
"Rockland","447","5990","New York","4/7/20","2863","3127","36087","109.22"
"Saratoga","7","155","New York","4/7/20","108","47","36091","43.52"
"Schenectady","9","145","New York","4/7/20","85","60","36093","70.59"
"Schoharie","1","12","New York","4/7/20","6","6","36095","100"
"Schuyler","0","4","New York","4/7/20","2","2","36097","100"
"Seneca","1","10","New York","4/7/20","0","10","36099","1"
"St. Lawrence","5","61","New York","4/7/20","23","38","36089","165.22"
"Steuben","8","75","New York","4/7/20","19","56","36101","294.74"
"Suffolk","1264","15561","New York","4/7/20","6713","8848","36103","131.8"
"Sullivan","23","270","New York","4/7/20","106","164","36105","154.72"
"Tioga","0","8","New York","4/7/20","8","0","36107","0"
"Tompkins","4","103","New York","4/7/20","73","30","36109","41.1"
"Ulster","27","398","New York","4/7/20","207","191","36111","92.27"
"Warren","2","31","New York","4/7/20","18","13","36113","72.22"
"Washington","1","19","New York","4/7/20","9","10","36115","111.11"
"Wayne","3","35","New York","4/7/20","15","20","36117","133.33"
"Westchester","618","14294","New York","4/7/20","9967","4327","36119","43.41"
"Wyoming","2","23","New York","4/7/20","8","15","36121","187.5"
"Yates","0","1","New York","4/7/20","0","1","36123","1"
"Alamance","2","24","North Carolina","4/7/20","7","17","37001","242.86"
"Alexander","0","2","North Carolina","4/7/20","2","0","37003","0"
"Alleghany","0","2","North Carolina","4/7/20","2","0","37005","0"
"Anson","1","5","North Carolina","4/7/20","1","4","37007","400"
"Ashe","0","2","North Carolina","4/7/20","0","2","37009","1"
"Beaufort","1","10","North Carolina","4/7/20","5","5","37013","100"
"Bertie","0","9","North Carolina","4/7/20","6","3","37015","50"
"Bladen","0","1","North Carolina","4/7/20","0","1","37017","1"
"Brunswick","1","26","North Carolina","4/7/20","16","10","37019","62.5"
"Buncombe","2","33","North Carolina","4/7/20","22","11","37021","50"
"Burke","5","39","North Carolina","4/7/20","6","33","37023","550"
"Cabarrus","5","81","North Carolina","4/7/20","47","34","37025","72.34"
"Caldwell","1","11","North Carolina","4/7/20","3","8","37027","266.67"
"Carteret","2","25","North Carolina","4/7/20","12","13","37031","108.33"
"Caswell","0","2","North Carolina","4/7/20","1","1","37033","100"
"Catawba","2","27","North Carolina","4/7/20","14","13","37035","92.86"
"Chatham","1","21","North Carolina","4/7/20","16","5","37037","31.25"
"Cherokee","1","12","North Carolina","4/7/20","7","5","37039","71.43"
"Chowan","0","1","North Carolina","4/7/20","0","1","37041","1"
"Clay","0","3","North Carolina","4/7/20","1","2","37043","200"
"Cleveland","2","23","North Carolina","4/7/20","6","17","37045","283.33"
"Columbus","1","13","North Carolina","4/7/20","4","9","37047","225"
"Craven","2","18","North Carolina","4/7/20","6","12","37049","200"
"Cumberland","6","62","North Carolina","4/7/20","18","44","37051","244.44"
"Currituck","0","3","North Carolina","4/7/20","1","2","37053","200"
"Dare","1","6","North Carolina","4/7/20","2","4","37055","200"
"Davidson","7","70","North Carolina","4/7/20","22","48","37057","218.18"
"Davie","1","20","North Carolina","4/7/20","11","9","37059","81.82"
"Duplin","1","7","North Carolina","4/7/20","1","6","37061","600"
"Durham","14","219","North Carolina","4/7/20","122","97","37063","79.51"
"Edgecombe","1","11","North Carolina","4/7/20","3","8","37065","266.67"
"Forsyth","9","106","North Carolina","4/7/20","42","64","37067","152.38"
"Franklin","1","17","North Carolina","4/7/20","11","6","37069","54.55"
"Gaston","4","58","North Carolina","4/7/20","27","31","37071","114.81"
"Gates","0","2","North Carolina","4/7/20","0","2","37073","1"
"Granville","10","76","North Carolina","4/7/20","9","67","37077","744.44"
"Greene","1","10","North Carolina","4/7/20","3","7","37079","233.33"
"Guilford","10","119","North Carolina","4/7/20","50","69","37081","138"
"Halifax","1","13","North Carolina","4/7/20","6","7","37083","116.67"
"Harnett","2","32","North Carolina","4/7/20","18","14","37085","77.78"
"Haywood","0","3","North Carolina","4/7/20","0","3","37087","1"
"Henderson","5","51","North Carolina","4/7/20","18","33","37089","183.33"
"Hertford","0","5","North Carolina","4/7/20","4","1","37091","25"
"Hoke","1","12","North Carolina","4/7/20","4","8","37093","200"
"Iredell","4","54","North Carolina","4/7/20","25","29","37097","116"
"Jackson","0","2","North Carolina","4/7/20","1","1","37099","100"
"Johnston","5","47","North Carolina","4/7/20","14","33","37101","235.71"
"Jones","0","2","North Carolina","4/7/20","0","2","37103","1"
"Lee","0","4","North Carolina","4/7/20","3","1","37105","33.33"
"Lenoir","1","10","North Carolina","4/7/20","3","7","37107","233.33"
"Lincoln","1","11","North Carolina","4/7/20","4","7","37109","175"
"Macon","0","1","North Carolina","4/7/20","0","1","37113","1"
"Martin","0","4","North Carolina","4/7/20","3","1","37117","33.33"
"McDowell","0","10","North Carolina","4/7/20","7","3","37111","42.86"
"Mecklenburg","56","810","North Carolina","4/7/20","420","390","37119","92.86"
"Mitchell","0","3","North Carolina","4/7/20","1","2","37121","200"
"Montgomery","1","11","North Carolina","4/7/20","5","6","37123","120"
"Moore","2","20","North Carolina","4/7/20","8","12","37125","150"
"Nash","2","24","North Carolina","4/7/20","9","15","37127","166.67"
"New Hanover","2","51","North Carolina","4/7/20","34","17","37129","50"
"Northampton","3","53","North Carolina","4/7/20","30","23","37131","76.67"
"Onslow","2","23","North Carolina","4/7/20","7","16","37133","228.57"
"Orange","6","73","North Carolina","4/7/20","34","39","37135","114.71"
"Pamlico","0","3","North Carolina","4/7/20","1","2","37137","200"
"Pasquotank","1","9","North Carolina","4/7/20","4","5","37139","125"
"Pender","0","2","North Carolina","4/7/20","0","2","37141","1"
"Perquimans","0","2","North Carolina","4/7/20","1","1","37143","100"
"Person","1","7","North Carolina","4/7/20","2","5","37145","250"
"Pitt","2","44","North Carolina","4/7/20","27","17","37147","62.96"
"Polk","1","8","North Carolina","4/7/20","3","5","37149","166.67"
"Randolph","3","35","North Carolina","4/7/20","17","18","37151","105.88"
"Richmond","0","1","North Carolina","4/7/20","0","1","37153","1"
"Robeson","0","6","North Carolina","4/7/20","3","3","37155","100"
"Rockingham","1","8","North Carolina","4/7/20","2","6","37157","300"
"Rowan","6","62","North Carolina","4/7/20","23","39","37159","169.57"
"Rutherford","2","21","North Carolina","4/7/20","5","16","37161","320"
"Sampson","1","5","North Carolina","4/7/20","1","4","37163","400"
"Scotland","0","3","North Carolina","4/7/20","2","1","37165","50"
"Stanly","0","8","North Carolina","4/7/20","5","3","37167","60"
"Stokes","1","8","North Carolina","4/7/20","0","8","37169","1"
"Surry","1","10","North Carolina","4/7/20","2","8","37171","400"
"Swain","0","1","North Carolina","4/7/20","0","1","37173","1"
"Transylvania","0","6","North Carolina","4/7/20","5","1","37175","20"
"Union","6","83","North Carolina","4/7/20","41","42","37179","102.44"
"Vance","1","12","North Carolina","4/7/20","4","8","37181","200"
"Wake","23","351","North Carolina","4/7/20","193","158","37183","81.87"
"Warren","0","3","North Carolina","4/7/20","0","3","37185","1"
"Washington","1","7","North Carolina","4/7/20","2","5","37187","250"
"Watauga","0","8","North Carolina","4/7/20","5","3","37189","60"
"Wayne","4","32","North Carolina","4/7/20","5","27","37191","540"
"Wilkes","0","4","North Carolina","4/7/20","2","2","37193","100"
"Wilson","3","36","North Carolina","4/7/20","13","23","37195","176.92"
"Yadkin","1","9","North Carolina","4/7/20","3","6","37197","200"
"Barnes","0","2","North Dakota","4/7/20","2","0","38003","0"
"Bowman","0","1","North Dakota","4/7/20","0","1","38011","1"
"Burke","0","2","North Dakota","4/7/20","0","2","38013","1"
"Burleigh","1","39","North Dakota","4/7/20","29","10","38015","34.48"
"Cass","5","70","North Dakota","4/7/20","32","38","38017","118.75"
"Divide","0","1","North Dakota","4/7/20","1","0","38023","0"
"Dunn","0","1","North Dakota","4/7/20","1","0","38025","0"
"Eddy","0","1","North Dakota","4/7/20","0","1","38027","1"
"Emmons","0","1","North Dakota","4/7/20","0","1","38029","1"
"Foster","0","1","North Dakota","4/7/20","1","0","38031","0"
"Grand Forks","1","11","North Dakota","4/7/20","2","9","38035","450"
"Grant","0","1","North Dakota","4/7/20","1","0","38037","0"
"McHenry","0","1","North Dakota","4/7/20","1","0","38049","0"
"McIntosh","0","1","North Dakota","4/7/20","1","0","38051","0"
"McKenzie","1","5","North Dakota","4/7/20","0","5","38053","1"
"McLean","0","2","North Dakota","4/7/20","2","0","38055","0"
"Morton","1","18","North Dakota","4/7/20","14","4","38059","28.57"
"Mountrail","2","20","North Dakota","4/7/20","5","15","38061","300"
"Oliver","0","1","North Dakota","4/7/20","1","0","38065","0"
"Pierce","0","2","North Dakota","4/7/20","2","0","38069","0"
"Ramsey","0","3","North Dakota","4/7/20","3","0","38071","0"
"Sioux","0","1","North Dakota","4/7/20","1","0","38085","0"
"Slope","0","3","North Dakota","4/7/20","0","3","38087","1"
"Stark","2","25","North Dakota","4/7/20","11","14","38089","127.27"
"Walsh","0","3","North Dakota","4/7/20","1","2","38099","200"
"Ward","1","16","North Dakota","4/7/20","9","7","38101","77.78"
"Williams","0","5","North Dakota","4/7/20","2","3","38105","150"
"","1","8","Northern Mariana Islands","4/7/20","2","6",,"300"
"Adams","0","2","Ohio","4/7/20","0","2","39001","1"
"Allen","2","22","Ohio","4/7/20","5","17","39003","340"
"Ashland","0","3","Ohio","4/7/20","2","1","39005","50"
"Ashtabula","2","18","Ohio","4/7/20","6","12","39007","200"
"Athens","0","3","Ohio","4/7/20","3","0","39009","0"
"Auglaize","1","8","Ohio","4/7/20","2","6","39011","300"
"Belmont","2","25","Ohio","4/7/20","9","16","39013","177.78"
"Brown","0","4","Ohio","4/7/20","2","2","39015","100"
"Butler","8","92","Ohio","4/7/20","36","56","39017","155.56"
"Carroll","1","9","Ohio","4/7/20","5","4","39019","80"
"Champaign","0","5","Ohio","4/7/20","3","2","39021","66.67"
"Clark","1","11","Ohio","4/7/20","6","5","39023","83.33"
"Clermont","2","22","Ohio","4/7/20","10","12","39025","120"
"Clinton","1","9","Ohio","4/7/20","3","6","39027","200"
"Columbiana","6","59","Ohio","4/7/20","15","44","39029","293.33"
"Coshocton","1","10","Ohio","4/7/20","5","5","39031","100"
"Crawford","1","9","Ohio","4/7/20","5","4","39033","80"
"Cuyahoga","55","911","Ohio","4/7/20","527","384","39035","72.87"
"Darke","3","34","Ohio","4/7/20","13","21","39037","161.54"
"Defiance","1","9","Ohio","4/7/20","5","4","39039","80"
"Delaware","5","77","Ohio","4/7/20","42","35","39041","83.33"
"Erie","1","10","Ohio","4/7/20","5","5","39043","100"
"Fairfield","6","59","Ohio","4/7/20","14","45","39045","321.43"
"Fayette","0","2","Ohio","4/7/20","1","1","39047","100"
"Franklin","54","703","Ohio","4/7/20","325","378","39049","116.31"
"Fulton","0","5","Ohio","4/7/20","2","3","39051","150"
"Gallia","0","4","Ohio","4/7/20","1","3","39053","300"
"Geauga","2","41","Ohio","4/7/20","24","17","39055","70.83"
"Greene","2","20","Ohio","4/7/20","6","14","39057","233.33"
"Guernsey","0","1","Ohio","4/7/20","0","1","39059","1"
"Hamilton","41","411","Ohio","4/7/20","124","287","39061","231.45"
"Hancock","1","15","Ohio","4/7/20","5","10","39063","200"
"Hardin","0","2","Ohio","4/7/20","0","2","39065","1"
"Highland","1","6","Ohio","4/7/20","1","5","39071","500"
"Holmes","0","2","Ohio","4/7/20","1","1","39075","100"
"Huron","1","10","Ohio","4/7/20","4","6","39077","150"
"Jefferson","1","15","Ohio","4/7/20","11","4","39081","36.36"
"Knox","0","7","Ohio","4/7/20","4","3","39083","75"
"Lake","7","92","Ohio","4/7/20","44","48","39085","109.09"
"Lawrence","1","9","Ohio","4/7/20","1","8","39087","800"
"Licking","5","61","Ohio","4/7/20","25","36","39089","144"
"Logan","0","5","Ohio","4/7/20","3","2","39091","66.67"
"Lorain","5","116","Ohio","4/7/20","82","34","39093","41.46"
"Lucas","31","347","Ohio","4/7/20","133","214","39095","160.9"
"Madison","2","18","Ohio","4/7/20","7","11","39097","157.14"
"Mahoning","21","300","Ohio","4/7/20","153","147","39099","96.08"
"Marion","3","28","Ohio","4/7/20","8","20","39101","250"
"Medina","5","88","Ohio","4/7/20","55","33","39103","60"
"Meigs","0","1","Ohio","4/7/20","0","1","39105","1"
"Mercer","1","8","Ohio","4/7/20","2","6","39107","300"
"Miami","7","101","Ohio","4/7/20","52","49","39109","94.23"
"Monroe","0","2","Ohio","4/7/20","0","2","39111","1"
"Montgomery","14","132","Ohio","4/7/20","37","95","39113","256.76"
"Morgan","0","1","Ohio","4/7/20","0","1","39115","1"
"Morrow","1","6","Ohio","4/7/20","0","6","39117","1"
"Muskingum","1","6","Ohio","4/7/20","2","4","39119","200"
"Ottawa","0","5","Ohio","4/7/20","2","3","39123","150"
"Paulding","0","1","Ohio","4/7/20","0","1","39125","1"
"Perry","0","4","Ohio","4/7/20","1","3","39127","300"
"Pickaway","3","31","Ohio","4/7/20","12","19","39129","158.33"
"Pike","0","1","Ohio","4/7/20","1","0","39131","0"
"Portage","9","101","Ohio","4/7/20","38","63","39133","165.79"
"Preble","1","7","Ohio","4/7/20","1","6","39135","600"
"Richland","2","20","Ohio","4/7/20","6","14","39139","233.33"
"Ross","1","9","Ohio","4/7/20","2","7","39141","350"
"Sandusky","0","5","Ohio","4/7/20","4","1","39143","25"
"Scioto","0","1","Ohio","4/7/20","0","1","39145","1"
"Seneca","0","6","Ohio","4/7/20","3","3","39147","100"
"Shelby","2","18","Ohio","4/7/20","5","13","39149","260"
"Stark","9","110","Ohio","4/7/20","45","65","39151","144.44"
"Summit","10","199","Ohio","4/7/20","131","68","39153","51.91"
"Trumbull","9","110","Ohio","4/7/20","50","60","39155","120"
"Tuscarawas","2","23","Ohio","4/7/20","7","16","39157","228.57"
"Union","1","8","Ohio","4/7/20","4","4","39159","100"
"Van Wert","0","2","Ohio","4/7/20","1","1","39161","100"
"Warren","3","45","Ohio","4/7/20","21","24","39165","114.29"
"Washington","3","27","Ohio","4/7/20","3","24","39167","800"
"Wayne","3","29","Ohio","4/7/20","9","20","39169","222.22"
"Williams","0","1","Ohio","4/7/20","0","1","39171","1"
"Wood","3","38","Ohio","4/7/20","15","23","39173","153.33"
"Wyandot","0","5","Ohio","4/7/20","2","3","39175","150"
"Adair","3","25","Oklahoma","4/7/20","4","21","40001","525"
"Atoka","0","1","Oklahoma","4/7/20","0","1","40005","1"
"Beaver","0","1","Oklahoma","4/7/20","0","1","40007","1"
"Beckham","0","1","Oklahoma","4/7/20","1","0","40009","0"
"Bryan","0","3","Oklahoma","4/7/20","1","2","40013","200"
"Caddo","1","6","Oklahoma","4/7/20","1","5","40015","500"
"Canadian","3","40","Oklahoma","4/7/20","19","21","40017","110.53"
"Carter","0","1","Oklahoma","4/7/20","1","0","40019","0"
"Cherokee","2","16","Oklahoma","4/7/20","4","12","40021","300"
"Choctaw","0","2","Oklahoma","4/7/20","1","1","40023","100"
"Cleveland","20","203","Oklahoma","4/7/20","65","138","40027","212.31"
"Comanche","4","42","Oklahoma","4/7/20","15","27","40031","180"
"Cotton","0","4","Oklahoma","4/7/20","1","3","40033","300"
"Craig","0","4","Oklahoma","4/7/20","1","3","40035","300"
"Creek","4","47","Oklahoma","4/7/20","21","26","40037","123.81"
"Custer","0","5","Oklahoma","4/7/20","4","1","40039","25"
"Delaware","1","13","Oklahoma","4/7/20","7","6","40041","85.71"
"Dewey","0","1","Oklahoma","4/7/20","0","1","40043","1"
"Garfield","0","5","Oklahoma","4/7/20","2","3","40047","150"
"Garvin","1","12","Oklahoma","4/7/20","6","6","40049","100"
"Grady","1","9","Oklahoma","4/7/20","2","7","40051","350"
"Grant","0","1","Oklahoma","4/7/20","0","1","40053","1"
"Greer","4","31","Oklahoma","4/7/20","0","31","40055","1"
"Jackson","1","6","Oklahoma","4/7/20","1","5","40065","500"
"Jefferson","0","1","Oklahoma","4/7/20","0","1","40067","1"
"Kay","1","33","Oklahoma","4/7/20","24","9","40071","37.5"
"Kingfisher","0","3","Oklahoma","4/7/20","0","3","40073","1"
"Kiowa","0","1","Oklahoma","4/7/20","0","1","40075","1"
"Latimer","0","4","Oklahoma","4/7/20","1","3","40077","300"
"Le Flore","0","1","Oklahoma","4/7/20","1","0","40079","0"
"Lincoln","1","10","Oklahoma","4/7/20","5","5","40081","100"
"Logan","0","6","Oklahoma","4/7/20","4","2","40083","50"
"Love","0","2","Oklahoma","4/7/20","1","1","40085","100"
"Major","0","1","Oklahoma","4/7/20","0","1","40093","1"
"Marshall","0","1","Oklahoma","4/7/20","0","1","40095","1"
"Mayes","1","12","Oklahoma","4/7/20","4","8","40097","200"
"McClain","2","16","Oklahoma","4/7/20","3","13","40087","433.33"
"McCurtain","0","2","Oklahoma","4/7/20","0","2","40089","1"
"McIntosh","0","2","Oklahoma","4/7/20","0","2","40091","1"
"Muskogee","2","21","Oklahoma","4/7/20","8","13","40101","162.5"
"Noble","0","6","Oklahoma","4/7/20","4","2","40103","50"
"Nowata","1","10","Oklahoma","4/7/20","5","5","40105","100"
"Oklahoma","21","303","Oklahoma","4/7/20","155","148","40109","95.48"
"Okmulgee","1","11","Oklahoma","4/7/20","3","8","40111","266.67"
"Osage","3","34","Oklahoma","4/7/20","16","18","40113","112.5"
"Ottawa","1","14","Oklahoma","4/7/20","7","7","40115","100"
"Out of OK","0","2","Oklahoma","4/7/20","2","0","80040","0"
"Pawnee","1","23","Oklahoma","4/7/20","15","8","40117","53.33"
"Payne","1","24","Oklahoma","4/7/20","15","9","40119","60"
"Pittsburg","1","7","Oklahoma","4/7/20","2","5","40121","250"
"Pontotoc","1","9","Oklahoma","4/7/20","5","4","40123","80"
"Pottawatomie","2","19","Oklahoma","4/7/20","5","14","40125","280"
"Rogers","2","17","Oklahoma","4/7/20","3","14","40131","466.67"
"Seminole","0","3","Oklahoma","4/7/20","1","2","40133","200"
"Sequoyah","1","10","Oklahoma","4/7/20","2","8","40135","400"
"Stephens","1","11","Oklahoma","4/7/20","5","6","40137","120"
"Texas","0","3","Oklahoma","4/7/20","1","2","40139","200"
"Tillman","0","1","Oklahoma","4/7/20","0","1","40141","1"
"Tulsa","27","273","Oklahoma","4/7/20","83","190","40143","228.92"
"Wagoner","6","55","Oklahoma","4/7/20","10","45","40145","450"
"Washington","3","43","Oklahoma","4/7/20","21","22","40147","104.76"
"Woodward","0","1","Oklahoma","4/7/20","0","1","40153","1"
"Benton","1","21","Oregon","4/7/20","12","9","41003","75"
"Clackamas","6","90","Oregon","4/7/20","50","40","41005","80"
"Clatsop","0","4","Oregon","4/7/20","3","1","41007","33.33"
"Columbia","1","8","Oregon","4/7/20","1","7","41009","700"
"Crook","0","1","Oregon","4/7/20","0","1","41013","1"
"Curry","0","2","Oregon","4/7/20","0","2","41015","1"
"Deschutes","2","40","Oregon","4/7/20","24","16","41017","66.67"
"Douglas","0","12","Oregon","4/7/20","9","3","41019","33.33"
"Grant","0","1","Oregon","4/7/20","1","0","41023","0"
"Hood River","0","2","Oregon","4/7/20","3","-1","41027","-33.33"
"Jackson","3","39","Oregon","4/7/20","21","18","41029","85.71"
"Josephine","1","16","Oregon","4/7/20","10","6","41033","60"
"Klamath","2","18","Oregon","4/7/20","5","13","41035","260"
"Lane","2","29","Oregon","4/7/20","16","13","41039","81.25"
"Lincoln","0","4","Oregon","4/7/20","2","2","41041","100"
"Linn","1","44","Oregon","4/7/20","37","7","41043","18.92"
"Malheur","0","2","Oregon","4/7/20","1","1","41045","100"
"Marion","10","209","Oregon","4/7/20","141","68","41047","48.23"
"Morrow","0","2","Oregon","4/7/20","1","1","41049","100"
"Multnomah","18","243","Oregon","4/7/20","116","127","41051","109.48"
"Polk","1","26","Oregon","4/7/20","18","8","41053","44.44"
"Sherman","0","1","Oregon","4/7/20","0","1","41055","1"
"Tillamook","0","3","Oregon","4/7/20","3","0","41057","0"
"Umatilla","0","8","Oregon","4/7/20","5","3","41059","60"
"Union","0","3","Oregon","4/7/20","1","2","41061","200"
"Wallowa","0","1","Oregon","4/7/20","1","0","41063","0"
"Wasco","0","7","Oregon","4/7/20","7","0","41065","0"
"Washington","12","271","Oregon","4/7/20","186","85","41067","45.7"
"Yamhill","1","25","Oregon","4/7/20","16","9","41071","56.25"
"Adams","3","28","Pennsylvania","4/7/20","9","19","42001","211.11"
"Allegheny","52","689","Pennsylvania","4/7/20","325","364","42003","112"
"Armstrong","2","18","Pennsylvania","4/7/20","5","13","42005","260"
"Beaver","9","116","Pennsylvania","4/7/20","52","64","42007","123.08"
"Bedford","0","4","Pennsylvania","4/7/20","2","2","42009","100"
"Berks","37","369","Pennsylvania","4/7/20","110","259","42011","235.45"
"Blair","0","6","Pennsylvania","4/7/20","4","2","42013","50"
"Bradford","1","14","Pennsylvania","4/7/20","7","7","42015","100"
"Bucks","61","713","Pennsylvania","4/7/20","288","425","42017","147.57"
"Butler","7","107","Pennsylvania","4/7/20","60","47","42019","78.33"
"Cambria","1","7","Pennsylvania","4/7/20","2","5","42021","250"
"Cameron","0","1","Pennsylvania","4/7/20","1","0","42023","0"
"Carbon","7","67","Pennsylvania","4/7/20","17","50","42025","294.12"
"Centre","4","55","Pennsylvania","4/7/20","26","29","42027","111.54"
"Chester","25","335","Pennsylvania","4/7/20","159","176","42029","110.69"
"Clarion","1","9","Pennsylvania","4/7/20","3","6","42031","200"
"Clearfield","0","7","Pennsylvania","4/7/20","4","3","42033","75"
"Clinton","0","3","Pennsylvania","4/7/20","0","3","42035","1"
"Columbia","5","42","Pennsylvania","4/7/20","7","35","42037","500"
"Crawford","1","8","Pennsylvania","4/7/20","4","4","42039","100"
"Cumberland","6","77","Pennsylvania","4/7/20","36","41","42041","113.89"
"Dauphin","16","155","Pennsylvania","4/7/20","45","110","42043","244.44"
"Delaware","80","898","Pennsylvania","4/7/20","338","560","42045","165.68"
"Elk","0","2","Pennsylvania","4/7/20","0","2","42047","1"
"Erie","2","29","Pennsylvania","4/7/20","14","15","42049","107.14"
"Fayette","3","32","Pennsylvania","4/7/20","14","18","42051","128.57"
"Forest","1","5","Pennsylvania","4/7/20","0","5","42053","1"
"Franklin","3","39","Pennsylvania","4/7/20","19","20","42055","105.26"
"Fulton","0","1","Pennsylvania","4/7/20","0","1","42057","1"
"Greene","1","15","Pennsylvania","4/7/20","9","6","42059","66.67"
"Huntingdon","1","5","Pennsylvania","4/7/20","1","4","42061","400"
"Indiana","2","21","Pennsylvania","4/7/20","6","15","42063","250"
"Jefferson","0","1","Pennsylvania","4/7/20","0","1","42065","1"
"Juniata","2","14","Pennsylvania","4/7/20","3","11","42067","366.67"
"Lackawanna","22","235","Pennsylvania","4/7/20","78","157","42069","201.28"
"Lancaster","52","490","Pennsylvania","4/7/20","123","367","42071","298.37"
"Lawrence","2","29","Pennsylvania","4/7/20","13","16","42073","123.08"
"Lebanon","17","145","Pennsylvania","4/7/20","28","117","42075","417.86"
"Lehigh","125","1146","Pennsylvania","4/7/20","272","874","42077","321.32"
"Luzerne","110","982","Pennsylvania","4/7/20","212","770","42079","363.21"
"Lycoming","1","12","Pennsylvania","4/7/20","6","6","42081","100"
"McKean","0","1","Pennsylvania","4/7/20","1","0","42083","0"
"Mercer","3","26","Pennsylvania","4/7/20","8","18","42085","225"
"Mifflin","1","6","Pennsylvania","4/7/20","2","4","42087","200"
"Monroe","53","610","Pennsylvania","4/7/20","236","374","42089","158.47"
"Montgomery","113","1359","Pennsylvania","4/7/20","570","789","42091","138.42"
"Montour","4","37","Pennsylvania","4/7/20","9","28","42093","311.11"
"Northampton","76","774","Pennsylvania","4/7/20","245","529","42095","215.92"
"Northumberland","3","22","Pennsylvania","4/7/20","1","21","42097","2100"
"Perry","1","9","Pennsylvania","4/7/20","1","8","42099","800"
"Philadelphia","422","4272","Pennsylvania","4/7/20","1315","2957","42101","224.87"
"Pike","13","136","Pennsylvania","4/7/20","48","88","42103","183.33"
"Potter","0","3","Pennsylvania","4/7/20","2","1","42105","50"
"Schuylkill","12","119","Pennsylvania","4/7/20","38","81","42107","213.16"
"Snyder","1","9","Pennsylvania","4/7/20","2","7","42109","350"
"Somerset","1","7","Pennsylvania","4/7/20","2","5","42111","250"
"Sullivan","0","1","Pennsylvania","4/7/20","0","1","42113","1"
"Susquehanna","1","11","Pennsylvania","4/7/20","1","10","42115","1000"
"Tioga","1","10","Pennsylvania","4/7/20","2","8","42117","400"
"Union","0","7","Pennsylvania","4/7/20","4","3","42119","75"
"Venango","0","5","Pennsylvania","4/7/20","3","2","42121","66.67"
"Warren","0","1","Pennsylvania","4/7/20","1","0","42123","0"
"Washington","3","57","Pennsylvania","4/7/20","33","24","42125","72.73"
"Wayne","4","40","Pennsylvania","4/7/20","10","30","42127","300"
"Westmoreland","17","177","Pennsylvania","4/7/20","61","116","42129","190.16"
"Wyoming","1","5","Pennsylvania","4/7/20","0","5","42131","1"
"York","22","218","Pennsylvania","4/7/20","66","152","42133","230.3"
"","48","573","Puerto Rico","4/7/20","239","334",,"139.75"
"Bristol","2","27","Rhode Island","4/7/20","14","13","44001","92.86"
"Kent","11","105","Rhode Island","4/7/20","31","74","44003","238.71"
"Newport","4","52","Rhode Island","4/7/20","23","29","44005","126.09"
"Providence","59","622","Rhode Island","4/7/20","208","414","44007","199.04"
"Washington","6","70","Rhode Island","4/7/20","28","42","44009","150"
"Abbeville","0","5","South Carolina","4/7/20","4","1","45001","25"
"Aiken","2","28","South Carolina","4/7/20","13","15","45003","115.38"
"Allendale","0","2","South Carolina","4/7/20","0","2","45005","1"
"Anderson","5","75","South Carolina","4/7/20","39","36","45007","92.31"
"Bamberg","1","6","South Carolina","4/7/20","2","4","45009","200"
"Barnwell","0","3","South Carolina","4/7/20","1","2","45011","200"
"Beaufort","11","169","South Carolina","4/7/20","91","78","45013","85.71"
"Berkeley","6","55","South Carolina","4/7/20","15","40","45015","266.67"
"Calhoun","0","5","South Carolina","4/7/20","3","2","45017","66.67"
"Charleston","23","305","South Carolina","4/7/20","142","163","45019","114.79"
"Cherokee","1","4","South Carolina","4/7/20","0","4","45021","1"
"Chester","2","15","South Carolina","4/7/20","2","13","45023","650"
"Chesterfield","1","16","South Carolina","4/7/20","6","10","45025","166.67"
"Clarendon","6","68","South Carolina","4/7/20","25","43","45027","172"
"Colleton","1","10","South Carolina","4/7/20","5","5","45029","100"
"Darlington","3","29","South Carolina","4/7/20","11","18","45031","163.64"
"Dillon","0","1","South Carolina","4/7/20","1","0","45033","0"
"Dorchester","5","51","South Carolina","4/7/20","17","34","45035","200"
"Edgefield","1","6","South Carolina","4/7/20","2","4","45037","200"
"Fairfield","2","17","South Carolina","4/7/20","6","11","45039","183.33"
"Florence","4","45","South Carolina","4/7/20","19","26","45041","136.84"
"Georgetown","1","22","South Carolina","4/7/20","13","9","45043","69.23"
"Greenville","15","214","South Carolina","4/7/20","106","108","45045","101.89"
"Greenwood","1","12","South Carolina","4/7/20","5","7","45047","140"
"Hampton","1","4","South Carolina","4/7/20","0","4","45049","1"
"Horry","8","91","South Carolina","4/7/20","37","54","45051","145.95"
"Jasper","1","12","South Carolina","4/7/20","3","9","45053","300"
"Kershaw","8","159","South Carolina","4/7/20","105","54","45055","51.43"
"Lancaster","4","46","South Carolina","4/7/20","15","31","45057","206.67"
"Laurens","0","6","South Carolina","4/7/20","3","3","45059","100"
"Lee","2","19","South Carolina","4/7/20","5","14","45061","280"
"Lexington","11","130","South Carolina","4/7/20","54","76","45063","140.74"
"Marion","0","5","South Carolina","4/7/20","2","3","45067","150"
"Marlboro","1","8","South Carolina","4/7/20","2","6","45069","300"
"McCormick","0","2","South Carolina","4/7/20","0","2","45065","1"
"Newberry","1","7","South Carolina","4/7/20","2","5","45071","250"
"Oconee","1","9","South Carolina","4/7/20","5","4","45073","80"
"Orangeburg","1","30","South Carolina","4/7/20","22","8","45075","36.36"
"Pickens","1","21","South Carolina","4/7/20","14","7","45077","50"
"Richland","27","340","South Carolina","4/7/20","148","192","45079","129.73"
"Saluda","1","5","South Carolina","4/7/20","1","4","45081","400"
"Spartanburg","12","120","South Carolina","4/7/20","37","83","45083","224.32"
"Sumter","9","105","South Carolina","4/7/20","39","66","45085","169.23"
"Union","2","15","South Carolina","4/7/20","3","12","45087","400"
"Williamsburg","1","12","South Carolina","4/7/20","2","10","45089","500"
"York","7","108","South Carolina","4/7/20","56","52","45091","92.86"
"Aurora","0","1","South Dakota","4/7/20","1","0","46003","0"
"Beadle","0","21","South Dakota","4/7/20","20","1","46005","5"
"Bon Homme","0","2","South Dakota","4/7/20","1","1","46009","100"
"Brookings","1","6","South Dakota","4/7/20","1","5","46011","500"
"Brown","1","13","South Dakota","4/7/20","3","10","46013","333.33"
"Charles Mix","0","2","South Dakota","4/7/20","1","1","46023","100"
"Clark","0","1","South Dakota","4/7/20","1","0","46025","0"
"Clay","0","6","South Dakota","4/7/20","3","3","46027","100"
"Codington","1","12","South Dakota","4/7/20","5","7","46029","140"
"Davison","0","3","South Dakota","4/7/20","2","1","46035","50"
"Deuel","0","1","South Dakota","4/7/20","1","0","46039","0"
"Fall River","0","1","South Dakota","4/7/20","1","0","46047","0"
"Faulk","0","1","South Dakota","4/7/20","1","0","46049","0"
"Hamlin","0","1","South Dakota","4/7/20","1","0","46057","0"
"Hughes","0","3","South Dakota","4/7/20","1","2","46065","200"
"Hutchinson","0","2","South Dakota","4/7/20","2","0","46067","0"
"Kingsbury","0","0","South Dakota","4/7/20","1","-1","46077","-100"
"Lake","0","1","South Dakota","4/7/20","0","1","46079","1"
"Lawrence","0","9","South Dakota","4/7/20","6","3","46081","50"
"Lincoln","3","27","South Dakota","4/7/20","5","22","46083","440"
"Lyman","0","2","South Dakota","4/7/20","1","1","46085","100"
"Marshall","0","1","South Dakota","4/7/20","1","0","46091","0"
"McCook","0","2","South Dakota","4/7/20","2","0","46087","0"
"Meade","0","1","South Dakota","4/7/20","1","0","46093","0"
"Minnehaha","19","165","South Dakota","4/7/20","31","134","46099","432.26"
"Pennington","0","6","South Dakota","4/7/20","5","1","46103","20"
"Roberts","0","4","South Dakota","4/7/20","1","3","46109","300"
"Spink","0","3","South Dakota","4/7/20","0","3","46115","1"
"Todd","0","1","South Dakota","4/7/20","1","0","46121","0"
"Turner","0","4","South Dakota","4/7/20","1","3","46125","300"
"Union","0","3","South Dakota","4/7/20","1","2","46127","200"
"Yankton","1","15","South Dakota","4/7/20","6","9","46135","150"
"Anderson","0","11","Tennessee","4/7/20","10","1","47001","10"
"Bedford","1","10","Tennessee","4/7/20","2","8","47003","400"
"Benton","0","4","Tennessee","4/7/20","4","0","47005","0"
"Bledsoe","0","3","Tennessee","4/7/20","2","1","47007","50"
"Blount","2","41","Tennessee","4/7/20","25","16","47009","64"
"Bradley","2","25","Tennessee","4/7/20","10","15","47011","150"
"Campbell","0","6","Tennessee","4/7/20","4","2","47013","50"
"Cannon","1","7","Tennessee","4/7/20","3","4","47015","133.33"
"Carroll","0","8","Tennessee","4/7/20","5","3","47017","60"
"Carter","0","3","Tennessee","4/7/20","1","2","47019","200"
"Cheatham","0","13","Tennessee","4/7/20","10","3","47021","30"
"Chester","1","7","Tennessee","4/7/20","3","4","47023","133.33"
"Claiborne","0","2","Tennessee","4/7/20","2","0","47025","0"
"Clay","0","1","Tennessee","4/7/20","0","1","47027","1"
"Cocke","0","2","Tennessee","4/7/20","1","1","47029","100"
"Coffee","1","7","Tennessee","4/7/20","1","6","47031","600"
"Cumberland","3","32","Tennessee","4/7/20","11","21","47035","190.91"
"Davidson","50","888","Tennessee","4/7/20","541","347","47037","64.14"
"DeKalb","0","7","Tennessee","4/7/20","4","3","47041","75"
"Dickson","1","27","Tennessee","4/7/20","17","10","47043","58.82"
"Dyer","1","10","Tennessee","4/7/20","3","7","47045","233.33"
"Fayette","1","21","Tennessee","4/7/20","12","9","47047","75"
"Fentress","0","2","Tennessee","4/7/20","1","1","47049","100"
"Franklin","1","14","Tennessee","4/7/20","5","9","47051","180"
"Gibson","1","13","Tennessee","4/7/20","6","7","47053","116.67"
"Giles","0","3","Tennessee","4/7/20","3","0","47055","0"
"Grainger","0","3","Tennessee","4/7/20","0","3","47057","1"
"Greene","1","18","Tennessee","4/7/20","12","6","47059","50"
"Grundy","2","16","Tennessee","4/7/20","4","12","47061","300"
"Hamblen","0","4","Tennessee","4/7/20","2","2","47063","100"
"Hamilton","6","95","Tennessee","4/7/20","50","45","47065","90"
"Hardeman","1","6","Tennessee","4/7/20","1","5","47069","500"
"Hardin","0","2","Tennessee","4/7/20","1","1","47071","100"
"Hawkins","2","16","Tennessee","4/7/20","4","12","47073","300"
"Haywood","1","6","Tennessee","4/7/20","2","4","47075","200"
"Henderson","0","2","Tennessee","4/7/20","0","2","47077","1"
"Henry","1","6","Tennessee","4/7/20","1","5","47079","500"
"Hickman","0","2","Tennessee","4/7/20","0","2","47081","1"
"Houston","0","2","Tennessee","4/7/20","1","1","47083","100"
"Humphreys","0","4","Tennessee","4/7/20","2","2","47085","100"
"Jackson","0","3","Tennessee","4/7/20","0","3","47087","1"
"Jefferson","1","10","Tennessee","4/7/20","6","4","47089","66.67"
"Johnson","0","2","Tennessee","4/7/20","2","0","47091","0"
"Knox","11","143","Tennessee","4/7/20","66","77","47093","116.67"
"Lauderdale","1","5","Tennessee","4/7/20","0","5","47097","1"
"Lawrence","1","6","Tennessee","4/7/20","2","4","47099","200"
"Lewis","0","2","Tennessee","4/7/20","2","0","47101","0"
"Lincoln","1","6","Tennessee","4/7/20","1","5","47103","500"
"Loudon","1","15","Tennessee","4/7/20","8","7","47105","87.5"
"Macon","1","12","Tennessee","4/7/20","4","8","47111","200"
"Madison","5","43","Tennessee","4/7/20","5","38","47113","760"
"Marion","2","21","Tennessee","4/7/20","5","16","47115","320"
"Marshall","1","9","Tennessee","4/7/20","1","8","47117","800"
"Maury","2","26","Tennessee","4/7/20","15","11","47119","73.33"
"McMinn","0","3","Tennessee","4/7/20","3","0","47107","0"
"McNairy","1","5","Tennessee","4/7/20","1","4","47109","400"
"Meigs","0","2","Tennessee","4/7/20","1","1","47121","100"
"Monroe","0","6","Tennessee","4/7/20","5","1","47123","20"
"Montgomery","7","65","Tennessee","4/7/20","19","46","47125","242.11"
"Morgan","1","5","Tennessee","4/7/20","1","4","47129","400"
"Obion","0","3","Tennessee","4/7/20","1","2","47131","200"
"Out of TN","14","290","Tennessee","4/7/20","190","100","80047","52.63"
"Overton","0","4","Tennessee","4/7/20","2","2","47133","100"
"Perry","0","3","Tennessee","4/7/20","2","1","47135","50"
"Polk","0","3","Tennessee","4/7/20","0","3","47139","1"
"Putnam","5","57","Tennessee","4/7/20","24","33","47141","137.5"
"Rhea","0","0","Tennessee","4/7/20","1","-1","47143","-100"
"Roane","0","5","Tennessee","4/7/20","2","3","47145","150"
"Robertson","5","65","Tennessee","4/7/20","28","37","47147","132.14"
"Rutherford","16","178","Tennessee","4/7/20","68","110","47149","161.76"
"Scott","0","4","Tennessee","4/7/20","2","2","47151","100"
"Sequatchie","0","2","Tennessee","4/7/20","1","1","47153","100"
"Sevier","1","18","Tennessee","4/7/20","8","10","47155","125"
"Shelby","58","835","Tennessee","4/7/20","428","407","47157","95.09"
"Smith","0","3","Tennessee","4/7/20","2","1","47159","50"
"Stewart","0","2","Tennessee","4/7/20","0","2","47161","1"
"Sullivan","2","26","Tennessee","4/7/20","13","13","47163","100"
"Sumner","25","361","Tennessee","4/7/20","184","177","47165","96.2"
"Tipton","2","38","Tennessee","4/7/20","21","17","47167","80.95"
"Trousdale","1","14","Tennessee","4/7/20","4","10","47169","250"
"Unicoi","0","1","Tennessee","4/7/20","1","0","47171","0"
"Union","0","1","Tennessee","4/7/20","1","0","47173","0"
"Warren","0","2","Tennessee","4/7/20","1","1","47177","100"
"Washington","2","27","Tennessee","4/7/20","14","13","47179","92.86"
"Wayne","0","2","Tennessee","4/7/20","1","1","47181","100"
"Weakley","1","5","Tennessee","4/7/20","1","4","47183","400"
"White","0","2","Tennessee","4/7/20","1","1","47185","100"
"Williamson","21","278","Tennessee","4/7/20","131","147","47187","112.21"
"Wilson","11","113","Tennessee","4/7/20","39","74","47189","189.74"
"Anderson","0","2","Texas","4/7/20","1","1","48001","100"
"Andrews","1","10","Texas","4/7/20","0","10","48003","1"
"Angelina","1","14","Texas","4/7/20","5","9","48005","180"
"Aransas","0","2","Texas","4/7/20","0","2","48007","1"
"Atascosa","0","4","Texas","4/7/20","2","2","48013","100"
"Austin","1","6","Texas","4/7/20","2","4","48015","200"
"Bastrop","1","15","Texas","4/7/20","6","9","48021","150"
"Bell","4","71","Texas","4/7/20","44","27","48027","61.36"
"Bexar","41","456","Texas","4/7/20","168","288","48029","171.43"
"Blanco","0","4","Texas","4/7/20","1","3","48031","300"
"Bowie","1","17","Texas","4/7/20","9","8","48037","88.89"
"Brazoria","11","173","Texas","4/7/20","95","78","48039","82.11"
"Brazos","6","97","Texas","4/7/20","53","44","48041","83.02"
"Brown","0","6","Texas","4/7/20","3","3","48049","100"
"Burleson","1","5","Texas","4/7/20","1","4","48051","400"
"Burnet","0","5","Texas","4/7/20","3","2","48053","66.67"
"Caldwell","1","5","Texas","4/7/20","1","4","48055","400"
"Calhoun","1","12","Texas","4/7/20","7","5","48057","71.43"
"Callahan","0","1","Texas","4/7/20","0","1","48059","1"
"Cameron","11","101","Texas","4/7/20","26","75","48061","288.46"
"Camp","0","2","Texas","4/7/20","0","2","48063","1"
"Cass","0","4","Texas","4/7/20","2","2","48067","100"
"Castro","0","11","Texas","4/7/20","8","3","48069","37.5"
"Chambers","1","17","Texas","4/7/20","8","9","48071","112.5"
"Cherokee","1","6","Texas","4/7/20","2","4","48073","200"
"Clay","0","1","Texas","4/7/20","0","1","48077","1"
"Collin","21","306","Texas","4/7/20","160","146","48085","91.25"
"Colorado","0","3","Texas","4/7/20","2","1","48089","50"
"Comal","2","27","Texas","4/7/20","11","16","48091","145.45"
"Comanche","0","3","Texas","4/7/20","2","1","48093","50"
"Coryell","1","11","Texas","4/7/20","1","10","48099","1000"
"Crane","0","2","Texas","4/7/20","2","0","48103","0"
"Crosby","0","1","Texas","4/7/20","0","1","48107","1"
"Dallam","0","1","Texas","4/7/20","0","1","48111","1"
"Dallas","90","1261","Texas","4/7/20","631","630","48113","99.84"
"Dawson","1","7","Texas","4/7/20","3","4","48115","133.33"
"Deaf Smith","1","7","Texas","4/7/20","2","5","48117","250"
"Denton","23","366","Texas","4/7/20","206","160","48121","77.67"
"DeWitt","0","7","Texas","4/7/20","6","1","48123","16.67"
"Donley","1","7","Texas","4/7/20","1","6","48129","600"
"Eastland","0","3","Texas","4/7/20","4","-1","48133","-25"
"Ector","3","30","Texas","4/7/20","10","20","48135","200"
"El Paso","11","132","Texas","4/7/20","53","79","48141","149.06"
"Ellis","2","35","Texas","4/7/20","20","15","48139","75"
"Erath","1","11","Texas","4/7/20","5","6","48143","120"
"Falls","0","1","Texas","4/7/20","1","0","48145","0"
"Fannin","0","2","Texas","4/7/20","1","1","48147","100"
"Fayette","1","9","Texas","4/7/20","2","7","48149","350"
"Floyd","0","1","Texas","4/7/20","0","1","48153","1"
"Fort Bend","22","318","Texas","4/7/20","163","155","48157","95.09"
"Franklin","0","1","Texas","4/7/20","1","0","48159","0"
"Gaines","0","1","Texas","4/7/20","1","0","48165","0"
"Galveston","23","256","Texas","4/7/20","92","164","48167","178.26"
"Gillespie","0","1","Texas","4/7/20","1","0","48171","0"
"Goliad","0","3","Texas","4/7/20","0","3","48175","1"
"Gonzales","0","1","Texas","4/7/20","0","1","48177","1"
"Gray","1","9","Texas","4/7/20","0","9","48179","1"
"Grayson","1","14","Texas","4/7/20","7","7","48181","100"
"Gregg","3","23","Texas","4/7/20","5","18","48183","360"
"Grimes","0","4","Texas","4/7/20","3","1","48185","33.33"
"Guadalupe","3","39","Texas","4/7/20","15","24","48187","160"
"Hale","1","7","Texas","4/7/20","1","6","48189","600"
"Hamilton","0","1","Texas","4/7/20","0","1","48193","1"
"Hansford","0","1","Texas","4/7/20","0","1","48195","1"
"Hardin","2","28","Texas","4/7/20","12","16","48199","133.33"
"Harris","209","2146","Texas","4/7/20","680","1466","48201","215.59"
"Harrison","1","11","Texas","4/7/20","1","10","48203","1000"
"Hays","3","61","Texas","4/7/20","38","23","48209","60.53"
"Hemphill","0","1","Texas","4/7/20","0","1","48211","1"
"Henderson","1","6","Texas","4/7/20","1","5","48213","500"
"Hidalgo","11","113","Texas","4/7/20","38","75","48215","197.37"
"Hill","1","5","Texas","4/7/20","1","4","48217","400"
"Hockley","0","10","Texas","4/7/20","7","3","48219","42.86"
"Hood","1","10","Texas","4/7/20","6","4","48221","66.67"
"Hopkins","0","4","Texas","4/7/20","2","2","48223","100"
"Hunt","0","1","Texas","4/7/20","4","-3","48231","-75"
"Hutchinson","0","2","Texas","4/7/20","0","2","48233","1"
"Jackson","0","4","Texas","4/7/20","1","3","48239","300"
"Jasper","0","3","Texas","4/7/20","1","2","48241","200"
"Jefferson","9","78","Texas","4/7/20","18","60","48245","333.33"
"Jim Wells","0","2","Texas","4/7/20","0","2","48249","1"
"Johnson","2","24","Texas","4/7/20","8","16","48251","200"
"Karnes","0","2","Texas","4/7/20","2","0","48255","0"
"Kaufman","2","14","Texas","4/7/20","3","11","48257","366.67"
"Kendall","0","9","Texas","4/7/20","7","2","48259","28.57"
"Kerr","0","2","Texas","4/7/20","1","1","48265","100"
"Kleberg","0","2","Texas","4/7/20","1","1","48273","100"
"Knox","0","1","Texas","4/7/20","0","1","48275","1"
"Lamar","0","6","Texas","4/7/20","3","3","48277","100"
"Lamb","0","1","Texas","4/7/20","1","0","48279","0"
"Lampasas","0","2","Texas","4/7/20","0","2","48281","1"
"Lavaca","0","2","Texas","4/7/20","1","1","48285","100"
"Lee","0","2","Texas","4/7/20","0","2","48287","1"
"Leon","0","2","Texas","4/7/20","1","1","48289","100"
"Liberty","1","12","Texas","4/7/20","2","10","48291","500"
"Limestone","1","6","Texas","4/7/20","2","4","48293","200"
"Live Oak","0","3","Texas","4/7/20","1","2","48297","200"
"Llano","0","3","Texas","4/7/20","3","0","48299","0"
"Lubbock","15","180","Texas","4/7/20","77","103","48303","133.77"
"Lynn","0","4","Texas","4/7/20","2","2","48305","100"
"Martin","0","2","Texas","4/7/20","1","1","48317","100"
"Mason","0","1","Texas","4/7/20","0","1","48319","1"
"Matagorda","3","42","Texas","4/7/20","21","21","48321","100"
"Maverick","1","5","Texas","4/7/20","1","4","48323","400"
"McCulloch","0","1","Texas","4/7/20","0","1","48307","1"
"McLennan","2","56","Texas","4/7/20","39","17","48309","43.59"
"Medina","0","6","Texas","4/7/20","3","3","48325","100"
"Midland","2","27","Texas","4/7/20","16","11","48329","68.75"
"Milam","0","3","Texas","4/7/20","2","1","48331","50"
"Mitchell","0","1","Texas","4/7/20","0","1","48335","1"
"Montague","0","1","Texas","4/7/20","1","0","48337","0"
"Montgomery","15","197","Texas","4/7/20","93","104","48339","111.83"
"Moore","1","8","Texas","4/7/20","1","7","48341","700"
"Morris","0","1","Texas","4/7/20","1","0","48343","0"
"Nacogdoches","3","21","Texas","4/7/20","2","19","48347","950"
"Navarro","0","4","Texas","4/7/20","3","1","48349","33.33"
"Newton","0","1","Texas","4/7/20","1","0","48351","0"
"Nueces","4","65","Texas","4/7/20","34","31","48355","91.18"
"Oldham","0","3","Texas","4/7/20","2","1","48359","50"
"Orange","3","26","Texas","4/7/20","5","21","48361","420"
"Palo Pinto","0","2","Texas","4/7/20","0","2","48363","1"
"Panola","0","4","Texas","4/7/20","1","3","48365","300"
"Parker","0","6","Texas","4/7/20","4","2","48367","50"
"Pecos","0","1","Texas","4/7/20","0","1","48371","1"
"Polk","1","8","Texas","4/7/20","4","4","48373","100"
"Potter","5","41","Texas","4/7/20","8","33","48375","412.5"
"Randall","4","36","Texas","4/7/20","10","26","48381","260"
"Reeves","0","1","Texas","4/7/20","0","1","48389","1"
"Robertson","0","2","Texas","4/7/20","2","0","48395","0"
"Rockwall","1","11","Texas","4/7/20","5","6","48397","120"
"Rusk","1","13","Texas","4/7/20","3","10","48401","333.33"
"San Augustine","0","4","Texas","4/7/20","1","3","48405","300"
"San Jacinto","0","1","Texas","4/7/20","1","0","48407","0"
"San Patricio","0","2","Texas","4/7/20","2","0","48409","0"
"Shelby","2","13","Texas","4/7/20","2","11","48419","550"
"Smith","6","75","Texas","4/7/20","36","39","48423","108.33"
"Starr","1","7","Texas","4/7/20","2","5","48427","250"
"Swisher","0","2","Texas","4/7/20","1","1","48437","100"
"Tarrant","35","517","Texas","4/7/20","273","244","48439","89.38"
"Taylor","3","38","Texas","4/7/20","14","24","48441","171.43"
"Terry","0","6","Texas","4/7/20","4","2","48445","50"
"Titus","0","2","Texas","4/7/20","0","2","48449","1"
"Tom Green","2","24","Texas","4/7/20","9","15","48451","166.67"
"Travis","37","502","Texas","4/7/20","244","258","48453","105.74"
"Trinity","0","2","Texas","4/7/20","0","2","48455","1"
"Tyler","0","2","Texas","4/7/20","1","1","48457","100"
"Upshur","0","5","Texas","4/7/20","2","3","48459","150"
"Uvalde","0","5","Texas","4/7/20","2","3","48463","150"
"Val Verde","0","6","Texas","4/7/20","5","1","48465","20"
"Van Zandt","1","7","Texas","4/7/20","2","5","48467","250"
"Victoria","5","50","Texas","4/7/20","15","35","48469","233.33"
"Walker","2","15","Texas","4/7/20","3","12","48471","400"
"Waller","1","11","Texas","4/7/20","3","8","48473","266.67"
"Washington","2","21","Texas","4/7/20","9","12","48477","133.33"
"Webb","11","122","Texas","4/7/20","45","77","48479","171.11"
"Wharton","2","17","Texas","4/7/20","6","11","48481","183.33"
"Wichita","3","48","Texas","4/7/20","30","18","48485","60"
"Willacy","0","5","Texas","4/7/20","2","3","48489","150"
"Williamson","6","81","Texas","4/7/20","42","39","48491","92.86"
"Wilson","1","7","Texas","4/7/20","3","4","48493","133.33"
"Wise","0","3","Texas","4/7/20","1","2","48497","200"
"Wood","0","4","Texas","4/7/20","1","3","48499","300"
"Young","0","3","Texas","4/7/20","1","2","48503","200"
"Zapata","0","1","Texas","4/7/20","0","1","48505","1"
"Bear River","1","13","Utah","4/7/20","7","6","00000","85.71"
"Cache","2","24","Utah","4/7/20","7","17","49005","242.86"
"Carbon","0","1","Utah","4/7/20","0","1","49007","1"
"Davis","11","158","Utah","4/7/20","84","74","49011","88.1"
"Duchesne","0","1","Utah","4/7/20","0","1","49013","1"
"Emery","0","2","Utah","4/7/20","0","2","49015","1"
"Garfield","0","1","Utah","4/7/20","1","0","49017","0"
"Grand","0","1","Utah","4/7/20","1","0","49019","0"
"Iron","1","13","Utah","4/7/20","6","7","49021","116.67"
"Kane","0","2","Utah","4/7/20","0","2","49025","1"
"Out of UT","-3","0","Utah","4/7/20","22","-22","80049","-100"
"Salt Lake","59","807","Utah","4/7/20","396","411","49035","103.79"
"San Juan","0","5","Utah","4/7/20","4","1","49037","25"
"Summit","13","265","Utah","4/7/20","172","93","49043","54.07"
"Tooele","1","22","Utah","4/7/20","12","10","49045","83.33"
"Uintah","0","2","Utah","4/7/20","1","1","49047","100"
"Utah","24","236","Utah","4/7/20","70","166","49049","237.14"
"Wasatch","4","80","Utah","4/7/20","50","30","49051","60"
"Washington","2","31","Utah","4/7/20","14","17","49053","121.43"
"Weber-Morgan","5","75","Utah","4/7/20","41","34","00000","82.93"
"Addison","3","47","Vermont","4/7/20","23","24","50001","104.35"
"Bennington","1","27","Vermont","4/7/20","18","9","50003","50"
"Caledonia","1","8","Vermont","4/7/20","2","6","50005","300"
"Chittenden","22","308","Vermont","4/7/20","152","156","50007","102.63"
"Franklin","3","33","Vermont","4/7/20","13","20","50011","153.85"
"Grand Isle","0","1","Vermont","4/7/20","0","1","50013","1"
"Lamoille","1","19","Vermont","4/7/20","13","6","50015","46.15"
"Orange","0","4","Vermont","4/7/20","4","0","50017","0"
"Orleans","0","8","Vermont","4/7/20","7","1","50019","14.29"
"Rutland","4","31","Vermont","4/7/20","6","25","50021","416.67"
"Washington","1","24","Vermont","4/7/20","15","9","50023","60"
"Windham","4","38","Vermont","4/7/20","11","27","50025","245.45"
"Windsor","1","24","Vermont","4/7/20","18","6","50027","33.33"
"","2","43","Virgin Islands","4/7/20","30","13",,"43.33"
"Accomack","1","11","Virginia","4/7/20","7","4","51001","57.14"
"Albemarle","2","38","Virginia","4/7/20","21","17","51003","80.95"
"Alexandria","14","126","Virginia","4/7/20","30","96","51510","320"
"Alleghany","0","2","Virginia","4/7/20","1","1","51005","100"
"Amelia","1","7","Virginia","4/7/20","2","5","51007","250"
"Amherst","1","8","Virginia","4/7/20","3","5","51009","166.67"
"Appomattox","0","3","Virginia","4/7/20","0","3","51011","1"
"Arlington","19","237","Virginia","4/7/20","104","133","51013","127.88"
"Augusta","1","10","Virginia","4/7/20","0","10","51015","1"
"Bedford","1","8","Virginia","4/7/20","2","6","51019","300"
"Botetourt","2","18","Virginia","4/7/20","5","13","51023","260"
"Bristol","0","1","Virginia","4/7/20","1","0","51520","0"
"Brunswick","0","1","Virginia","4/7/20","1","0","51025","0"
"Buchanan","0","1","Virginia","4/7/20","0","1","51027","1"
"Buckingham","1","6","Virginia","4/7/20","2","4","51029","200"
"Buena Vista","1","4","Virginia","4/7/20","0","4","51530","1"
"Campbell","0","3","Virginia","4/7/20","1","2","51031","200"
"Caroline","1","4","Virginia","4/7/20","0","4","51033","1"
"Carroll","0","2","Virginia","4/7/20","1","1","51035","100"
"Charles City","0","4","Virginia","4/7/20","1","3","51036","300"
"Charlotte","0","1","Virginia","4/7/20","0","1","51037","1"
"Charlottesville","1","23","Virginia","4/7/20","14","9","51540","64.29"
"Chesapeake","8","80","Virginia","4/7/20","23","57","51550","247.83"
"Chesterfield","12","128","Virginia","4/7/20","43","85","51041","197.67"
"Clarke","0","2","Virginia","4/7/20","0","2","51043","1"
"Covington","0","1","Virginia","4/7/20","0","1","51580","1"
"Craig","0","2","Virginia","4/7/20","0","2","51045","1"
"Culpeper","1","9","Virginia","4/7/20","3","6","51047","200"
"Cumberland","1","6","Virginia","4/7/20","0","6","51049","1"
"Danville","2","15","Virginia","4/7/20","4","11","51590","275"
"Dinwiddie","0","1","Virginia","4/7/20","0","1","51053","1"
"Emporia","0","2","Virginia","4/7/20","0","2","51595","1"
"Fairfax","41","532","Virginia","4/7/20","244","288","51059","118.03"
"Fairfax City","0","0","Virginia","4/7/20","1","-1","51600","-100"
"Fauquier","2","18","Virginia","4/7/20","7","11","51061","157.14"
"Fluvanna","1","9","Virginia","4/7/20","3","6","51065","200"
"Franklin","1","11","Virginia","4/7/20","5","6","51067","120"
"Franklin City","0","4","Virginia","4/7/20","1","3","51620","300"
"Frederick","4","43","Virginia","4/7/20","12","31","51069","258.33"
"Fredericksburg","1","8","Virginia","4/7/20","1","7","51630","700"
"Galax","0","1","Virginia","4/7/20","1","0","51640","0"
"Giles","0","2","Virginia","4/7/20","0","2","51071","1"
"Gloucester","1","15","Virginia","4/7/20","7","8","51073","114.29"
"Goochland","2","22","Virginia","4/7/20","7","15","51075","214.29"
"Greene","0","4","Virginia","4/7/20","1","3","51079","300"
"Greensville","0","5","Virginia","4/7/20","3","2","51081","66.67"
"Halifax","0","2","Virginia","4/7/20","1","1","51083","100"
"Hampton","4","43","Virginia","4/7/20","13","30","51650","230.77"
"Hanover","2","19","Virginia","4/7/20","6","13","51085","216.67"
"Harrisonburg","3","27","Virginia","4/7/20","6","21","51660","350"
"Henrico","29","267","Virginia","4/7/20","62","205","51087","330.65"
"Henry","0","4","Virginia","4/7/20","1","3","51089","300"
"Hopewell","1","13","Virginia","4/7/20","4","9","51670","225"
"Isle of Wight","3","23","Virginia","4/7/20","4","19","51093","475"
"James City","4","119","Virginia","4/7/20","89","30","51095","33.71"
"King and Queen","0","1","Virginia","4/7/20","1","0","51097","0"
"King George","1","10","Virginia","4/7/20","3","7","51099","233.33"
"King William","0","2","Virginia","4/7/20","1","1","51101","100"
"Lancaster","0","1","Virginia","4/7/20","1","0","51103","0"
"Lee","0","2","Virginia","4/7/20","2","0","51105","0"
"Lexington","0","3","Virginia","4/7/20","0","3","51678","1"
"Loudoun","17","209","Virginia","4/7/20","87","122","51107","140.23"
"Louisa","1","14","Virginia","4/7/20","9","5","51109","55.56"
"Lunenburg","0","2","Virginia","4/7/20","0","2","51111","1"
"Lynchburg","2","20","Virginia","4/7/20","5","15","51680","300"
"Madison","0","4","Virginia","4/7/20","3","1","51113","33.33"
"Manassas","2","20","Virginia","4/7/20","8","12","51683","150"
"Manassas Park","0","4","Virginia","4/7/20","1","3","51685","300"
"Mathews","0","2","Virginia","4/7/20","2","0","51115","0"
"Mecklenburg","1","12","Virginia","4/7/20","4","8","51117","200"
"Montgomery","2","16","Virginia","4/7/20","1","15","51121","1500"
"Nelson","0","2","Virginia","4/7/20","2","0","51125","0"
"New Kent","2","12","Virginia","4/7/20","1","11","51127","1100"
"Newport News","5","57","Virginia","4/7/20","23","34","51700","147.83"
"Norfolk","6","72","Virginia","4/7/20","27","45","51710","166.67"
"Northampton","0","2","Virginia","4/7/20","1","1","51131","100"
"Northumberland","0","3","Virginia","4/7/20","3","0","51133","0"
"Nottoway","0","3","Virginia","4/7/20","1","2","51135","200"
"Orange","1","7","Virginia","4/7/20","2","5","51137","250"
"Page","0","3","Virginia","4/7/20","1","2","51139","200"
"Petersburg","1","10","Virginia","4/7/20","2","8","51730","400"
"Pittsylvania","0","3","Virginia","4/7/20","1","2","51143","200"
"Poquoson","0","4","Virginia","4/7/20","2","2","51735","100"
"Portsmouth","3","36","Virginia","4/7/20","12","24","51740","200"
"Powhatan","0","4","Virginia","4/7/20","4","0","51145","0"
"Prince Edward","0","3","Virginia","4/7/20","2","1","51147","50"
"Prince George","2","21","Virginia","4/7/20","7","14","51149","200"
"Prince William","20","236","Virginia","4/7/20","94","142","51153","151.06"
"Pulaski","0","2","Virginia","4/7/20","0","2","51155","1"
"Radford","0","1","Virginia","4/7/20","1","0","51750","0"
"Rappahannock","0","1","Virginia","4/7/20","0","1","51157","1"
"Richmond","0","2","Virginia","4/7/20","0","2","51159","1"
"Richmond City","12","110","Virginia","4/7/20","26","84","51760","323.08"
"Roanoke","1","8","Virginia","4/7/20","3","5","51161","166.67"
"Roanoke City","1","12","Virginia","4/7/20","6","6","51770","100"
"Rockbridge","0","3","Virginia","4/7/20","2","1","51163","50"
"Rockingham","2","16","Virginia","4/7/20","5","11","51165","220"
"Russell","0","1","Virginia","4/7/20","0","1","51167","1"
"Salem","0","1","Virginia","4/7/20","0","1","51775","1"
"Shenandoah","1","13","Virginia","4/7/20","7","6","51171","85.71"
"Smyth","0","3","Virginia","4/7/20","1","2","51173","200"
"Southampton","1","5","Virginia","4/7/20","1","4","51175","400"
"Spotsylvania","3","29","Virginia","4/7/20","7","22","51177","314.29"
"Stafford","4","49","Virginia","4/7/20","24","25","51179","104.17"
"Staunton","0","1","Virginia","4/7/20","0","1","51790","1"
"Suffolk","4","30","Virginia","4/7/20","4","26","51800","650"
"Surry","0","3","Virginia","4/7/20","1","2","51181","200"
"Sussex","1","5","Virginia","4/7/20","0","5","51183","1"
"Tazewell","0","4","Virginia","4/7/20","2","2","51185","100"
"Virginia Beach","19","200","Virginia","4/7/20","65","135","51810","207.69"
"Warren","0","6","Virginia","4/7/20","3","3","51187","100"
"Washington","1","10","Virginia","4/7/20","2","8","51191","400"
"Waynesboro","0","3","Virginia","4/7/20","2","1","51820","50"
"Westmoreland","0","3","Virginia","4/7/20","0","3","51193","1"
"Williamsburg","1","14","Virginia","4/7/20","8","6","51830","75"
"Winchester","2","14","Virginia","4/7/20","3","11","51840","366.67"
"Wise","0","3","Virginia","4/7/20","0","3","51195","1"
"Wythe","0","3","Virginia","4/7/20","1","2","51197","200"
"York","2","25","Virginia","4/7/20","14","11","51199","78.57"
"Adams","2","27","Washington","4/7/20","13","14","53001","107.69"
"Asotin","1","4","Washington","4/7/20","0","4","53003","1"
"Benton","12","176","Washington","4/7/20","89","87","53005","97.75"
"Chelan","3","34","Washington","4/7/20","16","18","53007","112.5"
"Clallam","0","8","Washington","4/7/20","8","0","53009","0"
"Clark","10","185","Washington","4/7/20","116","69","53011","59.48"
"Columbia","0","1","Washington","4/7/20","1","0","53013","0"
"Cowlitz","1","21","Washington","4/7/20","14","7","53015","50"
"Douglas","1","10","Washington","4/7/20","5","5","53017","100"
"Ferry","0","1","Washington","4/7/20","1","0","53019","0"
"Franklin","5","70","Washington","4/7/20","33","37","53021","112.12"
"Grant","4","88","Washington","4/7/20","63","25","53025","39.68"
"Grays Harbor","1","6","Washington","4/7/20","2","4","53027","200"
"Island","5","142","Washington","4/7/20","106","36","53029","33.96"
"Jefferson","2","27","Washington","4/7/20","16","11","53031","68.75"
"King","165","3486","Washington","4/7/20","2330","1156","53033","49.61"
"Kitsap","6","119","Washington","4/7/20","74","45","53035","60.81"
"Kittitas","1","13","Washington","4/7/20","9","4","53037","44.44"
"Klickitat","0","11","Washington","4/7/20","9","2","53039","22.22"
"Lewis","1","16","Washington","4/7/20","10","6","53041","60"
"Lincoln","0","1","Washington","4/7/20","1","0","53043","0"
"Mason","2","16","Washington","4/7/20","5","11","53045","220"
"Okanogan","1","9","Washington","4/7/20","3","6","53047","200"
"Pend Oreille","0","1","Washington","4/7/20","0","1","53051","1"
"Pierce","55","760","Washington","4/7/20","377","383","53053","101.59"
"San Juan","1","10","Washington","4/7/20","4","6","53055","150"
"Skagit","6","166","Washington","4/7/20","121","45","53057","37.19"
"Skamania","0","2","Washington","4/7/20","1","1","53059","100"
"Snohomish","61","1659","Washington","4/7/20","1229","430","53061","34.99"
"Spokane","12","222","Washington","4/7/20","136","86","53063","63.24"
"Stevens","0","5","Washington","4/7/20","4","1","53065","25"
"Thurston","4","74","Washington","4/7/20","48","26","53067","54.17"
"Wahkiakum","0","2","Washington","4/7/20","0","2","53069","1"
"Walla Walla","1","13","Washington","4/7/20","6","7","53071","116.67"
"Whatcom","14","238","Washington","4/7/20","139","99","53073","71.22"
"Whitman","1","12","Washington","4/7/20","8","4","53075","50"
"Yakima","31","380","Washington","4/7/20","161","219","53077","136.02"
"Barbour","0","3","West Virginia","4/7/20","0","3","54001","1"
"Berkeley","6","57","West Virginia","4/7/20","16","41","54003","256.25"
"Brooke","0","1","West Virginia","4/7/20","0","1","54009","1"
"Cabell","1","11","West Virginia","4/7/20","1","10","54011","1000"
"Fayette","0","1","West Virginia","4/7/20","0","1","54019","1"
"Greenbrier","0","3","West Virginia","4/7/20","3","0","54025","0"
"Hancock","1","7","West Virginia","4/7/20","3","4","54029","133.33"
"Hardy","0","2","West Virginia","4/7/20","1","1","54031","100"
"Harrison","2","25","West Virginia","4/7/20","11","14","54033","127.27"
"Jackson","1","19","West Virginia","4/7/20","9","10","54035","111.11"
"Jefferson","3","31","West Virginia","4/7/20","8","23","54037","287.5"
"Kanawha","4","61","West Virginia","4/7/20","31","30","54039","96.77"
"Lewis","0","1","West Virginia","4/7/20","0","1","54041","1"
"Logan","1","7","West Virginia","4/7/20","2","5","54045","250"
"Marion","3","25","West Virginia","4/7/20","5","20","54049","400"
"Marshall","0","5","West Virginia","4/7/20","4","1","54051","25"
"Mason","0","6","West Virginia","4/7/20","3","3","54053","100"
"McDowell","0","2","West Virginia","4/7/20","0","2","54047","1"
"Mercer","0","5","West Virginia","4/7/20","2","3","54055","150"
"Mineral","0","3","West Virginia","4/7/20","0","3","54057","1"
"Monongalia","4","60","West Virginia","4/7/20","31","29","54061","93.55"
"Morgan","0","4","West Virginia","4/7/20","1","3","54065","300"
"Nicholas","0","2","West Virginia","4/7/20","0","2","54067","1"
"Ohio","1","19","West Virginia","4/7/20","10","9","54069","90"
"Pendleton","0","1","West Virginia","4/7/20","0","1","54071","1"
"Pleasants","0","1","West Virginia","4/7/20","1","0","54073","0"
"Preston","0","6","West Virginia","4/7/20","3","3","54077","100"
"Putnam","1","10","West Virginia","4/7/20","4","6","54079","150"
"Raleigh","0","4","West Virginia","4/7/20","3","1","54081","33.33"
"Randolph","0","3","West Virginia","4/7/20","1","2","54083","200"
"Roane","0","2","West Virginia","4/7/20","2","0","54087","0"
"Taylor","0","3","West Virginia","4/7/20","0","3","54091","1"
"Tucker","0","3","West Virginia","4/7/20","2","1","54093","50"
"Tyler","0","1","West Virginia","4/7/20","0","1","54095","1"
"Upshur","0","1","West Virginia","4/7/20","1","0","54097","0"
"Wetzel","0","2","West Virginia","4/7/20","1","1","54103","100"
"Wirt","0","1","West Virginia","4/7/20","1","0","54105","0"
"Wood","2","13","West Virginia","4/7/20","2","11","54107","550"
"Wyoming","0","1","West Virginia","4/7/20","0","1","54109","1"
"Adams","0","2","Wisconsin","4/7/20","0","2","55001","1"
"Ashland","0","1","Wisconsin","4/7/20","1","0","55003","0"
"Barron","1","4","Wisconsin","4/7/20","0","4","55005","1"
"Bayfield","0","3","Wisconsin","4/7/20","2","1","55007","50"
"Brown","5","41","Wisconsin","4/7/20","9","32","55009","355.56"
"Buffalo","0","2","Wisconsin","4/7/20","1","1","55011","100"
"Calumet","0","4","Wisconsin","4/7/20","1","3","55015","300"
"Chippewa","1","16","Wisconsin","4/7/20","8","8","55017","100"
"Clark","1","7","Wisconsin","4/7/20","3","4","55019","133.33"
"Columbia","1","23","Wisconsin","4/7/20","14","9","55021","64.29"
"Crawford","0","2","Wisconsin","4/7/20","0","2","55023","1"
"Dane","11","289","Wisconsin","4/7/20","214","75","55025","35.05"
"Dodge","1","15","Wisconsin","4/7/20","10","5","55027","50"
"Door","1","7","Wisconsin","4/7/20","1","6","55029","600"
"Douglas","0","7","Wisconsin","4/7/20","6","1","55031","16.67"
"Dunn","0","5","Wisconsin","4/7/20","3","2","55033","66.67"
"Eau Claire","1","21","Wisconsin","4/7/20","11","10","55035","90.91"
"Florence","0","2","Wisconsin","4/7/20","0","2","55037","1"
"Fond du Lac","3","44","Wisconsin","4/7/20","22","22","55039","100"
"Grant","0","3","Wisconsin","4/7/20","2","1","55043","50"
"Green","0","9","Wisconsin","4/7/20","6","3","55045","50"
"Iowa","0","4","Wisconsin","4/7/20","3","1","55049","33.33"
"Iron","0","1","Wisconsin","4/7/20","1","0","55051","0"
"Jackson","0","4","Wisconsin","4/7/20","2","2","55053","100"
"Jefferson","1","15","Wisconsin","4/7/20","11","4","55055","36.36"
"Juneau","0","5","Wisconsin","4/7/20","3","2","55057","66.67"
"Kenosha","11","112","Wisconsin","4/7/20","37","75","55059","202.7"
"Kewaunee","0","1","Wisconsin","4/7/20","0","1","55061","1"
"La Crosse","0","22","Wisconsin","4/7/20","19","3","55063","15.79"
"Lafayette","0","1","Wisconsin","4/7/20","0","1","55065","1"
"Manitowoc","0","3","Wisconsin","4/7/20","0","3","55071","1"
"Marathon","1","12","Wisconsin","4/7/20","3","9","55073","300"
"Marinette","0","3","Wisconsin","4/7/20","1","2","55075","200"
"Marquette","0","2","Wisconsin","4/7/20","2","0","55077","0"
"Menominee","0","1","Wisconsin","4/7/20","0","1","55078","1"
"Milwaukee","88","1323","Wisconsin","4/7/20","710","613","55079","86.34"
"Monroe","0","5","Wisconsin","4/7/20","2","3","55081","150"
"Oconto","0","1","Wisconsin","4/7/20","1","0","55083","0"
"Oneida","0","5","Wisconsin","4/7/20","3","2","55085","66.67"
"Outagamie","2","25","Wisconsin","4/7/20","12","13","55087","108.33"
"Ozaukee","3","66","Wisconsin","4/7/20","43","23","55089","53.49"
"Pierce","0","7","Wisconsin","4/7/20","7","0","55093","0"
"Portage","0","4","Wisconsin","4/7/20","1","3","55097","300"
"Racine","6","66","Wisconsin","4/7/20","26","40","55101","153.85"
"Richland","0","3","Wisconsin","4/7/20","2","1","55103","50"
"Rock","3","37","Wisconsin","4/7/20","16","21","55105","131.25"
"Rusk","0","3","Wisconsin","4/7/20","0","3","55107","1"
"Sauk","1","20","Wisconsin","4/7/20","13","7","55111","53.85"
"Shawano","0","3","Wisconsin","4/7/20","0","3","55115","1"
"Sheboygan","3","30","Wisconsin","4/7/20","11","19","55117","172.73"
"St. Croix","0","7","Wisconsin","4/7/20","5","2","55109","40"
"Trempealeau","0","1","Wisconsin","4/7/20","0","1","55121","1"
"Vilas","0","4","Wisconsin","4/7/20","3","1","55125","33.33"
"Walworth","2","21","Wisconsin","4/7/20","6","15","55127","250"
"Washington","3","59","Wisconsin","4/7/20","40","19","55131","47.5"
"Waukesha","9","166","Wisconsin","4/7/20","101","65","55133","64.36"
"Waupaca","0","2","Wisconsin","4/7/20","1","1","55135","100"
"Waushara","0","1","Wisconsin","4/7/20","0","1","55137","1"
"Winnebago","2","24","Wisconsin","4/7/20","11","13","55139","118.18"
"Wood","0","2","Wisconsin","4/7/20","2","0","55141","0"
"Albany","0","4","Wyoming","4/7/20","1","3","56001","300"
"Campbell","1","9","Wyoming","4/7/20","2","7","56005","350"
"Carbon","0","4","Wyoming","4/7/20","3","1","56007","33.33"
"Converse","0","4","Wyoming","4/7/20","1","3","56009","300"
"Crook","0","1","Wyoming","4/7/20","0","1","56011","1"
"Fremont","2","38","Wyoming","4/7/20","25","13","56013","52"
"Goshen","0","3","Wyoming","4/7/20","1","2","56015","200"
"Johnson","0","8","Wyoming","4/7/20","7","1","56019","14.29"
"Laramie","4","47","Wyoming","4/7/20","22","25","56021","113.64"
"Lincoln","1","4","Wyoming","4/7/20","0","4","56023","1"
"Natrona","2","26","Wyoming","4/7/20","12","14","56025","116.67"
"Park","0","1","Wyoming","4/7/20","1","0","56029","0"
"Platte","0","1","Wyoming","4/7/20","0","1","56031","1"
"Sheridan","0","12","Wyoming","4/7/20","10","2","56033","20"
"Sublette","0","1","Wyoming","4/7/20","1","0","56035","0"
"Sweetwater","0","5","Wyoming","4/7/20","2","3","56037","150"
"Teton","3","41","Wyoming","4/7/20","20","21","56039","105"
"Uinta","0","3","Wyoming","4/7/20","0","3","56041","1"
"Washakie","0","4","Wyoming","4/7/20","1","3","56043","300"
