"Locality","DailyAvgNewCasesPast7Days","TotalCases","State","Date","TotalCases7DaysAgo","NewCasesPast7Days","FIPS-Code","PercentIncreaseTotalCasesPast7Days"
"Autauga","1","12","Alabama","4/8/20","8","4","01001","50"
"Baldwin","3","44","Alabama","4/8/20","20","24","01003","120"
"Barbour","0","3","Alabama","4/8/20","0","3","01005","1"
"Bibb","1","9","Alabama","4/8/20","3","6","01007","200"
"Blount","1","10","Alabama","4/8/20","5","5","01009","100"
"Bullock","0","3","Alabama","4/8/20","3","0","01011","0"
"Butler","0","2","Alabama","4/8/20","1","1","01013","100"
"Calhoun","5","49","Alabama","4/8/20","11","38","01015","345.45"
"Chambers","10","109","Alabama","4/8/20","42","67","01017","159.52"
"Cherokee","1","7","Alabama","4/8/20","2","5","01019","250"
"Chilton","1","20","Alabama","4/8/20","13","7","01021","53.85"
"Choctaw","0","6","Alabama","4/8/20","4","2","01023","50"
"Clarke","1","10","Alabama","4/8/20","0","10","01025","1"
"Clay","1","10","Alabama","4/8/20","2","8","01027","400"
"Cleburne","1","12","Alabama","4/8/20","6","6","01029","100"
"Coffee","1","8","Alabama","4/8/20","0","8","01031","1"
"Colbert","0","7","Alabama","4/8/20","4","3","01033","75"
"Conecuh","1","4","Alabama","4/8/20","0","4","01035","1"
"Coosa","1","9","Alabama","4/8/20","4","5","01037","125"
"Covington","1","9","Alabama","4/8/20","3","6","01039","200"
"Crenshaw","0","2","Alabama","4/8/20","1","1","01041","100"
"Cullman","2","22","Alabama","4/8/20","9","13","01043","144.44"
"Dale","1","4","Alabama","4/8/20","0","4","01045","1"
"Dallas","1","7","Alabama","4/8/20","2","5","01047","250"
"DeKalb","1","14","Alabama","4/8/20","5","9","01049","180"
"Elmore","1","22","Alabama","4/8/20","14","8","01051","57.14"
"Escambia","0","3","Alabama","4/8/20","1","2","01053","200"
"Etowah","5","43","Alabama","4/8/20","10","33","01055","330"
"Fayette","0","1","Alabama","4/8/20","1","0","01057","0"
"Franklin","1","7","Alabama","4/8/20","3","4","01059","133.33"
"Geneva","0","1","Alabama","4/8/20","0","1","01061","1"
"Greene","1","10","Alabama","4/8/20","4","6","01063","150"
"Hale","1","7","Alabama","4/8/20","1","6","01065","600"
"Henry","1","5","Alabama","4/8/20","0","5","01067","1"
"Houston","2","25","Alabama","4/8/20","8","17","01069","212.5"
"Jackson","2","19","Alabama","4/8/20","8","11","01071","137.5"
"Jefferson","27","479","Alabama","4/8/20","292","187","01073","64.04"
"Lamar","1","5","Alabama","4/8/20","1","4","01075","400"
"Lauderdale","1","18","Alabama","4/8/20","12","6","01077","50"
"Lawrence","1","8","Alabama","4/8/20","3","5","01079","166.67"
"Lee","10","148","Alabama","4/8/20","81","67","01081","82.72"
"Limestone","1","32","Alabama","4/8/20","23","9","01083","39.13"
"Lowndes","1","10","Alabama","4/8/20","1","9","01085","900"
"Macon","1","6","Alabama","4/8/20","1","5","01087","500"
"Madison","7","153","Alabama","4/8/20","105","48","01089","45.71"
"Marengo","1","14","Alabama","4/8/20","4","10","01091","250"
"Marion","2","23","Alabama","4/8/20","9","14","01093","155.56"
"Marshall","5","42","Alabama","4/8/20","6","36","01095","600"
"Mobile","28","249","Alabama","4/8/20","56","193","01097","344.64"
"Monroe","1","5","Alabama","4/8/20","1","4","01099","400"
"Montgomery","6","77","Alabama","4/8/20","35","42","01101","120"
"Morgan","2","31","Alabama","4/8/20","19","12","01103","63.16"
"Pickens","2","15","Alabama","4/8/20","4","11","01107","275"
"Pike","2","16","Alabama","4/8/20","5","11","01109","220"
"Randolph","1","15","Alabama","4/8/20","5","10","01111","200"
"Russell","2","14","Alabama","4/8/20","1","13","01113","1300"
"Shelby","10","159","Alabama","4/8/20","88","71","01117","80.68"
"St. Clair","2","30","Alabama","4/8/20","18","12","01115","66.67"
"Sumter","2","16","Alabama","4/8/20","2","14","01119","700"
"Talladega","2","22","Alabama","4/8/20","7","15","01121","214.29"
"Tallapoosa","3","35","Alabama","4/8/20","13","22","01123","169.23"
"Tuscaloosa","8","83","Alabama","4/8/20","30","53","01125","176.67"
"Walker","5","65","Alabama","4/8/20","32","33","01127","103.12"
"Washington","1","7","Alabama","4/8/20","3","4","01129","133.33"
"Wilcox","1","13","Alabama","4/8/20","3","10","01131","333.33"
"Winston","0","3","Alabama","4/8/20","2","1","01133","50"
"Anchorage","5","103","Alaska","4/8/20","65","38","02020","58.46"
"Bethel","0","1","Alaska","4/8/20","0","1","02050","1"
"Fairbanks North Star","5","71","Alaska","4/8/20","35","36","02090","102.86"
"Juneau","1","14","Alaska","4/8/20","9","5","02110","55.56"
"Kenai Peninsula","1","13","Alaska","4/8/20","7","6","02122","85.71"
"Ketchikan Gateway","0","14","Alaska","4/8/20","13","1","02130","7.69"
"Matanuska-Susitna","0","5","Alaska","4/8/20","3","2","02170","66.67"
"Petersburg","0","2","Alaska","4/8/20","0","2","02195","1"
"Southeast Fairbanks","0","1","Alaska","4/8/20","0","1","02240","1"
"Yukon-Koyukuk","0","1","Alaska","4/8/20","0","1","02290","1"
"Apache","2","34","Arizona","4/8/20","17","17","04001","100"
"Cochise","1","9","Arizona","4/8/20","4","5","04003","125"
"Coconino","14","186","Arizona","4/8/20","85","101","04005","118.82"
"Gila","0","3","Arizona","4/8/20","1","2","04007","200"
"Graham","0","2","Arizona","4/8/20","2","0","04009","0"
"Greenlee","0","1","Arizona","4/8/20","1","0","04011","0"
"La Paz","0","3","Arizona","4/8/20","2","1","04012","50"
"Maricopa","98","1559","Arizona","4/8/20","871","688","04013","78.99"
"Mohave","2","23","Arizona","4/8/20","7","16","04015","228.57"
"Navajo","20","240","Arizona","4/8/20","102","138","04017","135.29"
"Pima","35","464","Arizona","4/8/20","217","247","04019","113.82"
"Pinal","8","124","Arizona","4/8/20","65","59","04021","90.77"
"Santa Cruz","0","6","Arizona","4/8/20","3","3","04023","100"
"Yavapai","5","58","Arizona","4/8/20","24","34","04025","141.67"
"Yuma","0","14","Arizona","4/8/20","12","2","04027","16.67"
"Arkansas","0","1","Arkansas","4/8/20","1","0","05001","0"
"Ashley","1","5","Arkansas","4/8/20","1","4","05003","400"
"Baxter","0","1","Arkansas","4/8/20","1","0","05005","0"
"Benton","1","45","Arkansas","4/8/20","39","6","05007","15.38"
"Boone","0","1","Arkansas","4/8/20","1","0","05009","0"
"Bradley","0","5","Arkansas","4/8/20","4","1","05011","25"
"Carroll","0","1","Arkansas","4/8/20","0","1","05015","1"
"Chicot","0","2","Arkansas","4/8/20","2","0","05017","0"
"Clark","0","27","Arkansas","4/8/20","24","3","05019","12.5"
"Clay","0","1","Arkansas","4/8/20","0","1","05021","1"
"Cleburne","1","67","Arkansas","4/8/20","62","5","05023","8.06"
"Cleveland","0","7","Arkansas","4/8/20","5","2","05025","40"
"Columbia","0","1","Arkansas","4/8/20","1","0","05027","0"
"Conway","0","1","Arkansas","4/8/20","1","0","05029","0"
"Craighead","2","23","Arkansas","4/8/20","11","12","05031","109.09"
"Crawford","0","1","Arkansas","4/8/20","1","0","05033","0"
"Crittenden","5","61","Arkansas","4/8/20","29","32","05035","110.34"
"Cross","1","5","Arkansas","4/8/20","1","4","05037","400"
"Dallas","0","1","Arkansas","4/8/20","0","1","05039","1"
"Desha","0","5","Arkansas","4/8/20","2","3","05041","150"
"Drew","1","5","Arkansas","4/8/20","1","4","05043","400"
"Faulkner","3","55","Arkansas","4/8/20","36","19","05045","52.78"
"Franklin","0","1","Arkansas","4/8/20","0","1","05047","1"
"Garland","3","51","Arkansas","4/8/20","32","19","05051","59.38"
"Grant","0","5","Arkansas","4/8/20","3","2","05053","66.67"
"Greene","1","6","Arkansas","4/8/20","1","5","05055","500"
"Hempstead","0","1","Arkansas","4/8/20","1","0","05057","0"
"Hot Spring","1","7","Arkansas","4/8/20","1","6","05059","600"
"Howard","1","5","Arkansas","4/8/20","1","4","05061","400"
"Independence","0","5","Arkansas","4/8/20","3","2","05063","66.67"
"Izard","0","1","Arkansas","4/8/20","0","1","05065","1"
"Jefferson","5","78","Arkansas","4/8/20","42","36","05069","85.71"
"Johnson","1","11","Arkansas","4/8/20","1","10","05071","1000"
"Lafayette","0","1","Arkansas","4/8/20","0","1","05073","1"
"Lawrence","0","1","Arkansas","4/8/20","1","0","05075","0"
"Lee","0","1","Arkansas","4/8/20","0","1","05077","1"
"Lincoln","1","11","Arkansas","4/8/20","6","5","05079","83.33"
"Logan","0","1","Arkansas","4/8/20","0","1","05083","1"
"Lonoke","2","23","Arkansas","4/8/20","6","17","05085","283.33"
"Miller","2","16","Arkansas","4/8/20","1","15","05091","1500"
"Mississippi","0","1","Arkansas","4/8/20","0","1","05093","1"
"Monroe","0","1","Arkansas","4/8/20","0","1","05095","1"
"Nevada","0","1","Arkansas","4/8/20","1","0","05099","0"
"Newton","0","1","Arkansas","4/8/20","1","0","05101","0"
"Ouachita","0","1","Arkansas","4/8/20","0","1","05103","1"
"Perry","0","1","Arkansas","4/8/20","1","0","05105","0"
"Phillips","0","1","Arkansas","4/8/20","0","1","05107","1"
"Pike","0","1","Arkansas","4/8/20","1","0","05109","0"
"Poinsett","0","6","Arkansas","4/8/20","5","1","05111","20"
"Polk","1","6","Arkansas","4/8/20","1","5","05113","500"
"Pope","2","20","Arkansas","4/8/20","6","14","05115","233.33"
"Prairie","0","1","Arkansas","4/8/20","0","1","05117","1"
"Pulaski","10","179","Arkansas","4/8/20","107","72","05119","67.29"
"Randolph","1","6","Arkansas","4/8/20","1","5","05121","500"
"Saline","3","33","Arkansas","4/8/20","13","20","05125","153.85"
"Scott","0","1","Arkansas","4/8/20","1","0","05127","0"
"Searcy","1","6","Arkansas","4/8/20","2","4","05129","200"
"Sebastian","0","9","Arkansas","4/8/20","8","1","05131","12.5"
"Sevier","1","6","Arkansas","4/8/20","1","5","05133","500"
"Sharp","0","1","Arkansas","4/8/20","0","1","05135","1"
"St. Francis","4","29","Arkansas","4/8/20","1","28","05123","2800"
"Stone","0","5","Arkansas","4/8/20","5","0","05137","0"
"Union","1","13","Arkansas","4/8/20","9","4","05139","44.44"
"Van Buren","0","22","Arkansas","4/8/20","20","2","05141","10"
"Washington","1","30","Arkansas","4/8/20","22","8","05143","36.36"
"White","2","27","Arkansas","4/8/20","11","16","05145","145.45"
"Woodruff","0","1","Arkansas","4/8/20","1","0","05147","0"
"Yell","0","1","Arkansas","4/8/20","0","1","05149","1"
"Alameda","52","674","California","4/8/20","313","361","06001","115.34"
"Alpine","0","1","California","4/8/20","1","0","06003","0"
"Amador","0","3","California","4/8/20","2","1","06005","50"
"Butte","1","13","California","4/8/20","8","5","06007","62.5"
"Calaveras","0","5","California","4/8/20","3","2","06009","66.67"
"Colusa","0","3","California","4/8/20","1","2","06011","200"
"Contra Costa","30","462","California","4/8/20","249","213","06013","85.54"
"Del Norte","0","2","California","4/8/20","0","2","06015","1"
"El Dorado","1","28","California","4/8/20","18","10","06017","55.56"
"Fresno","11","146","California","4/8/20","68","78","06019","114.71"
"Glenn","0","2","California","4/8/20","2","0","06021","0"
"Humboldt","3","50","California","4/8/20","27","23","06023","85.19"
"Imperial","5","73","California","4/8/20","38","35","06025","92.11"
"Inyo","0","11","California","4/8/20","9","2","06027","22.22"
"Kern","23","271","California","4/8/20","110","161","06029","146.36"
"Kings","0","5","California","4/8/20","4","1","06031","25"
"Lake","0","2","California","4/8/20","0","2","06033","1"
"Los Angeles","577","7559","California","4/8/20","3518","4041","06037","114.87"
"Madera","1","28","California","4/8/20","23","5","06039","21.74"
"Marin","6","148","California","4/8/20","107","41","06041","38.32"
"Mendocino","0","4","California","4/8/20","4","0","06045","0"
"Merced","3","34","California","4/8/20","10","24","06047","240"
"Mono","1","19","California","4/8/20","13","6","06051","46.15"
"Monterey","3","64","California","4/8/20","42","22","06053","52.38"
"Napa","1","25","California","4/8/20","15","10","06055","66.67"
"Nevada","1","34","California","4/8/20","26","8","06057","30.77"
"Orange","59","1016","California","4/8/20","606","410","06059","67.66"
"Placer","6","117","California","4/8/20","78","39","06061","50"
"Plumas","0","3","California","4/8/20","1","2","06063","200"
"Riverside","115","1179","California","4/8/20","371","808","06065","217.79"
"Sacramento","51","580","California","4/8/20","224","356","06067","158.93"
"San Benito","2","33","California","4/8/20","21","12","06069","57.14"
"San Bernardino","52","547","California","4/8/20","183","364","06071","198.91"
"San Diego","103","1454","California","4/8/20","733","721","06073","98.36"
"San Francisco","35","676","California","4/8/20","434","242","06075","55.76"
"San Joaquin","10","223","California","4/8/20","151","72","06077","47.68"
"San Luis Obispo","3","99","California","4/8/20","80","19","06079","23.75"
"San Mateo","33","617","California","4/8/20","388","229","06081","59.02"
"Santa Barbara","17","218","California","4/8/20","99","119","06083","120.2"
"Santa Clara","61","1380","California","4/8/20","956","424","06085","44.35"
"Santa Cruz","4","76","California","4/8/20","49","27","06087","55.1"
"Shasta","2","23","California","4/8/20","7","16","06089","228.57"
"Siskiyou","0","4","California","4/8/20","3","1","06093","33.33"
"Solano","7","99","California","4/8/20","49","50","06095","102.04"
"Sonoma","6","120","California","4/8/20","78","42","06097","53.85"
"Stanislaus","7","90","California","4/8/20","39","51","06099","130.77"
"Sutter","1","19","California","4/8/20","10","9","06101","90"
"Tehama","0","1","California","4/8/20","0","1","06103","1"
"Tulare","16","157","California","4/8/20","45","112","06107","248.89"
"Tuolumne","0","1","California","4/8/20","2","-1","06109","-50"
"Ventura","16","263","California","4/8/20","149","114","06111","76.51"
"Yolo","4","56","California","4/8/20","25","31","06113","124"
"Yuba","1","13","California","4/8/20","7","6","06115","85.71"
"Adams","29","417","Colorado","4/8/20","212","205","08001","96.7"
"Alamosa","0","5","Colorado","4/8/20","4","1","08003","25"
"Arapahoe","55","764","Colorado","4/8/20","381","383","08005","100.52"
"Archuleta","1","6","Colorado","4/8/20","1","5","08007","500"
"Baca","1","9","Colorado","4/8/20","3","6","08009","200"
"Boulder","13","207","Colorado","4/8/20","114","93","08013","81.58"
"Broomfield","4","52","Colorado","4/8/20","21","31","08014","147.62"
"Chaffee","1","23","Colorado","4/8/20","17","6","08015","35.29"
"Clear Creek","0","7","Colorado","4/8/20","6","1","08019","16.67"
"Costilla","0","3","Colorado","4/8/20","3","0","08023","0"
"Crowley","0","1","Colorado","4/8/20","1","0","08025","0"
"Custer","0","2","Colorado","4/8/20","0","2","08027","1"
"Delta","1","5","Colorado","4/8/20","1","4","08029","400"
"Denver","49","927","Colorado","4/8/20","586","341","08031","58.19"
"Douglas","12","244","Colorado","4/8/20","158","86","08035","54.43"
"Eagle","11","374","Colorado","4/8/20","295","79","08037","26.78"
"El Paso","23","472","Colorado","4/8/20","314","158","08041","50.32"
"Elbert","1","10","Colorado","4/8/20","5","5","08039","100"
"Fremont","0","4","Colorado","4/8/20","2","2","08043","100"
"Garfield","2","49","Colorado","4/8/20","34","15","08045","44.12"
"Grand","0","4","Colorado","4/8/20","4","0","08049","0"
"Gunnison","2","98","Colorado","4/8/20","84","14","08051","16.67"
"Hinsdale","0","1","Colorado","4/8/20","1","0","08053","0"
"Huerfano","0","1","Colorado","4/8/20","1","0","08055","0"
"Jefferson","36","610","Colorado","4/8/20","356","254","08059","71.35"
"Kit Carson","0","5","Colorado","4/8/20","4","1","08063","25"
"La Plata","2","34","Colorado","4/8/20","23","11","08067","47.83"
"Lake","0","3","Colorado","4/8/20","2","1","08065","50"
"Larimer","9","167","Colorado","4/8/20","107","60","08069","56.07"
"Las Animas","0","1","Colorado","4/8/20","0","1","08071","1"
"Lincoln","0","1","Colorado","4/8/20","1","0","08073","0"
"Logan","1","13","Colorado","4/8/20","6","7","08075","116.67"
"Mesa","3","32","Colorado","4/8/20","14","18","08077","128.57"
"Mineral","0","2","Colorado","4/8/20","2","0","08079","0"
"Moffat","0","3","Colorado","4/8/20","4","-1","08081","-25"
"Montezuma","1","8","Colorado","4/8/20","1","7","08083","700"
"Montrose","3","35","Colorado","4/8/20","13","22","08085","169.23"
"Morgan","3","23","Colorado","4/8/20","5","18","08087","360"
"Otero","0","4","Colorado","4/8/20","3","1","08089","33.33"
"Ouray","0","3","Colorado","4/8/20","0","3","08091","1"
"Park","0","5","Colorado","4/8/20","3","2","08093","66.67"
"Phillips","0","4","Colorado","4/8/20","1","3","08095","300"
"Pitkin","1","39","Colorado","4/8/20","33","6","08097","18.18"
"Pueblo","3","45","Colorado","4/8/20","22","23","08101","104.55"
"Rio Blanco","0","1","Colorado","4/8/20","0","1","08103","1"
"Rio Grande","0","5","Colorado","4/8/20","5","0","08105","0"
"Routt","2","32","Colorado","4/8/20","19","13","08107","68.42"
"Saguache","0","3","Colorado","4/8/20","1","2","08109","200"
"San Miguel","1","10","Colorado","4/8/20","4","6","08113","150"
"Summit","3","56","Colorado","4/8/20","34","22","08117","64.71"
"Teller","1","12","Colorado","4/8/20","7","5","08119","71.43"
"Washington","0","1","Colorado","4/8/20","1","0","08121","0"
"Weld","40","573","Colorado","4/8/20","293","280","08123","95.56"
"Yuma","0","2","Colorado","4/8/20","2","0","08125","0"
"Fairfield","307","4136","Connecticut","4/8/20","1986","2150","09001","108.26"
"Hartford","82","1045","Connecticut","4/8/20","469","576","09003","122.81"
"Litchfield","18","255","Connecticut","4/8/20","131","124","09005","94.66"
"Middlesex","12","150","Connecticut","4/8/20","66","84","09007","127.27"
"New Haven","150","1664","Connecticut","4/8/20","611","1053","09009","172.34"
"New London","8","85","Connecticut","4/8/20","29","56","09011","193.1"
"Tolland","7","111","Connecticut","4/8/20","61","50","09013","81.97"
"Windham","3","43","Connecticut","4/8/20","19","24","09015","126.32"
"Kent","23","201","Delaware","4/8/20","41","160","10001","390.24"
"New Castle","59","636","Delaware","4/8/20","226","410","10003","181.42"
"Sussex","25","279","Delaware","4/8/20","101","178","10005","176.24"
"","0","49","Diamond Princess","4/8/20","49","0",,"0"
"District of Columbia","122","1440","District of Columbia","4/8/20","586","854","11001","145.73"
"Alachua","8","144","Florida","4/8/20","90","54","12001","60"
"Baker","1","15","Florida","4/8/20","9","6","12003","66.67"
"Bay","3","28","Florida","4/8/20","10","18","12005","180"
"Bradford","2","15","Florida","4/8/20","3","12","12007","400"
"Brevard","9","102","Florida","4/8/20","38","64","12009","168.42"
"Broward","161","2358","Florida","4/8/20","1232","1126","12011","91.4"
"Calhoun","0","4","Florida","4/8/20","1","3","12013","300"
"Charlotte","7","76","Florida","4/8/20","24","52","12015","216.67"
"Citrus","5","54","Florida","4/8/20","19","35","12017","184.21"
"Clay","7","97","Florida","4/8/20","46","51","12019","110.87"
"Collier","18","277","Florida","4/8/20","150","127","12021","84.67"
"Columbia","2","17","Florida","4/8/20","3","14","12023","466.67"
"DeSoto","2","18","Florida","4/8/20","7","11","12027","157.14"
"Dixie","0","2","Florida","4/8/20","0","2","12029","1"
"Duval","47","549","Florida","4/8/20","218","331","12031","151.83"
"Escambia","12","180","Florida","4/8/20","94","86","12033","91.49"
"Flagler","2","35","Florida","4/8/20","20","15","12035","75"
"Franklin","0","2","Florida","4/8/20","0","2","12037","1"
"Gadsden","1","8","Florida","4/8/20","1","7","12039","700"
"Gilchrist","0","1","Florida","4/8/20","0","1","12041","1"
"Glades","0","4","Florida","4/8/20","3","1","12043","33.33"
"Gulf","0","1","Florida","4/8/20","1","0","12045","0"
"Hamilton","0","1","Florida","4/8/20","0","1","12047","1"
"Hardee","0","2","Florida","4/8/20","0","2","12049","1"
"Hendry","1","10","Florida","4/8/20","4","6","12051","150"
"Hernando","5","56","Florida","4/8/20","24","32","12053","133.33"
"Highlands","3","41","Florida","4/8/20","17","24","12055","141.18"
"Hillsborough","45","626","Florida","4/8/20","309","317","12057","102.59"
"Holmes","0","3","Florida","4/8/20","1","2","12059","200"
"Indian River","4","63","Florida","4/8/20","33","30","12061","90.91"
"Jackson","0","4","Florida","4/8/20","2","2","12063","100"
"Jefferson","1","8","Florida","4/8/20","0","8","12065","1"
"Lake","10","136","Florida","4/8/20","67","69","12069","102.99"
"Lee","36","462","Florida","4/8/20","212","250","12071","117.92"
"Leon","6","71","Florida","4/8/20","28","43","12073","153.57"
"Levy","0","5","Florida","4/8/20","2","3","12075","150"
"Madison","2","12","Florida","4/8/20","0","12","12079","1"
"Manatee","16","171","Florida","4/8/20","58","113","12081","194.83"
"Marion","5","65","Florida","4/8/20","28","37","12083","132.14"
"Martin","10","101","Florida","4/8/20","29","72","12085","248.28"
"Miami-Dade","450","5354","Florida","4/8/20","2202","3152","12086","143.14"
"Monroe","3","51","Florida","4/8/20","27","24","12087","88.89"
"Nassau","3","29","Florida","4/8/20","11","18","12089","163.64"
"Okaloosa","6","78","Florida","4/8/20","39","39","12091","100"
"Okeechobee","1","4","Florida","4/8/20","0","4","12093","1"
"Orange","59","803","Florida","4/8/20","392","411","12095","104.85"
"Osceola","22","272","Florida","4/8/20","115","157","12097","136.52"
"Palm Beach","91","1206","Florida","4/8/20","567","639","12099","112.7"
"Pasco","12","125","Florida","4/8/20","43","82","12101","190.7"
"Pinellas","32","394","Florida","4/8/20","170","224","12103","131.76"
"Polk","19","206","Florida","4/8/20","76","130","12105","171.05"
"Putnam","1","21","Florida","4/8/20","13","8","12107","61.54"
"Santa Rosa","4","69","Florida","4/8/20","44","25","12113","56.82"
"Sarasota","14","180","Florida","4/8/20","82","98","12115","119.51"
"Seminole","15","216","Florida","4/8/20","109","107","12117","98.17"
"St. Johns","10","154","Florida","4/8/20","83","71","12109","85.54"
"St. Lucie","13","130","Florida","4/8/20","40","90","12111","225"
"Sumter","5","90","Florida","4/8/20","52","38","12119","73.08"
"Suwannee","6","46","Florida","4/8/20","4","42","12121","1050"
"Taylor","0","1","Florida","4/8/20","0","1","12123","1"
"Union","0","2","Florida","4/8/20","1","1","12125","100"
"Volusia","12","163","Florida","4/8/20","80","83","12127","103.75"
"Wakulla","1","7","Florida","4/8/20","1","6","12129","600"
"Walton","1","26","Florida","4/8/20","18","8","12131","44.44"
"Washington","0","2","Florida","4/8/20","1","1","12133","100"
"Appling","1","6","Georgia","4/8/20","1","5","13001","500"
"Atkinson","1","4","Georgia","4/8/20","0","4","13003","1"
"Bacon","1","13","Georgia","4/8/20","6","7","13005","116.67"
"Baker","1","9","Georgia","4/8/20","4","5","13007","125"
"Baldwin","3","27","Georgia","4/8/20","6","21","13009","350"
"Banks","0","4","Georgia","4/8/20","3","1","13011","33.33"
"Barrow","3","42","Georgia","4/8/20","20","22","13013","110"
"Bartow","7","192","Georgia","4/8/20","144","48","13015","33.33"
"Ben Hill","0","6","Georgia","4/8/20","3","3","13017","100"
"Berrien","0","4","Georgia","4/8/20","2","2","13019","100"
"Bibb","4","50","Georgia","4/8/20","22","28","13021","127.27"
"Bleckley","0","1","Georgia","4/8/20","1","0","13023","0"
"Brantley","1","5","Georgia","4/8/20","0","5","13025","1"
"Brooks","2","16","Georgia","4/8/20","2","14","13027","700"
"Bryan","3","26","Georgia","4/8/20","8","18","13029","225"
"Bulloch","1","12","Georgia","4/8/20","2","10","13031","500"
"Burke","1","17","Georgia","4/8/20","8","9","13033","112.5"
"Butts","2","20","Georgia","4/8/20","8","12","13035","150"
"Calhoun","3","30","Georgia","4/8/20","10","20","13037","200"
"Camden","2","17","Georgia","4/8/20","4","13","13039","325"
"Candler","0","4","Georgia","4/8/20","1","3","13043","300"
"Carroll","7","183","Georgia","4/8/20","131","52","13045","39.69"
"Catoosa","0","7","Georgia","4/8/20","4","3","13047","75"
"Charlton","0","3","Georgia","4/8/20","1","2","13049","200"
"Chatham","13","125","Georgia","4/8/20","36","89","13051","247.22"
"Chattahoochee","0","2","Georgia","4/8/20","2","0","13053","0"
"Chattooga","0","4","Georgia","4/8/20","3","1","13055","33.33"
"Cherokee","10","151","Georgia","4/8/20","83","68","13057","81.93"
"Clarke","4","81","Georgia","4/8/20","51","30","13059","58.82"
"Clay","1","13","Georgia","4/8/20","5","8","13061","160"
"Clayton","24","293","Georgia","4/8/20","122","171","13063","140.16"
"Clinch","0","3","Georgia","4/8/20","1","2","13065","200"
"Cobb","42","588","Georgia","4/8/20","293","295","13067","100.68"
"Coffee","5","44","Georgia","4/8/20","9","35","13069","388.89"
"Colquitt","7","68","Georgia","4/8/20","20","48","13071","240"
"Columbia","3","48","Georgia","4/8/20","24","24","13073","100"
"Cook","0","4","Georgia","4/8/20","1","3","13075","300"
"Coweta","5","79","Georgia","4/8/20","42","37","13077","88.1"
"Crawford","0","3","Georgia","4/8/20","0","3","13079","1"
"Crisp","4","48","Georgia","4/8/20","17","31","13081","182.35"
"Dade","0","2","Georgia","4/8/20","1","1","13083","100"
"Dawson","2","22","Georgia","4/8/20","11","11","13085","100"
"Decatur","3","30","Georgia","4/8/20","8","22","13087","275"
"DeKalb","49","706","Georgia","4/8/20","365","341","13089","93.42"
"Dodge","1","9","Georgia","4/8/20","3","6","13091","200"
"Dooly","2","27","Georgia","4/8/20","10","17","13093","170"
"Dougherty","72","986","Georgia","4/8/20","480","506","13095","105.42"
"Douglas","10","122","Georgia","4/8/20","55","67","13097","121.82"
"Early","9","98","Georgia","4/8/20","34","64","13099","188.24"
"Echols","0","1","Georgia","4/8/20","0","1","13101","1"
"Effingham","2","18","Georgia","4/8/20","5","13","13103","260"
"Elbert","0","3","Georgia","4/8/20","0","3","13105","1"
"Emanuel","1","5","Georgia","4/8/20","1","4","13107","400"
"Fannin","1","9","Georgia","4/8/20","5","4","13111","80"
"Fayette","5","85","Georgia","4/8/20","48","37","13113","77.08"
"Floyd","5","93","Georgia","4/8/20","60","33","13115","55"
"Forsyth","7","99","Georgia","4/8/20","48","51","13117","106.25"
"Franklin","0","3","Georgia","4/8/20","5","-2","13119","-40"
"Fulton","88","1240","Georgia","4/8/20","624","616","13121","98.72"
"Gilmer","0","4","Georgia","4/8/20","1","3","13123","300"
"Glynn","2","30","Georgia","4/8/20","18","12","13127","66.67"
"Gordon","1","26","Georgia","4/8/20","18","8","13129","44.44"
"Grady","1","6","Georgia","4/8/20","1","5","13131","500"
"Greene","2","22","Georgia","4/8/20","8","14","13133","175"
"Gwinnett","45","565","Georgia","4/8/20","250","315","13135","126"
"Habersham","1","8","Georgia","4/8/20","2","6","13137","300"
"Hall","23","228","Georgia","4/8/20","69","159","13139","230.43"
"Hancock","0","1","Georgia","4/8/20","0","1","13141","1"
"Haralson","2","17","Georgia","4/8/20","5","12","13143","240"
"Harris","2","15","Georgia","4/8/20","3","12","13145","400"
"Hart","0","3","Georgia","4/8/20","4","-1","13147","-25"
"Heard","0","3","Georgia","4/8/20","3","0","13149","0"
"Henry","18","215","Georgia","4/8/20","90","125","13151","138.89"
"Houston","8","92","Georgia","4/8/20","35","57","13153","162.86"
"Irwin","1","9","Georgia","4/8/20","3","6","13155","200"
"Jackson","2","23","Georgia","4/8/20","9","14","13157","155.56"
"Jasper","0","5","Georgia","4/8/20","2","3","13159","150"
"Jeff Davis","0","1","Georgia","4/8/20","0","1","13161","1"
"Jefferson","0","4","Georgia","4/8/20","2","2","13163","100"
"Jenkins","1","7","Georgia","4/8/20","1","6","13165","600"
"Johnson","2","13","Georgia","4/8/20","1","12","13167","1200"
"Jones","0","7","Georgia","4/8/20","4","3","13169","75"
"Lamar","1","14","Georgia","4/8/20","4","10","13171","250"
"Lanier","1","5","Georgia","4/8/20","0","5","13173","1"
"Laurens","2","25","Georgia","4/8/20","14","11","13175","78.57"
"Lee","16","208","Georgia","4/8/20","94","114","13177","121.28"
"Liberty","1","14","Georgia","4/8/20","5","9","13179","180"
"Lincoln","0","6","Georgia","4/8/20","4","2","13181","50"
"Long","0","1","Georgia","4/8/20","1","0","13183","0"
"Lowndes","4","49","Georgia","4/8/20","24","25","13185","104.17"
"Lumpkin","0","9","Georgia","4/8/20","7","2","13187","28.57"
"Macon","1","11","Georgia","4/8/20","2","9","13193","450"
"Madison","1","9","Georgia","4/8/20","3","6","13195","200"
"Marion","1","5","Georgia","4/8/20","0","5","13197","1"
"McDuffie","2","16","Georgia","4/8/20","3","13","13189","433.33"
"McIntosh","0","3","Georgia","4/8/20","1","2","13191","200"
"Meriwether","2","18","Georgia","4/8/20","7","11","13199","157.14"
"Miller","1","12","Georgia","4/8/20","4","8","13201","200"
"Mitchell","10","108","Georgia","4/8/20","38","70","13205","184.21"
"Monroe","1","12","Georgia","4/8/20","6","6","13207","100"
"Morgan","1","12","Georgia","4/8/20","2","10","13211","500"
"Murray","1","11","Georgia","4/8/20","5","6","13213","120"
"Muscogee","5","57","Georgia","4/8/20","21","36","13215","171.43"
"Newton","5","67","Georgia","4/8/20","32","35","13217","109.38"
"Oconee","2","33","Georgia","4/8/20","17","16","13219","94.12"
"Oglethorpe","0","2","Georgia","4/8/20","1","1","13221","100"
"Paulding","5","66","Georgia","4/8/20","32","34","13223","106.25"
"Peach","2","19","Georgia","4/8/20","7","12","13225","171.43"
"Pickens","0","10","Georgia","4/8/20","7","3","13227","42.86"
"Pierce","4","36","Georgia","4/8/20","5","31","13229","620"
"Pike","1","10","Georgia","4/8/20","2","8","13231","400"
"Polk","1","22","Georgia","4/8/20","16","6","13233","37.5"
"Pulaski","1","8","Georgia","4/8/20","4","4","13235","100"
"Putnam","1","5","Georgia","4/8/20","0","5","13237","1"
"Quitman","1","4","Georgia","4/8/20","0","4","13239","1"
"Rabun","0","5","Georgia","4/8/20","2","3","13241","150"
"Randolph","11","82","Georgia","4/8/20","5","77","13243","1540"
"Richmond","5","76","Georgia","4/8/20","41","35","13245","85.37"
"Rockdale","6","86","Georgia","4/8/20","45","41","13247","91.11"
"Schley","1","10","Georgia","4/8/20","4","6","13249","150"
"Screven","0","4","Georgia","4/8/20","2","2","13251","100"
"Seminole","1","13","Georgia","4/8/20","6","7","13253","116.67"
"Spalding","6","56","Georgia","4/8/20","16","40","13255","250"
"Stephens","1","15","Georgia","4/8/20","5","10","13257","200"
"Stewart","0","4","Georgia","4/8/20","1","3","13259","300"
"Sumter","19","168","Georgia","4/8/20","37","131","13261","354.05"
"Talbot","1","8","Georgia","4/8/20","1","7","13263","700"
"Tattnall","0","3","Georgia","4/8/20","2","1","13267","50"
"Taylor","0","5","Georgia","4/8/20","2","3","13269","150"
"Telfair","1","4","Georgia","4/8/20","0","4","13271","1"
"Terrell","7","93","Georgia","4/8/20","46","47","13273","102.17"
"Thomas","5","43","Georgia","4/8/20","11","32","13275","290.91"
"Tift","3","47","Georgia","4/8/20","24","23","13277","95.83"
"Toombs","1","8","Georgia","4/8/20","2","6","13279","300"
"Towns","0","2","Georgia","4/8/20","0","2","13281","1"
"Treutlen","0","1","Georgia","4/8/20","0","1","13283","1"
"Troup","4","48","Georgia","4/8/20","19","29","13285","152.63"
"Turner","2","20","Georgia","4/8/20","4","16","13287","400"
"Twiggs","0","2","Georgia","4/8/20","2","0","13289","0"
"Union","1","4","Georgia","4/8/20","0","4","13291","1"
"Upson","3","29","Georgia","4/8/20","5","24","13293","480"
"Walker","0","3","Georgia","4/8/20","2","1","13295","50"
"Walton","2","25","Georgia","4/8/20","12","13","13297","108.33"
"Ware","5","42","Georgia","4/8/20","10","32","13299","320"
"Warren","0","6","Georgia","4/8/20","4","2","13301","50"
"Washington","2","17","Georgia","4/8/20","4","13","13303","325"
"Wayne","1","4","Georgia","4/8/20","0","4","13305","1"
"Webster","0","3","Georgia","4/8/20","1","2","13307","200"
"Wheeler","0","1","Georgia","4/8/20","1","0","13309","0"
"White","1","10","Georgia","4/8/20","3","7","13311","233.33"
"Whitfield","2","21","Georgia","4/8/20","10","11","13313","110"
"Wilcox","0","2","Georgia","4/8/20","1","1","13315","100"
"Wilkes","0","5","Georgia","4/8/20","2","3","13317","150"
"Wilkinson","0","4","Georgia","4/8/20","2","2","13319","100"
"Worth","5","64","Georgia","4/8/20","28","36","13321","128.57"
"","0","103","Grand Princess","4/8/20","103","0",,"0"
"","6","121","Guam","4/8/20","77","44",,"57.14"
"Hawaii","1","23","Hawaii","4/8/20","15","8","15001","53.33"
"Honolulu","22","312","Hawaii","4/8/20","157","155","15003","98.73"
"Kauai","1","18","Hawaii","4/8/20","12","6","15007","50"
"Maui","3","48","Hawaii","4/8/20","25","23","15009","92"
"Out of HI","0","2","Hawaii","4/8/20","0","2","80015","1"
"Ada","35","438","Idaho","4/8/20","195","243","16001","124.62"
"Adams","0","1","Idaho","4/8/20","0","1","16003","1"
"Bannock","0","5","Idaho","4/8/20","4","1","16005","25"
"Bingham","0","2","Idaho","4/8/20","2","0","16011","0"
"Blaine","29","428","Idaho","4/8/20","228","200","16013","87.72"
"Bonner","0","3","Idaho","4/8/20","1","2","16017","200"
"Bonneville","1","7","Idaho","4/8/20","2","5","16019","250"
"Camas","0","1","Idaho","4/8/20","1","0","16025","0"
"Canyon","9","114","Idaho","4/8/20","53","61","16027","115.09"
"Caribou","0","1","Idaho","4/8/20","0","1","16029","1"
"Cassia","1","5","Idaho","4/8/20","1","4","16031","400"
"Custer","0","2","Idaho","4/8/20","2","0","16037","0"
"Elmore","2","14","Idaho","4/8/20","3","11","16039","366.67"
"Fremont","0","2","Idaho","4/8/20","1","1","16043","100"
"Gem","0","8","Idaho","4/8/20","5","3","16045","60"
"Gooding","0","3","Idaho","4/8/20","0","3","16047","1"
"Idaho","0","3","Idaho","4/8/20","2","1","16049","50"
"Jefferson","0","4","Idaho","4/8/20","3","1","16051","33.33"
"Jerome","2","18","Idaho","4/8/20","2","16","16053","800"
"Kootenai","2","42","Idaho","4/8/20","30","12","16055","40"
"Latah","0","2","Idaho","4/8/20","1","1","16057","100"
"Lincoln","1","12","Idaho","4/8/20","3","9","16063","300"
"Madison","0","4","Idaho","4/8/20","4","0","16065","0"
"Minidoka","0","3","Idaho","4/8/20","1","2","16067","200"
"Nez Perce","1","17","Idaho","4/8/20","9","8","16069","88.89"
"Owyhee","0","2","Idaho","4/8/20","1","1","16073","100"
"Payette","1","6","Idaho","4/8/20","1","5","16075","500"
"Power","0","2","Idaho","4/8/20","0","2","16077","1"
"Teton","0","5","Idaho","4/8/20","2","3","16081","150"
"Twin Falls","7","53","Idaho","4/8/20","7","46","16083","657.14"
"Valley","0","2","Idaho","4/8/20","2","0","16085","0"
"Washington","0","1","Idaho","4/8/20","0","1","16087","1"
"Adams","0","1","Illinois","4/8/20","2","-1","17001","-50"
"Bond","0","3","Illinois","4/8/20","2","1","17005","50"
"Boone","1","7","Illinois","4/8/20","0","7","17007","1"
"Bureau","0","4","Illinois","4/8/20","2","2","17011","100"
"Calhoun","0","1","Illinois","4/8/20","0","1","17013","1"
"Carroll","0","5","Illinois","4/8/20","3","2","17015","66.67"
"Champaign","5","69","Illinois","4/8/20","33","36","17019","109.09"
"Christian","1","23","Illinois","4/8/20","14","9","17021","64.29"
"Clark","0","3","Illinois","4/8/20","1","2","17023","200"
"Clinton","1","13","Illinois","4/8/20","8","5","17027","62.5"
"Coles","0","2","Illinois","4/8/20","0","2","17029","1"
"Cook","767","10520","Illinois","4/8/20","5152","5368","17031","104.19"
"Crawford","0","4","Illinois","4/8/20","1","3","17033","300"
"Cumberland","0","1","Illinois","4/8/20","1","0","17035","0"
"De Witt","0","2","Illinois","4/8/20","0","2","17039","1"
"DeKalb","3","32","Illinois","4/8/20","14","18","17037","128.57"
"Douglas","0","10","Illinois","4/8/20","8","2","17041","25"
"DuPage","69","875","Illinois","4/8/20","392","483","17043","123.21"
"Effingham","0","2","Illinois","4/8/20","0","2","17049","1"
"Fayette","0","4","Illinois","4/8/20","2","2","17051","100"
"Ford","0","3","Illinois","4/8/20","1","2","17053","200"
"Franklin","0","2","Illinois","4/8/20","1","1","17055","100"
"Gallatin","0","1","Illinois","4/8/20","0","1","17059","1"
"Grundy","1","12","Illinois","4/8/20","4","8","17063","200"
"Hancock","0","1","Illinois","4/8/20","0","1","17067","1"
"Henry","2","16","Illinois","4/8/20","3","13","17073","433.33"
"Iroquois","1","7","Illinois","4/8/20","2","5","17075","250"
"Jackson","3","22","Illinois","4/8/20","4","18","17077","450"
"Jasper","0","3","Illinois","4/8/20","0","3","17079","1"
"Jefferson","0","3","Illinois","4/8/20","0","3","17081","1"
"Jersey","1","5","Illinois","4/8/20","0","5","17083","1"
"Jo Daviess","1","8","Illinois","4/8/20","3","5","17085","166.67"
"Kane","22","296","Illinois","4/8/20","142","154","17089","108.45"
"Kankakee","13","145","Illinois","4/8/20","51","94","17091","184.31"
"Kendall","7","79","Illinois","4/8/20","27","52","17093","192.59"
"Knox","0","1","Illinois","4/8/20","1","0","17095","0"
"Lake","81","1041","Illinois","4/8/20","477","564","17097","118.24"
"LaSalle","2","17","Illinois","4/8/20","6","11","17099","183.33"
"Lawrence","0","2","Illinois","4/8/20","0","2","17101","1"
"Lee","1","6","Illinois","4/8/20","0","6","17103","1"
"Livingston","1","10","Illinois","4/8/20","5","5","17105","100"
"Logan","0","3","Illinois","4/8/20","0","3","17107","1"
"Macon","2","13","Illinois","4/8/20","2","11","17115","550"
"Macoupin","1","10","Illinois","4/8/20","0","10","17117","1"
"Madison","8","82","Illinois","4/8/20","25","57","17119","228"
"Marion","0","4","Illinois","4/8/20","2","2","17121","100"
"Marshall","0","1","Illinois","4/8/20","1","0","17123","0"
"Mason","0","3","Illinois","4/8/20","0","3","17125","1"
"Massac","0","2","Illinois","4/8/20","0","2","17127","1"
"McHenry","16","180","Illinois","4/8/20","69","111","17111","160.87"
"McLean","7","65","Illinois","4/8/20","18","47","17113","261.11"
"Menard","0","2","Illinois","4/8/20","0","2","17129","1"
"Mercer","0","2","Illinois","4/8/20","0","2","17131","1"
"Monroe","2","20","Illinois","4/8/20","3","17","17133","566.67"
"Montgomery","0","4","Illinois","4/8/20","2","2","17135","100"
"Morgan","0","8","Illinois","4/8/20","5","3","17137","60"
"Moultrie","0","2","Illinois","4/8/20","0","2","17139","1"
"Ogle","2","12","Illinois","4/8/20","1","11","17141","1100"
"Peoria","1","16","Illinois","4/8/20","10","6","17143","60"
"Piatt","1","4","Illinois","4/8/20","0","4","17147","1"
"Pike","0","1","Illinois","4/8/20","0","1","17149","1"
"Randolph","3","31","Illinois","4/8/20","7","24","17157","342.86"
"Richland","0","1","Illinois","4/8/20","0","1","17159","1"
"Rock Island","7","67","Illinois","4/8/20","17","50","17161","294.12"
"Saline","0","2","Illinois","4/8/20","1","1","17165","100"
"Sangamon","2","33","Illinois","4/8/20","17","16","17167","94.12"
"Shelby","0","3","Illinois","4/8/20","0","3","17173","1"
"St. Clair","11","127","Illinois","4/8/20","53","74","17163","139.62"
"Stark","0","1","Illinois","4/8/20","0","1","17175","1"
"Stephenson","0","6","Illinois","4/8/20","3","3","17177","100"
"Tazewell","2","17","Illinois","4/8/20","4","13","17179","325"
"Vermilion","1","5","Illinois","4/8/20","0","5","17183","1"
"Wabash","0","1","Illinois","4/8/20","0","1","17185","1"
"Washington","0","2","Illinois","4/8/20","1","1","17189","100"
"Whiteside","2","21","Illinois","4/8/20","5","16","17195","320"
"Will","85","914","Illinois","4/8/20","322","592","17197","183.85"
"Williamson","1","9","Illinois","4/8/20","1","8","17199","800"
"Winnebago","6","63","Illinois","4/8/20","18","45","17201","250"
"Woodford","1","7","Illinois","4/8/20","3","4","17203","133.33"
"Adams","0","2","Indiana","4/8/20","1","1","18001","100"
"Allen","8","95","Indiana","4/8/20","39","56","18003","143.59"
"Bartholomew","8","66","Indiana","4/8/20","13","53","18005","407.69"
"Benton","0","0","Indiana","4/8/20","1","-1","18007","-100"
"Blackford","1","4","Indiana","4/8/20","0","4","18009","1"
"Boone","7","76","Indiana","4/8/20","29","47","18011","162.07"
"Brown","1","9","Indiana","4/8/20","3","6","18013","200"
"Carroll","0","3","Indiana","4/8/20","2","1","18015","50"
"Cass","2","15","Indiana","4/8/20","1","14","18017","1400"
"Clark","7","86","Indiana","4/8/20","38","48","18019","126.32"
"Clay","1","11","Indiana","4/8/20","1","10","18021","1000"
"Clinton","1","8","Indiana","4/8/20","1","7","18023","700"
"Crawford","1","11","Indiana","4/8/20","1","10","18025","1000"
"Daviess","1","5","Indiana","4/8/20","0","5","18027","1"
"Dearborn","4","47","Indiana","4/8/20","17","30","18029","176.47"
"Decatur","7","99","Indiana","4/8/20","48","51","18031","106.25"
"DeKalb","0","4","Indiana","4/8/20","2","2","18033","100"
"Delaware","3","46","Indiana","4/8/20","22","24","18035","109.09"
"Dubois","1","9","Indiana","4/8/20","3","6","18037","200"
"Elkhart","3","46","Indiana","4/8/20","23","23","18039","100"
"Fayette","1","18","Indiana","4/8/20","10","8","18041","80"
"Floyd","8","77","Indiana","4/8/20","21","56","18043","266.67"
"Fountain","0","2","Indiana","4/8/20","1","1","18045","100"
"Franklin","3","61","Indiana","4/8/20","39","22","18047","56.41"
"Fulton","0","3","Indiana","4/8/20","1","2","18049","200"
"Gibson","0","4","Indiana","4/8/20","4","0","18051","0"
"Grant","2","22","Indiana","4/8/20","9","13","18053","144.44"
"Greene","1","12","Indiana","4/8/20","3","9","18055","300"
"Hamilton","30","392","Indiana","4/8/20","179","213","18057","118.99"
"Hancock","9","99","Indiana","4/8/20","33","66","18059","200"
"Harrison","5","48","Indiana","4/8/20","15","33","18061","220"
"Hendricks","22","243","Indiana","4/8/20","91","152","18063","167.03"
"Henry","2","19","Indiana","4/8/20","4","15","18065","375"
"Howard","3","44","Indiana","4/8/20","20","24","18067","120"
"Huntington","1","6","Indiana","4/8/20","2","4","18069","200"
"Jackson","5","46","Indiana","4/8/20","10","36","18071","360"
"Jasper","1","14","Indiana","4/8/20","9","5","18073","55.56"
"Jay","0","3","Indiana","4/8/20","1","2","18075","200"
"Jefferson","1","7","Indiana","4/8/20","1","6","18077","600"
"Jennings","4","42","Indiana","4/8/20","17","25","18079","147.06"
"Johnson","16","230","Indiana","4/8/20","118","112","18081","94.92"
"Knox","1","10","Indiana","4/8/20","3","7","18083","233.33"
"Kosciusko","2","16","Indiana","4/8/20","5","11","18085","220"
"LaGrange","1","6","Indiana","4/8/20","2","4","18087","200"
"Lake","40","461","Indiana","4/8/20","180","281","18089","156.11"
"LaPorte","2","28","Indiana","4/8/20","11","17","18091","154.55"
"Lawrence","6","55","Indiana","4/8/20","11","44","18093","400"
"Madison","14","143","Indiana","4/8/20","46","97","18095","210.87"
"Marion","168","2290","Indiana","4/8/20","1117","1173","18097","105.01"
"Marshall","1","11","Indiana","4/8/20","3","8","18099","266.67"
"Martin","0","1","Indiana","4/8/20","0","1","18101","1"
"Miami","1","12","Indiana","4/8/20","3","9","18103","300"
"Monroe","4","60","Indiana","4/8/20","33","27","18105","81.82"
"Montgomery","2","17","Indiana","4/8/20","6","11","18107","183.33"
"Morgan","6","82","Indiana","4/8/20","41","41","18109","100"
"Newton","1","6","Indiana","4/8/20","1","5","18111","500"
"Noble","1","11","Indiana","4/8/20","3","8","18113","266.67"
"Ohio","0","1","Indiana","4/8/20","1","0","18115","0"
"Orange","1","11","Indiana","4/8/20","3","8","18117","266.67"
"Owen","1","17","Indiana","4/8/20","12","5","18119","41.67"
"Parke","1","5","Indiana","4/8/20","0","5","18121","1"
"Porter","8","85","Indiana","4/8/20","27","58","18127","214.81"
"Posey","0","5","Indiana","4/8/20","4","1","18129","25"
"Pulaski","0","1","Indiana","4/8/20","0","1","18131","1"
"Putnam","2","27","Indiana","4/8/20","11","16","18133","145.45"
"Randolph","1","7","Indiana","4/8/20","3","4","18135","133.33"
"Ripley","6","76","Indiana","4/8/20","33","43","18137","130.3"
"Rush","1","14","Indiana","4/8/20","5","9","18139","180"
"Scott","1","11","Indiana","4/8/20","1","10","18143","1000"
"Shelby","5","56","Indiana","4/8/20","19","37","18145","194.74"
"Spencer","0","1","Indiana","4/8/20","0","1","18147","1"
"St. Joseph","12","142","Indiana","4/8/20","57","85","18141","149.12"
"Starke","1","6","Indiana","4/8/20","1","5","18149","500"
"Steuben","1","10","Indiana","4/8/20","2","8","18151","400"
"Sullivan","0","4","Indiana","4/8/20","3","1","18153","33.33"
"Switzerland","1","11","Indiana","4/8/20","3","8","18155","266.67"
"Tippecanoe","3","38","Indiana","4/8/20","18","20","18157","111.11"
"Tipton","1","9","Indiana","4/8/20","5","4","18159","80"
"Union","1","5","Indiana","4/8/20","0","5","18161","1"
"Vanderburgh","3","41","Indiana","4/8/20","20","21","18163","105"
"Vermillion","0","2","Indiana","4/8/20","0","2","18165","1"
"Vigo","3","32","Indiana","4/8/20","8","24","18167","300"
"Wabash","1","5","Indiana","4/8/20","1","4","18169","400"
"Warren","0","2","Indiana","4/8/20","2","0","18171","0"
"Warrick","3","26","Indiana","4/8/20","8","18","18173","225"
"Washington","2","21","Indiana","4/8/20","9","12","18175","133.33"
"Wayne","2","16","Indiana","4/8/20","3","13","18177","433.33"
"Wells","0","2","Indiana","4/8/20","2","0","18179","0"
"White","0","3","Indiana","4/8/20","2","1","18181","50"
"Whitley","1","8","Indiana","4/8/20","3","5","18183","166.67"
"Adair","0","1","Iowa","4/8/20","1","0","19001","0"
"Allamakee","2","19","Iowa","4/8/20","7","12","19005","171.43"
"Appanoose","0","1","Iowa","4/8/20","1","0","19007","0"
"Audubon","0","1","Iowa","4/8/20","1","0","19009","0"
"Benton","1","12","Iowa","4/8/20","7","5","19011","71.43"
"Black Hawk","2","19","Iowa","4/8/20","7","12","19013","171.43"
"Boone","0","3","Iowa","4/8/20","1","2","19015","200"
"Bremer","0","2","Iowa","4/8/20","0","2","19017","1"
"Buchanan","0","5","Iowa","4/8/20","2","3","19019","150"
"Buena Vista","0","1","Iowa","4/8/20","0","1","19021","1"
"Butler","0","1","Iowa","4/8/20","1","0","19023","0"
"Carroll","0","1","Iowa","4/8/20","1","0","19027","0"
"Cedar","1","18","Iowa","4/8/20","9","9","19031","100"
"Cerro Gordo","1","12","Iowa","4/8/20","8","4","19033","50"
"Chickasaw","0","1","Iowa","4/8/20","0","1","19037","1"
"Clarke","0","1","Iowa","4/8/20","0","1","19039","1"
"Clay","0","2","Iowa","4/8/20","1","1","19041","100"
"Clayton","0","5","Iowa","4/8/20","2","3","19043","150"
"Clinton","2","19","Iowa","4/8/20","6","13","19045","216.67"
"Crawford","1","6","Iowa","4/8/20","1","5","19047","500"
"Dallas","1","35","Iowa","4/8/20","27","8","19049","29.63"
"Delaware","0","1","Iowa","4/8/20","0","1","19055","1"
"Des Moines","0","3","Iowa","4/8/20","2","1","19057","50"
"Dickinson","0","1","Iowa","4/8/20","1","0","19059","0"
"Dubuque","1","28","Iowa","4/8/20","22","6","19061","27.27"
"Fayette","0","3","Iowa","4/8/20","2","1","19065","50"
"Franklin","0","1","Iowa","4/8/20","0","1","19069","1"
"Greene","0","1","Iowa","4/8/20","0","1","19073","1"
"Grundy","0","1","Iowa","4/8/20","0","1","19075","1"
"Guthrie","0","1","Iowa","4/8/20","1","0","19077","0"
"Hamilton","0","2","Iowa","4/8/20","0","2","19079","1"
"Hancock","0","3","Iowa","4/8/20","3","0","19081","0"
"Hardin","0","1","Iowa","4/8/20","1","0","19083","0"
"Harrison","0","11","Iowa","4/8/20","10","1","19085","10"
"Henry","1","15","Iowa","4/8/20","5","10","19087","200"
"Howard","0","1","Iowa","4/8/20","0","1","19089","1"
"Iowa","0","6","Iowa","4/8/20","5","1","19095","20"
"Jackson","0","4","Iowa","4/8/20","1","3","19097","300"
"Jasper","0","8","Iowa","4/8/20","7","1","19099","14.29"
"Jefferson","0","3","Iowa","4/8/20","0","3","19101","1"
"Johnson","10","147","Iowa","4/8/20","76","71","19103","93.42"
"Jones","0","6","Iowa","4/8/20","4","2","19105","50"
"Keokuk","0","2","Iowa","4/8/20","1","1","19107","100"
"Kossuth","0","1","Iowa","4/8/20","1","0","19109","0"
"Lee","0","1","Iowa","4/8/20","0","1","19111","1"
"Linn","15","197","Iowa","4/8/20","94","103","19113","109.57"
"Louisa","4","30","Iowa","4/8/20","0","30","19115","1"
"Lyon","0","2","Iowa","4/8/20","0","2","19119","1"
"Madison","0","1","Iowa","4/8/20","1","0","19121","0"
"Mahaska","0","4","Iowa","4/8/20","2","2","19123","100"
"Marion","0","2","Iowa","4/8/20","0","2","19125","1"
"Marshall","1","15","Iowa","4/8/20","8","7","19127","87.5"
"Mills","0","1","Iowa","4/8/20","0","1","19129","1"
"Mitchell","0","2","Iowa","4/8/20","2","0","19131","0"
"Monona","0","6","Iowa","4/8/20","5","1","19133","20"
"Montgomery","0","1","Iowa","4/8/20","1","0","19137","0"
"Muscatine","6","61","Iowa","4/8/20","18","43","19139","238.89"
"O'Brien","0","3","Iowa","4/8/20","0","3","19141","1"
"Page","0","3","Iowa","4/8/20","2","1","19145","50"
"Plymouth","1","4","Iowa","4/8/20","0","4","19149","1"
"Polk","8","134","Iowa","4/8/20","81","53","19153","65.43"
"Pottawattamie","1","11","Iowa","4/8/20","5","6","19155","120"
"Poweshiek","0","6","Iowa","4/8/20","6","0","19157","0"
"Scott","8","77","Iowa","4/8/20","21","56","19163","266.67"
"Shelby","0","6","Iowa","4/8/20","3","3","19165","100"
"Sioux","0","7","Iowa","4/8/20","4","3","19167","75"
"Story","0","6","Iowa","4/8/20","4","2","19169","50"
"Tama","5","46","Iowa","4/8/20","14","32","19171","228.57"
"Taylor","0","1","Iowa","4/8/20","1","0","19173","0"
"Van Buren","1","6","Iowa","4/8/20","2","4","19177","200"
"Wapello","0","2","Iowa","4/8/20","1","1","19179","100"
"Warren","1","13","Iowa","4/8/20","4","9","19181","225"
"Washington","4","62","Iowa","4/8/20","34","28","19183","82.35"
"Webster","0","2","Iowa","4/8/20","1","1","19187","100"
"Winnebago","0","1","Iowa","4/8/20","0","1","19189","1"
"Winneshiek","0","4","Iowa","4/8/20","3","1","19191","33.33"
"Woodbury","1","11","Iowa","4/8/20","4","7","19193","175"
"Worth","0","1","Iowa","4/8/20","0","1","19195","1"
"Wright","0","1","Iowa","4/8/20","1","0","19197","0"
"Atchison","0","2","Kansas","4/8/20","1","1","20005","100"
"Barber","0","1","Kansas","4/8/20","0","1","20007","1"
"Barton","0","4","Kansas","4/8/20","1","3","20009","300"
"Bourbon","1","7","Kansas","4/8/20","3","4","20011","133.33"
"Butler","0","8","Kansas","4/8/20","5","3","20015","60"
"Chautauqua","0","3","Kansas","4/8/20","1","2","20019","200"
"Cherokee","0","5","Kansas","4/8/20","3","2","20021","66.67"
"Clay","0","1","Kansas","4/8/20","1","0","20027","0"
"Cloud","0","3","Kansas","4/8/20","0","3","20029","1"
"Coffey","3","35","Kansas","4/8/20","16","19","20031","118.75"
"Cowley","0","1","Kansas","4/8/20","0","1","20035","1"
"Crawford","0","4","Kansas","4/8/20","5","-1","20037","-20"
"Doniphan","0","1","Kansas","4/8/20","1","0","20043","0"
"Douglas","1","38","Kansas","4/8/20","31","7","20045","22.58"
"Finney","1","11","Kansas","4/8/20","1","10","20055","1000"
"Ford","0","2","Kansas","4/8/20","0","2","20057","1"
"Franklin","0","10","Kansas","4/8/20","7","3","20059","42.86"
"Geary","1","4","Kansas","4/8/20","0","4","20061","1"
"Gove","0","1","Kansas","4/8/20","1","0","20063","0"
"Greenwood","0","1","Kansas","4/8/20","0","1","20073","1"
"Harvey","0","4","Kansas","4/8/20","2","2","20079","100"
"Jackson","0","1","Kansas","4/8/20","1","0","20085","0"
"Jefferson","1","5","Kansas","4/8/20","1","4","20087","400"
"Jewell","0","2","Kansas","4/8/20","0","2","20089","1"
"Johnson","14","244","Kansas","4/8/20","143","101","20091","70.63"
"Labette","1","9","Kansas","4/8/20","1","8","20099","800"
"Leavenworth","5","59","Kansas","4/8/20","25","34","20103","136"
"Linn","0","5","Kansas","4/8/20","5","0","20107","0"
"Lyon","2","26","Kansas","4/8/20","12","14","20111","116.67"
"Marion","0","3","Kansas","4/8/20","0","3","20115","1"
"McPherson","1","11","Kansas","4/8/20","5","6","20113","120"
"Miami","0","2","Kansas","4/8/20","0","2","20121","1"
"Mitchell","0","2","Kansas","4/8/20","2","0","20123","0"
"Montgomery","1","11","Kansas","4/8/20","6","5","20125","83.33"
"Morris","0","2","Kansas","4/8/20","2","0","20127","0"
"Morton","0","1","Kansas","4/8/20","0","1","20129","1"
"Neosho","0","1","Kansas","4/8/20","1","0","20133","0"
"Osage","0","3","Kansas","4/8/20","3","0","20139","0"
"Osborne","0","2","Kansas","4/8/20","0","2","20141","1"
"Ottawa","0","3","Kansas","4/8/20","1","2","20143","200"
"Pottawatomie","0","5","Kansas","4/8/20","2","3","20149","150"
"Pratt","0","1","Kansas","4/8/20","1","0","20151","0"
"Reno","0","10","Kansas","4/8/20","8","2","20155","25"
"Republic","0","3","Kansas","4/8/20","0","3","20157","1"
"Riley","2","19","Kansas","4/8/20","5","14","20161","280"
"Rooks","0","2","Kansas","4/8/20","0","2","20163","1"
"Saline","1","7","Kansas","4/8/20","1","6","20169","600"
"Scott","0","1","Kansas","4/8/20","0","1","20171","1"
"Sedgwick","13","154","Kansas","4/8/20","64","90","20173","140.62"
"Seward","0","3","Kansas","4/8/20","0","3","20175","1"
"Shawnee","5","50","Kansas","4/8/20","18","32","20177","177.78"
"Stafford","0","1","Kansas","4/8/20","1","0","20185","0"
"Stevens","0","1","Kansas","4/8/20","1","0","20189","0"
"Sumner","0","2","Kansas","4/8/20","1","1","20191","100"
"Wabaunsee","0","1","Kansas","4/8/20","0","1","20197","1"
"Woodson","0","3","Kansas","4/8/20","3","0","20207","0"
"Wyandotte","22","245","Kansas","4/8/20","93","152","20209","163.44"
"Adair","0","3","Kentucky","4/8/20","0","3","21001","1"
"Allen","0","2","Kentucky","4/8/20","2","0","21003","0"
"Anderson","0","3","Kentucky","4/8/20","2","1","21005","50"
"Barren","0","1","Kentucky","4/8/20","1","0","21009","0"
"Bath","0","1","Kentucky","4/8/20","0","1","21011","1"
"Boone","2","21","Kentucky","4/8/20","8","13","21015","162.5"
"Bourbon","0","4","Kentucky","4/8/20","2","2","21017","100"
"Boyd","2","15","Kentucky","4/8/20","4","11","21019","275"
"Boyle","0","7","Kentucky","4/8/20","4","3","21021","75"
"Bracken","0","1","Kentucky","4/8/20","1","0","21023","0"
"Breathitt","0","1","Kentucky","4/8/20","2","-1","21025","-50"
"Breckinridge","0","2","Kentucky","4/8/20","2","0","21027","0"
"Bullitt","1","11","Kentucky","4/8/20","6","5","21029","83.33"
"Butler","0","1","Kentucky","4/8/20","1","0","21031","0"
"Caldwell","0","2","Kentucky","4/8/20","0","2","21033","1"
"Calloway","0","5","Kentucky","4/8/20","3","2","21035","66.67"
"Campbell","1","13","Kentucky","4/8/20","8","5","21037","62.5"
"Carroll","0","2","Kentucky","4/8/20","2","0","21041","0"
"Carter","0","1","Kentucky","4/8/20","0","1","21043","1"
"Christian","4","32","Kentucky","4/8/20","7","25","21047","357.14"
"Clark","0","11","Kentucky","4/8/20","8","3","21049","37.5"
"Clinton","0","1","Kentucky","4/8/20","0","1","21053","1"
"Crittenden","0","2","Kentucky","4/8/20","0","2","21055","1"
"Cumberland","0","1","Kentucky","4/8/20","0","1","21057","1"
"Daviess","3","58","Kentucky","4/8/20","34","24","21059","70.59"
"Edmonson","0","5","Kentucky","4/8/20","2","3","21061","150"
"Fayette","2","123","Kentucky","4/8/20","110","13","21067","11.82"
"Franklin","0","7","Kentucky","4/8/20","6","1","21073","16.67"
"Grant","0","2","Kentucky","4/8/20","1","1","21081","100"
"Graves","0","2","Kentucky","4/8/20","0","2","21083","1"
"Grayson","0","2","Kentucky","4/8/20","2","0","21085","0"
"Greenup","0","2","Kentucky","4/8/20","0","2","21089","1"
"Hancock","0","1","Kentucky","4/8/20","1","0","21091","0"
"Hardin","0","9","Kentucky","4/8/20","6","3","21093","50"
"Harrison","0","12","Kentucky","4/8/20","11","1","21097","9.09"
"Henderson","0","6","Kentucky","4/8/20","5","1","21101","20"
"Henry","0","2","Kentucky","4/8/20","0","2","21103","1"
"Hopkins","3","36","Kentucky","4/8/20","17","19","21107","111.76"
"Jefferson","16","319","Kentucky","4/8/20","206","113","21111","54.85"
"Jessamine","0","16","Kentucky","4/8/20","13","3","21113","23.08"
"Johnson","0","1","Kentucky","4/8/20","0","1","21115","1"
"Kenton","2","36","Kentucky","4/8/20","20","16","21117","80"
"Larue","0","3","Kentucky","4/8/20","1","2","21123","200"
"Laurel","0","2","Kentucky","4/8/20","2","0","21125","0"
"Lawrence","0","1","Kentucky","4/8/20","1","0","21127","0"
"Leslie","0","1","Kentucky","4/8/20","0","1","21131","1"
"Lewis","0","2","Kentucky","4/8/20","1","1","21135","100"
"Logan","0","4","Kentucky","4/8/20","3","1","21141","33.33"
"Lyon","0","4","Kentucky","4/8/20","1","3","21143","300"
"Madison","0","12","Kentucky","4/8/20","10","2","21151","20"
"Marion","0","3","Kentucky","4/8/20","1","2","21155","200"
"Marshall","1","5","Kentucky","4/8/20","1","4","21157","400"
"Martin","0","1","Kentucky","4/8/20","1","0","21159","0"
"Mason","0","2","Kentucky","4/8/20","1","1","21161","100"
"McCracken","1","13","Kentucky","4/8/20","8","5","21145","62.5"
"McCreary","0","1","Kentucky","4/8/20","1","0","21147","0"
"McLean","0","1","Kentucky","4/8/20","1","0","21149","0"
"Meade","0","2","Kentucky","4/8/20","0","2","21163","1"
"Menifee","0","3","Kentucky","4/8/20","2","1","21165","50"
"Mercer","0","4","Kentucky","4/8/20","2","2","21167","100"
"Montgomery","1","6","Kentucky","4/8/20","2","4","21173","200"
"Muhlenberg","2","27","Kentucky","4/8/20","10","17","21177","170"
"Nelson","0","4","Kentucky","4/8/20","3","1","21179","33.33"
"Nicholas","0","1","Kentucky","4/8/20","1","0","21181","0"
"Ohio","0","1","Kentucky","4/8/20","0","1","21183","1"
"Oldham","0","8","Kentucky","4/8/20","6","2","21185","33.33"
"Pendleton","0","2","Kentucky","4/8/20","1","1","21191","100"
"Perry","0","3","Kentucky","4/8/20","0","3","21193","1"
"Pike","0","1","Kentucky","4/8/20","0","1","21195","1"
"Powell","0","1","Kentucky","4/8/20","1","0","21197","0"
"Pulaski","1","13","Kentucky","4/8/20","8","5","21199","62.5"
"Rockcastle","0","4","Kentucky","4/8/20","1","3","21203","300"
"Russell","0","1","Kentucky","4/8/20","0","1","21207","1"
"Scott","1","14","Kentucky","4/8/20","6","8","21209","133.33"
"Shelby","1","8","Kentucky","4/8/20","2","6","21211","300"
"Simpson","1","13","Kentucky","4/8/20","9","4","21213","44.44"
"Spencer","0","2","Kentucky","4/8/20","2","0","21215","0"
"Taylor","0","2","Kentucky","4/8/20","2","0","21217","0"
"Union","0","2","Kentucky","4/8/20","2","0","21225","0"
"Warren","1","21","Kentucky","4/8/20","13","8","21227","61.54"
"Washington","0","2","Kentucky","4/8/20","1","1","21229","100"
"Wayne","0","4","Kentucky","4/8/20","3","1","21231","33.33"
"Webster","0","3","Kentucky","4/8/20","2","1","21233","50"
"Woodford","0","8","Kentucky","4/8/20","5","3","21239","60"
"Acadia","6","86","Louisiana","4/8/20","47","39","22001","82.98"
"Allen","7","65","Louisiana","4/8/20","19","46","22003","242.11"
"Ascension","25","366","Louisiana","4/8/20","189","177","22005","93.65"
"Assumption","9","89","Louisiana","4/8/20","25","64","22007","256"
"Avoyelles","2","48","Louisiana","4/8/20","31","17","22009","54.84"
"Beauregard","2","23","Louisiana","4/8/20","8","15","22011","187.5"
"Bienville","2","17","Louisiana","4/8/20","6","11","22013","183.33"
"Bossier","12","159","Louisiana","4/8/20","75","84","22015","112"
"Caddo","72","803","Louisiana","4/8/20","298","505","22017","169.46"
"Calcasieu","14","191","Louisiana","4/8/20","90","101","22019","112.22"
"Caldwell","2","14","Louisiana","4/8/20","0","14","22021","1"
"Cameron","0","1","Louisiana","4/8/20","0","1","22023","1"
"Catahoula","2","14","Louisiana","4/8/20","3","11","22025","366.67"
"Claiborne","3","33","Louisiana","4/8/20","10","23","22027","230"
"Concordia","1","12","Louisiana","4/8/20","5","7","22029","140"
"De Soto","7","91","Louisiana","4/8/20","39","52","22031","133.33"
"East Baton Rouge","99","935","Louisiana","4/8/20","244","691","22033","283.2"
"East Carroll","0","1","Louisiana","4/8/20","1","0","22035","0"
"East Feliciana","4","39","Louisiana","4/8/20","10","29","22037","290"
"Evangeline","2","25","Louisiana","4/8/20","11","14","22039","127.27"
"Franklin","4","30","Louisiana","4/8/20","5","25","22041","500"
"Grant","1","10","Louisiana","4/8/20","3","7","22043","233.33"
"Iberia","7","97","Louisiana","4/8/20","49","48","22045","97.96"
"Iberville","19","171","Louisiana","4/8/20","36","135","22047","375"
"Jackson","0","5","Louisiana","4/8/20","4","1","22049","25"
"Jefferson","380","4092","Louisiana","4/8/20","1433","2659","22051","185.55"
"Jefferson Davis","3","28","Louisiana","4/8/20","9","19","22053","211.11"
"Lafayette","18","285","Louisiana","4/8/20","159","126","22055","79.25"
"Lafourche","36","355","Louisiana","4/8/20","105","250","22057","238.1"
"LaSalle","1","8","Louisiana","4/8/20","2","6","22059","300"
"Lincoln","2","24","Louisiana","4/8/20","13","11","22061","84.62"
"Livingston","11","99","Louisiana","4/8/20","25","74","22063","296"
"Madison","0","2","Louisiana","4/8/20","1","1","22065","100"
"Morehouse","3","23","Louisiana","4/8/20","2","21","22067","1050"
"Natchitoches","3","25","Louisiana","4/8/20","2","23","22069","1150"
"Orleans","400","5070","Louisiana","4/8/20","2270","2800","22071","123.35"
"Ouachita","28","275","Louisiana","4/8/20","80","195","22073","243.75"
"Plaquemines","11","123","Louisiana","4/8/20","47","76","22075","161.7"
"Pointe Coupee","3","27","Louisiana","4/8/20","7","20","22077","285.71"
"Rapides","9","135","Louisiana","4/8/20","69","66","22079","95.65"
"Red River","0","3","Louisiana","4/8/20","1","2","22081","200"
"Richland","1","13","Louisiana","4/8/20","3","10","22083","333.33"
"Sabine","1","7","Louisiana","4/8/20","3","4","22085","133.33"
"St. Bernard","30","304","Louisiana","4/8/20","94","210","22087","223.4"
"St. Charles","35","328","Louisiana","4/8/20","82","246","22089","300"
"St. Helena","1","10","Louisiana","4/8/20","1","9","22091","900"
"St. James","14","181","Louisiana","4/8/20","86","95","22093","110.47"
"St. John the Baptist","45","432","Louisiana","4/8/20","118","314","22095","266.1"
"St. Landry","6","86","Louisiana","4/8/20","45","41","22097","91.11"
"St. Martin","10","112","Louisiana","4/8/20","41","71","22099","173.17"
"St. Mary","8","81","Louisiana","4/8/20","26","55","22101","211.54"
"St. Tammany","66","733","Louisiana","4/8/20","270","463","22103","171.48"
"Tangipahoa","34","269","Louisiana","4/8/20","33","236","22105","715.15"
"Terrebonne","22","209","Louisiana","4/8/20","55","154","22109","280"
"Union","3","35","Louisiana","4/8/20","11","24","22111","218.18"
"Vermilion","2","22","Louisiana","4/8/20","10","12","22113","120"
"Vernon","1","11","Louisiana","4/8/20","6","5","22115","83.33"
"Washington","10","106","Louisiana","4/8/20","39","67","22117","171.79"
"Webster","5","51","Louisiana","4/8/20","17","34","22119","200"
"West Baton Rouge","6","54","Louisiana","4/8/20","14","40","22121","285.71"
"West Carroll","0","1","Louisiana","4/8/20","0","1","22123","1"
"West Feliciana","3","32","Louisiana","4/8/20","8","24","22125","300"
"Winn","1","5","Louisiana","4/8/20","1","4","22127","400"
"Androscoggin","2","23","Maine","4/8/20","11","12","23001","109.09"
"Aroostook","0","2","Maine","4/8/20","0","2","23003","1"
"Cumberland","13","262","Maine","4/8/20","169","93","23005","55.03"
"Franklin","0","5","Maine","4/8/20","2","3","23007","150"
"Hancock","0","3","Maine","4/8/20","0","3","23009","1"
"Kennebec","2","26","Maine","4/8/20","12","14","23011","116.67"
"Knox","1","9","Maine","4/8/20","5","4","23013","80"
"Lincoln","0","9","Maine","4/8/20","8","1","23015","12.5"
"Oxford","0","12","Maine","4/8/20","9","3","23017","33.33"
"Penobscot","3","31","Maine","4/8/20","12","19","23019","158.33"
"Sagadahoc","1","13","Maine","4/8/20","7","6","23023","85.71"
"Somerset","1","5","Maine","4/8/20","1","4","23025","400"
"Waldo","1","7","Maine","4/8/20","2","5","23027","250"
"Washington","0","1","Maine","4/8/20","0","1","23029","1"
"York","9","121","Maine","4/8/20","59","62","23031","105.08"
"Allegany","1","6","Maryland","4/8/20","0","6","24001","1"
"Anne Arundel","44","466","Maryland","4/8/20","158","308","24003","194.94"
"Baltimore","82","866","Maryland","4/8/20","289","577","24005","199.65"
"Baltimore City","50","571","Maryland","4/8/20","221","350","24510","158.37"
"Calvert","5","56","Maryland","4/8/20","18","38","24009","211.11"
"Caroline","1","11","Maryland","4/8/20","4","7","24011","175"
"Carroll","13","186","Maryland","4/8/20","96","90","24013","93.75"
"Cecil","5","49","Maryland","4/8/20","16","33","24015","206.25"
"Charles","15","164","Maryland","4/8/20","56","108","24017","192.86"
"Dorchester","0","4","Maryland","4/8/20","1","3","24019","300"
"Frederick","23","199","Maryland","4/8/20","35","164","24021","468.57"
"Garrett","0","5","Maryland","4/8/20","3","2","24023","66.67"
"Harford","7","86","Maryland","4/8/20","34","52","24025","152.94"
"Howard","19","274","Maryland","4/8/20","142","132","24027","92.96"
"Kent","1","9","Maryland","4/8/20","3","6","24029","200"
"Montgomery","92","1088","Maryland","4/8/20","447","641","24031","143.4"
"Prince George's","130","1310","Maryland","4/8/20","403","907","24033","225.06"
"Queen Anne's","1","16","Maryland","4/8/20","7","9","24035","128.57"
"Somerset","0","4","Maryland","4/8/20","4","0","24039","0"
"St. Mary's","6","62","Maryland","4/8/20","19","43","24037","226.32"
"Talbot","1","10","Maryland","4/8/20","4","6","24041","150"
"Washington","6","57","Maryland","4/8/20","15","42","24043","280"
"Wicomico","2","20","Maryland","4/8/20","7","13","24045","185.71"
"Worcester","1","10","Maryland","4/8/20","4","6","24047","150"
"Barnstable","24","423","Massachusetts","4/8/20","255","168","25001","65.88"
"Berkshire","14","281","Massachusetts","4/8/20","183","98","25003","53.55"
"Bristol","67","835","Massachusetts","4/8/20","366","469","25005","128.14"
"Dukes and Nantucket","1","17","Massachusetts","4/8/20","11","6","00000","54.55"
"Essex","174","2103","Massachusetts","4/8/20","885","1218","25009","137.63"
"Franklin","6","117","Massachusetts","4/8/20","72","45","25011","62.5"
"Hampden","87","1081","Massachusetts","4/8/20","475","606","25013","127.58"
"Hampshire","12","164","Massachusetts","4/8/20","81","83","25015","102.47"
"Middlesex","280","3545","Massachusetts","4/8/20","1582","1963","25017","124.08"
"Norfolk","136","1778","Massachusetts","4/8/20","829","949","25021","114.48"
"Plymouth","109","1327","Massachusetts","4/8/20","561","766","25023","136.54"
"Suffolk","282","3600","Massachusetts","4/8/20","1624","1976","25025","121.67"
"Worcester","105","1296","Massachusetts","4/8/20","563","733","25027","130.2"
"Allegan","2","21","Michigan","4/8/20","5","16","26005","320"
"Antrim","0","7","Michigan","4/8/20","5","2","26009","40"
"Arenac","0","4","Michigan","4/8/20","1","3","26011","300"
"Barry","1","9","Michigan","4/8/20","4","5","26015","125"
"Bay","4","43","Michigan","4/8/20","12","31","26017","258.33"
"Berrien","8","138","Michigan","4/8/20","85","53","26021","62.35"
"Branch","3","20","Michigan","4/8/20","2","18","26023","900"
"Calhoun","5","59","Michigan","4/8/20","26","33","26025","126.92"
"Cass","0","13","Michigan","4/8/20","10","3","26027","30"
"Charlevoix","1","8","Michigan","4/8/20","4","4","26029","100"
"Cheboygan","1","11","Michigan","4/8/20","3","8","26031","266.67"
"Chippewa","0","1","Michigan","4/8/20","1","0","26033","0"
"Clare","0","2","Michigan","4/8/20","1","1","26035","100"
"Clinton","7","86","Michigan","4/8/20","36","50","26037","138.89"
"Crawford","1","6","Michigan","4/8/20","1","5","26039","500"
"Delta","1","9","Michigan","4/8/20","3","6","26041","200"
"Dickinson","0","2","Michigan","4/8/20","0","2","26043","1"
"Eaton","6","70","Michigan","4/8/20","28","42","26045","150"
"Emmet","1","16","Michigan","4/8/20","7","9","26047","128.57"
"Genesee","68","731","Michigan","4/8/20","255","476","26049","186.67"
"Gladwin","0","4","Michigan","4/8/20","2","2","26051","100"
"Gogebic","0","3","Michigan","4/8/20","2","1","26053","50"
"Grand Traverse","1","16","Michigan","4/8/20","8","8","26055","100"
"Gratiot","0","6","Michigan","4/8/20","3","3","26057","100"
"Hillsdale","6","63","Michigan","4/8/20","19","44","26059","231.58"
"Houghton","0","1","Michigan","4/8/20","1","0","26061","0"
"Huron","0","6","Michigan","4/8/20","3","3","26063","100"
"Ingham","12","214","Michigan","4/8/20","127","87","26065","68.5"
"Ionia","1","11","Michigan","4/8/20","6","5","26067","83.33"
"Iosco","0","5","Michigan","4/8/20","2","3","26069","150"
"Isabella","3","30","Michigan","4/8/20","7","23","26073","328.57"
"Jackson","11","137","Michigan","4/8/20","63","74","26075","117.46"
"Kalamazoo","6","76","Michigan","4/8/20","33","43","26077","130.3"
"Kalkaska","1","11","Michigan","4/8/20","7","4","26079","57.14"
"Kent","14","218","Michigan","4/8/20","123","95","26081","77.24"
"Lapeer","8","69","Michigan","4/8/20","11","58","26087","527.27"
"Leelanau","0","4","Michigan","4/8/20","1","3","26089","300"
"Lenawee","2","39","Michigan","4/8/20","24","15","26091","62.5"
"Livingston","13","208","Michigan","4/8/20","118","90","26093","76.27"
"Luce","0","1","Michigan","4/8/20","0","1","26095","1"
"Mackinac","0","3","Michigan","4/8/20","1","2","26097","200"
"Macomb","220","2631","Michigan","4/8/20","1090","1541","26099","141.38"
"Manistee","1","10","Michigan","4/8/20","1","9","26101","900"
"Marquette","2","18","Michigan","4/8/20","4","14","26103","350"
"Mason","0","2","Michigan","4/8/20","1","1","26105","100"
"Mecosta","1","9","Michigan","4/8/20","3","6","26107","200"
"Midland","3","35","Michigan","4/8/20","17","18","26111","105.88"
"Missaukee","0","1","Michigan","4/8/20","1","0","26113","0"
"Monroe","13","152","Michigan","4/8/20","58","94","26115","162.07"
"Montcalm","1","19","Michigan","4/8/20","11","8","26117","72.73"
"Muskegon","3","42","Michigan","4/8/20","18","24","26121","133.33"
"Newaygo","0","3","Michigan","4/8/20","1","2","26123","200"
"Oakland","313","4299","Michigan","4/8/20","2107","2192","26125","104.03"
"Oceana","0","3","Michigan","4/8/20","2","1","26127","50"
"Ogemaw","0","4","Michigan","4/8/20","2","2","26129","100"
"Osceola","0","5","Michigan","4/8/20","2","3","26133","150"
"Oscoda","0","2","Michigan","4/8/20","2","0","26135","0"
"Otsego","2","31","Michigan","4/8/20","19","12","26137","63.16"
"Ottawa","5","74","Michigan","4/8/20","36","38","26139","105.56"
"Out of MI","12","126","Michigan","4/8/20","42","84","80026","200"
"Presque Isle","0","1","Michigan","4/8/20","0","1","26141","1"
"Roscommon","1","6","Michigan","4/8/20","1","5","26143","500"
"Saginaw","16","186","Michigan","4/8/20","71","115","26145","161.97"
"Sanilac","2","22","Michigan","4/8/20","7","15","26151","214.29"
"Schoolcraft","0","1","Michigan","4/8/20","0","1","26153","1"
"Shiawassee","3","30","Michigan","4/8/20","12","18","26155","150"
"St. Clair","15","160","Michigan","4/8/20","52","108","26147","207.69"
"St. Joseph","2","16","Michigan","4/8/20","5","11","26149","220"
"Tuscola","2","28","Michigan","4/8/20","11","17","26157","154.55"
"Van Buren","2","26","Michigan","4/8/20","14","12","26159","85.71"
"Washtenaw","35","674","Michigan","4/8/20","430","244","26161","56.74"
"Wayne","743","9707","Michigan","4/8/20","4503","5204","26163","115.57"
"Wexford","1","8","Michigan","4/8/20","2","6","26165","300"
"Anoka","3","46","Minnesota","4/8/20","26","20","27003","76.92"
"Beltrami","0","6","Minnesota","4/8/20","4","2","27007","50"
"Benton","0","1","Minnesota","4/8/20","1","0","27009","0"
"Big Stone","0","1","Minnesota","4/8/20","1","0","27011","0"
"Blue Earth","2","21","Minnesota","4/8/20","9","12","27013","133.33"
"Brown","1","7","Minnesota","4/8/20","2","5","27015","250"
"Carlton","2","14","Minnesota","4/8/20","2","12","27017","600"
"Carver","0","10","Minnesota","4/8/20","10","0","27019","0"
"Cass","0","3","Minnesota","4/8/20","1","2","27021","200"
"Chisago","0","5","Minnesota","4/8/20","3","2","27025","66.67"
"Clay","2","20","Minnesota","4/8/20","7","13","27027","185.71"
"Clearwater","0","2","Minnesota","4/8/20","2","0","27029","0"
"Cottonwood","0","5","Minnesota","4/8/20","3","2","27033","66.67"
"Crow Wing","1","10","Minnesota","4/8/20","1","9","27035","900"
"Dakota","4","75","Minnesota","4/8/20","48","27","27037","56.25"
"Dodge","0","13","Minnesota","4/8/20","10","3","27039","30"
"Douglas","0","1","Minnesota","4/8/20","1","0","27041","0"
"Faribault","0","3","Minnesota","4/8/20","2","1","27043","50"
"Fillmore","0","10","Minnesota","4/8/20","8","2","27045","25"
"Freeborn","2","17","Minnesota","4/8/20","2","15","27047","750"
"Goodhue","1","13","Minnesota","4/8/20","4","9","27049","225"
"Hennepin","18","344","Minnesota","4/8/20","218","126","27053","57.8"
"Houston","0","1","Minnesota","4/8/20","0","1","27055","1"
"Isanti","0","4","Minnesota","4/8/20","2","2","27059","100"
"Itasca","0","2","Minnesota","4/8/20","1","1","27061","100"
"Jackson","0","1","Minnesota","4/8/20","1","0","27063","0"
"Kandiyohi","0","2","Minnesota","4/8/20","2","0","27067","0"
"Koochiching","0","1","Minnesota","4/8/20","0","1","27071","1"
"Lac qui Parle","0","1","Minnesota","4/8/20","1","0","27073","0"
"Le Sueur","1","20","Minnesota","4/8/20","15","5","27079","33.33"
"Lincoln","0","2","Minnesota","4/8/20","1","1","27081","100"
"Lyon","0","4","Minnesota","4/8/20","2","2","27083","100"
"Mahnomen","0","1","Minnesota","4/8/20","1","0","27087","0"
"Martin","1","34","Minnesota","4/8/20","29","5","27091","17.24"
"McLeod","0","1","Minnesota","4/8/20","0","1","27085","1"
"Meeker","0","1","Minnesota","4/8/20","1","0","27093","0"
"Mower","1","18","Minnesota","4/8/20","14","4","27099","28.57"
"Murray","0","1","Minnesota","4/8/20","0","1","27101","1"
"Nicollet","0","5","Minnesota","4/8/20","3","2","27103","66.67"
"Olmsted","7","108","Minnesota","4/8/20","61","47","27109","77.05"
"Otter Tail","0","2","Minnesota","4/8/20","1","1","27111","100"
"Pipestone","0","1","Minnesota","4/8/20","0","1","27117","1"
"Polk","0","1","Minnesota","4/8/20","0","1","27119","1"
"Ramsey","7","112","Minnesota","4/8/20","66","46","27123","69.7"
"Redwood","0","1","Minnesota","4/8/20","0","1","27127","1"
"Renville","0","2","Minnesota","4/8/20","1","1","27129","100"
"Rice","0","4","Minnesota","4/8/20","4","0","27131","0"
"Roseau","0","1","Minnesota","4/8/20","0","1","27135","1"
"Scott","1","17","Minnesota","4/8/20","10","7","27139","70"
"Sherburne","0","10","Minnesota","4/8/20","8","2","27141","25"
"Sibley","0","1","Minnesota","4/8/20","1","0","27143","0"
"St. Louis","2","28","Minnesota","4/8/20","13","15","27137","115.38"
"Stearns","0","7","Minnesota","4/8/20","5","2","27145","40"
"Steele","0","8","Minnesota","4/8/20","6","2","27147","33.33"
"Swift","0","1","Minnesota","4/8/20","0","1","27151","1"
"Traverse","0","2","Minnesota","4/8/20","2","0","27155","0"
"Wabasha","0","6","Minnesota","4/8/20","6","0","27157","0"
"Waseca","0","3","Minnesota","4/8/20","3","0","27161","0"
"Washington","4","70","Minnesota","4/8/20","44","26","27163","59.09"
"Watonwan","0","4","Minnesota","4/8/20","2","2","27165","100"
"Wilkin","0","2","Minnesota","4/8/20","1","1","27167","100"
"Winona","1","19","Minnesota","4/8/20","10","9","27169","90"
"Wright","1","12","Minnesota","4/8/20","6","6","27171","100"
"Yellow Medicine","0","2","Minnesota","4/8/20","1","1","27173","100"
"Adams","2","25","Mississippi","4/8/20","11","14","28001","127.27"
"Alcorn","0","6","Mississippi","4/8/20","3","3","28003","100"
"Amite","0","7","Mississippi","4/8/20","4","3","28005","75"
"Attala","1","15","Mississippi","4/8/20","11","4","28007","36.36"
"Benton","0","5","Mississippi","4/8/20","4","1","28009","25"
"Bolivar","4","54","Mississippi","4/8/20","25","29","28011","116"
"Calhoun","1","13","Mississippi","4/8/20","3","10","28013","333.33"
"Carroll","1","7","Mississippi","4/8/20","2","5","28015","250"
"Chickasaw","0","17","Mississippi","4/8/20","15","2","28017","13.33"
"Choctaw","0","9","Mississippi","4/8/20","7","2","28019","28.57"
"Claiborne","0","3","Mississippi","4/8/20","1","2","28021","200"
"Clarke","1","10","Mississippi","4/8/20","5","5","28023","100"
"Clay","1","11","Mississippi","4/8/20","5","6","28025","120"
"Coahoma","1","32","Mississippi","4/8/20","22","10","28027","45.45"
"Copiah","1","19","Mississippi","4/8/20","9","10","28029","111.11"
"Covington","1","7","Mississippi","4/8/20","3","4","28031","133.33"
"DeSoto","7","144","Mississippi","4/8/20","94","50","28033","53.19"
"Forrest","5","59","Mississippi","4/8/20","27","32","28035","118.52"
"Franklin","0","5","Mississippi","4/8/20","3","2","28037","66.67"
"George","0","5","Mississippi","4/8/20","4","1","28039","25"
"Greene","0","1","Mississippi","4/8/20","0","1","28041","1"
"Grenada","1","8","Mississippi","4/8/20","3","5","28043","166.67"
"Hancock","2","32","Mississippi","4/8/20","20","12","28045","60"
"Harrison","6","88","Mississippi","4/8/20","49","39","28047","79.59"
"Hinds","10","178","Mississippi","4/8/20","109","69","28049","63.3"
"Holmes","2","27","Mississippi","4/8/20","16","11","28051","68.75"
"Humphreys","0","6","Mississippi","4/8/20","4","2","28053","50"
"Itawamba","0","5","Mississippi","4/8/20","4","1","28057","25"
"Jackson","8","111","Mississippi","4/8/20","52","59","28059","113.46"
"Jasper","0","4","Mississippi","4/8/20","1","3","28061","300"
"Jefferson","0","4","Mississippi","4/8/20","1","3","28063","300"
"Jones","1","15","Mississippi","4/8/20","6","9","28067","150"
"Kemper","1","11","Mississippi","4/8/20","1","10","28069","1000"
"Lafayette","2","26","Mississippi","4/8/20","15","11","28071","73.33"
"Lamar","2","19","Mississippi","4/8/20","6","13","28073","216.67"
"Lauderdale","6","84","Mississippi","4/8/20","39","45","28075","115.38"
"Lawrence","0","6","Mississippi","4/8/20","5","1","28077","20"
"Leake","1","15","Mississippi","4/8/20","5","10","28079","200"
"Lee","2","40","Mississippi","4/8/20","25","15","28081","60"
"Leflore","1","28","Mississippi","4/8/20","20","8","28083","40"
"Lincoln","2","26","Mississippi","4/8/20","13","13","28085","100"
"Lowndes","1","17","Mississippi","4/8/20","11","6","28087","54.55"
"Madison","4","83","Mississippi","4/8/20","53","30","28089","56.6"
"Marion","1","14","Mississippi","4/8/20","6","8","28091","133.33"
"Marshall","1","24","Mississippi","4/8/20","15","9","28093","60"
"Monroe","2","19","Mississippi","4/8/20","7","12","28095","171.43"
"Montgomery","1","12","Mississippi","4/8/20","8","4","28097","50"
"Neshoba","1","13","Mississippi","4/8/20","5","8","28099","160"
"Newton","1","7","Mississippi","4/8/20","2","5","28101","250"
"Noxubee","0","5","Mississippi","4/8/20","3","2","28103","66.67"
"Oktibbeha","2","30","Mississippi","4/8/20","18","12","28105","66.67"
"Panola","2","19","Mississippi","4/8/20","8","11","28107","137.5"
"Pearl River","4","60","Mississippi","4/8/20","32","28","28109","87.5"
"Perry","1","14","Mississippi","4/8/20","5","9","28111","180"
"Pike","2","33","Mississippi","4/8/20","20","13","28113","65"
"Pontotoc","1","13","Mississippi","4/8/20","6","7","28115","116.67"
"Prentiss","1","10","Mississippi","4/8/20","4","6","28117","150"
"Quitman","1","12","Mississippi","4/8/20","4","8","28119","200"
"Rankin","4","79","Mississippi","4/8/20","48","31","28121","64.58"
"Scott","3","34","Mississippi","4/8/20","12","22","28123","183.33"
"Sharkey","0","3","Mississippi","4/8/20","2","1","28125","50"
"Simpson","0","6","Mississippi","4/8/20","3","3","28127","100"
"Smith","2","15","Mississippi","4/8/20","1","14","28129","1400"
"Stone","1","4","Mississippi","4/8/20","0","4","28131","1"
"Sunflower","2","27","Mississippi","4/8/20","12","15","28133","125"
"Tallahatchie","0","3","Mississippi","4/8/20","2","1","28135","50"
"Tate","1","18","Mississippi","4/8/20","11","7","28137","63.64"
"Tippah","1","37","Mississippi","4/8/20","28","9","28139","32.14"
"Tishomingo","0","1","Mississippi","4/8/20","1","0","28141","0"
"Tunica","1","17","Mississippi","4/8/20","13","4","28143","30.77"
"Union","0","6","Mississippi","4/8/20","3","3","28145","100"
"Walthall","1","15","Mississippi","4/8/20","7","8","28147","114.29"
"Warren","1","9","Mississippi","4/8/20","2","7","28149","350"
"Washington","3","41","Mississippi","4/8/20","22","19","28151","86.36"
"Wayne","1","5","Mississippi","4/8/20","0","5","28153","1"
"Webster","1","13","Mississippi","4/8/20","7","6","28155","85.71"
"Wilkinson","2","33","Mississippi","4/8/20","16","17","28157","106.25"
"Winston","1","16","Mississippi","4/8/20","9","7","28159","77.78"
"Yalobusha","1","11","Mississippi","4/8/20","6","5","28161","83.33"
"Yazoo","4","38","Mississippi","4/8/20","9","29","28163","322.22"
"Adair","1","11","Missouri","4/8/20","3","8","29001","266.67"
"Atchison","0","1","Missouri","4/8/20","1","0","29005","0"
"Barry","0","1","Missouri","4/8/20","1","0","29009","0"
"Bates","0","3","Missouri","4/8/20","2","1","29013","50"
"Benton","0","3","Missouri","4/8/20","3","0","29015","0"
"Bollinger","0","2","Missouri","4/8/20","1","1","29017","100"
"Boone","2","77","Missouri","4/8/20","66","11","29019","16.67"
"Buchanan","1","14","Missouri","4/8/20","5","9","29021","180"
"Butler","1","5","Missouri","4/8/20","1","4","29023","400"
"Caldwell","0","1","Missouri","4/8/20","1","0","29025","0"
"Callaway","0","19","Missouri","4/8/20","17","2","29027","11.76"
"Camden","1","24","Missouri","4/8/20","17","7","29029","41.18"
"Cape Girardeau","1","20","Missouri","4/8/20","15","5","29031","33.33"
"Carter","0","3","Missouri","4/8/20","4","-1","29035","-25"
"Cass","1","25","Missouri","4/8/20","17","8","29037","47.06"
"Cedar","0","7","Missouri","4/8/20","5","2","29039","40"
"Chariton","0","4","Missouri","4/8/20","4","0","29041","0"
"Christian","1","17","Missouri","4/8/20","12","5","29043","41.67"
"Clark","0","1","Missouri","4/8/20","0","1","29045","1"
"Clay","2","37","Missouri","4/8/20","21","16","29047","76.19"
"Clinton","0","8","Missouri","4/8/20","5","3","29049","60"
"Cole","1","32","Missouri","4/8/20","25","7","29051","28"
"Cooper","0","2","Missouri","4/8/20","2","0","29053","0"
"Crawford","0","3","Missouri","4/8/20","1","2","29055","200"
"Dallas","0","1","Missouri","4/8/20","0","1","29059","1"
"DeKalb","0","1","Missouri","4/8/20","1","0","29063","0"
"Dunklin","0","9","Missouri","4/8/20","6","3","29069","50"
"Franklin","3","35","Missouri","4/8/20","16","19","29071","118.75"
"Gasconade","0","2","Missouri","4/8/20","1","1","29073","100"
"Gentry","0","1","Missouri","4/8/20","0","1","29075","1"
"Greene","3","72","Missouri","4/8/20","51","21","29077","41.18"
"Harrison","0","4","Missouri","4/8/20","1","3","29081","300"
"Henry","0","2","Missouri","4/8/20","1","1","29083","100"
"Howard","0","1","Missouri","4/8/20","0","1","29089","1"
"Howell","1","4","Missouri","4/8/20","0","4","29091","1"
"Jackson","11","162","Missouri","4/8/20","86","76","29095","88.37"
"Jasper","1","15","Missouri","4/8/20","7","8","29097","114.29"
"Jefferson","8","93","Missouri","4/8/20","38","55","29099","144.74"
"Johnson","2","33","Missouri","4/8/20","19","14","29101","73.68"
"Kansas City","15","234","Missouri","4/8/20","128","106","00000","82.81"
"Lafayette","1","28","Missouri","4/8/20","20","8","29107","40"
"Lincoln","2","24","Missouri","4/8/20","10","14","29113","140"
"Linn","0","3","Missouri","4/8/20","0","3","29115","1"
"Livingston","0","1","Missouri","4/8/20","1","0","29117","0"
"Macon","0","2","Missouri","4/8/20","3","-1","29121","-33.33"
"Madison","0","1","Missouri","4/8/20","0","1","29123","1"
"Maries","0","2","Missouri","4/8/20","2","0","29125","0"
"McDonald","0","3","Missouri","4/8/20","2","1","29119","50"
"Moniteau","0","4","Missouri","4/8/20","2","2","29135","100"
"Montgomery","0","5","Missouri","4/8/20","2","3","29139","150"
"Morgan","0","1","Missouri","4/8/20","1","0","29141","0"
"New Madrid","1","5","Missouri","4/8/20","0","5","29143","1"
"Newton","0","6","Missouri","4/8/20","5","1","29145","20"
"Nodaway","0","2","Missouri","4/8/20","0","2","29147","1"
"Oregon","0","1","Missouri","4/8/20","0","1","29149","1"
"Osage","0","4","Missouri","4/8/20","2","2","29151","100"
"Pemiscot","0","3","Missouri","4/8/20","2","1","29155","50"
"Perry","2","31","Missouri","4/8/20","18","13","29157","72.22"
"Pettis","0","3","Missouri","4/8/20","1","2","29159","200"
"Phelps","0","1","Missouri","4/8/20","0","1","29161","1"
"Pike","0","4","Missouri","4/8/20","1","3","29163","300"
"Platte","1","18","Missouri","4/8/20","12","6","29165","50"
"Polk","0","1","Missouri","4/8/20","0","1","29167","1"
"Pulaski","1","12","Missouri","4/8/20","8","4","29169","50"
"Ralls","0","1","Missouri","4/8/20","1","0","29173","0"
"Randolph","1","7","Missouri","4/8/20","2","5","29175","250"
"Ray","1","7","Missouri","4/8/20","1","6","29177","600"
"Reynolds","0","2","Missouri","4/8/20","2","0","29179","0"
"Ripley","0","2","Missouri","4/8/20","2","0","29181","0"
"Saline","1","5","Missouri","4/8/20","0","5","29195","1"
"Scotland","0","1","Missouri","4/8/20","0","1","29199","1"
"Scott","1","11","Missouri","4/8/20","6","5","29201","83.33"
"Shelby","0","1","Missouri","4/8/20","1","0","29205","0"
"St. Charles","25","271","Missouri","4/8/20","93","178","29183","191.4"
"St. Francois","2","19","Missouri","4/8/20","6","13","29187","216.67"
"St. Louis","102","1467","Missouri","4/8/20","751","716","29189","95.34"
"St. Louis City","39","514","Missouri","4/8/20","239","275","29510","115.06"
"Ste. Genevieve","0","6","Missouri","4/8/20","3","3","29186","100"
"Stoddard","1","8","Missouri","4/8/20","3","5","29207","166.67"
"Stone","0","3","Missouri","4/8/20","2","1","29209","50"
"Taney","1","7","Missouri","4/8/20","2","5","29213","250"
"Texas","0","0","Missouri","4/8/20","1","-1","29215","-100"
"Warren","1","13","Missouri","4/8/20","6","7","29219","116.67"
"Webster","0","3","Missouri","4/8/20","2","1","29225","50"
"Worth","0","1","Missouri","4/8/20","0","1","29227","1"
"Wright","0","7","Missouri","4/8/20","4","3","29229","75"
"Beaverhead","0","1","Montana","4/8/20","0","1","30001","1"
"Broadwater","0","4","Montana","4/8/20","3","1","30007","33.33"
"Carbon","0","3","Montana","4/8/20","0","3","30009","1"
"Cascade","0","11","Montana","4/8/20","9","2","30013","22.22"
"Deer Lodge","0","3","Montana","4/8/20","3","0","30023","0"
"Flathead","2","31","Montana","4/8/20","14","17","30029","121.43"
"Gallatin","6","120","Montana","4/8/20","76","44","30031","57.89"
"Glacier","0","2","Montana","4/8/20","0","2","30035","1"
"Hill","0","1","Montana","4/8/20","1","0","30041","0"
"Jefferson","0","2","Montana","4/8/20","2","0","30043","0"
"Lake","0","5","Montana","4/8/20","4","1","30047","25"
"Lewis and Clark","0","16","Montana","4/8/20","14","2","30049","14.29"
"Liberty","0","1","Montana","4/8/20","1","0","30051","0"
"Lincoln","0","7","Montana","4/8/20","5","2","30053","40"
"Madison","0","8","Montana","4/8/20","6","2","30057","33.33"
"Meagher","0","1","Montana","4/8/20","1","0","30059","0"
"Missoula","2","25","Montana","4/8/20","14","11","30063","78.57"
"Musselshell","0","1","Montana","4/8/20","1","0","30065","0"
"Park","1","7","Montana","4/8/20","3","4","30067","133.33"
"Ravalli","0","3","Montana","4/8/20","1","2","30081","200"
"Richland","0","2","Montana","4/8/20","0","2","30083","1"
"Roosevelt","0","2","Montana","4/8/20","1","1","30085","100"
"Silver Bow","0","11","Montana","4/8/20","10","1","30093","10"
"Toole","1","17","Montana","4/8/20","7","10","30101","142.86"
"Yellowstone","2","48","Montana","4/8/20","32","16","30111","50"
"Adams","3","27","Nebraska","4/8/20","4","23","31001","575"
"Antelope","0","1","Nebraska","4/8/20","1","0","31003","0"
"Buffalo","3","28","Nebraska","4/8/20","7","21","31019","300"
"Cass","0","3","Nebraska","4/8/20","2","1","31025","50"
"Cherry","0","1","Nebraska","4/8/20","0","1","31031","1"
"Cheyenne","0","1","Nebraska","4/8/20","0","1","31033","1"
"Colfax","0","3","Nebraska","4/8/20","0","3","31037","1"
"Cuming","0","2","Nebraska","4/8/20","1","1","31039","100"
"Custer","0","3","Nebraska","4/8/20","0","3","31041","1"
"Dawson","0","1","Nebraska","4/8/20","1","0","31047","0"
"Dodge","0","7","Nebraska","4/8/20","4","3","31053","75"
"Douglas","11","181","Nebraska","4/8/20","101","80","31055","79.21"
"Gage","3","23","Nebraska","4/8/20","0","23","31067","1"
"Gosper","0","1","Nebraska","4/8/20","1","0","31073","0"
"Hall","8","69","Nebraska","4/8/20","15","54","31079","360"
"Hamilton","1","7","Nebraska","4/8/20","0","7","31081","1"
"Johnson","0","1","Nebraska","4/8/20","0","1","31097","1"
"Kearney","0","3","Nebraska","4/8/20","1","2","31099","200"
"Kimball","1","9","Nebraska","4/8/20","1","8","31105","800"
"Knox","0","2","Nebraska","4/8/20","2","0","31107","0"
"Lancaster","4","39","Nebraska","4/8/20","9","30","31109","333.33"
"Lincoln","1","17","Nebraska","4/8/20","9","8","31111","88.89"
"Madison","0","5","Nebraska","4/8/20","3","2","31119","66.67"
"Merrick","0","2","Nebraska","4/8/20","0","2","31121","1"
"Nemaha","0","1","Nebraska","4/8/20","1","0","31127","0"
"Otoe","0","1","Nebraska","4/8/20","0","1","31131","1"
"Phelps","0","1","Nebraska","4/8/20","0","1","31137","1"
"Platte","0","5","Nebraska","4/8/20","2","3","31141","150"
"Sarpy","3","37","Nebraska","4/8/20","17","20","31153","117.65"
"Saunders","0","4","Nebraska","4/8/20","2","2","31155","100"
"Scotts Bluff","1","10","Nebraska","4/8/20","3","7","31157","233.33"
"Seward","0","1","Nebraska","4/8/20","0","1","31159","1"
"Stanton","0","1","Nebraska","4/8/20","0","1","31167","1"
"Washington","0","20","Nebraska","4/8/20","19","1","31177","5.26"
"York","0","2","Nebraska","4/8/20","1","1","31185","100"
"Carson City","1","13","Nevada","4/8/20","5","8","32510","160"
"Clark","131","1878","Nevada","4/8/20","961","917","32003","95.42"
"Douglas","0","8","Nevada","4/8/20","6","2","32005","33.33"
"Elko","0","8","Nevada","4/8/20","5","3","32007","60"
"Humboldt","1","14","Nevada","4/8/20","5","9","32013","180"
"Lyon","0","4","Nevada","4/8/20","1","3","32019","300"
"Nye","0","7","Nevada","4/8/20","4","3","32023","75"
"Washoe","26","326","Nevada","4/8/20","143","183","32031","127.97"
"White Pine","0","1","Nevada","4/8/20","1","0","32033","0"
"Belknap","1","21","New Hampshire","4/8/20","12","9","33001","75"
"Carroll","1","19","New Hampshire","4/8/20","12","7","33003","58.33"
"Cheshire","1","13","New Hampshire","4/8/20","4","9","33005","225"
"Coos","0","1","New Hampshire","4/8/20","0","1","33007","1"
"Grafton","1","41","New Hampshire","4/8/20","34","7","33009","20.59"
"Hillsborough","26","288","New Hampshire","4/8/20","109","179","33011","164.22"
"Merrimack","4","56","New Hampshire","4/8/20","27","29","33013","107.41"
"Rockingham","17","255","New Hampshire","4/8/20","137","118","33015","86.13"
"Strafford","3","46","New Hampshire","4/8/20","28","18","33017","64.29"
"Sullivan","0","6","New Hampshire","4/8/20","4","2","33019","50"
"Atlantic","18","168","New Jersey","4/8/20","40","128","34001","320"
"Bergen","626","7874","New Jersey","4/8/20","3494","4380","34003","125.36"
"Burlington","78","801","New Jersey","4/8/20","255","546","34005","214.12"
"Camden","78","838","New Jersey","4/8/20","289","549","34007","189.97"
"Cape May","11","100","New Jersey","4/8/20","22","78","34009","354.55"
"Cumberland","8","80","New Jersey","4/8/20","27","53","34011","196.3"
"Essex","477","5598","New Jersey","4/8/20","2262","3336","34013","147.48"
"Gloucester","27","340","New Jersey","4/8/20","149","191","34015","128.19"
"Hudson","504","5437","New Jersey","4/8/20","1910","3527","34017","184.66"
"Hunterdon","20","255","New Jersey","4/8/20","117","138","34019","117.95"
"Mercer","94","992","New Jersey","4/8/20","333","659","34021","197.9"
"Middlesex","380","4156","New Jersey","4/8/20","1493","2663","34023","178.37"
"Monmouth","248","3038","New Jersey","4/8/20","1301","1737","34025","133.51"
"Morris","218","2468","New Jersey","4/8/20","942","1526","34027","162"
"Ocean","235","2856","New Jersey","4/8/20","1209","1647","34029","136.23"
"Passaic","411","4372","New Jersey","4/8/20","1494","2878","34031","192.64"
"Salem","2","36","New Jersey","4/8/20","19","17","34033","89.47"
"Somerset","98","1160","New Jersey","4/8/20","472","688","34035","145.76"
"Sussex","28","357","New Jersey","4/8/20","158","199","34037","125.95"
"Union","453","4831","New Jersey","4/8/20","1661","3170","34039","190.85"
"Warren","28","289","New Jersey","4/8/20","96","193","34041","201.04"
"Bernalillo","25","307","New Mexico","4/8/20","129","178","35001","137.98"
"Catron","0","1","New Mexico","4/8/20","0","1","35003","1"
"Chaves","1","15","New Mexico","4/8/20","10","5","35005","50"
"Cibola","2","16","New Mexico","4/8/20","4","12","35006","300"
"Curry","1","8","New Mexico","4/8/20","3","5","35009","166.67"
"Dona Ana","2","35","New Mexico","4/8/20","18","17","35013","94.44"
"Eddy","0","4","New Mexico","4/8/20","4","0","35015","0"
"Grant","1","4","New Mexico","4/8/20","0","4","35017","1"
"Lea","0","2","New Mexico","4/8/20","2","0","35025","0"
"Lincoln","0","1","New Mexico","4/8/20","0","1","35027","1"
"Los Alamos","0","2","New Mexico","4/8/20","0","2","35028","1"
"McKinley","7","70","New Mexico","4/8/20","20","50","35031","250"
"Otero","0","3","New Mexico","4/8/20","1","2","35035","200"
"Rio Arriba","0","6","New Mexico","4/8/20","4","2","35039","50"
"Roosevelt","0","1","New Mexico","4/8/20","1","0","35041","0"
"San Juan","11","116","New Mexico","4/8/20","37","79","35045","213.51"
"San Miguel","0","1","New Mexico","4/8/20","1","0","35047","0"
"Sandoval","14","128","New Mexico","4/8/20","29","99","35043","341.38"
"Santa Fe","3","66","New Mexico","4/8/20","42","24","35049","57.14"
"Socorro","1","7","New Mexico","4/8/20","3","4","35053","133.33"
"Taos","0","14","New Mexico","4/8/20","11","3","35055","27.27"
"Torrance","1","7","New Mexico","4/8/20","3","4","35057","133.33"
"Valencia","0","7","New Mexico","4/8/20","5","2","35061","40"
"Albany","15","342","New York","4/8/20","240","102","36001","42.5"
"Allegany","2","21","New York","4/8/20","10","11","36003","110"
"Broome","7","93","New York","4/8/20","42","51","36007","121.43"
"Cattaraugus","1","15","New York","4/8/20","7","8","36009","114.29"
"Cayuga","1","14","New York","4/8/20","4","10","36011","250"
"Chautauqua","1","18","New York","4/8/20","8","10","36013","125"
"Chemung","5","55","New York","4/8/20","22","33","36015","150"
"Chenango","4","53","New York","4/8/20","26","27","36017","103.85"
"Clinton","2","39","New York","4/8/20","25","14","36019","56"
"Columbia","5","76","New York","4/8/20","41","35","36021","85.37"
"Cortland","1","16","New York","4/8/20","10","6","36023","60"
"Delaware","2","37","New York","4/8/20","20","17","36025","85"
"Dutchess","121","1395","New York","4/8/20","547","848","36027","155.03"
"Erie","108","1335","New York","4/8/20","582","753","36029","129.38"
"Essex","0","9","New York","4/8/20","6","3","36031","50"
"Franklin","0","10","New York","4/8/20","9","1","36033","11.11"
"Fulton","2","14","New York","4/8/20","2","12","36035","600"
"Genesee","5","47","New York","4/8/20","13","34","36037","261.54"
"Greene","1","25","New York","4/8/20","18","7","36039","38.89"
"Hamilton","0","2","New York","4/8/20","2","0","36041","0"
"Herkimer","2","29","New York","4/8/20","12","17","36043","141.67"
"Jefferson","4","40","New York","4/8/20","12","28","36045","233.33"
"Lewis","1","6","New York","4/8/20","2","4","36049","200"
"Livingston","2","29","New York","4/8/20","18","11","36051","61.11"
"Madison","4","92","New York","4/8/20","62","30","36053","48.39"
"Monroe","43","651","New York","4/8/20","349","302","36055","86.53"
"Montgomery","2","18","New York","4/8/20","7","11","36057","157.14"
"Nassau","1285","18548","New York","4/8/20","9554","8994","36059","94.14"
"New York","4909","81803","New York","4/8/20","47439","34364","36061","72.44"
"Niagara","16","155","New York","4/8/20","46","109","36063","236.96"
"Oneida","11","125","New York","4/8/20","50","75","36065","150"
"Onondaga","21","422","New York","4/8/20","277","145","36067","52.35"
"Ontario","2","39","New York","4/8/20","24","15","36069","62.5"
"Orange","331","4075","New York","4/8/20","1756","2319","36071","132.06"
"Orleans","1","16","New York","4/8/20","6","10","36073","166.67"
"Oswego","2","34","New York","4/8/20","20","14","36075","70"
"Otsego","3","38","New York","4/8/20","19","19","36077","100"
"Putnam","31","427","New York","4/8/20","207","220","36079","106.28"
"Rensselaer","5","88","New York","4/8/20","55","33","36083","60"
"Rockland","442","6413","New York","4/8/20","3321","3092","36087","93.1"
"Saratoga","6","162","New York","4/8/20","122","40","36091","32.79"
"Schenectady","8","149","New York","4/8/20","93","56","36093","60.22"
"Schoharie","0","12","New York","4/8/20","9","3","36095","33.33"
"Schuyler","0","4","New York","4/8/20","2","2","36097","100"
"Seneca","1","12","New York","4/8/20","2","10","36099","500"
"St. Lawrence","6","78","New York","4/8/20","34","44","36089","129.41"
"Steuben","7","87","New York","4/8/20","38","49","36101","128.95"
"Suffolk","1343","17008","New York","4/8/20","7605","9403","36103","123.64"
"Sullivan","25","296","New York","4/8/20","121","175","36105","144.63"
"Tioga","1","15","New York","4/8/20","8","7","36107","87.5"
"Tompkins","4","105","New York","4/8/20","76","29","36109","38.16"
"Ulster","34","462","New York","4/8/20","222","240","36111","108.11"
"Warren","2","33","New York","4/8/20","18","15","36113","83.33"
"Washington","1","20","New York","4/8/20","11","9","36115","81.82"
"Wayne","2","39","New York","4/8/20","24","15","36117","62.5"
"Westchester","743","15887","New York","4/8/20","10683","5204","36119","48.71"
"Wyoming","2","27","New York","4/8/20","10","17","36121","170"
"Yates","0","1","New York","4/8/20","0","1","36123","1"
"Alamance","3","30","North Carolina","4/8/20","7","23","37001","328.57"
"Alexander","0","2","North Carolina","4/8/20","2","0","37003","0"
"Alleghany","0","2","North Carolina","4/8/20","2","0","37005","0"
"Anson","1","6","North Carolina","4/8/20","1","5","37007","500"
"Ashe","0","2","North Carolina","4/8/20","0","2","37009","1"
"Beaufort","0","10","North Carolina","4/8/20","7","3","37013","42.86"
"Bertie","1","10","North Carolina","4/8/20","6","4","37015","66.67"
"Bladen","0","1","North Carolina","4/8/20","0","1","37017","1"
"Brunswick","1","26","North Carolina","4/8/20","16","10","37019","62.5"
"Buncombe","2","37","North Carolina","4/8/20","22","15","37021","68.18"
"Burke","4","34","North Carolina","4/8/20","6","28","37023","466.67"
"Cabarrus","6","88","North Carolina","4/8/20","47","41","37025","87.23"
"Caldwell","1","11","North Carolina","4/8/20","3","8","37027","266.67"
"Carteret","1","19","North Carolina","4/8/20","14","5","37031","35.71"
"Caswell","0","2","North Carolina","4/8/20","1","1","37033","100"
"Catawba","2","28","North Carolina","4/8/20","16","12","37035","75"
"Chatham","1","24","North Carolina","4/8/20","16","8","37037","50"
"Cherokee","0","12","North Carolina","4/8/20","11","1","37039","9.09"
"Chowan","0","1","North Carolina","4/8/20","0","1","37041","1"
"Clay","0","3","North Carolina","4/8/20","3","0","37043","0"
"Cleveland","3","26","North Carolina","4/8/20","6","20","37045","333.33"
"Columbus","1","14","North Carolina","4/8/20","4","10","37047","250"
"Craven","2","19","North Carolina","4/8/20","7","12","37049","171.43"
"Cumberland","6","66","North Carolina","4/8/20","24","42","37051","175"
"Currituck","0","3","North Carolina","4/8/20","1","2","37053","200"
"Dare","1","10","North Carolina","4/8/20","2","8","37055","400"
"Davidson","5","73","North Carolina","4/8/20","41","32","37057","78.05"
"Davie","1","20","North Carolina","4/8/20","12","8","37059","66.67"
"Duplin","1","8","North Carolina","4/8/20","2","6","37061","300"
"Durham","16","236","North Carolina","4/8/20","126","110","37063","87.3"
"Edgecombe","1","12","North Carolina","4/8/20","3","9","37065","300"
"Forsyth","7","108","North Carolina","4/8/20","57","51","37067","89.47"
"Franklin","2","23","North Carolina","4/8/20","11","12","37069","109.09"
"Gaston","4","62","North Carolina","4/8/20","31","31","37071","100"
"Gates","0","3","North Carolina","4/8/20","0","3","37073","1"
"Granville","10","83","North Carolina","4/8/20","16","67","37077","418.75"
"Greene","1","10","North Carolina","4/8/20","4","6","37079","150"
"Guilford","10","122","North Carolina","4/8/20","55","67","37081","121.82"
"Halifax","1","14","North Carolina","4/8/20","6","8","37083","133.33"
"Harnett","2","34","North Carolina","4/8/20","18","16","37085","88.89"
"Haywood","0","3","North Carolina","4/8/20","0","3","37087","1"
"Henderson","5","51","North Carolina","4/8/20","18","33","37089","183.33"
"Hertford","0","5","North Carolina","4/8/20","4","1","37091","25"
"Hoke","1","13","North Carolina","4/8/20","4","9","37093","225"
"Iredell","5","57","North Carolina","4/8/20","25","32","37097","128"
"Jackson","0","2","North Carolina","4/8/20","1","1","37099","100"
"Johnston","5","51","North Carolina","4/8/20","17","34","37101","200"
"Jones","0","3","North Carolina","4/8/20","0","3","37103","1"
"Lee","0","5","North Carolina","4/8/20","3","2","37105","66.67"
"Lenoir","1","11","North Carolina","4/8/20","3","8","37107","266.67"
"Lincoln","1","11","North Carolina","4/8/20","4","7","37109","175"
"Macon","0","1","North Carolina","4/8/20","0","1","37113","1"
"Martin","0","4","North Carolina","4/8/20","3","1","37117","33.33"
"McDowell","1","13","North Carolina","4/8/20","8","5","37111","62.5"
"Mecklenburg","58","848","North Carolina","4/8/20","444","404","37119","90.99"
"Mitchell","0","3","North Carolina","4/8/20","1","2","37121","200"
"Montgomery","1","13","North Carolina","4/8/20","5","8","37123","160"
"Moore","4","37","North Carolina","4/8/20","8","29","37125","362.5"
"Nash","2","25","North Carolina","4/8/20","11","14","37127","127.27"
"New Hanover","3","53","North Carolina","4/8/20","34","19","37129","55.88"
"Northampton","3","54","North Carolina","4/8/20","30","24","37131","80"
"Onslow","2","24","North Carolina","4/8/20","7","17","37133","242.86"
"Orange","7","81","North Carolina","4/8/20","34","47","37135","138.24"
"Pamlico","0","3","North Carolina","4/8/20","1","2","37137","200"
"Pasquotank","1","10","North Carolina","4/8/20","4","6","37139","150"
"Pender","0","2","North Carolina","4/8/20","0","2","37141","1"
"Perquimans","0","2","North Carolina","4/8/20","1","1","37143","100"
"Person","1","7","North Carolina","4/8/20","2","5","37145","250"
"Pitt","3","51","North Carolina","4/8/20","27","24","37147","88.89"
"Polk","1","8","North Carolina","4/8/20","4","4","37149","100"
"Randolph","3","37","North Carolina","4/8/20","17","20","37151","117.65"
"Richmond","0","2","North Carolina","4/8/20","0","2","37153","1"
"Robeson","1","7","North Carolina","4/8/20","3","4","37155","133.33"
"Rockingham","1","8","North Carolina","4/8/20","2","6","37157","300"
"Rowan","6","64","North Carolina","4/8/20","24","40","37159","166.67"
"Rutherford","3","25","North Carolina","4/8/20","5","20","37161","400"
"Sampson","1","5","North Carolina","4/8/20","1","4","37163","400"
"Scotland","0","3","North Carolina","4/8/20","2","1","37165","50"
"Stanly","0","8","North Carolina","4/8/20","5","3","37167","60"
"Stokes","1","8","North Carolina","4/8/20","2","6","37169","300"
"Surry","1","10","North Carolina","4/8/20","2","8","37171","400"
"Swain","0","1","North Carolina","4/8/20","0","1","37173","1"
"Transylvania","0","6","North Carolina","4/8/20","5","1","37175","20"
"Union","6","87","North Carolina","4/8/20","47","40","37179","85.11"
"Vance","1","14","North Carolina","4/8/20","5","9","37181","180"
"Wake","22","365","North Carolina","4/8/20","213","152","37183","71.36"
"Warren","0","3","North Carolina","4/8/20","0","3","37185","1"
"Washington","1","8","North Carolina","4/8/20","2","6","37187","300"
"Watauga","0","8","North Carolina","4/8/20","6","2","37189","33.33"
"Wayne","4","34","North Carolina","4/8/20","5","29","37191","580"
"Wilkes","0","4","North Carolina","4/8/20","2","2","37193","100"
"Wilson","3","38","North Carolina","4/8/20","15","23","37195","153.33"
"Yadkin","1","9","North Carolina","4/8/20","3","6","37197","200"
"Barnes","0","2","North Dakota","4/8/20","2","0","38003","0"
"Bowman","0","1","North Dakota","4/8/20","0","1","38011","1"
"Burke","0","2","North Dakota","4/8/20","2","0","38013","0"
"Burleigh","1","42","North Dakota","4/8/20","32","10","38015","31.25"
"Cass","6","77","North Dakota","4/8/20","34","43","38017","126.47"
"Divide","0","1","North Dakota","4/8/20","1","0","38023","0"
"Dunn","0","1","North Dakota","4/8/20","1","0","38025","0"
"Eddy","0","1","North Dakota","4/8/20","0","1","38027","1"
"Emmons","0","1","North Dakota","4/8/20","0","1","38029","1"
"Foster","0","1","North Dakota","4/8/20","1","0","38031","0"
"Grand Forks","1","11","North Dakota","4/8/20","5","6","38035","120"
"Grant","0","1","North Dakota","4/8/20","1","0","38037","0"
"McHenry","0","1","North Dakota","4/8/20","1","0","38049","0"
"McIntosh","0","1","North Dakota","4/8/20","1","0","38051","0"
"McKenzie","1","5","North Dakota","4/8/20","1","4","38053","400"
"McLean","0","2","North Dakota","4/8/20","2","0","38055","0"
"Morton","1","18","North Dakota","4/8/20","14","4","38059","28.57"
"Mountrail","2","20","North Dakota","4/8/20","6","14","38061","233.33"
"Oliver","0","1","North Dakota","4/8/20","1","0","38065","0"
"Pierce","0","2","North Dakota","4/8/20","2","0","38069","0"
"Ramsey","0","3","North Dakota","4/8/20","3","0","38071","0"
"Rolette","0","0","North Dakota","4/8/20","1","-1","38079","-100"
"Sioux","0","1","North Dakota","4/8/20","1","0","38085","0"
"Slope","0","3","North Dakota","4/8/20","0","3","38087","1"
"Stark","2","28","North Dakota","4/8/20","14","14","38089","100"
"Stutsman","0","1","North Dakota","4/8/20","0","1","38093","1"
"Walsh","0","3","North Dakota","4/8/20","1","2","38099","200"
"Ward","1","16","North Dakota","4/8/20","12","4","38101","33.33"
"Williams","0","5","North Dakota","4/8/20","3","2","38105","66.67"
"","1","11","Northern Mariana Islands","4/8/20","6","5",,"83.33"
"Adams","0","2","Ohio","4/8/20","0","2","39001","1"
"Allen","2","23","Ohio","4/8/20","6","17","39003","283.33"
"Ashland","0","3","Ohio","4/8/20","2","1","39005","50"
"Ashtabula","2","20","Ohio","4/8/20","6","14","39007","233.33"
"Athens","0","3","Ohio","4/8/20","3","0","39009","0"
"Auglaize","1","8","Ohio","4/8/20","3","5","39011","166.67"
"Belmont","3","30","Ohio","4/8/20","11","19","39013","172.73"
"Brown","0","4","Ohio","4/8/20","2","2","39015","100"
"Butler","9","102","Ohio","4/8/20","41","61","39017","148.78"
"Carroll","1","9","Ohio","4/8/20","5","4","39019","80"
"Champaign","0","5","Ohio","4/8/20","4","1","39021","25"
"Clark","1","13","Ohio","4/8/20","6","7","39023","116.67"
"Clermont","2","27","Ohio","4/8/20","11","16","39025","145.45"
"Clinton","1","11","Ohio","4/8/20","4","7","39027","175"
"Columbiana","7","71","Ohio","4/8/20","19","52","39029","273.68"
"Coshocton","0","10","Ohio","4/8/20","7","3","39031","42.86"
"Crawford","1","9","Ohio","4/8/20","5","4","39033","80"
"Cuyahoga","53","960","Ohio","4/8/20","589","371","39035","62.99"
"Darke","2","38","Ohio","4/8/20","22","16","39037","72.73"
"Defiance","1","10","Ohio","4/8/20","6","4","39039","66.67"
"Delaware","5","79","Ohio","4/8/20","47","32","39041","68.09"
"Erie","1","10","Ohio","4/8/20","5","5","39043","100"
"Fairfield","6","65","Ohio","4/8/20","22","43","39045","195.45"
"Fayette","0","4","Ohio","4/8/20","1","3","39047","300"
"Franklin","53","761","Ohio","4/8/20","391","370","39049","94.63"
"Fulton","0","5","Ohio","4/8/20","2","3","39051","150"
"Gallia","0","4","Ohio","4/8/20","1","3","39053","300"
"Geauga","3","44","Ohio","4/8/20","25","19","39055","76"
"Greene","2","21","Ohio","4/8/20","8","13","39057","162.5"
"Guernsey","0","2","Ohio","4/8/20","0","2","39059","1"
"Hamilton","40","437","Ohio","4/8/20","154","283","39061","183.77"
"Hancock","2","17","Ohio","4/8/20","6","11","39063","183.33"
"Hardin","0","2","Ohio","4/8/20","0","2","39065","1"
"Henry","0","1","Ohio","4/8/20","0","1","39069","1"
"Highland","1","6","Ohio","4/8/20","2","4","39071","200"
"Holmes","0","3","Ohio","4/8/20","1","2","39075","200"
"Huron","1","9","Ohio","4/8/20","4","5","39077","125"
"Jackson","0","2","Ohio","4/8/20","0","2","39079","1"
"Jefferson","1","18","Ohio","4/8/20","11","7","39081","63.64"
"Knox","0","7","Ohio","4/8/20","4","3","39083","75"
"Lake","7","99","Ohio","4/8/20","48","51","39085","106.25"
"Lawrence","2","13","Ohio","4/8/20","1","12","39087","1200"
"Licking","6","64","Ohio","4/8/20","24","40","39089","166.67"
"Logan","0","5","Ohio","4/8/20","3","2","39091","66.67"
"Lorain","7","136","Ohio","4/8/20","85","51","39093","60"
"Lucas","29","371","Ohio","4/8/20","171","200","39095","116.96"
"Madison","2","20","Ohio","4/8/20","9","11","39097","122.22"
"Mahoning","18","305","Ohio","4/8/20","177","128","39099","72.32"
"Marion","3","32","Ohio","4/8/20","9","23","39101","255.56"
"Medina","5","94","Ohio","4/8/20","59","35","39103","59.32"
"Meigs","0","1","Ohio","4/8/20","0","1","39105","1"
"Mercer","1","11","Ohio","4/8/20","4","7","39107","175"
"Miami","7","107","Ohio","4/8/20","60","47","39109","78.33"
"Monroe","0","2","Ohio","4/8/20","0","2","39111","1"
"Montgomery","15","147","Ohio","4/8/20","41","106","39113","258.54"
"Morgan","0","2","Ohio","4/8/20","0","2","39115","1"
"Morrow","1","6","Ohio","4/8/20","1","5","39117","500"
"Muskingum","1","6","Ohio","4/8/20","2","4","39119","200"
"Ottawa","0","6","Ohio","4/8/20","4","2","39123","50"
"Paulding","0","2","Ohio","4/8/20","0","2","39125","1"
"Perry","1","6","Ohio","4/8/20","2","4","39127","200"
"Pickaway","3","35","Ohio","4/8/20","12","23","39129","191.67"
"Pike","0","1","Ohio","4/8/20","1","0","39131","0"
"Portage","9","108","Ohio","4/8/20","44","64","39133","145.45"
"Preble","1","8","Ohio","4/8/20","1","7","39135","700"
"Richland","2","25","Ohio","4/8/20","8","17","39139","212.5"
"Ross","1","10","Ohio","4/8/20","2","8","39141","400"
"Sandusky","0","5","Ohio","4/8/20","5","0","39143","0"
"Scioto","0","1","Ohio","4/8/20","0","1","39145","1"
"Seneca","0","6","Ohio","4/8/20","4","2","39147","50"
"Shelby","2","19","Ohio","4/8/20","6","13","39149","216.67"
"Stark","9","114","Ohio","4/8/20","52","62","39151","119.23"
"Summit","10","211","Ohio","4/8/20","144","67","39153","46.53"
"Trumbull","10","126","Ohio","4/8/20","58","68","39155","117.24"
"Tuscarawas","2","26","Ohio","4/8/20","14","12","39157","85.71"
"Union","1","8","Ohio","4/8/20","4","4","39159","100"
"Van Wert","0","2","Ohio","4/8/20","2","0","39161","0"
"Warren","3","46","Ohio","4/8/20","23","23","39165","100"
"Washington","4","30","Ohio","4/8/20","3","27","39167","900"
"Wayne","3","30","Ohio","4/8/20","11","19","39169","172.73"
"Williams","0","1","Ohio","4/8/20","0","1","39171","1"
"Wood","4","41","Ohio","4/8/20","15","26","39173","173.33"
"Wyandot","0","5","Ohio","4/8/20","2","3","39175","150"
"Adair","2","25","Oklahoma","4/8/20","8","17","40001","212.5"
"Atoka","0","1","Oklahoma","4/8/20","0","1","40005","1"
"Beaver","0","1","Oklahoma","4/8/20","0","1","40007","1"
"Beckham","0","1","Oklahoma","4/8/20","1","0","40009","0"
"Bryan","0","3","Oklahoma","4/8/20","1","2","40013","200"
"Caddo","1","6","Oklahoma","4/8/20","1","5","40015","500"
"Canadian","2","40","Oklahoma","4/8/20","24","16","40017","66.67"
"Carter","0","1","Oklahoma","4/8/20","1","0","40019","0"
"Cherokee","1","16","Oklahoma","4/8/20","7","9","40021","128.57"
"Choctaw","0","2","Oklahoma","4/8/20","1","1","40023","100"
"Cleveland","18","212","Oklahoma","4/8/20","87","125","40027","143.68"
"Comanche","3","44","Oklahoma","4/8/20","21","23","40031","109.52"
"Cotton","0","4","Oklahoma","4/8/20","1","3","40033","300"
"Craig","0","5","Oklahoma","4/8/20","2","3","40035","150"
"Creek","3","47","Oklahoma","4/8/20","27","20","40037","74.07"
"Custer","0","5","Oklahoma","4/8/20","4","1","40039","25"
"Delaware","1","13","Oklahoma","4/8/20","8","5","40041","62.5"
"Dewey","0","1","Oklahoma","4/8/20","0","1","40043","1"
"Garfield","0","5","Oklahoma","4/8/20","4","1","40047","25"
"Garvin","1","11","Oklahoma","4/8/20","7","4","40049","57.14"
"Grady","1","9","Oklahoma","4/8/20","3","6","40051","200"
"Grant","0","1","Oklahoma","4/8/20","0","1","40053","1"
"Greer","4","32","Oklahoma","4/8/20","2","30","40055","1500"
"Jackson","1","6","Oklahoma","4/8/20","2","4","40065","200"
"Jefferson","0","1","Oklahoma","4/8/20","0","1","40067","1"
"Kay","1","33","Oklahoma","4/8/20","24","9","40071","37.5"
"Kingfisher","0","3","Oklahoma","4/8/20","0","3","40073","1"
"Kiowa","0","1","Oklahoma","4/8/20","0","1","40075","1"
"Latimer","0","4","Oklahoma","4/8/20","2","2","40077","100"
"Le Flore","0","1","Oklahoma","4/8/20","1","0","40079","0"
"Lincoln","1","10","Oklahoma","4/8/20","5","5","40081","100"
"Logan","0","6","Oklahoma","4/8/20","4","2","40083","50"
"Love","0","2","Oklahoma","4/8/20","1","1","40085","100"
"Major","0","1","Oklahoma","4/8/20","0","1","40093","1"
"Marshall","0","1","Oklahoma","4/8/20","0","1","40095","1"
"Mayes","1","12","Oklahoma","4/8/20","5","7","40097","140"
"McClain","1","15","Oklahoma","4/8/20","9","6","40087","66.67"
"McCurtain","0","2","Oklahoma","4/8/20","0","2","40089","1"
"McIntosh","0","1","Oklahoma","4/8/20","0","1","40091","1"
"Muskogee","1","21","Oklahoma","4/8/20","13","8","40101","61.54"
"Noble","0","6","Oklahoma","4/8/20","5","1","40103","20"
"Nowata","1","10","Oklahoma","4/8/20","5","5","40105","100"
"Oklahoma","18","317","Oklahoma","4/8/20","192","125","40109","65.1"
"Okmulgee","1","11","Oklahoma","4/8/20","4","7","40111","175"
"Osage","2","33","Oklahoma","4/8/20","19","14","40113","73.68"
"Ottawa","1","15","Oklahoma","4/8/20","7","8","40115","114.29"
"Out of OK","0","2","Oklahoma","4/8/20","2","0","80040","0"
"Pawnee","1","23","Oklahoma","4/8/20","15","8","40117","53.33"
"Payne","1","24","Oklahoma","4/8/20","16","8","40119","50"
"Pittsburg","1","7","Oklahoma","4/8/20","2","5","40121","250"
"Pontotoc","1","9","Oklahoma","4/8/20","5","4","40123","80"
"Pottawatomie","2","20","Oklahoma","4/8/20","6","14","40125","233.33"
"Rogers","2","19","Oklahoma","4/8/20","4","15","40131","375"
"Seminole","0","4","Oklahoma","4/8/20","1","3","40133","300"
"Sequoyah","1","10","Oklahoma","4/8/20","2","8","40135","400"
"Stephens","1","11","Oklahoma","4/8/20","6","5","40137","83.33"
"Texas","0","3","Oklahoma","4/8/20","1","2","40139","200"
"Tillman","0","1","Oklahoma","4/8/20","0","1","40141","1"
"Tulsa","25","293","Oklahoma","4/8/20","115","178","40143","154.78"
"Wagoner","6","57","Oklahoma","4/8/20","15","42","40145","280"
"Washington","3","45","Oklahoma","4/8/20","23","22","40147","95.65"
"Woodward","0","1","Oklahoma","4/8/20","0","1","40153","1"
"Benton","1","21","Oregon","4/8/20","13","8","41003","61.54"
"Clackamas","6","97","Oregon","4/8/20","56","41","41005","73.21"
"Clatsop","0","5","Oregon","4/8/20","3","2","41007","66.67"
"Columbia","1","8","Oregon","4/8/20","1","7","41009","700"
"Crook","0","1","Oregon","4/8/20","0","1","41013","1"
"Curry","0","2","Oregon","4/8/20","0","2","41015","1"
"Deschutes","2","44","Oregon","4/8/20","27","17","41017","62.96"
"Douglas","0","12","Oregon","4/8/20","10","2","41019","20"
"Grant","0","1","Oregon","4/8/20","1","0","41023","0"
"Hood River","0","2","Oregon","4/8/20","2","0","41027","0"
"Jackson","2","39","Oregon","4/8/20","22","17","41029","77.27"
"Josephine","1","16","Oregon","4/8/20","10","6","41033","60"
"Klamath","2","19","Oregon","4/8/20","5","14","41035","280"
"Lane","2","30","Oregon","4/8/20","18","12","41039","66.67"
"Lincoln","0","4","Oregon","4/8/20","3","1","41041","33.33"
"Linn","1","45","Oregon","4/8/20","37","8","41043","21.62"
"Malheur","0","2","Oregon","4/8/20","1","1","41045","100"
"Marion","9","215","Oregon","4/8/20","151","64","41047","42.38"
"Morrow","0","2","Oregon","4/8/20","1","1","41049","100"
"Multnomah","18","258","Oregon","4/8/20","134","124","41051","92.54"
"Polk","1","28","Oregon","4/8/20","18","10","41053","55.56"
"Sherman","0","1","Oregon","4/8/20","0","1","41055","1"
"Tillamook","0","3","Oregon","4/8/20","3","0","41057","0"
"Umatilla","0","8","Oregon","4/8/20","5","3","41059","60"
"Union","0","3","Oregon","4/8/20","1","2","41061","200"
"Wallowa","0","1","Oregon","4/8/20","1","0","41063","0"
"Wasco","0","7","Oregon","4/8/20","7","0","41065","0"
"Washington","13","282","Oregon","4/8/20","189","93","41067","49.21"
"Yamhill","1","25","Oregon","4/8/20","17","8","41071","47.06"
"Adams","3","33","Pennsylvania","4/8/20","12","21","42001","175"
"Allegheny","52","720","Pennsylvania","4/8/20","356","364","42003","102.25"
"Armstrong","2","19","Pennsylvania","4/8/20","5","14","42005","280"
"Beaver","11","128","Pennsylvania","4/8/20","54","74","42007","137.04"
"Bedford","0","4","Pennsylvania","4/8/20","3","1","42009","33.33"
"Berks","38","416","Pennsylvania","4/8/20","151","265","42011","175.5"
"Blair","0","6","Pennsylvania","4/8/20","4","2","42013","50"
"Bradford","1","15","Pennsylvania","4/8/20","8","7","42015","87.5"
"Bucks","71","816","Pennsylvania","4/8/20","319","497","42017","155.8"
"Butler","7","113","Pennsylvania","4/8/20","64","49","42019","76.56"
"Cambria","1","9","Pennsylvania","4/8/20","3","6","42021","200"
"Cameron","0","1","Pennsylvania","4/8/20","1","0","42023","0"
"Carbon","8","76","Pennsylvania","4/8/20","23","53","42025","230.43"
"Centre","4","57","Pennsylvania","4/8/20","27","30","42027","111.11"
"Chester","27","373","Pennsylvania","4/8/20","183","190","42029","103.83"
"Clarion","1","8","Pennsylvania","4/8/20","4","4","42031","100"
"Clearfield","0","7","Pennsylvania","4/8/20","4","3","42033","75"
"Clinton","0","3","Pennsylvania","4/8/20","0","3","42035","1"
"Columbia","7","54","Pennsylvania","4/8/20","8","46","42037","575"
"Crawford","0","8","Pennsylvania","4/8/20","5","3","42039","60"
"Cumberland","7","84","Pennsylvania","4/8/20","38","46","42041","121.05"
"Dauphin","16","168","Pennsylvania","4/8/20","59","109","42043","184.75"
"Delaware","92","1034","Pennsylvania","4/8/20","390","644","42045","165.13"
"Elk","0","2","Pennsylvania","4/8/20","0","2","42047","1"
"Erie","2","29","Pennsylvania","4/8/20","15","14","42049","93.33"
"Fayette","3","35","Pennsylvania","4/8/20","14","21","42051","150"
"Forest","1","5","Pennsylvania","4/8/20","0","5","42053","1"
"Franklin","3","43","Pennsylvania","4/8/20","21","22","42055","104.76"
"Fulton","0","1","Pennsylvania","4/8/20","0","1","42057","1"
"Greene","1","17","Pennsylvania","4/8/20","9","8","42059","88.89"
"Huntingdon","1","6","Pennsylvania","4/8/20","1","5","42061","500"
"Indiana","2","21","Pennsylvania","4/8/20","6","15","42063","250"
"Jefferson","0","1","Pennsylvania","4/8/20","0","1","42065","1"
"Juniata","2","18","Pennsylvania","4/8/20","2","16","42067","800"
"Lackawanna","26","266","Pennsylvania","4/8/20","85","181","42069","212.94"
"Lancaster","58","561","Pennsylvania","4/8/20","157","404","42071","257.32"
"Lawrence","3","32","Pennsylvania","4/8/20","13","19","42073","146.15"
"Lebanon","19","169","Pennsylvania","4/8/20","36","133","42075","369.44"
"Lehigh","135","1319","Pennsylvania","4/8/20","374","945","42077","252.67"
"Luzerne","122","1134","Pennsylvania","4/8/20","282","852","42079","302.13"
"Lycoming","1","15","Pennsylvania","4/8/20","7","8","42081","114.29"
"McKean","0","1","Pennsylvania","4/8/20","1","0","42083","0"
"Mercer","3","27","Pennsylvania","4/8/20","8","19","42085","237.5"
"Mifflin","1","10","Pennsylvania","4/8/20","1","9","42087","900"
"Monroe","56","671","Pennsylvania","4/8/20","278","393","42089","141.37"
"Montgomery","125","1521","Pennsylvania","4/8/20","649","872","42091","134.36"
"Montour","3","37","Pennsylvania","4/8/20","13","24","42093","184.62"
"Northampton","78","857","Pennsylvania","4/8/20","312","545","42095","174.68"
"Northumberland","2","22","Pennsylvania","4/8/20","6","16","42097","266.67"
"Perry","2","13","Pennsylvania","4/8/20","1","12","42099","1200"
"Philadelphia","443","4777","Pennsylvania","4/8/20","1675","3102","42101","185.19"
"Pike","13","148","Pennsylvania","4/8/20","57","91","42103","159.65"
"Potter","0","3","Pennsylvania","4/8/20","2","1","42105","50"
"Schuylkill","13","136","Pennsylvania","4/8/20","47","89","42107","189.36"
"Snyder","1","9","Pennsylvania","4/8/20","3","6","42109","200"
"Somerset","1","7","Pennsylvania","4/8/20","3","4","42111","133.33"
"Sullivan","0","1","Pennsylvania","4/8/20","0","1","42113","1"
"Susquehanna","2","14","Pennsylvania","4/8/20","2","12","42115","600"
"Tioga","1","10","Pennsylvania","4/8/20","2","8","42117","400"
"Union","1","8","Pennsylvania","4/8/20","2","6","42119","300"
"Venango","0","5","Pennsylvania","4/8/20","3","2","42121","66.67"
"Warren","0","1","Pennsylvania","4/8/20","1","0","42123","0"
"Washington","3","59","Pennsylvania","4/8/20","35","24","42125","68.57"
"Wayne","5","47","Pennsylvania","4/8/20","14","33","42127","235.71"
"Westmoreland","16","183","Pennsylvania","4/8/20","72","111","42129","154.17"
"Wyoming","1","5","Pennsylvania","4/8/20","0","5","42131","1"
"York","22","233","Pennsylvania","4/8/20","79","154","42133","194.94"
"","48","620","Puerto Rico","4/8/20","286","334",,"116.78"
"Bristol","2","31","Rhode Island","4/8/20","18","13","44001","72.22"
"Kent","14","137","Rhode Island","4/8/20","39","98","44003","251.28"
"Newport","5","56","Rhode Island","4/8/20","23","33","44005","143.48"
"Providence","76","832","Rhode Island","4/8/20","301","531","44007","176.41"
"Washington","14","120","Rhode Island","4/8/20","25","95","44009","380"
"Abbeville","0","5","South Carolina","4/8/20","4","1","45001","25"
"Aiken","1","28","South Carolina","4/8/20","18","10","45003","55.56"
"Allendale","0","2","South Carolina","4/8/20","1","1","45005","100"
"Anderson","4","75","South Carolina","4/8/20","47","28","45007","59.57"
"Bamberg","0","6","South Carolina","4/8/20","4","2","45009","50"
"Barnwell","0","3","South Carolina","4/8/20","2","1","45011","50"
"Beaufort","10","169","South Carolina","4/8/20","101","68","45013","67.33"
"Berkeley","5","55","South Carolina","4/8/20","18","37","45015","205.56"
"Calhoun","0","5","South Carolina","4/8/20","3","2","45017","66.67"
"Charleston","16","305","South Carolina","4/8/20","190","115","45019","60.53"
"Cherokee","1","4","South Carolina","4/8/20","0","4","45021","1"
"Chester","2","15","South Carolina","4/8/20","3","12","45023","400"
"Chesterfield","1","16","South Carolina","4/8/20","9","7","45025","77.78"
"Clarendon","6","68","South Carolina","4/8/20","28","40","45027","142.86"
"Colleton","1","10","South Carolina","4/8/20","5","5","45029","100"
"Darlington","3","29","South Carolina","4/8/20","11","18","45031","163.64"
"Dillon","0","1","South Carolina","4/8/20","1","0","45033","0"
"Dorchester","3","51","South Carolina","4/8/20","27","24","45035","88.89"
"Edgefield","0","6","South Carolina","4/8/20","4","2","45037","50"
"Fairfield","1","17","South Carolina","4/8/20","7","10","45039","142.86"
"Florence","3","45","South Carolina","4/8/20","21","24","45041","114.29"
"Georgetown","1","22","South Carolina","4/8/20","14","8","45043","57.14"
"Greenville","12","214","South Carolina","4/8/20","129","85","45045","65.89"
"Greenwood","1","12","South Carolina","4/8/20","6","6","45047","100"
"Hampton","1","4","South Carolina","4/8/20","0","4","45049","1"
"Horry","7","91","South Carolina","4/8/20","42","49","45051","116.67"
"Jasper","1","12","South Carolina","4/8/20","4","8","45053","200"
"Kershaw","6","159","South Carolina","4/8/20","116","43","45055","37.07"
"Lancaster","4","46","South Carolina","4/8/20","17","29","45057","170.59"
"Laurens","0","6","South Carolina","4/8/20","4","2","45059","50"
"Lee","2","19","South Carolina","4/8/20","5","14","45061","280"
"Lexington","10","130","South Carolina","4/8/20","61","69","45063","113.11"
"Marion","0","5","South Carolina","4/8/20","2","3","45067","150"
"Marlboro","1","8","South Carolina","4/8/20","2","6","45069","300"
"McCormick","0","2","South Carolina","4/8/20","0","2","45065","1"
"Newberry","1","7","South Carolina","4/8/20","2","5","45071","250"
"Oconee","1","9","South Carolina","4/8/20","5","4","45073","80"
"Orangeburg","1","30","South Carolina","4/8/20","24","6","45075","25"
"Pickens","1","21","South Carolina","4/8/20","14","7","45077","50"
"Richland","23","340","South Carolina","4/8/20","176","164","45079","93.18"
"Saluda","1","5","South Carolina","4/8/20","1","4","45081","400"
"Spartanburg","11","120","South Carolina","4/8/20","45","75","45083","166.67"
"Sumter","8","105","South Carolina","4/8/20","48","57","45085","118.75"
"Union","2","15","South Carolina","4/8/20","3","12","45087","400"
"Williamsburg","1","12","South Carolina","4/8/20","3","9","45089","300"
"York","6","108","South Carolina","4/8/20","66","42","45091","63.64"
"Aurora","0","1","South Dakota","4/8/20","1","0","46003","0"
"Beadle","0","21","South Dakota","4/8/20","21","0","46005","0"
"Bon Homme","0","3","South Dakota","4/8/20","1","2","46009","200"
"Brookings","1","6","South Dakota","4/8/20","2","4","46011","200"
"Brown","1","13","South Dakota","4/8/20","4","9","46013","225"
"Charles Mix","0","2","South Dakota","4/8/20","1","1","46023","100"
"Clark","0","1","South Dakota","4/8/20","1","0","46025","0"
"Clay","0","6","South Dakota","4/8/20","3","3","46027","100"
"Codington","1","12","South Dakota","4/8/20","5","7","46029","140"
"Davison","0","3","South Dakota","4/8/20","2","1","46035","50"
"Deuel","0","1","South Dakota","4/8/20","1","0","46039","0"
"Fall River","0","1","South Dakota","4/8/20","1","0","46047","0"
"Faulk","0","1","South Dakota","4/8/20","1","0","46049","0"
"Hamlin","0","1","South Dakota","4/8/20","1","0","46057","0"
"Hughes","0","3","South Dakota","4/8/20","2","1","46065","50"
"Hutchinson","0","2","South Dakota","4/8/20","2","0","46067","0"
"Lake","0","2","South Dakota","4/8/20","0","2","46079","1"
"Lawrence","0","9","South Dakota","4/8/20","6","3","46081","50"
"Lincoln","3","31","South Dakota","4/8/20","11","20","46083","181.82"
"Lyman","0","2","South Dakota","4/8/20","1","1","46085","100"
"Marshall","0","1","South Dakota","4/8/20","1","0","46091","0"
"McCook","0","2","South Dakota","4/8/20","2","0","46087","0"
"Meade","0","1","South Dakota","4/8/20","1","0","46093","0"
"Minnehaha","27","228","South Dakota","4/8/20","40","188","46099","470"
"Oglala Lakota","0","1","South Dakota","4/8/20","0","1","46102","1"
"Pennington","0","6","South Dakota","4/8/20","5","1","46103","20"
"Roberts","0","4","South Dakota","4/8/20","2","2","46109","100"
"Spink","0","3","South Dakota","4/8/20","0","3","46115","1"
"Todd","0","1","South Dakota","4/8/20","1","0","46121","0"
"Turner","1","5","South Dakota","4/8/20","1","4","46125","400"
"Union","0","3","South Dakota","4/8/20","1","2","46127","200"
"Yankton","1","17","South Dakota","4/8/20","8","9","46135","112.5"
"Anderson","0","11","Tennessee","4/8/20","10","1","47001","10"
"Bedford","1","12","Tennessee","4/8/20","4","8","47003","200"
"Benton","0","4","Tennessee","4/8/20","4","0","47005","0"
"Bledsoe","0","3","Tennessee","4/8/20","2","1","47007","50"
"Blount","2","42","Tennessee","4/8/20","28","14","47009","50"
"Bradley","2","28","Tennessee","4/8/20","14","14","47011","100"
"Campbell","0","6","Tennessee","4/8/20","4","2","47013","50"
"Cannon","1","7","Tennessee","4/8/20","3","4","47015","133.33"
"Carroll","0","8","Tennessee","4/8/20","5","3","47017","60"
"Carter","0","3","Tennessee","4/8/20","1","2","47019","200"
"Cheatham","0","13","Tennessee","4/8/20","11","2","47021","18.18"
"Chester","0","6","Tennessee","4/8/20","3","3","47023","100"
"Claiborne","0","2","Tennessee","4/8/20","2","0","47025","0"
"Clay","0","2","Tennessee","4/8/20","1","1","47027","100"
"Cocke","0","2","Tennessee","4/8/20","1","1","47029","100"
"Coffee","1","7","Tennessee","4/8/20","1","6","47031","600"
"Cumberland","3","33","Tennessee","4/8/20","14","19","47035","135.71"
"Davidson","39","946","Tennessee","4/8/20","673","273","47037","40.56"
"Decatur","0","1","Tennessee","4/8/20","0","1","47039","1"
"DeKalb","0","7","Tennessee","4/8/20","5","2","47041","40"
"Dickson","1","26","Tennessee","4/8/20","18","8","47043","44.44"
"Dyer","1","11","Tennessee","4/8/20","3","8","47045","266.67"
"Fayette","1","22","Tennessee","4/8/20","14","8","47047","57.14"
"Fentress","0","2","Tennessee","4/8/20","1","1","47049","100"
"Franklin","1","17","Tennessee","4/8/20","7","10","47051","142.86"
"Gibson","1","13","Tennessee","4/8/20","6","7","47053","116.67"
"Giles","0","3","Tennessee","4/8/20","3","0","47055","0"
"Grainger","0","3","Tennessee","4/8/20","3","0","47057","0"
"Greene","1","20","Tennessee","4/8/20","15","5","47059","33.33"
"Grundy","1","16","Tennessee","4/8/20","6","10","47061","166.67"
"Hamblen","0","4","Tennessee","4/8/20","3","1","47063","33.33"
"Hamilton","6","95","Tennessee","4/8/20","50","45","47065","90"
"Hardeman","0","6","Tennessee","4/8/20","4","2","47069","50"
"Hardin","0","2","Tennessee","4/8/20","2","0","47071","0"
"Hawkins","2","18","Tennessee","4/8/20","5","13","47073","260"
"Haywood","1","7","Tennessee","4/8/20","2","5","47075","250"
"Henderson","0","2","Tennessee","4/8/20","0","2","47077","1"
"Henry","1","6","Tennessee","4/8/20","1","5","47079","500"
"Hickman","0","2","Tennessee","4/8/20","1","1","47081","100"
"Houston","0","2","Tennessee","4/8/20","1","1","47083","100"
"Humphreys","0","4","Tennessee","4/8/20","2","2","47085","100"
"Jackson","1","4","Tennessee","4/8/20","0","4","47087","1"
"Jefferson","1","12","Tennessee","4/8/20","6","6","47089","100"
"Johnson","0","2","Tennessee","4/8/20","2","0","47091","0"
"Knox","10","148","Tennessee","4/8/20","78","70","47093","89.74"
"Lauderdale","1","6","Tennessee","4/8/20","1","5","47097","500"
"Lawrence","1","10","Tennessee","4/8/20","2","8","47099","400"
"Lewis","0","2","Tennessee","4/8/20","2","0","47101","0"
"Lincoln","1","7","Tennessee","4/8/20","2","5","47103","250"
"Loudon","1","15","Tennessee","4/8/20","8","7","47105","87.5"
"Macon","2","16","Tennessee","4/8/20","4","12","47111","300"
"Madison","5","43","Tennessee","4/8/20","7","36","47113","514.29"
"Marion","2","21","Tennessee","4/8/20","8","13","47115","162.5"
"Marshall","1","9","Tennessee","4/8/20","1","8","47117","800"
"Maury","2","29","Tennessee","4/8/20","17","12","47119","70.59"
"McMinn","0","3","Tennessee","4/8/20","3","0","47107","0"
"McNairy","1","7","Tennessee","4/8/20","1","6","47109","600"
"Meigs","0","3","Tennessee","4/8/20","1","2","47121","200"
"Monroe","0","6","Tennessee","4/8/20","5","1","47123","20"
"Montgomery","6","72","Tennessee","4/8/20","27","45","47125","166.67"
"Morgan","1","5","Tennessee","4/8/20","1","4","47129","400"
"Obion","0","4","Tennessee","4/8/20","2","2","47131","100"
"Out of TN","6","282","Tennessee","4/8/20","243","39","80047","16.05"
"Overton","0","5","Tennessee","4/8/20","2","3","47133","150"
"Perry","0","3","Tennessee","4/8/20","2","1","47135","50"
"Polk","0","3","Tennessee","4/8/20","0","3","47139","1"
"Putnam","7","81","Tennessee","4/8/20","31","50","47141","161.29"
"Rhea","0","0","Tennessee","4/8/20","1","-1","47143","-100"
"Roane","0","5","Tennessee","4/8/20","2","3","47145","150"
"Robertson","5","67","Tennessee","4/8/20","35","32","47147","91.43"
"Rutherford","15","193","Tennessee","4/8/20","86","107","47149","124.42"
"Scott","0","5","Tennessee","4/8/20","3","2","47151","66.67"
"Sequatchie","0","1","Tennessee","4/8/20","1","0","47153","0"
"Sevier","1","19","Tennessee","4/8/20","9","10","47155","111.11"
"Shelby","59","912","Tennessee","4/8/20","496","416","47157","83.87"
"Smith","0","3","Tennessee","4/8/20","3","0","47159","0"
"Stewart","0","2","Tennessee","4/8/20","0","2","47161","1"
"Sullivan","1","27","Tennessee","4/8/20","17","10","47163","58.82"
"Sumner","25","376","Tennessee","4/8/20","201","175","47165","87.06"
"Tipton","2","38","Tennessee","4/8/20","22","16","47167","72.73"
"Trousdale","1","14","Tennessee","4/8/20","5","9","47169","180"
"Unicoi","0","1","Tennessee","4/8/20","1","0","47171","0"
"Union","0","2","Tennessee","4/8/20","1","1","47173","100"
"Warren","0","2","Tennessee","4/8/20","1","1","47177","100"
"Washington","1","30","Tennessee","4/8/20","21","9","47179","42.86"
"Wayne","0","2","Tennessee","4/8/20","1","1","47181","100"
"Weakley","1","5","Tennessee","4/8/20","1","4","47183","400"
"White","0","2","Tennessee","4/8/20","2","0","47185","0"
"Williamson","20","287","Tennessee","4/8/20","148","139","47187","93.92"
"Wilson","10","117","Tennessee","4/8/20","45","72","47189","160"
"Anderson","0","2","Texas","4/8/20","1","1","48001","100"
"Andrews","1","10","Texas","4/8/20","0","10","48003","1"
"Angelina","1","14","Texas","4/8/20","5","9","48005","180"
"Aransas","0","2","Texas","4/8/20","0","2","48007","1"
"Atascosa","0","5","Texas","4/8/20","2","3","48013","150"
"Austin","1","7","Texas","4/8/20","2","5","48015","250"
"Bandera","0","1","Texas","4/8/20","0","1","48019","1"
"Bastrop","1","17","Texas","4/8/20","8","9","48021","112.5"
"Bell","4","74","Texas","4/8/20","46","28","48027","60.87"
"Bexar","42","503","Texas","4/8/20","207","296","48029","143"
"Blanco","0","4","Texas","4/8/20","1","3","48031","300"
"Bowie","2","20","Texas","4/8/20","9","11","48037","122.22"
"Brazoria","11","173","Texas","4/8/20","95","78","48039","82.11"
"Brazos","6","108","Texas","4/8/20","63","45","48041","71.43"
"Brown","0","6","Texas","4/8/20","3","3","48049","100"
"Burleson","1","5","Texas","4/8/20","1","4","48051","400"
"Burnet","0","5","Texas","4/8/20","3","2","48053","66.67"
"Caldwell","1","5","Texas","4/8/20","1","4","48055","400"
"Calhoun","1","12","Texas","4/8/20","7","5","48057","71.43"
"Callahan","0","1","Texas","4/8/20","0","1","48059","1"
"Cameron","12","108","Texas","4/8/20","26","82","48061","315.38"
"Camp","0","2","Texas","4/8/20","1","1","48063","100"
"Cass","0","4","Texas","4/8/20","3","1","48067","33.33"
"Castro","0","11","Texas","4/8/20","8","3","48069","37.5"
"Chambers","1","19","Texas","4/8/20","9","10","48071","111.11"
"Cherokee","0","6","Texas","4/8/20","5","1","48073","20"
"Clay","0","1","Texas","4/8/20","1","0","48077","0"
"Collin","23","343","Texas","4/8/20","184","159","48085","86.41"
"Colorado","1","6","Texas","4/8/20","2","4","48089","200"
"Comal","2","29","Texas","4/8/20","12","17","48091","141.67"
"Comanche","0","3","Texas","4/8/20","2","1","48093","50"
"Coryell","2","12","Texas","4/8/20","1","11","48099","1100"
"Crane","0","2","Texas","4/8/20","2","0","48103","0"
"Crosby","0","1","Texas","4/8/20","0","1","48107","1"
"Dallam","0","1","Texas","4/8/20","0","1","48111","1"
"Dallas","85","1324","Texas","4/8/20","731","593","48113","81.12"
"Dawson","1","7","Texas","4/8/20","3","4","48115","133.33"
"Deaf Smith","1","7","Texas","4/8/20","2","5","48117","250"
"Denton","23","366","Texas","4/8/20","206","160","48121","77.67"
"DeWitt","0","7","Texas","4/8/20","6","1","48123","16.67"
"Dickens","0","1","Texas","4/8/20","0","1","48125","1"
"Donley","2","13","Texas","4/8/20","1","12","48129","1200"
"Eastland","0","3","Texas","4/8/20","4","-1","48133","-25"
"Ector","3","30","Texas","4/8/20","11","19","48135","172.73"
"El Paso","14","153","Texas","4/8/20","57","96","48141","168.42"
"Ellis","3","41","Texas","4/8/20","20","21","48139","105"
"Erath","1","11","Texas","4/8/20","7","4","48143","57.14"
"Falls","0","1","Texas","4/8/20","1","0","48145","0"
"Fannin","0","4","Texas","4/8/20","1","3","48147","300"
"Fayette","1","9","Texas","4/8/20","4","5","48149","125"
"Floyd","0","1","Texas","4/8/20","0","1","48153","1"
"Fort Bend","36","417","Texas","4/8/20","163","254","48157","155.83"
"Franklin","0","1","Texas","4/8/20","1","0","48159","0"
"Frio","0","1","Texas","4/8/20","0","1","48163","1"
"Gaines","0","1","Texas","4/8/20","1","0","48165","0"
"Galveston","24","272","Texas","4/8/20","106","166","48167","156.6"
"Gillespie","0","1","Texas","4/8/20","1","0","48171","0"
"Goliad","0","3","Texas","4/8/20","0","3","48175","1"
"Gonzales","0","1","Texas","4/8/20","1","0","48177","0"
"Gray","2","11","Texas","4/8/20","0","11","48179","1"
"Grayson","1","15","Texas","4/8/20","8","7","48181","87.5"
"Gregg","3","32","Texas","4/8/20","8","24","48183","300"
"Grimes","0","6","Texas","4/8/20","3","3","48185","100"
"Guadalupe","4","45","Texas","4/8/20","17","28","48187","164.71"
"Hale","1","7","Texas","4/8/20","1","6","48189","600"
"Hamilton","0","2","Texas","4/8/20","0","2","48193","1"
"Hansford","0","1","Texas","4/8/20","0","1","48195","1"
"Hardin","4","41","Texas","4/8/20","13","28","48199","215.38"
"Harris","213","2341","Texas","4/8/20","847","1494","48201","176.39"
"Harrison","1","11","Texas","4/8/20","3","8","48203","266.67"
"Hays","5","75","Texas","4/8/20","42","33","48209","78.57"
"Hemphill","0","1","Texas","4/8/20","0","1","48211","1"
"Henderson","0","4","Texas","4/8/20","1","3","48213","300"
"Hidalgo","12","128","Texas","4/8/20","46","82","48215","178.26"
"Hill","1","6","Texas","4/8/20","2","4","48217","200"
"Hockley","0","10","Texas","4/8/20","7","3","48219","42.86"
"Hood","1","10","Texas","4/8/20","6","4","48221","66.67"
"Hopkins","0","4","Texas","4/8/20","3","1","48223","33.33"
"Hunt","1","14","Texas","4/8/20","4","10","48231","250"
"Hutchinson","0","2","Texas","4/8/20","0","2","48233","1"
"Jackson","0","4","Texas","4/8/20","1","3","48239","300"
"Jasper","0","3","Texas","4/8/20","1","2","48241","200"
"Jefferson","7","78","Texas","4/8/20","27","51","48245","188.89"
"Jim Wells","0","2","Texas","4/8/20","0","2","48249","1"
"Johnson","2","25","Texas","4/8/20","12","13","48251","108.33"
"Jones","0","1","Texas","4/8/20","0","1","48253","1"
"Karnes","0","2","Texas","4/8/20","2","0","48255","0"
"Kaufman","2","16","Texas","4/8/20","4","12","48257","300"
"Kendall","0","9","Texas","4/8/20","7","2","48259","28.57"
"Kerr","0","2","Texas","4/8/20","1","1","48265","100"
"Kleberg","0","2","Texas","4/8/20","1","1","48273","100"
"Knox","0","1","Texas","4/8/20","0","1","48275","1"
"Lamar","0","6","Texas","4/8/20","3","3","48277","100"
"Lamb","0","1","Texas","4/8/20","1","0","48279","0"
"Lampasas","0","2","Texas","4/8/20","0","2","48281","1"
"Lavaca","0","3","Texas","4/8/20","1","2","48285","200"
"Lee","0","2","Texas","4/8/20","0","2","48287","1"
"Leon","0","2","Texas","4/8/20","2","0","48289","0"
"Liberty","2","15","Texas","4/8/20","3","12","48291","400"
"Limestone","1","6","Texas","4/8/20","2","4","48293","200"
"Live Oak","0","3","Texas","4/8/20","1","2","48297","200"
"Llano","0","3","Texas","4/8/20","3","0","48299","0"
"Lubbock","13","191","Texas","4/8/20","100","91","48303","91"
"Lynn","0","4","Texas","4/8/20","2","2","48305","100"
"Martin","0","2","Texas","4/8/20","1","1","48317","100"
"Mason","0","1","Texas","4/8/20","0","1","48319","1"
"Matagorda","2","42","Texas","4/8/20","27","15","48321","55.56"
"Maverick","1","7","Texas","4/8/20","1","6","48323","600"
"McLennan","3","62","Texas","4/8/20","44","18","48309","40.91"
"Medina","1","7","Texas","4/8/20","3","4","48325","133.33"
"Midland","2","30","Texas","4/8/20","16","14","48329","87.5"
"Milam","1","7","Texas","4/8/20","2","5","48331","250"
"Mitchell","0","1","Texas","4/8/20","0","1","48335","1"
"Montague","0","1","Texas","4/8/20","1","0","48337","0"
"Montgomery","14","210","Texas","4/8/20","110","100","48339","90.91"
"Moore","1","9","Texas","4/8/20","1","8","48341","800"
"Morris","0","1","Texas","4/8/20","1","0","48343","0"
"Nacogdoches","3","25","Texas","4/8/20","4","21","48347","525"
"Navarro","0","4","Texas","4/8/20","4","0","48349","0"
"Newton","0","1","Texas","4/8/20","1","0","48351","0"
"Nueces","4","65","Texas","4/8/20","34","31","48355","91.18"
"Oldham","0","3","Texas","4/8/20","2","1","48359","50"
"Orange","3","29","Texas","4/8/20","7","22","48361","314.29"
"Palo Pinto","0","3","Texas","4/8/20","0","3","48363","1"
"Panola","0","4","Texas","4/8/20","3","1","48365","33.33"
"Parker","0","6","Texas","4/8/20","4","2","48367","50"
"Pecos","0","1","Texas","4/8/20","0","1","48371","1"
"Polk","1","8","Texas","4/8/20","4","4","48373","100"
"Potter","4","47","Texas","4/8/20","16","31","48375","193.75"
"Randall","3","40","Texas","4/8/20","17","23","48381","135.29"
"Reeves","0","1","Texas","4/8/20","0","1","48389","1"
"Robertson","0","2","Texas","4/8/20","2","0","48395","0"
"Rockwall","1","14","Texas","4/8/20","9","5","48397","55.56"
"Rusk","1","14","Texas","4/8/20","5","9","48401","180"
"San Augustine","0","4","Texas","4/8/20","1","3","48405","300"
"San Jacinto","0","3","Texas","4/8/20","1","2","48407","200"
"San Patricio","1","7","Texas","4/8/20","2","5","48409","250"
"Shelby","2","17","Texas","4/8/20","4","13","48419","325"
"Smith","6","79","Texas","4/8/20","37","42","48423","113.51"
"Starr","0","7","Texas","4/8/20","4","3","48427","75"
"Swisher","0","2","Texas","4/8/20","1","1","48437","100"
"Tarrant","43","588","Texas","4/8/20","288","300","48439","104.17"
"Taylor","3","38","Texas","4/8/20","14","24","48441","171.43"
"Terry","0","6","Texas","4/8/20","4","2","48445","50"
"Titus","0","2","Texas","4/8/20","0","2","48449","1"
"Tom Green","2","25","Texas","4/8/20","9","16","48451","177.78"
"Travis","44","554","Texas","4/8/20","244","310","48453","127.05"
"Trinity","0","2","Texas","4/8/20","0","2","48455","1"
"Tyler","0","2","Texas","4/8/20","1","1","48457","100"
"Upshur","1","6","Texas","4/8/20","2","4","48459","200"
"Uvalde","0","5","Texas","4/8/20","4","1","48463","25"
"Val Verde","0","7","Texas","4/8/20","5","2","48465","40"
"Van Zandt","1","7","Texas","4/8/20","2","5","48467","250"
"Victoria","6","59","Texas","4/8/20","16","43","48469","268.75"
"Walker","1","15","Texas","4/8/20","5","10","48471","200"
"Waller","1","11","Texas","4/8/20","3","8","48473","266.67"
"Washington","1","24","Texas","4/8/20","17","7","48477","41.18"
"Webb","13","135","Texas","4/8/20","45","90","48479","200"
"Wharton","2","18","Texas","4/8/20","7","11","48481","157.14"
"Wichita","1","48","Texas","4/8/20","38","10","48485","26.32"
"Willacy","1","7","Texas","4/8/20","2","5","48489","250"
"Williamson","5","87","Texas","4/8/20","50","37","48491","74"
"Wilson","1","8","Texas","4/8/20","3","5","48493","166.67"
"Wise","0","3","Texas","4/8/20","1","2","48497","200"
"Wood","0","4","Texas","4/8/20","1","3","48499","300"
"Young","0","3","Texas","4/8/20","3","0","48503","0"
"Zapata","0","1","Texas","4/8/20","0","1","48505","1"
"Bear River","1","13","Utah","4/8/20","7","6","00000","85.71"
"Cache","3","28","Utah","4/8/20","7","21","49005","300"
"Carbon","0","2","Utah","4/8/20","0","2","49007","1"
"Davis","11","163","Utah","4/8/20","84","79","49011","94.05"
"Duchesne","0","2","Utah","4/8/20","0","2","49013","1"
"Emery","0","2","Utah","4/8/20","0","2","49015","1"
"Garfield","0","1","Utah","4/8/20","1","0","49017","0"
"Grand","0","1","Utah","4/8/20","1","0","49019","0"
"Iron","1","13","Utah","4/8/20","6","7","49021","116.67"
"Kane","0","2","Utah","4/8/20","0","2","49025","1"
"Out of UT","-3","0","Utah","4/8/20","22","-22","80049","-100"
"Salt Lake","66","858","Utah","4/8/20","396","462","49035","116.67"
"San Juan","0","6","Utah","4/8/20","4","2","49037","50"
"Summit","14","273","Utah","4/8/20","172","101","49043","58.72"
"Tooele","2","23","Utah","4/8/20","12","11","49045","91.67"
"Uintah","0","4","Utah","4/8/20","1","3","49047","300"
"Utah","28","267","Utah","4/8/20","70","197","49049","281.43"
"Wasatch","5","82","Utah","4/8/20","50","32","49051","64"
"Washington","2","31","Utah","4/8/20","14","17","49053","121.43"
"Weber-Morgan","5","77","Utah","4/8/20","41","36","00000","87.8"
"Addison","3","47","Vermont","4/8/20","24","23","50001","95.83"
"Bennington","1","27","Vermont","4/8/20","18","9","50003","50"
"Caledonia","1","8","Vermont","4/8/20","3","5","50005","166.67"
"Chittenden","21","308","Vermont","4/8/20","164","144","50007","87.8"
"Franklin","3","33","Vermont","4/8/20","15","18","50011","120"
"Grand Isle","0","1","Vermont","4/8/20","0","1","50013","1"
"Lamoille","1","19","Vermont","4/8/20","13","6","50015","46.15"
"Orange","0","4","Vermont","4/8/20","4","0","50017","0"
"Orleans","0","8","Vermont","4/8/20","7","1","50019","14.29"
"Rutland","3","31","Vermont","4/8/20","10","21","50021","210"
"Washington","1","24","Vermont","4/8/20","15","9","50023","60"
"Windham","3","38","Vermont","4/8/20","16","22","50025","137.5"
"Windsor","1","24","Vermont","4/8/20","18","6","50027","33.33"
"","2","45","Virgin Islands","4/8/20","30","15",,"50"
"Accomack","1","11","Virginia","4/8/20","7","4","51001","57.14"
"Albemarle","3","41","Virginia","4/8/20","21","20","51003","95.24"
"Alexandria","16","143","Virginia","4/8/20","32","111","51510","346.88"
"Alleghany","0","2","Virginia","4/8/20","1","1","51005","100"
"Amelia","1","8","Virginia","4/8/20","2","6","51007","300"
"Amherst","0","8","Virginia","4/8/20","5","3","51009","60"
"Appomattox","0","3","Virginia","4/8/20","0","3","51011","1"
"Arlington","19","254","Virginia","4/8/20","119","135","51013","113.45"
"Augusta","2","13","Virginia","4/8/20","1","12","51015","1200"
"Bedford","1","12","Virginia","4/8/20","3","9","51019","300"
"Botetourt","2","18","Virginia","4/8/20","6","12","51023","200"
"Bristol","0","1","Virginia","4/8/20","1","0","51520","0"
"Brunswick","0","1","Virginia","4/8/20","1","0","51025","0"
"Buchanan","0","1","Virginia","4/8/20","0","1","51027","1"
"Buckingham","1","9","Virginia","4/8/20","2","7","51029","350"
"Buena Vista","1","4","Virginia","4/8/20","0","4","51530","1"
"Campbell","0","4","Virginia","4/8/20","2","2","51031","100"
"Caroline","1","4","Virginia","4/8/20","0","4","51033","1"
"Carroll","0","2","Virginia","4/8/20","1","1","51035","100"
"Charles City","0","5","Virginia","4/8/20","2","3","51036","150"
"Charlotte","0","1","Virginia","4/8/20","0","1","51037","1"
"Charlottesville","1","23","Virginia","4/8/20","16","7","51540","43.75"
"Chesapeake","10","99","Virginia","4/8/20","31","68","51550","219.35"
"Chesterfield","12","145","Virginia","4/8/20","59","86","51041","145.76"
"Clarke","0","3","Virginia","4/8/20","0","3","51043","1"
"Colonial Heights","0","1","Virginia","4/8/20","0","1","51570","1"
"Covington","0","1","Virginia","4/8/20","1","0","51580","0"
"Craig","0","2","Virginia","4/8/20","0","2","51045","1"
"Culpeper","1","10","Virginia","4/8/20","5","5","51047","100"
"Cumberland","1","6","Virginia","4/8/20","0","6","51049","1"
"Danville","2","15","Virginia","4/8/20","4","11","51590","275"
"Dinwiddie","0","2","Virginia","4/8/20","0","2","51053","1"
"Emporia","1","4","Virginia","4/8/20","0","4","51595","1"
"Fairfax","40","570","Virginia","4/8/20","288","282","51059","97.92"
"Fauquier","1","17","Virginia","4/8/20","7","10","51061","142.86"
"Fluvanna","1","12","Virginia","4/8/20","3","9","51065","300"
"Franklin","1","12","Virginia","4/8/20","5","7","51067","140"
"Franklin City","1","5","Virginia","4/8/20","1","4","51620","400"
"Frederick","4","46","Virginia","4/8/20","15","31","51069","206.67"
"Fredericksburg","1","8","Virginia","4/8/20","1","7","51630","700"
"Galax","0","1","Virginia","4/8/20","1","0","51640","0"
"Giles","0","2","Virginia","4/8/20","0","2","51071","1"
"Gloucester","1","16","Virginia","4/8/20","8","8","51073","100"
"Goochland","2","24","Virginia","4/8/20","7","17","51075","242.86"
"Greene","0","4","Virginia","4/8/20","1","3","51079","300"
"Greensville","0","5","Virginia","4/8/20","3","2","51081","66.67"
"Halifax","0","2","Virginia","4/8/20","1","1","51083","100"
"Hampton","6","53","Virginia","4/8/20","14","39","51650","278.57"
"Hanover","2","22","Virginia","4/8/20","6","16","51085","266.67"
"Harrisonburg","4","36","Virginia","4/8/20","10","26","51660","260"
"Henrico","30","291","Virginia","4/8/20","78","213","51087","273.08"
"Henry","0","4","Virginia","4/8/20","2","2","51089","100"
"Hopewell","1","13","Virginia","4/8/20","4","9","51670","225"
"Isle of Wight","3","23","Virginia","4/8/20","5","18","51093","360"
"James City","4","122","Virginia","4/8/20","95","27","51095","28.42"
"King and Queen","0","1","Virginia","4/8/20","1","0","51097","0"
"King George","1","11","Virginia","4/8/20","4","7","51099","175"
"King William","0","2","Virginia","4/8/20","1","1","51101","100"
"Lancaster","0","1","Virginia","4/8/20","1","0","51103","0"
"Lee","0","3","Virginia","4/8/20","2","1","51105","50"
"Lexington","0","3","Virginia","4/8/20","0","3","51678","1"
"Loudoun","19","238","Virginia","4/8/20","105","133","51107","126.67"
"Louisa","1","16","Virginia","4/8/20","12","4","51109","33.33"
"Lunenburg","0","2","Virginia","4/8/20","0","2","51111","1"
"Lynchburg","2","20","Virginia","4/8/20","7","13","51680","185.71"
"Madison","0","5","Virginia","4/8/20","3","2","51113","66.67"
"Manassas","2","20","Virginia","4/8/20","9","11","51683","122.22"
"Manassas Park","1","5","Virginia","4/8/20","1","4","51685","400"
"Mathews","0","2","Virginia","4/8/20","2","0","51115","0"
"Mecklenburg","2","16","Virginia","4/8/20","4","12","51117","300"
"Montgomery","2","16","Virginia","4/8/20","1","15","51121","1500"
"Nelson","0","3","Virginia","4/8/20","2","1","51125","50"
"New Kent","1","11","Virginia","4/8/20","1","10","51127","1000"
"Newport News","4","60","Virginia","4/8/20","29","31","51700","106.9"
"Norfolk","6","77","Virginia","4/8/20","33","44","51710","133.33"
"Northampton","0","2","Virginia","4/8/20","1","1","51131","100"
"Northumberland","0","3","Virginia","4/8/20","3","0","51133","0"
"Nottoway","0","3","Virginia","4/8/20","1","2","51135","200"
"Orange","0","7","Virginia","4/8/20","4","3","51137","75"
"Page","0","3","Virginia","4/8/20","1","2","51139","200"
"Petersburg","1","9","Virginia","4/8/20","4","5","51730","125"
"Pittsylvania","0","3","Virginia","4/8/20","1","2","51143","200"
"Poquoson","0","4","Virginia","4/8/20","3","1","51735","33.33"
"Portsmouth","4","41","Virginia","4/8/20","13","28","51740","215.38"
"Powhatan","0","4","Virginia","4/8/20","3","1","51145","33.33"
"Prince Edward","0","3","Virginia","4/8/20","2","1","51147","50"
"Prince George","2","24","Virginia","4/8/20","8","16","51149","200"
"Prince William","22","263","Virginia","4/8/20","106","157","51153","148.11"
"Pulaski","0","2","Virginia","4/8/20","0","2","51155","1"
"Radford","0","1","Virginia","4/8/20","1","0","51750","0"
"Rappahannock","0","1","Virginia","4/8/20","0","1","51157","1"
"Richmond","0","2","Virginia","4/8/20","0","2","51159","1"
"Richmond City","12","119","Virginia","4/8/20","33","86","51760","260.61"
"Roanoke","1","9","Virginia","4/8/20","4","5","51161","125"
"Roanoke City","1","14","Virginia","4/8/20","6","8","51770","133.33"
"Rockbridge","0","3","Virginia","4/8/20","2","1","51163","50"
"Rockingham","2","20","Virginia","4/8/20","9","11","51165","122.22"
"Russell","0","1","Virginia","4/8/20","0","1","51167","1"
"Salem","0","1","Virginia","4/8/20","0","1","51775","1"
"Shenandoah","1","13","Virginia","4/8/20","8","5","51171","62.5"
"Smyth","0","5","Virginia","4/8/20","2","3","51173","150"
"Southampton","1","5","Virginia","4/8/20","1","4","51175","400"
"Spotsylvania","3","31","Virginia","4/8/20","8","23","51177","287.5"
"Stafford","3","48","Virginia","4/8/20","28","20","51179","71.43"
"Staunton","0","1","Virginia","4/8/20","0","1","51790","1"
"Suffolk","4","31","Virginia","4/8/20","5","26","51800","520"
"Surry","0","3","Virginia","4/8/20","1","2","51181","200"
"Sussex","1","6","Virginia","4/8/20","1","5","51183","500"
"Tazewell","0","4","Virginia","4/8/20","2","2","51185","100"
"Virginia Beach","17","207","Virginia","4/8/20","88","119","51810","135.23"
"Warren","1","8","Virginia","4/8/20","3","5","51187","166.67"
"Washington","1","12","Virginia","4/8/20","2","10","51191","500"
"Waynesboro","0","2","Virginia","4/8/20","2","0","51820","0"
"Westmoreland","1","5","Virginia","4/8/20","0","5","51193","1"
"Williamsburg","1","16","Virginia","4/8/20","9","7","51830","77.78"
"Winchester","1","15","Virginia","4/8/20","5","10","51840","200"
"Wise","1","4","Virginia","4/8/20","0","4","51195","1"
"Wythe","1","6","Virginia","4/8/20","2","4","51197","200"
"York","1","25","Virginia","4/8/20","16","9","51199","56.25"
"Adams","2","29","Washington","4/8/20","14","15","53001","107.14"
"Asotin","1","4","Washington","4/8/20","0","4","53003","1"
"Benton","10","179","Washington","4/8/20","108","71","53005","65.74"
"Chelan","2","34","Washington","4/8/20","17","17","53007","100"
"Clallam","0","9","Washington","4/8/20","8","1","53009","12.5"
"Clark","9","190","Washington","4/8/20","130","60","53011","46.15"
"Columbia","0","1","Washington","4/8/20","1","0","53013","0"
"Cowlitz","1","21","Washington","4/8/20","14","7","53015","50"
"Douglas","1","10","Washington","4/8/20","5","5","53017","100"
"Ferry","0","1","Washington","4/8/20","1","0","53019","0"
"Franklin","6","75","Washington","4/8/20","33","42","53021","127.27"
"Grant","4","94","Washington","4/8/20","63","31","53025","49.21"
"Grays Harbor","1","7","Washington","4/8/20","2","5","53027","250"
"Island","5","145","Washington","4/8/20","109","36","53029","33.03"
"Jefferson","1","27","Washington","4/8/20","17","10","53031","58.82"
"King","194","3688","Washington","4/8/20","2330","1358","53033","58.28"
"Kitsap","6","119","Washington","4/8/20","74","45","53035","60.81"
"Kittitas","1","13","Washington","4/8/20","9","4","53037","44.44"
"Klickitat","0","11","Washington","4/8/20","9","2","53039","22.22"
"Lewis","1","16","Washington","4/8/20","10","6","53041","60"
"Lincoln","0","1","Washington","4/8/20","1","0","53043","0"
"Mason","2","17","Washington","4/8/20","6","11","53045","183.33"
"Okanogan","1","10","Washington","4/8/20","3","7","53047","233.33"
"Pend Oreille","0","1","Washington","4/8/20","0","1","53051","1"
"Pierce","60","795","Washington","4/8/20","377","418","53053","110.88"
"San Juan","1","12","Washington","4/8/20","4","8","53055","200"
"Skagit","6","169","Washington","4/8/20","128","41","53057","32.03"
"Skamania","0","2","Washington","4/8/20","1","1","53059","100"
"Snohomish","56","1695","Washington","4/8/20","1304","391","53061","29.98"
"Spokane","12","239","Washington","4/8/20","158","81","53063","51.27"
"Stevens","0","5","Washington","4/8/20","4","1","53065","25"
"Thurston","4","74","Washington","4/8/20","48","26","53067","54.17"
"Wahkiakum","0","2","Washington","4/8/20","0","2","53069","1"
"Walla Walla","1","16","Washington","4/8/20","7","9","53071","128.57"
"Whatcom","14","238","Washington","4/8/20","139","99","53073","71.22"
"Whitman","0","12","Washington","4/8/20","10","2","53075","20"
"Yakima","34","400","Washington","4/8/20","161","239","53077","148.45"
"Barbour","0","4","West Virginia","4/8/20","1","3","54001","300"
"Berkeley","6","66","West Virginia","4/8/20","21","45","54003","214.29"
"Boone","0","1","West Virginia","4/8/20","0","1","54005","1"
"Braxton","0","1","West Virginia","4/8/20","0","1","54007","1"
"Brooke","0","1","West Virginia","4/8/20","0","1","54009","1"
"Cabell","2","12","West Virginia","4/8/20","1","11","54011","1100"
"Fayette","0","1","West Virginia","4/8/20","0","1","54019","1"
"Greenbrier","0","3","West Virginia","4/8/20","3","0","54025","0"
"Hampshire","0","1","West Virginia","4/8/20","0","1","54027","1"
"Hancock","0","7","West Virginia","4/8/20","6","1","54029","16.67"
"Hardy","0","2","West Virginia","4/8/20","1","1","54031","100"
"Harrison","2","29","West Virginia","4/8/20","14","15","54033","107.14"
"Jackson","1","19","West Virginia","4/8/20","11","8","54035","72.73"
"Jefferson","4","38","West Virginia","4/8/20","9","29","54037","322.22"
"Kanawha","5","69","West Virginia","4/8/20","37","32","54039","86.49"
"Lewis","0","1","West Virginia","4/8/20","0","1","54041","1"
"Logan","1","8","West Virginia","4/8/20","3","5","54045","166.67"
"Marion","3","30","West Virginia","4/8/20","8","22","54049","275"
"Marshall","0","5","West Virginia","4/8/20","4","1","54051","25"
"Mason","0","6","West Virginia","4/8/20","3","3","54053","100"
"McDowell","0","3","West Virginia","4/8/20","0","3","54047","1"
"Mercer","1","6","West Virginia","4/8/20","2","4","54055","200"
"Mineral","0","3","West Virginia","4/8/20","0","3","54057","1"
"Monongalia","5","68","West Virginia","4/8/20","32","36","54061","112.5"
"Morgan","0","4","West Virginia","4/8/20","1","3","54065","300"
"Nicholas","0","2","West Virginia","4/8/20","0","2","54067","1"
"Ohio","1","18","West Virginia","4/8/20","11","7","54069","63.64"
"Pendleton","0","1","West Virginia","4/8/20","0","1","54071","1"
"Pleasants","0","1","West Virginia","4/8/20","1","0","54073","0"
"Preston","0","6","West Virginia","4/8/20","3","3","54077","100"
"Putnam","1","10","West Virginia","4/8/20","5","5","54079","100"
"Raleigh","0","4","West Virginia","4/8/20","3","1","54081","33.33"
"Randolph","0","3","West Virginia","4/8/20","1","2","54083","200"
"Roane","0","2","West Virginia","4/8/20","2","0","54087","0"
"Taylor","0","3","West Virginia","4/8/20","0","3","54091","1"
"Tucker","0","3","West Virginia","4/8/20","2","1","54093","50"
"Tyler","0","1","West Virginia","4/8/20","0","1","54095","1"
"Upshur","0","1","West Virginia","4/8/20","1","0","54097","0"
"Wetzel","0","3","West Virginia","4/8/20","2","1","54103","50"
"Wirt","0","1","West Virginia","4/8/20","1","0","54105","0"
"Wood","2","14","West Virginia","4/8/20","2","12","54107","600"
"Wyoming","0","1","West Virginia","4/8/20","0","1","54109","1"
"Adams","0","2","Wisconsin","4/8/20","0","2","55001","1"
"Ashland","0","1","Wisconsin","4/8/20","1","0","55003","0"
"Barron","1","4","Wisconsin","4/8/20","0","4","55005","1"
"Bayfield","0","3","Wisconsin","4/8/20","3","0","55007","0"
"Brown","4","41","Wisconsin","4/8/20","11","30","55009","272.73"
"Buffalo","0","2","Wisconsin","4/8/20","1","1","55011","100"
"Calumet","0","4","Wisconsin","4/8/20","2","2","55015","100"
"Chippewa","1","16","Wisconsin","4/8/20","10","6","55017","60"
"Clark","0","7","Wisconsin","4/8/20","5","2","55019","40"
"Columbia","1","23","Wisconsin","4/8/20","14","9","55021","64.29"
"Crawford","0","2","Wisconsin","4/8/20","1","1","55023","100"
"Dane","13","303","Wisconsin","4/8/20","215","88","55025","40.93"
"Dodge","0","15","Wisconsin","4/8/20","13","2","55027","15.38"
"Door","1","7","Wisconsin","4/8/20","1","6","55029","600"
"Douglas","0","7","Wisconsin","4/8/20","7","0","55031","0"
"Dunn","0","5","Wisconsin","4/8/20","3","2","55033","66.67"
"Eau Claire","1","21","Wisconsin","4/8/20","12","9","55035","75"
"Florence","0","2","Wisconsin","4/8/20","0","2","55037","1"
"Fond du Lac","3","44","Wisconsin","4/8/20","24","20","55039","83.33"
"Grant","0","3","Wisconsin","4/8/20","2","1","55043","50"
"Green","0","9","Wisconsin","4/8/20","7","2","55045","28.57"
"Iowa","0","4","Wisconsin","4/8/20","3","1","55049","33.33"
"Iron","0","1","Wisconsin","4/8/20","1","0","55051","0"
"Jackson","0","4","Wisconsin","4/8/20","2","2","55053","100"
"Jefferson","0","15","Wisconsin","4/8/20","12","3","55055","25"
"Juneau","0","5","Wisconsin","4/8/20","4","1","55057","25"
"Kenosha","10","127","Wisconsin","4/8/20","54","73","55059","135.19"
"Kewaunee","0","1","Wisconsin","4/8/20","0","1","55061","1"
"La Crosse","0","22","Wisconsin","4/8/20","19","3","55063","15.79"
"Lafayette","0","1","Wisconsin","4/8/20","0","1","55065","1"
"Manitowoc","0","3","Wisconsin","4/8/20","0","3","55071","1"
"Marathon","1","12","Wisconsin","4/8/20","5","7","55073","140"
"Marinette","0","3","Wisconsin","4/8/20","2","1","55075","50"
"Marquette","0","2","Wisconsin","4/8/20","2","0","55077","0"
"Menominee","0","1","Wisconsin","4/8/20","0","1","55078","1"
"Milwaukee","91","1416","Wisconsin","4/8/20","780","636","55079","81.54"
"Monroe","0","5","Wisconsin","4/8/20","2","3","55081","150"
"Oconto","0","1","Wisconsin","4/8/20","1","0","55083","0"
"Oneida","0","5","Wisconsin","4/8/20","3","2","55085","66.67"
"Outagamie","2","25","Wisconsin","4/8/20","12","13","55087","108.33"
"Ozaukee","3","70","Wisconsin","4/8/20","46","24","55089","52.17"
"Pierce","0","7","Wisconsin","4/8/20","7","0","55093","0"
"Portage","0","4","Wisconsin","4/8/20","1","3","55097","300"
"Racine","5","66","Wisconsin","4/8/20","28","38","55101","135.71"
"Richland","0","3","Wisconsin","4/8/20","2","1","55103","50"
"Rock","3","37","Wisconsin","4/8/20","17","20","55105","117.65"
"Rusk","0","3","Wisconsin","4/8/20","0","3","55107","1"
"Sauk","1","20","Wisconsin","4/8/20","14","6","55111","42.86"
"Shawano","0","3","Wisconsin","4/8/20","0","3","55115","1"
"Sheboygan","3","32","Wisconsin","4/8/20","12","20","55117","166.67"
"St. Croix","0","7","Wisconsin","4/8/20","6","1","55109","16.67"
"Trempealeau","0","1","Wisconsin","4/8/20","0","1","55121","1"
"Vilas","0","4","Wisconsin","4/8/20","3","1","55125","33.33"
"Walworth","1","21","Wisconsin","4/8/20","12","9","55127","75"
"Washington","3","63","Wisconsin","4/8/20","44","19","55131","43.18"
"Waukesha","8","166","Wisconsin","4/8/20","107","59","55133","55.14"
"Waupaca","0","2","Wisconsin","4/8/20","2","0","55135","0"
"Waushara","0","1","Wisconsin","4/8/20","0","1","55137","1"
"Winnebago","1","24","Wisconsin","4/8/20","19","5","55139","26.32"
"Wood","0","2","Wisconsin","4/8/20","2","0","55141","0"
"Albany","0","4","Wyoming","4/8/20","3","1","56001","33.33"
"Campbell","1","9","Wyoming","4/8/20","4","5","56005","125"
"Carbon","0","4","Wyoming","4/8/20","3","1","56007","33.33"
"Converse","0","4","Wyoming","4/8/20","2","2","56009","100"
"Crook","0","1","Wyoming","4/8/20","0","1","56011","1"
"Fremont","2","38","Wyoming","4/8/20","25","13","56013","52"
"Goshen","0","3","Wyoming","4/8/20","1","2","56015","200"
"Johnson","0","8","Wyoming","4/8/20","7","1","56019","14.29"
"Laramie","3","48","Wyoming","4/8/20","29","19","56021","65.52"
"Lincoln","1","4","Wyoming","4/8/20","0","4","56023","1"
"Natrona","2","26","Wyoming","4/8/20","15","11","56025","73.33"
"Park","0","1","Wyoming","4/8/20","1","0","56029","0"
"Sheridan","0","12","Wyoming","4/8/20","10","2","56033","20"
"Sublette","0","1","Wyoming","4/8/20","1","0","56035","0"
"Sweetwater","1","6","Wyoming","4/8/20","2","4","56037","200"
"Teton","3","44","Wyoming","4/8/20","26","18","56039","69.23"
"Uinta","0","3","Wyoming","4/8/20","0","3","56041","1"
"Washakie","1","5","Wyoming","4/8/20","1","4","56043","400"
