"Locality","DailyAvgNewCasesPast7Days","TotalCases","State","Date","TotalCases7DaysAgo","NewCasesPast7Days","FIPS-Code","PercentIncreaseTotalCasesPast7Days"
"Autauga","1","12","Alabama","4/4/20","6","6","01001","100"
"Baldwin","3","29","Alabama","4/4/20","10","19","01003","190"
"Barbour","0","2","Alabama","4/4/20","0","2","01005","1"
"Bibb","1","4","Alabama","4/4/20","0","4","01007","1"
"Blount","1","10","Alabama","4/4/20","5","5","01009","100"
"Bullock","0","2","Alabama","4/4/20","3","-1","01011","-33.33"
"Butler","0","1","Alabama","4/4/20","1","0","01013","0"
"Calhoun","3","21","Alabama","4/4/20","3","18","01015","600"
"Chambers","10","87","Alabama","4/4/20","17","70","01017","411.76"
"Cherokee","1","6","Alabama","4/4/20","1","5","01019","500"
"Chilton","1","15","Alabama","4/4/20","7","8","01021","114.29"
"Choctaw","0","4","Alabama","4/4/20","1","3","01023","300"
"Clarke","1","6","Alabama","4/4/20","0","6","01025","1"
"Clay","1","8","Alabama","4/4/20","2","6","01027","300"
"Cleburne","0","7","Alabama","4/4/20","4","3","01029","75"
"Coffee","1","7","Alabama","4/4/20","0","7","01031","1"
"Colbert","1","5","Alabama","4/4/20","1","4","01033","400"
"Conecuh","0","2","Alabama","4/4/20","0","2","01035","1"
"Coosa","1","6","Alabama","4/4/20","2","4","01037","200"
"Covington","0","4","Alabama","4/4/20","2","2","01039","100"
"Crenshaw","0","2","Alabama","4/4/20","1","1","01041","100"
"Cullman","1","15","Alabama","4/4/20","7","8","01043","114.29"
"Dale","0","2","Alabama","4/4/20","0","2","01045","1"
"Dallas","1","7","Alabama","4/4/20","2","5","01047","250"
"DeKalb","1","13","Alabama","4/4/20","4","9","01049","225"
"Elmore","1","19","Alabama","4/4/20","12","7","01051","58.33"
"Escambia","0","2","Alabama","4/4/20","1","1","01053","100"
"Etowah","3","26","Alabama","4/4/20","6","20","01055","333.33"
"Fayette","0","1","Alabama","4/4/20","0","1","01057","1"
"Franklin","0","6","Alabama","4/4/20","3","3","01059","100"
"Greene","0","5","Alabama","4/4/20","3","2","01063","66.67"
"Hale","0","3","Alabama","4/4/20","0","3","01065","1"
"Henry","0","2","Alabama","4/4/20","0","2","01067","1"
"Houston","1","14","Alabama","4/4/20","4","10","01069","250"
"Jackson","1","12","Alabama","4/4/20","5","7","01071","140"
"Jefferson","25","373","Alabama","4/4/20","195","178","01073","91.28"
"Lamar","0","2","Alabama","4/4/20","1","1","01075","100"
"Lauderdale","1","16","Alabama","4/4/20","12","4","01077","33.33"
"Lawrence","0","4","Alabama","4/4/20","3","1","01079","33.33"
"Lee","7","102","Alabama","4/4/20","56","46","01081","82.14"
"Limestone","2","31","Alabama","4/4/20","16","15","01083","93.75"
"Lowndes","0","3","Alabama","4/4/20","1","2","01085","200"
"Macon","1","5","Alabama","4/4/20","0","5","01087","1"
"Madison","9","125","Alabama","4/4/20","62","63","01089","101.61"
"Marengo","1","8","Alabama","4/4/20","3","5","01091","166.67"
"Marion","1","17","Alabama","4/4/20","9","8","01093","88.89"
"Marshall","2","17","Alabama","4/4/20","4","13","01095","325"
"Mobile","12","114","Alabama","4/4/20","29","85","01097","293.1"
"Monroe","1","5","Alabama","4/4/20","1","4","01099","400"
"Montgomery","6","62","Alabama","4/4/20","18","44","01101","244.44"
"Morgan","1","24","Alabama","4/4/20","15","9","01103","60"
"Pickens","2","12","Alabama","4/4/20","1","11","01107","1100"
"Pike","1","10","Alabama","4/4/20","4","6","01109","150"
"Randolph","1","11","Alabama","4/4/20","2","9","01111","450"
"Russell","0","4","Alabama","4/4/20","1","3","01113","300"
"Shelby","7","124","Alabama","4/4/20","72","52","01117","72.22"
"St. Clair","2","25","Alabama","4/4/20","11","14","01115","127.27"
"Sumter","1","6","Alabama","4/4/20","0","6","01119","1"
"Talladega","2","16","Alabama","4/4/20","4","12","01121","300"
"Tallapoosa","2","20","Alabama","4/4/20","5","15","01123","300"
"Tuscaloosa","3","43","Alabama","4/4/20","22","21","01125","95.45"
"Walker","3","49","Alabama","4/4/20","28","21","01127","75"
"Washington","0","5","Alabama","4/4/20","2","3","01129","150"
"Wilcox","1","11","Alabama","4/4/20","2","9","01131","450"
"Winston","0","3","Alabama","4/4/20","2","1","01133","50"
"Anchorage","5","81","Alaska","4/4/20","43","38","02020","88.37"
"Fairbanks North Star","4","46","Alaska","4/4/20","19","27","02090","142.11"
"Juneau","1","12","Alaska","4/4/20","4","8","02110","200"
"Kenai Peninsula","1","11","Alaska","4/4/20","5","6","02122","120"
"Ketchikan Gateway","0","14","Alaska","4/4/20","12","2","02130","16.67"
"Matanuska-Susitna","0","4","Alaska","4/4/20","2","2","02170","100"
"Petersburg","0","1","Alaska","4/4/20","0","1","02195","1"
"Southeast Fairbanks","0","1","Alaska","4/4/20","0","1","02240","1"
"Yukon-Koyukuk","0","1","Alaska","4/4/20","0","1","02290","1"
"Apache","1","20","Arizona","4/4/20","13","7","04001","53.85"
"Cochise","1","7","Arizona","4/4/20","3","4","04003","133.33"
"Coconino","13","147","Arizona","4/4/20","56","91","04005","162.5"
"Gila","0","3","Arizona","4/4/20","1","2","04007","200"
"Graham","0","3","Arizona","4/4/20","2","1","04009","50"
"Greenlee","0","1","Arizona","4/4/20","0","1","04011","1"
"La Paz","0","2","Arizona","4/4/20","2","0","04012","0"
"Maricopa","102","1171","Arizona","4/4/20","454","717","04013","157.93"
"Mohave","1","12","Arizona","4/4/20","5","7","04015","140"
"Navajo","17","177","Arizona","4/4/20","57","120","04017","210.53"
"Pima","29","326","Arizona","4/4/20","120","206","04019","171.67"
"Pinal","7","89","Arizona","4/4/20","41","48","04021","117.07"
"Santa Cruz","0","4","Arizona","4/4/20","2","2","04023","100"
"Yavapai","4","43","Arizona","4/4/20","13","30","04025","230.77"
"Yuma","1","14","Arizona","4/4/20","4","10","04027","250"
"Arkansas","0","1","Arkansas","4/4/20","0","1","05001","1"
"Ashley","0","1","Arkansas","4/4/20","0","1","05003","1"
"Baxter","0","1","Arkansas","4/4/20","1","0","05005","0"
"Benton","2","42","Arkansas","4/4/20","28","14","05007","50"
"Boone","0","1","Arkansas","4/4/20","1","0","05009","0"
"Bradley","0","4","Arkansas","4/4/20","4","0","05011","0"
"Carroll","0","1","Arkansas","4/4/20","0","1","05015","1"
"Chicot","0","2","Arkansas","4/4/20","1","1","05017","100"
"Clark","1","27","Arkansas","4/4/20","18","9","05019","50"
"Cleburne","2","65","Arkansas","4/4/20","50","15","05023","30"
"Cleveland","0","5","Arkansas","4/4/20","5","0","05025","0"
"Columbia","0","1","Arkansas","4/4/20","1","0","05027","0"
"Conway","0","1","Arkansas","4/4/20","1","0","05029","0"
"Craighead","2","16","Arkansas","4/4/20","4","12","05031","300"
"Crawford","0","1","Arkansas","4/4/20","1","0","05033","0"
"Crittenden","4","43","Arkansas","4/4/20","14","29","05035","207.14"
"Cross","1","5","Arkansas","4/4/20","1","4","05037","400"
"Desha","0","2","Arkansas","4/4/20","2","0","05041","0"
"Drew","0","1","Arkansas","4/4/20","1","0","05043","0"
"Faulkner","2","40","Arkansas","4/4/20","29","11","05045","37.93"
"Garland","3","40","Arkansas","4/4/20","20","20","05051","100"
"Grant","0","3","Arkansas","4/4/20","3","0","05053","0"
"Greene","0","1","Arkansas","4/4/20","1","0","05055","0"
"Hempstead","0","1","Arkansas","4/4/20","0","1","05057","1"
"Hot Spring","1","5","Arkansas","4/4/20","1","4","05059","400"
"Howard","0","1","Arkansas","4/4/20","1","0","05061","0"
"Independence","0","3","Arkansas","4/4/20","3","0","05063","0"
"Jefferson","4","53","Arkansas","4/4/20","25","28","05069","112"
"Johnson","1","7","Arkansas","4/4/20","1","6","05071","600"
"Lafayette","0","1","Arkansas","4/4/20","0","1","05073","1"
"Lawrence","0","1","Arkansas","4/4/20","1","0","05075","0"
"Lee","0","1","Arkansas","4/4/20","0","1","05077","1"
"Lincoln","0","6","Arkansas","4/4/20","6","0","05079","0"
"Lonoke","2","16","Arkansas","4/4/20","1","15","05085","1500"
"Miller","1","8","Arkansas","4/4/20","0","8","05091","1"
"Mississippi","0","1","Arkansas","4/4/20","0","1","05093","1"
"Monroe","0","1","Arkansas","4/4/20","0","1","05095","1"
"Nevada","0","1","Arkansas","4/4/20","0","1","05099","1"
"Newton","0","1","Arkansas","4/4/20","0","1","05101","1"
"Ouachita","0","1","Arkansas","4/4/20","0","1","05103","1"
"Perry","0","1","Arkansas","4/4/20","0","1","05105","1"
"Pike","0","1","Arkansas","4/4/20","1","0","05109","0"
"Poinsett","0","5","Arkansas","4/4/20","3","2","05111","66.67"
"Polk","1","5","Arkansas","4/4/20","1","4","05113","400"
"Pope","1","8","Arkansas","4/4/20","1","7","05115","700"
"Prairie","0","1","Arkansas","4/4/20","0","1","05117","1"
"Pulaski","6","137","Arkansas","4/4/20","92","45","05119","48.91"
"Randolph","0","1","Arkansas","4/4/20","1","0","05121","0"
"Saline","2","21","Arkansas","4/4/20","4","17","05125","425"
"Scott","0","1","Arkansas","4/4/20","0","1","05127","1"
"Searcy","0","2","Arkansas","4/4/20","2","0","05129","0"
"Sebastian","1","8","Arkansas","4/4/20","2","6","05131","300"
"Sevier","0","1","Arkansas","4/4/20","1","0","05133","0"
"Sharp","0","1","Arkansas","4/4/20","0","1","05135","1"
"St. Francis","0","1","Arkansas","4/4/20","0","1","05123","1"
"Stone","1","5","Arkansas","4/4/20","1","4","05137","400"
"Union","1","10","Arkansas","4/4/20","5","5","05139","100"
"Van Buren","0","20","Arkansas","4/4/20","17","3","05141","17.65"
"Washington","2","25","Arkansas","4/4/20","14","11","05143","78.57"
"White","2","23","Arkansas","4/4/20","6","17","05145","283.33"
"Woodruff","0","1","Arkansas","4/4/20","1","0","05147","0"
"Alameda","32","443","California","4/4/20","220","223","06001","101.36"
"Alpine","0","1","California","4/4/20","0","1","06003","1"
"Amador","0","3","California","4/4/20","2","1","06005","50"
"Butte","1","11","California","4/4/20","5","6","06007","120"
"Calaveras","0","4","California","4/4/20","3","1","06009","33.33"
"Colusa","0","2","California","4/4/20","1","1","06011","100"
"Contra Costa","20","307","California","4/4/20","168","139","06013","82.74"
"Del Norte","0","2","California","4/4/20","0","2","06015","1"
"El Dorado","1","22","California","4/4/20","12","10","06017","83.33"
"Fresno","10","100","California","4/4/20","31","69","06019","222.58"
"Glenn","0","2","California","4/4/20","0","2","06021","1"
"Humboldt","4","44","California","4/4/20","14","30","06023","214.29"
"Imperial","5","55","California","4/4/20","21","34","06025","161.9"
"Inyo","1","10","California","4/4/20","5","5","06027","100"
"Kern","23","210","California","4/4/20","47","163","06029","346.81"
"Kings","0","5","California","4/4/20","2","3","06031","150"
"Los Angeles","449","4605","California","4/4/20","1465","3140","06037","214.33"
"Madera","2","28","California","4/4/20","11","17","06039","154.55"
"Marin","9","131","California","4/4/20","68","63","06041","92.65"
"Mendocino","0","4","California","4/4/20","2","2","06045","100"
"Merced","1","16","California","4/4/20","7","9","06047","128.57"
"Mono","2","19","California","4/4/20","8","11","06051","137.5"
"Monterey","4","57","California","4/4/20","32","25","06053","78.12"
"Napa","2","20","California","4/4/20","9","11","06055","122.22"
"Nevada","3","31","California","4/4/20","12","19","06057","158.33"
"Orange","55","786","California","4/4/20","403","383","06059","95.04"
"Placer","8","97","California","4/4/20","41","56","06061","136.59"
"Plumas","0","2","California","4/4/20","0","2","06063","1"
"Riverside","65","638","California","4/4/20","183","455","06065","248.63"
"Sacramento","32","390","California","4/4/20","164","226","06067","137.8"
"San Benito","1","23","California","4/4/20","14","9","06069","64.29"
"San Bernardino","40","353","California","4/4/20","76","277","06071","364.47"
"San Diego","100","1112","California","4/4/20","413","699","06073","169.25"
"San Francisco","32","529","California","4/4/20","308","221","06075","71.75"
"San Joaquin","13","185","California","4/4/20","93","92","06077","98.92"
"San Luis Obispo","4","93","California","4/4/20","67","26","06079","38.81"
"San Mateo","38","538","California","4/4/20","274","264","06081","96.35"
"Santa Barbara","15","152","California","4/4/20","47","105","06083","223.4"
"Santa Clara","80","1148","California","4/4/20","591","557","06085","94.25"
"Santa Cruz","4","59","California","4/4/20","34","25","06087","73.53"
"Shasta","1","12","California","4/4/20","3","9","06089","300"
"Siskiyou","0","3","California","4/4/20","3","0","06093","0"
"Solano","6","73","California","4/4/20","34","39","06095","114.71"
"Sonoma","8","105","California","4/4/20","50","55","06097","110"
"Stanislaus","5","58","California","4/4/20","23","35","06099","152.17"
"Sutter","2","16","California","4/4/20","3","13","06101","433.33"
"Tehama","0","1","California","4/4/20","0","1","06103","1"
"Tulare","8","81","California","4/4/20","24","57","06107","237.5"
"Tuolumne","0","2","California","4/4/20","0","2","06109","1"
"Ventura","17","203","California","4/4/20","83","120","06111","144.58"
"Yolo","3","37","California","4/4/20","16","21","06113","131.25"
"Yuba","1","9","California","4/4/20","3","6","06115","200"
"Adams","32","320","Colorado","4/4/20","95","225","08001","236.84"
"Alamosa","0","4","Colorado","4/4/20","1","3","08003","300"
"Arapahoe","50","552","Colorado","4/4/20","204","348","08005","170.59"
"Archuleta","0","1","Colorado","4/4/20","0","1","08007","1"
"Baca","1","9","Colorado","4/4/20","1","8","08009","800"
"Boulder","10","154","Colorado","4/4/20","84","70","08013","83.33"
"Broomfield","4","44","Colorado","4/4/20","16","28","08014","175"
"Chaffee","1","21","Colorado","4/4/20","11","10","08015","90.91"
"Clear Creek","0","6","Colorado","4/4/20","3","3","08019","100"
"Costilla","0","3","Colorado","4/4/20","1","2","08023","200"
"Crowley","0","1","Colorado","4/4/20","1","0","08025","0"
"Custer","0","2","Colorado","4/4/20","0","2","08027","1"
"Delta","0","4","Colorado","4/4/20","1","3","08029","300"
"Denver","57","769","Colorado","4/4/20","367","402","08031","109.54"
"Douglas","17","209","Colorado","4/4/20","92","117","08035","127.17"
"Eagle","22","333","Colorado","4/4/20","182","151","08037","82.97"
"El Paso","32","406","Colorado","4/4/20","184","222","08041","120.65"
"Elbert","1","9","Colorado","4/4/20","3","6","08039","200"
"Fremont","0","3","Colorado","4/4/20","1","2","08043","200"
"Garfield","3","45","Colorado","4/4/20","23","22","08045","95.65"
"Grand","0","4","Colorado","4/4/20","2","2","08049","100"
"Gunnison","2","90","Colorado","4/4/20","78","12","08051","15.38"
"Hinsdale","0","1","Colorado","4/4/20","1","0","08053","0"
"Huerfano","0","1","Colorado","4/4/20","1","0","08055","0"
"Jefferson","43","483","Colorado","4/4/20","182","301","08059","165.38"
"Kit Carson","0","5","Colorado","4/4/20","2","3","08063","150"
"La Plata","1","25","Colorado","4/4/20","17","8","08067","47.06"
"Lake","0","3","Colorado","4/4/20","0","3","08065","1"
"Larimer","9","144","Colorado","4/4/20","79","65","08069","82.28"
"Las Animas","0","1","Colorado","4/4/20","0","1","08071","1"
"Lincoln","0","1","Colorado","4/4/20","1","0","08073","0"
"Logan","0","8","Colorado","4/4/20","5","3","08075","60"
"Mesa","2","20","Colorado","4/4/20","9","11","08077","122.22"
"Mineral","0","2","Colorado","4/4/20","0","2","08079","1"
"Moffat","0","3","Colorado","4/4/20","2","1","08081","50"
"Montezuma","1","6","Colorado","4/4/20","0","6","08083","1"
"Montrose","3","31","Colorado","4/4/20","8","23","08085","287.5"
"Morgan","2","16","Colorado","4/4/20","4","12","08087","300"
"Otero","0","3","Colorado","4/4/20","3","0","08089","0"
"Ouray","0","2","Colorado","4/4/20","0","2","08091","1"
"Park","1","5","Colorado","4/4/20","1","4","08093","400"
"Phillips","0","3","Colorado","4/4/20","0","3","08095","1"
"Pitkin","2","38","Colorado","4/4/20","26","12","08097","46.15"
"Pueblo","4","36","Colorado","4/4/20","7","29","08101","414.29"
"Rio Blanco","0","1","Colorado","4/4/20","0","1","08103","1"
"Rio Grande","0","5","Colorado","4/4/20","2","3","08105","150"
"Routt","2","29","Colorado","4/4/20","14","15","08107","107.14"
"Saguache","0","3","Colorado","4/4/20","0","3","08109","1"
"San Miguel","1","9","Colorado","4/4/20","1","8","08113","800"
"Summit","5","50","Colorado","4/4/20","13","37","08117","284.62"
"Teller","1","11","Colorado","4/4/20","7","4","08119","57.14"
"Washington","0","1","Colorado","4/4/20","1","0","08121","0"
"Weld","38","424","Colorado","4/4/20","161","263","08123","163.35"
"Yuma","0","2","Colorado","4/4/20","2","0","08125","0"
"Fairfield","274","2824","Connecticut","4/4/20","908","1916","09001","211.01"
"Hartford","71","726","Connecticut","4/4/20","228","498","09003","218.42"
"Litchfield","17","182","Connecticut","4/4/20","65","117","09005","180"
"Middlesex","10","100","Connecticut","4/4/20","28","72","09007","257.14"
"New Haven","113","1024","Connecticut","4/4/20","236","788","09009","333.9"
"New London","5","57","Connecticut","4/4/20","19","38","09011","200"
"Tolland","8","91","Connecticut","4/4/20","37","54","09013","145.95"
"Windham","4","31","Connecticut","4/4/20","3","28","09015","933.33"
"Kent","6","68","Delaware","4/4/20","25","43","10001","172"
"New Castle","39","400","Delaware","4/4/20","130","270","10003","207.69"
"Sussex","9","125","Delaware","4/4/20","59","66","10005","111.86"
"","0","49","Diamond Princess","4/4/20","49","0",,"0"
"District of Columbia","85","902","District of Columbia","4/4/20","304","598","11001","196.71"
"Alachua","7","116","Florida","4/4/20","67","49","12001","73.13"
"Baker","1","11","Florida","4/4/20","7","4","12003","57.14"
"Bay","3","23","Florida","4/4/20","5","18","12005","360"
"Bradford","1","6","Florida","4/4/20","1","5","12007","500"
"Brevard","7","72","Florida","4/4/20","26","46","12009","176.92"
"Broward","136","1765","Florida","4/4/20","814","951","12011","116.83"
"Calhoun","0","3","Florida","4/4/20","0","3","12013","1"
"Charlotte","5","46","Florida","4/4/20","12","34","12015","283.33"
"Citrus","3","34","Florida","4/4/20","14","20","12017","142.86"
"Clay","7","74","Florida","4/4/20","24","50","12019","208.33"
"Collier","18","221","Florida","4/4/20","92","129","12021","140.22"
"Columbia","1","10","Florida","4/4/20","3","7","12023","233.33"
"DeSoto","1","11","Florida","4/4/20","7","4","12027","57.14"
"Dixie","0","1","Florida","4/4/20","0","1","12029","1"
"Duval","39","387","Florida","4/4/20","115","272","12031","236.52"
"Escambia","13","118","Florida","4/4/20","28","90","12033","321.43"
"Flagler","2","29","Florida","4/4/20","13","16","12035","123.08"
"Franklin","0","1","Florida","4/4/20","0","1","12037","1"
"Gadsden","0","4","Florida","4/4/20","1","3","12039","300"
"Glades","1","4","Florida","4/4/20","0","4","12043","1"
"Gulf","0","1","Florida","4/4/20","0","1","12045","1"
"Hardee","0","1","Florida","4/4/20","0","1","12049","1"
"Hendry","1","6","Florida","4/4/20","0","6","12051","1"
"Hernando","4","40","Florida","4/4/20","13","27","12053","207.69"
"Highlands","3","30","Florida","4/4/20","10","20","12055","200"
"Hillsborough","43","497","Florida","4/4/20","195","302","12057","154.87"
"Holmes","0","1","Florida","4/4/20","0","1","12059","1"
"Indian River","5","50","Florida","4/4/20","16","34","12061","212.5"
"Jackson","0","4","Florida","4/4/20","1","3","12063","300"
"Jefferson","0","1","Florida","4/4/20","0","1","12065","1"
"Lake","9","95","Florida","4/4/20","35","60","12069","171.43"
"Lee","35","348","Florida","4/4/20","101","247","12071","244.55"
"Leon","4","42","Florida","4/4/20","16","26","12073","162.5"
"Levy","0","2","Florida","4/4/20","1","1","12075","100"
"Madison","1","6","Florida","4/4/20","0","6","12079","1"
"Manatee","14","129","Florida","4/4/20","30","99","12081","330"
"Marion","4","42","Florida","4/4/20","17","25","12083","147.06"
"Martin","4","53","Florida","4/4/20","25","28","12085","112"
"Miami-Dade","412","3890","Florida","4/4/20","1003","2887","12086","287.84"
"Monroe","3","42","Florida","4/4/20","20","22","12087","110"
"Nassau","2","21","Florida","4/4/20","6","15","12089","250"
"Okaloosa","5","59","Florida","4/4/20","27","32","12091","118.52"
"Okeechobee","0","3","Florida","4/4/20","0","3","12093","1"
"Orange","64","657","Florida","4/4/20","206","451","12095","218.93"
"Osceola","21","216","Florida","4/4/20","66","150","12097","227.27"
"Palm Beach","95","954","Florida","4/4/20","292","662","12099","226.71"
"Pasco","9","90","Florida","4/4/20","28","62","12101","221.43"
"Pinellas","35","342","Florida","4/4/20","94","248","12103","263.83"
"Polk","15","142","Florida","4/4/20","34","108","12105","317.65"
"Putnam","1","18","Florida","4/4/20","12","6","12107","50"
"Santa Rosa","5","50","Florida","4/4/20","14","36","12113","257.14"
"Sarasota","12","129","Florida","4/4/20","48","81","12115","168.75"
"Seminole","17","178","Florida","4/4/20","61","117","12117","191.8"
"St. Johns","12","132","Florida","4/4/20","48","84","12109","175"
"St. Lucie","8","76","Florida","4/4/20","21","55","12111","261.9"
"Sumter","6","73","Florida","4/4/20","33","40","12119","121.21"
"Suwannee","2","17","Florida","4/4/20","1","16","12121","1600"
"Union","0","2","Florida","4/4/20","0","2","12125","1"
"Volusia","13","134","Florida","4/4/20","44","90","12127","204.55"
"Wakulla","1","5","Florida","4/4/20","0","5","12129","1"
"Walton","1","21","Florida","4/4/20","15","6","12131","40"
"Washington","0","1","Florida","4/4/20","1","0","12133","0"
"Appling","1","5","Georgia","4/4/20","0","5","13001","1"
"Bacon","1","6","Georgia","4/4/20","0","6","13005","1"
"Baker","0","4","Georgia","4/4/20","1","3","13007","300"
"Baldwin","1","11","Georgia","4/4/20","2","9","13009","450"
"Banks","0","3","Georgia","4/4/20","0","3","13011","1"
"Barrow","2","22","Georgia","4/4/20","7","15","13013","214.29"
"Bartow","6","160","Georgia","4/4/20","116","44","13015","37.93"
"Ben Hill","0","4","Georgia","4/4/20","2","2","13017","100"
"Berrien","0","3","Georgia","4/4/20","0","3","13019","1"
"Bibb","4","36","Georgia","4/4/20","11","25","13021","227.27"
"Bleckley","0","1","Georgia","4/4/20","0","1","13023","1"
"Brooks","1","5","Georgia","4/4/20","0","5","13027","1"
"Bryan","1","15","Georgia","4/4/20","6","9","13029","150"
"Bulloch","1","5","Georgia","4/4/20","0","5","13031","1"
"Burke","1","8","Georgia","4/4/20","3","5","13033","166.67"
"Butts","1","10","Georgia","4/4/20","5","5","13035","100"
"Calhoun","1","11","Georgia","4/4/20","2","9","13037","450"
"Camden","1","6","Georgia","4/4/20","2","4","13039","200"
"Candler","0","1","Georgia","4/4/20","0","1","13043","1"
"Carroll","12","149","Georgia","4/4/20","64","85","13045","132.81"
"Catoosa","1","6","Georgia","4/4/20","1","5","13047","500"
"Charlton","0","1","Georgia","4/4/20","1","0","13049","0"
"Chatham","7","64","Georgia","4/4/20","15","49","13051","326.67"
"Chattahoochee","0","2","Georgia","4/4/20","1","1","13053","100"
"Chattooga","0","3","Georgia","4/4/20","1","2","13055","200"
"Cherokee","9","114","Georgia","4/4/20","52","62","13057","119.23"
"Clarke","4","60","Georgia","4/4/20","35","25","13059","71.43"
"Clay","1","7","Georgia","4/4/20","0","7","13061","1"
"Clayton","24","224","Georgia","4/4/20","57","167","13063","292.98"
"Clinch","0","2","Georgia","4/4/20","1","1","13065","100"
"Cobb","35","428","Georgia","4/4/20","181","247","13067","136.46"
"Coffee","2","15","Georgia","4/4/20","3","12","13069","400"
"Colquitt","6","46","Georgia","4/4/20","5","41","13071","820"
"Columbia","3","33","Georgia","4/4/20","12","21","13073","175"
"Cook","0","1","Georgia","4/4/20","0","1","13075","1"
"Coweta","6","58","Georgia","4/4/20","19","39","13077","205.26"
"Crisp","3","25","Georgia","4/4/20","5","20","13081","400"
"Dade","0","1","Georgia","4/4/20","0","1","13083","1"
"Dawson","2","13","Georgia","4/4/20","2","11","13085","550"
"Decatur","2","16","Georgia","4/4/20","3","13","13087","433.33"
"DeKalb","37","500","Georgia","4/4/20","240","260","13089","108.33"
"Dodge","1","5","Georgia","4/4/20","1","4","13091","400"
"Dooly","2","15","Georgia","4/4/20","0","15","13093","1"
"Dougherty","62","636","Georgia","4/4/20","205","431","13095","210.24"
"Douglas","6","80","Georgia","4/4/20","35","45","13097","128.57"
"Early","7","62","Georgia","4/4/20","15","47","13099","313.33"
"Effingham","0","7","Georgia","4/4/20","4","3","13103","75"
"Elbert","0","1","Georgia","4/4/20","0","1","13105","1"
"Emanuel","0","1","Georgia","4/4/20","0","1","13107","1"
"Fannin","1","8","Georgia","4/4/20","3","5","13111","166.67"
"Fayette","5","62","Georgia","4/4/20","25","37","13113","148"
"Floyd","7","79","Georgia","4/4/20","27","52","13115","192.59"
"Forsyth","6","63","Georgia","4/4/20","21","42","13117","200"
"Franklin","0","5","Georgia","4/4/20","2","3","13119","150"
"Fulton","81","941","Georgia","4/4/20","373","568","13121","152.28"
"Gilmer","0","1","Georgia","4/4/20","0","1","13123","1"
"Glynn","3","27","Georgia","4/4/20","7","20","13127","285.71"
"Gordon","1","21","Georgia","4/4/20","14","7","13129","50"
"Grady","0","3","Georgia","4/4/20","0","3","13131","1"
"Greene","2","12","Georgia","4/4/20","1","11","13133","1100"
"Gwinnett","34","364","Georgia","4/4/20","129","235","13135","182.17"
"Habersham","0","2","Georgia","4/4/20","0","2","13137","1"
"Hall","8","84","Georgia","4/4/20","31","53","13139","170.97"
"Haralson","1","10","Georgia","4/4/20","1","9","13143","900"
"Harris","1","6","Georgia","4/4/20","1","5","13145","500"
"Hart","0","3","Georgia","4/4/20","1","2","13147","200"
"Heard","0","2","Georgia","4/4/20","1","1","13149","100"
"Henry","14","150","Georgia","4/4/20","50","100","13151","200"
"Houston","7","58","Georgia","4/4/20","12","46","13153","383.33"
"Irwin","0","6","Georgia","4/4/20","3","3","13155","100"
"Jackson","2","13","Georgia","4/4/20","2","11","13157","550"
"Jasper","0","2","Georgia","4/4/20","2","0","13159","0"
"Jefferson","0","2","Georgia","4/4/20","0","2","13163","1"
"Jenkins","0","2","Georgia","4/4/20","1","1","13165","100"
"Johnson","0","1","Georgia","4/4/20","0","1","13167","1"
"Jones","1","6","Georgia","4/4/20","2","4","13169","200"
"Lamar","1","6","Georgia","4/4/20","2","4","13171","200"
"Lanier","0","1","Georgia","4/4/20","0","1","13173","1"
"Laurens","1","15","Georgia","4/4/20","7","8","13175","114.29"
"Lee","13","128","Georgia","4/4/20","37","91","13177","245.95"
"Liberty","1","9","Georgia","4/4/20","2","7","13179","350"
"Lincoln","0","5","Georgia","4/4/20","3","2","13181","66.67"
"Long","0","1","Georgia","4/4/20","1","0","13183","0"
"Lowndes","2","35","Georgia","4/4/20","20","15","13185","75"
"Lumpkin","0","7","Georgia","4/4/20","4","3","13187","75"
"Macon","0","4","Georgia","4/4/20","1","3","13193","300"
"Madison","1","7","Georgia","4/4/20","3","4","13195","133.33"
"Marion","0","2","Georgia","4/4/20","0","2","13197","1"
"McDuffie","1","5","Georgia","4/4/20","1","4","13189","400"
"McIntosh","0","2","Georgia","4/4/20","0","2","13191","1"
"Meriwether","1","10","Georgia","4/4/20","3","7","13199","233.33"
"Miller","1","10","Georgia","4/4/20","4","6","13201","150"
"Mitchell","5","52","Georgia","4/4/20","14","38","13205","271.43"
"Monroe","1","7","Georgia","4/4/20","3","4","13207","133.33"
"Morgan","0","2","Georgia","4/4/20","1","1","13211","100"
"Murray","1","9","Georgia","4/4/20","2","7","13213","350"
"Muscogee","4","33","Georgia","4/4/20","8","25","13215","312.5"
"Newton","4","43","Georgia","4/4/20","15","28","13217","186.67"
"Oconee","2","22","Georgia","4/4/20","10","12","13219","120"
"Oglethorpe","0","1","Georgia","4/4/20","0","1","13221","1"
"Paulding","4","48","Georgia","4/4/20","19","29","13223","152.63"
"Peach","1","10","Georgia","4/4/20","6","4","13225","66.67"
"Pickens","1","9","Georgia","4/4/20","5","4","13227","80"
"Pierce","2","16","Georgia","4/4/20","1","15","13229","1500"
"Pike","0","4","Georgia","4/4/20","1","3","13231","300"
"Polk","1","18","Georgia","4/4/20","10","8","13233","80"
"Pulaski","1","7","Georgia","4/4/20","2","5","13235","250"
"Putnam","0","2","Georgia","4/4/20","0","2","13237","1"
"Quitman","0","1","Georgia","4/4/20","0","1","13239","1"
"Rabun","0","2","Georgia","4/4/20","0","2","13241","1"
"Randolph","2","16","Georgia","4/4/20","3","13","13243","433.33"
"Richmond","6","51","Georgia","4/4/20","12","39","13245","325"
"Rockdale","8","70","Georgia","4/4/20","17","53","13247","311.76"
"Schley","1","6","Georgia","4/4/20","0","6","13249","1"
"Screven","0","2","Georgia","4/4/20","0","2","13251","1"
"Seminole","1","8","Georgia","4/4/20","3","5","13253","166.67"
"Spalding","2","24","Georgia","4/4/20","11","13","13255","118.18"
"Stephens","0","5","Georgia","4/4/20","2","3","13257","150"
"Stewart","0","1","Georgia","4/4/20","0","1","13259","1"
"Sumter","10","80","Georgia","4/4/20","11","69","13261","627.27"
"Talbot","0","3","Georgia","4/4/20","0","3","13263","1"
"Tattnall","0","3","Georgia","4/4/20","2","1","13267","50"
"Taylor","0","2","Georgia","4/4/20","1","1","13269","100"
"Telfair","0","3","Georgia","4/4/20","0","3","13271","1"
"Terrell","7","52","Georgia","4/4/20","6","46","13273","766.67"
"Thomas","3","26","Georgia","4/4/20","6","20","13275","333.33"
"Tift","3","34","Georgia","4/4/20","13","21","13277","161.54"
"Toombs","1","5","Georgia","4/4/20","1","4","13279","400"
"Towns","0","1","Georgia","4/4/20","0","1","13281","1"
"Troup","3","32","Georgia","4/4/20","9","23","13285","255.56"
"Turner","1","12","Georgia","4/4/20","2","10","13287","500"
"Twiggs","0","2","Georgia","4/4/20","2","0","13289","0"
"Union","0","1","Georgia","4/4/20","0","1","13291","1"
"Upson","1","10","Georgia","4/4/20","4","6","13293","150"
"Walker","0","3","Georgia","4/4/20","0","3","13295","1"
"Walton","2","16","Georgia","4/4/20","2","14","13297","700"
"Ware","2","18","Georgia","4/4/20","2","16","13299","800"
"Warren","1","4","Georgia","4/4/20","0","4","13301","1"
"Washington","0","5","Georgia","4/4/20","2","3","13303","150"
"Webster","0","1","Georgia","4/4/20","0","1","13307","1"
"Wheeler","0","1","Georgia","4/4/20","0","1","13309","1"
"White","0","3","Georgia","4/4/20","1","2","13311","200"
"Whitfield","1","16","Georgia","4/4/20","6","10","13313","166.67"
"Wilcox","0","2","Georgia","4/4/20","0","2","13315","1"
"Wilkes","0","3","Georgia","4/4/20","1","2","13317","200"
"Wilkinson","0","2","Georgia","4/4/20","0","2","13319","1"
"Worth","4","35","Georgia","4/4/20","8","27","13321","337.5"
"","0","103","Grand Princess","4/4/20","103","0",,"0"
"","5","93","Guam","4/4/20","55","38",,"69.09"
"Hawaii","2","22","Hawaii","4/4/20","10","12","15001","120"
"Honolulu","23","266","Hawaii","4/4/20","108","158","15003","146.3"
"Kauai","1","15","Hawaii","4/4/20","11","4","15007","36.36"
"Maui","3","38","Hawaii","4/4/20","16","22","15009","137.5"
"Out of HI","0","2","Hawaii","4/4/20","0","2","80015","1"
"Ada","41","360","Idaho","4/4/20","76","284","16001","373.68"
"Adams","0","1","Idaho","4/4/20","0","1","16003","1"
"Bannock","0","5","Idaho","4/4/20","3","2","16005","66.67"
"Bingham","0","2","Idaho","4/4/20","1","1","16011","100"
"Blaine","44","405","Idaho","4/4/20","99","306","16013","309.09"
"Bonner","0","2","Idaho","4/4/20","0","2","16017","1"
"Bonneville","1","5","Idaho","4/4/20","1","4","16019","400"
"Camas","0","1","Idaho","4/4/20","0","1","16025","1"
"Canyon","9","89","Idaho","4/4/20","23","66","16027","286.96"
"Cassia","0","4","Idaho","4/4/20","1","3","16031","300"
"Custer","0","2","Idaho","4/4/20","1","1","16037","100"
"Elmore","1","10","Idaho","4/4/20","0","10","16039","1"
"Fremont","0","1","Idaho","4/4/20","1","0","16043","0"
"Gem","1","7","Idaho","4/4/20","1","6","16045","600"
"Gooding","0","1","Idaho","4/4/20","0","1","16047","1"
"Idaho","0","2","Idaho","4/4/20","1","1","16049","100"
"Jefferson","0","3","Idaho","4/4/20","2","1","16051","50"
"Jerome","2","11","Idaho","4/4/20","0","11","16053","1"
"Kootenai","4","37","Idaho","4/4/20","11","26","16055","236.36"
"Latah","0","1","Idaho","4/4/20","0","1","16057","1"
"Lewis","0","1","Idaho","4/4/20","0","1","16061","1"
"Lincoln","1","7","Idaho","4/4/20","1","6","16063","600"
"Madison","0","4","Idaho","4/4/20","2","2","16065","100"
"Minidoka","0","1","Idaho","4/4/20","0","1","16067","1"
"Nez Perce","1","13","Idaho","4/4/20","4","9","16069","225"
"Owyhee","0","2","Idaho","4/4/20","0","2","16073","1"
"Payette","1","5","Idaho","4/4/20","1","4","16075","400"
"Teton","0","3","Idaho","4/4/20","2","1","16081","50"
"Twin Falls","4","33","Idaho","4/4/20","2","31","16083","1550"
"Valley","0","3","Idaho","4/4/20","1","2","16085","200"
"Washington","0","1","Idaho","4/4/20","0","1","16087","1"
"Adams","0","3","Illinois","4/4/20","1","2","17001","200"
"Bond","0","3","Illinois","4/4/20","0","3","17005","1"
"Bureau","0","3","Illinois","4/4/20","1","2","17011","200"
"Carroll","0","4","Illinois","4/4/20","1","3","17015","300"
"Champaign","6","55","Illinois","4/4/20","11","44","17019","400"
"Christian","2","17","Illinois","4/4/20","1","16","17021","1600"
"Clark","0","2","Illinois","4/4/20","0","2","17023","1"
"Clinton","1","10","Illinois","4/4/20","5","5","17027","100"
"Cook","689","7439","Illinois","4/4/20","2613","4826","17031","184.69"
"Crawford","0","2","Illinois","4/4/20","0","2","17033","1"
"Cumberland","0","1","Illinois","4/4/20","1","0","17035","0"
"De Witt","0","1","Illinois","4/4/20","0","1","17039","1"
"DeKalb","2","19","Illinois","4/4/20","4","15","17037","375"
"Douglas","1","9","Illinois","4/4/20","1","8","17041","800"
"DuPage","55","590","Illinois","4/4/20","202","388","17043","192.08"
"Effingham","0","1","Illinois","4/4/20","0","1","17049","1"
"Fayette","0","2","Illinois","4/4/20","1","1","17051","100"
"Ford","0","1","Illinois","4/4/20","0","1","17053","1"
"Franklin","0","1","Illinois","4/4/20","1","0","17055","0"
"Grundy","1","9","Illinois","4/4/20","2","7","17063","350"
"Henry","1","7","Illinois","4/4/20","2","5","17073","250"
"Iroquois","0","4","Illinois","4/4/20","1","3","17075","300"
"Jackson","1","10","Illinois","4/4/20","2","8","17077","400"
"Jasper","0","2","Illinois","4/4/20","0","2","17079","1"
"Jersey","0","1","Illinois","4/4/20","0","1","17083","1"
"Jo Daviess","0","4","Illinois","4/4/20","1","3","17085","300"
"Kane","17","207","Illinois","4/4/20","90","117","17089","130"
"Kankakee","6","68","Illinois","4/4/20","27","41","17091","151.85"
"Kendall","5","47","Illinois","4/4/20","11","36","17093","327.27"
"Knox","0","1","Illinois","4/4/20","0","1","17095","1"
"Lake","63","683","Illinois","4/4/20","241","442","17097","183.4"
"LaSalle","1","7","Illinois","4/4/20","3","4","17099","133.33"
"Lee","0","2","Illinois","4/4/20","0","2","17103","1"
"Livingston","1","6","Illinois","4/4/20","2","4","17105","200"
"Logan","0","1","Illinois","4/4/20","0","1","17107","1"
"Macon","1","5","Illinois","4/4/20","1","4","17115","400"
"Macoupin","1","4","Illinois","4/4/20","0","4","17117","1"
"Madison","5","47","Illinois","4/4/20","10","37","17119","370"
"Marion","0","3","Illinois","4/4/20","0","3","17121","1"
"Marshall","0","1","Illinois","4/4/20","1","0","17123","0"
"Mason","0","1","Illinois","4/4/20","0","1","17125","1"
"Massac","0","1","Illinois","4/4/20","0","1","17127","1"
"McHenry","11","122","Illinois","4/4/20","47","75","17111","159.57"
"McLean","4","40","Illinois","4/4/20","10","30","17113","300"
"Menard","0","1","Illinois","4/4/20","0","1","17129","1"
"Mercer","0","1","Illinois","4/4/20","0","1","17131","1"
"Monroe","1","9","Illinois","4/4/20","3","6","17133","200"
"Montgomery","0","2","Illinois","4/4/20","0","2","17135","1"
"Morgan","1","6","Illinois","4/4/20","1","5","17137","500"
"Moultrie","0","1","Illinois","4/4/20","0","1","17139","1"
"Ogle","1","4","Illinois","4/4/20","0","4","17141","1"
"Peoria","1","11","Illinois","4/4/20","7","4","17143","57.14"
"Piatt","0","1","Illinois","4/4/20","0","1","17147","1"
"Pike","0","1","Illinois","4/4/20","0","1","17149","1"
"Randolph","3","20","Illinois","4/4/20","0","20","17157","1"
"Rock Island","4","29","Illinois","4/4/20","4","25","17161","625"
"Saline","0","1","Illinois","4/4/20","0","1","17165","1"
"Sangamon","2","25","Illinois","4/4/20","8","17","17167","212.5"
"St. Clair","9","80","Illinois","4/4/20","18","62","17163","344.44"
"Stephenson","0","3","Illinois","4/4/20","2","1","17177","50"
"Tazewell","1","10","Illinois","4/4/20","3","7","17179","233.33"
"Vermilion","1","5","Illinois","4/4/20","0","5","17183","1"
"Washington","0","1","Illinois","4/4/20","1","0","17189","0"
"Whiteside","2","15","Illinois","4/4/20","2","13","17195","650"
"Will","65","582","Illinois","4/4/20","127","455","17197","358.27"
"Williamson","0","3","Illinois","4/4/20","1","2","17199","200"
"Winnebago","4","36","Illinois","4/4/20","9","27","17201","300"
"Woodford","0","6","Illinois","4/4/20","3","3","17203","100"
"Adams","0","2","Indiana","4/4/20","1","1","18001","100"
"Allen","5","59","Indiana","4/4/20","23","36","18003","156.52"
"Bartholomew","5","45","Indiana","4/4/20","7","38","18005","542.86"
"Blackford","0","2","Indiana","4/4/20","0","2","18009","1"
"Boone","6","50","Indiana","4/4/20","8","42","18011","525"
"Brown","0","4","Indiana","4/4/20","2","2","18013","100"
"Carroll","0","3","Indiana","4/4/20","1","2","18015","200"
"Cass","1","4","Indiana","4/4/20","0","4","18017","1"
"Clark","6","61","Indiana","4/4/20","18","43","18019","238.89"
"Clay","0","3","Indiana","4/4/20","0","3","18021","1"
"Clinton","0","3","Indiana","4/4/20","1","2","18023","200"
"Crawford","1","5","Indiana","4/4/20","1","4","18025","400"
"Dearborn","3","30","Indiana","4/4/20","8","22","18029","275"
"Decatur","7","79","Indiana","4/4/20","30","49","18031","163.33"
"DeKalb","0","3","Indiana","4/4/20","1","2","18033","200"
"Delaware","4","33","Indiana","4/4/20","8","25","18035","312.5"
"Dubois","0","4","Indiana","4/4/20","1","3","18037","300"
"Elkhart","3","31","Indiana","4/4/20","11","20","18039","181.82"
"Fayette","1","14","Indiana","4/4/20","4","10","18041","250"
"Floyd","4","41","Indiana","4/4/20","13","28","18043","215.38"
"Fountain","0","2","Indiana","4/4/20","1","1","18045","100"
"Franklin","4","50","Indiana","4/4/20","23","27","18047","117.39"
"Fulton","0","2","Indiana","4/4/20","1","1","18049","100"
"Gibson","0","4","Indiana","4/4/20","4","0","18051","0"
"Grant","1","15","Indiana","4/4/20","5","10","18053","200"
"Greene","1","9","Indiana","4/4/20","0","9","18055","1"
"Hamilton","29","265","Indiana","4/4/20","64","201","18057","314.06"
"Hancock","5","57","Indiana","4/4/20","19","38","18059","200"
"Harrison","3","28","Indiana","4/4/20","7","21","18061","300"
"Hendricks","18","163","Indiana","4/4/20","36","127","18063","352.78"
"Henry","1","8","Indiana","4/4/20","1","7","18065","700"
"Howard","3","27","Indiana","4/4/20","9","18","18067","200"
"Huntington","1","5","Indiana","4/4/20","1","4","18069","400"
"Jackson","3","28","Indiana","4/4/20","7","21","18071","300"
"Jasper","1","15","Indiana","4/4/20","5","10","18073","200"
"Jay","0","2","Indiana","4/4/20","0","2","18075","1"
"Jefferson","1","5","Indiana","4/4/20","0","5","18077","1"
"Jennings","4","35","Indiana","4/4/20","10","25","18079","250"
"Johnson","14","153","Indiana","4/4/20","52","101","18081","194.23"
"Knox","1","5","Indiana","4/4/20","0","5","18083","1"
"Kosciusko","1","11","Indiana","4/4/20","2","9","18085","450"
"LaGrange","0","4","Indiana","4/4/20","2","2","18087","100"
"Lake","35","313","Indiana","4/4/20","68","245","18089","360.29"
"LaPorte","2","19","Indiana","4/4/20","4","15","18091","375"
"Lawrence","4","36","Indiana","4/4/20","5","31","18093","620"
"Madison","9","72","Indiana","4/4/20","12","60","18095","500"
"Marion","141","1570","Indiana","4/4/20","584","986","18097","168.84"
"Marshall","0","4","Indiana","4/4/20","3","1","18099","33.33"
"Martin","0","1","Indiana","4/4/20","0","1","18101","1"
"Miami","1","8","Indiana","4/4/20","1","7","18103","700"
"Monroe","4","45","Indiana","4/4/20","16","29","18105","181.25"
"Montgomery","1","14","Indiana","4/4/20","4","10","18107","250"
"Morgan","7","60","Indiana","4/4/20","14","46","18109","328.57"
"Newton","0","1","Indiana","4/4/20","1","0","18111","0"
"Noble","1","9","Indiana","4/4/20","2","7","18113","350"
"Ohio","0","1","Indiana","4/4/20","1","0","18115","0"
"Orange","1","5","Indiana","4/4/20","1","4","18117","400"
"Owen","1","13","Indiana","4/4/20","7","6","18119","85.71"
"Parke","0","2","Indiana","4/4/20","0","2","18121","1"
"Porter","6","51","Indiana","4/4/20","9","42","18127","466.67"
"Posey","0","5","Indiana","4/4/20","2","3","18129","150"
"Putnam","1","14","Indiana","4/4/20","5","9","18133","180"
"Randolph","1","5","Indiana","4/4/20","1","4","18135","400"
"Ripley","5","51","Indiana","4/4/20","15","36","18137","240"
"Rush","1","10","Indiana","4/4/20","3","7","18139","233.33"
"Scott","1","7","Indiana","4/4/20","1","6","18143","600"
"Shelby","3","32","Indiana","4/4/20","10","22","18145","220"
"Spencer","0","1","Indiana","4/4/20","0","1","18147","1"
"St. Joseph","8","89","Indiana","4/4/20","31","58","18141","187.1"
"Starke","0","2","Indiana","4/4/20","1","1","18149","100"
"Steuben","1","4","Indiana","4/4/20","0","4","18151","1"
"Sullivan","0","3","Indiana","4/4/20","1","2","18153","200"
"Switzerland","1","7","Indiana","4/4/20","1","6","18155","600"
"Tippecanoe","2","28","Indiana","4/4/20","11","17","18157","154.55"
"Tipton","1","6","Indiana","4/4/20","2","4","18159","200"
"Union","0","2","Indiana","4/4/20","0","2","18161","1"
"Vanderburgh","4","35","Indiana","4/4/20","10","25","18163","250"
"Vermillion","0","2","Indiana","4/4/20","0","2","18165","1"
"Vigo","1","10","Indiana","4/4/20","4","6","18167","150"
"Wabash","0","1","Indiana","4/4/20","1","0","18169","0"
"Warren","0","2","Indiana","4/4/20","1","1","18171","100"
"Warrick","1","12","Indiana","4/4/20","6","6","18173","100"
"Washington","2","16","Indiana","4/4/20","4","12","18175","300"
"Wayne","1","6","Indiana","4/4/20","1","5","18177","500"
"Wells","0","2","Indiana","4/4/20","1","1","18179","100"
"White","0","3","Indiana","4/4/20","1","2","18181","200"
"Whitley","1","5","Indiana","4/4/20","1","4","18183","400"
"Adair","0","1","Iowa","4/4/20","1","0","19001","0"
"Allamakee","1","16","Iowa","4/4/20","7","9","19005","128.57"
"Appanoose","0","1","Iowa","4/4/20","1","0","19007","0"
"Audubon","0","1","Iowa","4/4/20","0","1","19009","1"
"Benton","0","7","Iowa","4/4/20","4","3","19011","75"
"Black Hawk","1","10","Iowa","4/4/20","6","4","19013","66.67"
"Boone","0","2","Iowa","4/4/20","1","1","19015","100"
"Bremer","0","2","Iowa","4/4/20","0","2","19017","1"
"Buchanan","0","3","Iowa","4/4/20","2","1","19019","50"
"Butler","0","1","Iowa","4/4/20","1","0","19023","0"
"Carroll","0","1","Iowa","4/4/20","1","0","19027","0"
"Cedar","1","11","Iowa","4/4/20","6","5","19031","83.33"
"Cerro Gordo","1","10","Iowa","4/4/20","4","6","19033","150"
"Clay","0","2","Iowa","4/4/20","0","2","19041","1"
"Clayton","0","3","Iowa","4/4/20","1","2","19043","200"
"Clinton","2","15","Iowa","4/4/20","1","14","19045","1400"
"Crawford","1","4","Iowa","4/4/20","0","4","19047","1"
"Dallas","3","33","Iowa","4/4/20","15","18","19049","120"
"Des Moines","0","1","Iowa","4/4/20","1","0","19057","0"
"Dickinson","0","1","Iowa","4/4/20","1","0","19059","0"
"Dubuque","2","24","Iowa","4/4/20","12","12","19061","100"
"Fayette","0","3","Iowa","4/4/20","2","1","19065","50"
"Grundy","0","1","Iowa","4/4/20","0","1","19075","1"
"Guthrie","0","1","Iowa","4/4/20","0","1","19077","1"
"Hancock","0","3","Iowa","4/4/20","3","0","19081","0"
"Hardin","0","1","Iowa","4/4/20","1","0","19083","0"
"Harrison","0","10","Iowa","4/4/20","8","2","19085","25"
"Henry","1","6","Iowa","4/4/20","2","4","19087","200"
"Howard","0","1","Iowa","4/4/20","0","1","19089","1"
"Iowa","1","6","Iowa","4/4/20","1","5","19095","500"
"Jackson","0","3","Iowa","4/4/20","0","3","19097","1"
"Jasper","1","8","Iowa","4/4/20","3","5","19099","166.67"
"Jefferson","0","3","Iowa","4/4/20","0","3","19101","1"
"Johnson","5","96","Iowa","4/4/20","61","35","19103","57.38"
"Jones","1","5","Iowa","4/4/20","0","5","19105","1"
"Keokuk","0","2","Iowa","4/4/20","1","1","19107","100"
"Kossuth","0","1","Iowa","4/4/20","1","0","19109","0"
"Lee","0","1","Iowa","4/4/20","0","1","19111","1"
"Linn","15","139","Iowa","4/4/20","36","103","19113","286.11"
"Louisa","0","1","Iowa","4/4/20","0","1","19115","1"
"Lyon","0","2","Iowa","4/4/20","0","2","19119","1"
"Madison","0","1","Iowa","4/4/20","0","1","19121","1"
"Mahaska","0","3","Iowa","4/4/20","2","1","19123","50"
"Marshall","1","10","Iowa","4/4/20","5","5","19127","100"
"Mills","0","1","Iowa","4/4/20","0","1","19129","1"
"Mitchell","0","2","Iowa","4/4/20","0","2","19131","1"
"Monona","1","6","Iowa","4/4/20","2","4","19133","200"
"Montgomery","0","1","Iowa","4/4/20","1","0","19137","0"
"Muscatine","2","27","Iowa","4/4/20","10","17","19139","170"
"O'Brien","0","3","Iowa","4/4/20","0","3","19141","1"
"Page","0","3","Iowa","4/4/20","2","1","19145","50"
"Plymouth","0","3","Iowa","4/4/20","0","3","19149","1"
"Polk","10","109","Iowa","4/4/20","40","69","19153","172.5"
"Pottawattamie","1","8","Iowa","4/4/20","3","5","19155","166.67"
"Poweshiek","0","6","Iowa","4/4/20","5","1","19157","20"
"Scott","4","38","Iowa","4/4/20","10","28","19163","280"
"Shelby","1","5","Iowa","4/4/20","1","4","19165","400"
"Sioux","1","7","Iowa","4/4/20","2","5","19167","250"
"Story","0","5","Iowa","4/4/20","2","3","19169","150"
"Tama","3","29","Iowa","4/4/20","8","21","19171","262.5"
"Taylor","0","1","Iowa","4/4/20","1","0","19173","0"
"Van Buren","1","6","Iowa","4/4/20","0","6","19177","1"
"Wapello","0","1","Iowa","4/4/20","1","0","19179","0"
"Warren","1","9","Iowa","4/4/20","1","8","19181","800"
"Washington","5","47","Iowa","4/4/20","11","36","19183","327.27"
"Webster","0","1","Iowa","4/4/20","1","0","19187","0"
"Winneshiek","0","4","Iowa","4/4/20","2","2","19191","100"
"Woodbury","1","8","Iowa","4/4/20","3","5","19193","166.67"
"Wright","0","1","Iowa","4/4/20","1","0","19197","0"
"Atchison","0","2","Kansas","4/4/20","0","2","20005","1"
"Barton","0","3","Kansas","4/4/20","0","3","20009","1"
"Bourbon","0","3","Kansas","4/4/20","3","0","20011","0"
"Butler","1","8","Kansas","4/4/20","3","5","20015","166.67"
"Chautauqua","0","3","Kansas","4/4/20","0","3","20019","1"
"Cherokee","0","5","Kansas","4/4/20","2","3","20021","150"
"Clay","0","1","Kansas","4/4/20","1","0","20027","0"
"Cloud","0","1","Kansas","4/4/20","0","1","20029","1"
"Coffey","3","23","Kansas","4/4/20","5","18","20031","360"
"Cowley","0","1","Kansas","4/4/20","0","1","20035","1"
"Crawford","0","4","Kansas","4/4/20","3","1","20037","33.33"
"Doniphan","0","1","Kansas","4/4/20","1","0","20043","0"
"Douglas","1","32","Kansas","4/4/20","23","9","20045","39.13"
"Finney","1","9","Kansas","4/4/20","0","9","20055","1"
"Ford","0","1","Kansas","4/4/20","1","0","20057","0"
"Franklin","0","9","Kansas","4/4/20","6","3","20059","50"
"Gove","0","1","Kansas","4/4/20","1","0","20063","0"
"Greenwood","0","1","Kansas","4/4/20","0","1","20073","1"
"Harvey","0","2","Kansas","4/4/20","1","1","20079","100"
"Jackson","0","1","Kansas","4/4/20","1","0","20085","0"
"Jefferson","0","2","Kansas","4/4/20","1","1","20087","100"
"Jewell","0","1","Kansas","4/4/20","0","1","20089","1"
"Johnson","15","185","Kansas","4/4/20","80","105","20091","131.25"
"Labette","1","4","Kansas","4/4/20","0","4","20099","1"
"Leavenworth","3","33","Kansas","4/4/20","15","18","20103","120"
"Linn","0","5","Kansas","4/4/20","4","1","20107","25"
"Lyon","2","19","Kansas","4/4/20","4","15","20111","375"
"Marion","0","2","Kansas","4/4/20","0","2","20115","1"
"McPherson","1","8","Kansas","4/4/20","1","7","20113","700"
"Miami","0","2","Kansas","4/4/20","0","2","20121","1"
"Mitchell","0","2","Kansas","4/4/20","2","0","20123","0"
"Montgomery","1","6","Kansas","4/4/20","0","6","20125","1"
"Morris","0","2","Kansas","4/4/20","2","0","20127","0"
"Neosho","0","1","Kansas","4/4/20","1","0","20133","0"
"Osage","0","3","Kansas","4/4/20","1","2","20139","200"
"Osborne","0","2","Kansas","4/4/20","0","2","20141","1"
"Ottawa","0","2","Kansas","4/4/20","1","1","20143","100"
"Pottawatomie","0","2","Kansas","4/4/20","1","1","20149","100"
"Pratt","0","1","Kansas","4/4/20","0","1","20151","1"
"Reno","1","9","Kansas","4/4/20","5","4","20155","80"
"Riley","1","11","Kansas","4/4/20","2","9","20161","450"
"Saline","1","5","Kansas","4/4/20","0","5","20169","1"
"Sedgwick","9","97","Kansas","4/4/20","33","64","20173","193.94"
"Shawnee","3","27","Kansas","4/4/20","7","20","20177","285.71"
"Stafford","0","1","Kansas","4/4/20","0","1","20185","1"
"Stevens","0","1","Kansas","4/4/20","0","1","20189","1"
"Sumner","0","2","Kansas","4/4/20","1","1","20191","100"
"Woodson","0","3","Kansas","4/4/20","1","2","20207","200"
"Wyandotte","14","149","Kansas","4/4/20","53","96","20209","181.13"
"Adair","0","3","Kentucky","4/4/20","0","3","21001","1"
"Allen","0","2","Kentucky","4/4/20","1","1","21003","100"
"Anderson","0","3","Kentucky","4/4/20","2","1","21005","50"
"Barren","0","1","Kentucky","4/4/20","0","1","21009","1"
"Bath","0","1","Kentucky","4/4/20","0","1","21011","1"
"Boone","1","11","Kentucky","4/4/20","5","6","21015","120"
"Bourbon","0","4","Kentucky","4/4/20","2","2","21017","100"
"Boyd","2","13","Kentucky","4/4/20","0","13","21019","1"
"Boyle","1","7","Kentucky","4/4/20","0","7","21021","1"
"Bracken","0","1","Kentucky","4/4/20","0","1","21023","1"
"Breathitt","0","1","Kentucky","4/4/20","2","-1","21025","-50"
"Bullitt","2","11","Kentucky","4/4/20","0","11","21029","1"
"Butler","0","1","Kentucky","4/4/20","0","1","21031","1"
"Caldwell","0","3","Kentucky","4/4/20","0","3","21033","1"
"Calloway","1","5","Kentucky","4/4/20","1","4","21035","400"
"Campbell","1","12","Kentucky","4/4/20","3","9","21037","300"
"Carroll","0","2","Kentucky","4/4/20","0","2","21041","1"
"Carter","0","1","Kentucky","4/4/20","0","1","21043","1"
"Christian","3","23","Kentucky","4/4/20","2","21","21047","1050"
"Clark","1","11","Kentucky","4/4/20","2","9","21049","450"
"Clinton","0","1","Kentucky","4/4/20","0","1","21053","1"
"Crittenden","0","1","Kentucky","4/4/20","0","1","21055","1"
"Cumberland","0","1","Kentucky","4/4/20","0","1","21057","1"
"Daviess","5","55","Kentucky","4/4/20","20","35","21059","175"
"Edmonson","1","5","Kentucky","4/4/20","0","5","21061","1"
"Fayette","13","120","Kentucky","4/4/20","28","92","21067","328.57"
"Franklin","1","7","Kentucky","4/4/20","2","5","21073","250"
"Grant","0","2","Kentucky","4/4/20","0","2","21081","1"
"Graves","0","2","Kentucky","4/4/20","0","2","21083","1"
"Grayson","0","2","Kentucky","4/4/20","0","2","21085","1"
"Greenup","0","1","Kentucky","4/4/20","0","1","21089","1"
"Hancock","0","1","Kentucky","4/4/20","1","0","21091","0"
"Hardin","1","9","Kentucky","4/4/20","2","7","21093","350"
"Harrison","0","11","Kentucky","4/4/20","10","1","21097","10"
"Henderson","0","6","Kentucky","4/4/20","3","3","21101","100"
"Henry","0","2","Kentucky","4/4/20","0","2","21103","1"
"Hopkins","5","33","Kentucky","4/4/20","0","33","21107","1"
"Jefferson","28","299","Kentucky","4/4/20","103","196","21111","190.29"
"Jessamine","2","15","Kentucky","4/4/20","1","14","21113","1400"
"Johnson","0","1","Kentucky","4/4/20","0","1","21115","1"
"Kenton","3","33","Kentucky","4/4/20","12","21","21117","175"
"Larue","0","3","Kentucky","4/4/20","0","3","21123","1"
"Laurel","0","2","Kentucky","4/4/20","1","1","21125","100"
"Lawrence","0","1","Kentucky","4/4/20","0","1","21127","1"
"Lewis","0","2","Kentucky","4/4/20","0","2","21135","1"
"Logan","0","4","Kentucky","4/4/20","1","3","21141","300"
"Lyon","0","4","Kentucky","4/4/20","1","3","21143","300"
"Madison","1","11","Kentucky","4/4/20","2","9","21151","450"
"Marion","0","3","Kentucky","4/4/20","0","3","21155","1"
"Marshall","0","2","Kentucky","4/4/20","0","2","21157","1"
"Martin","0","1","Kentucky","4/4/20","1","0","21159","0"
"Mason","0","2","Kentucky","4/4/20","0","2","21161","1"
"McCracken","1","10","Kentucky","4/4/20","2","8","21145","400"
"McCreary","0","1","Kentucky","4/4/20","0","1","21147","1"
"McLean","0","1","Kentucky","4/4/20","1","0","21149","0"
"Meade","0","2","Kentucky","4/4/20","0","2","21163","1"
"Menifee","0","3","Kentucky","4/4/20","1","2","21165","200"
"Mercer","0","3","Kentucky","4/4/20","0","3","21167","1"
"Montgomery","0","5","Kentucky","4/4/20","2","3","21173","150"
"Muhlenberg","0","0","Kentucky","4/4/20","2","-2","21177","-100"
"Nelson","0","4","Kentucky","4/4/20","1","3","21179","300"
"Nicholas","0","1","Kentucky","4/4/20","0","1","21181","1"
"Ohio","0","1","Kentucky","4/4/20","0","1","21183","1"
"Oldham","1","6","Kentucky","4/4/20","1","5","21185","500"
"Pendleton","0","1","Kentucky","4/4/20","0","1","21191","1"
"Perry","0","3","Kentucky","4/4/20","0","3","21193","1"
"Pike","0","1","Kentucky","4/4/20","0","1","21195","1"
"Powell","0","1","Kentucky","4/4/20","0","1","21197","1"
"Pulaski","1","12","Kentucky","4/4/20","3","9","21199","300"
"Rockcastle","0","1","Kentucky","4/4/20","0","1","21203","1"
"Russell","0","1","Kentucky","4/4/20","0","1","21207","1"
"Scott","2","12","Kentucky","4/4/20","1","11","21209","1100"
"Shelby","1","7","Kentucky","4/4/20","0","7","21211","1"
"Simpson","2","13","Kentucky","4/4/20","1","12","21213","1200"
"Spencer","0","2","Kentucky","4/4/20","1","1","21215","100"
"Taylor","0","2","Kentucky","4/4/20","0","2","21217","1"
"Union","0","2","Kentucky","4/4/20","0","2","21225","1"
"Warren","2","18","Kentucky","4/4/20","5","13","21227","260"
"Washington","0","2","Kentucky","4/4/20","0","2","21229","1"
"Wayne","1","4","Kentucky","4/4/20","0","4","21231","1"
"Webster","0","3","Kentucky","4/4/20","1","2","21233","200"
"Woodford","1","8","Kentucky","4/4/20","0","8","21239","1"
"Acadia","8","65","Louisiana","4/4/20","9","56","22001","622.22"
"Allen","5","39","Louisiana","4/4/20","7","32","22003","457.14"
"Ascension","25","284","Louisiana","4/4/20","107","177","22005","165.42"
"Assumption","7","56","Louisiana","4/4/20","8","48","22007","600"
"Avoyelles","3","36","Louisiana","4/4/20","12","24","22009","200"
"Beauregard","2","15","Louisiana","4/4/20","4","11","22011","275"
"Bienville","1","10","Louisiana","4/4/20","3","7","22013","233.33"
"Bossier","12","126","Louisiana","4/4/20","45","81","22015","180"
"Caddo","58","598","Louisiana","4/4/20","189","409","22017","216.4"
"Calcasieu","15","135","Louisiana","4/4/20","28","107","22019","382.14"
"Caldwell","0","3","Louisiana","4/4/20","0","3","22021","1"
"Catahoula","1","9","Louisiana","4/4/20","1","8","22025","800"
"Claiborne","2","20","Louisiana","4/4/20","4","16","22027","400"
"Concordia","1","5","Louisiana","4/4/20","0","5","22029","1"
"De Soto","7","71","Louisiana","4/4/20","21","50","22031","238.1"
"East Baton Rouge","67","621","Louisiana","4/4/20","153","468","22033","305.88"
"East Carroll","0","1","Louisiana","4/4/20","1","0","22035","0"
"East Feliciana","2","22","Louisiana","4/4/20","6","16","22037","266.67"
"Evangeline","2","19","Louisiana","4/4/20","4","15","22039","375"
"Franklin","2","19","Louisiana","4/4/20","4","15","22041","375"
"Grant","1","9","Louisiana","4/4/20","1","8","22043","800"
"Iberia","8","68","Louisiana","4/4/20","9","59","22045","655.56"
"Iberville","14","119","Louisiana","4/4/20","21","98","22047","466.67"
"Jackson","0","1","Louisiana","4/4/20","2","-1","22049","-50"
"Jefferson","323","3008","Louisiana","4/4/20","744","2264","22051","304.3"
"Jefferson Davis","1","9","Louisiana","4/4/20","1","8","22053","800"
"Lafayette","26","229","Louisiana","4/4/20","48","181","22055","377.08"
"Lafourche","26","217","Louisiana","4/4/20","34","183","22057","538.24"
"LaSalle","0","4","Louisiana","4/4/20","2","2","22059","100"
"Lincoln","2","17","Louisiana","4/4/20","6","11","22061","183.33"
"Livingston","7","64","Louisiana","4/4/20","12","52","22063","433.33"
"Madison","0","1","Louisiana","4/4/20","1","0","22065","0"
"Morehouse","1","9","Louisiana","4/4/20","2","7","22067","350"
"Natchitoches","2","15","Louisiana","4/4/20","2","13","22069","650"
"Orleans","381","3966","Louisiana","4/4/20","1298","2668","22071","205.55"
"Ouachita","20","176","Louisiana","4/4/20","34","142","22073","417.65"
"Plaquemines","10","86","Louisiana","4/4/20","19","67","22075","352.63"
"Pointe Coupee","2","16","Louisiana","4/4/20","2","14","22077","700"
"Rapides","9","97","Louisiana","4/4/20","37","60","22079","162.16"
"Red River","0","2","Louisiana","4/4/20","0","2","22081","1"
"Richland","1","9","Louisiana","4/4/20","2","7","22083","350"
"Sabine","1","4","Louisiana","4/4/20","0","4","22085","1"
"St. Bernard","28","239","Louisiana","4/4/20","43","196","22087","455.81"
"St. Charles","32","252","Louisiana","4/4/20","30","222","22089","740"
"St. Helena","1","4","Louisiana","4/4/20","0","4","22091","1"
"St. James","15","150","Louisiana","4/4/20","48","102","22093","212.5"
"St. John the Baptist","41","338","Louisiana","4/4/20","54","284","22095","525.93"
"St. Landry","5","45","Louisiana","4/4/20","10","35","22097","350"
"St. Martin","7","64","Louisiana","4/4/20","13","51","22099","392.31"
"St. Mary","8","65","Louisiana","4/4/20","7","58","22101","828.57"
"St. Tammany","57","532","Louisiana","4/4/20","134","398","22103","297.01"
"Tangipahoa","17","131","Louisiana","4/4/20","10","121","22105","1210"
"Terrebonne","17","143","Louisiana","4/4/20","26","117","22109","450"
"Union","2","19","Louisiana","4/4/20","7","12","22111","171.43"
"Vermilion","2","15","Louisiana","4/4/20","3","12","22113","400"
"Vernon","1","11","Louisiana","4/4/20","2","9","22115","450"
"Washington","9","75","Louisiana","4/4/20","10","65","22117","650"
"Webster","5","42","Louisiana","4/4/20","9","33","22119","366.67"
"West Baton Rouge","4","40","Louisiana","4/4/20","12","28","22121","233.33"
"West Feliciana","2","18","Louisiana","4/4/20","4","14","22125","350"
"Winn","0","2","Louisiana","4/4/20","1","1","22127","100"
"Androscoggin","2","20","Maine","4/4/20","7","13","23001","185.71"
"Aroostook","0","1","Maine","4/4/20","0","1","23003","1"
"Cumberland","16","231","Maine","4/4/20","120","111","23005","92.5"
"Franklin","0","4","Maine","4/4/20","2","2","23007","100"
"Hancock","0","2","Maine","4/4/20","0","2","23009","1"
"Kennebec","2","21","Maine","4/4/20","9","12","23011","133.33"
"Knox","1","9","Maine","4/4/20","2","7","23013","350"
"Lincoln","0","8","Maine","4/4/20","5","3","23015","60"
"Oxford","0","11","Maine","4/4/20","8","3","23017","37.5"
"Penobscot","2","22","Maine","4/4/20","10","12","23019","120"
"Sagadahoc","1","13","Maine","4/4/20","5","8","23023","160"
"Somerset","0","3","Maine","4/4/20","0","3","23025","1"
"Waldo","0","3","Maine","4/4/20","2","1","23027","50"
"Washington","0","1","Maine","4/4/20","0","1","23029","1"
"York","8","95","Maine","4/4/20","38","57","23031","150"
"Allegany","0","3","Maryland","4/4/20","0","3","24001","1"
"Anne Arundel","29","289","Maryland","4/4/20","88","201","24003","228.41"
"Baltimore","50","491","Maryland","4/4/20","141","350","24005","248.23"
"Baltimore City","33","343","Maryland","4/4/20","112","231","24510","206.25"
"Calvert","4","33","Maryland","4/4/20","8","25","24009","312.5"
"Caroline","0","4","Maryland","4/4/20","1","3","24011","300"
"Carroll","18","134","Maryland","4/4/20","10","124","24013","1240"
"Cecil","3","33","Maryland","4/4/20","13","20","24015","153.85"
"Charles","11","95","Maryland","4/4/20","21","74","24017","352.38"
"Dorchester","0","1","Maryland","4/4/20","0","1","24019","1"
"Frederick","7","73","Maryland","4/4/20","22","51","24021","231.82"
"Garrett","0","3","Maryland","4/4/20","3","0","24023","0"
"Harford","3","44","Maryland","4/4/20","21","23","24025","109.52"
"Howard","15","180","Maryland","4/4/20","73","107","24027","146.58"
"Kent","0","5","Maryland","4/4/20","2","3","24029","150"
"Montgomery","55","640","Maryland","4/4/20","255","385","24031","150.98"
"Prince George's","65","653","Maryland","4/4/20","196","457","24033","233.16"
"Queen Anne's","1","13","Maryland","4/4/20","4","9","24035","225"
"Somerset","0","4","Maryland","4/4/20","1","3","24039","300"
"St. Mary's","4","34","Maryland","4/4/20","8","26","24037","325"
"Talbot","1","6","Maryland","4/4/20","2","4","24041","200"
"Washington","3","29","Maryland","4/4/20","6","23","24043","383.33"
"Wicomico","0","8","Maryland","4/4/20","6","2","24045","33.33"
"Worcester","1","7","Maryland","4/4/20","2","5","24047","250"
"Barnstable","28","330","Massachusetts","4/4/20","133","197","25001","148.12"
"Berkshire","19","253","Massachusetts","4/4/20","119","134","25003","112.61"
"Bristol","60","601","Massachusetts","4/4/20","179","422","25005","235.75"
"Dukes and Nantucket","1","16","Massachusetts","4/4/20","8","8","00000","100"
"Essex","133","1400","Massachusetts","4/4/20","472","928","25009","196.61"
"Franklin","8","95","Massachusetts","4/4/20","39","56","25011","143.59"
"Hampden","79","733","Massachusetts","4/4/20","183","550","25013","300.55"
"Hampshire","14","125","Massachusetts","4/4/20","30","95","25015","316.67"
"Middlesex","232","2468","Massachusetts","4/4/20","842","1626","25017","193.11"
"Norfolk","101","1199","Massachusetts","4/4/20","490","709","25021","144.69"
"Plymouth","89","898","Massachusetts","4/4/20","272","626","25023","230.15"
"Suffolk","227","2429","Massachusetts","4/4/20","843","1586","25025","188.14"
"Worcester","89","915","Massachusetts","4/4/20","291","624","25027","214.43"
"Allegan","1","11","Michigan","4/4/20","2","9","26005","450"
"Antrim","1","5","Michigan","4/4/20","1","4","26009","400"
"Arenac","0","3","Michigan","4/4/20","0","3","26011","1"
"Barry","1","7","Michigan","4/4/20","2","5","26015","250"
"Bay","3","27","Michigan","4/4/20","6","21","26017","350"
"Berrien","8","113","Michigan","4/4/20","56","57","26021","101.79"
"Branch","1","10","Michigan","4/4/20","0","10","26023","1"
"Calhoun","4","37","Michigan","4/4/20","12","25","26025","208.33"
"Cass","1","10","Michigan","4/4/20","4","6","26027","150"
"Charlevoix","0","7","Michigan","4/4/20","4","3","26029","75"
"Cheboygan","1","8","Michigan","4/4/20","1","7","26031","700"
"Chippewa","0","1","Michigan","4/4/20","0","1","26033","1"
"Clare","0","1","Michigan","4/4/20","1","0","26035","0"
"Clinton","6","57","Michigan","4/4/20","13","44","26037","338.46"
"Crawford","0","1","Michigan","4/4/20","1","0","26039","0"
"Delta","1","5","Michigan","4/4/20","0","5","26041","1"
"Dickinson","0","1","Michigan","4/4/20","0","1","26043","1"
"Eaton","7","54","Michigan","4/4/20","8","46","26045","575"
"Emmet","1","8","Michigan","4/4/20","4","4","26047","100"
"Genesee","52","474","Michigan","4/4/20","112","362","26049","323.21"
"Gladwin","0","3","Michigan","4/4/20","2","1","26051","50"
"Gogebic","0","3","Michigan","4/4/20","1","2","26053","200"
"Grand Traverse","1","12","Michigan","4/4/20","5","7","26055","140"
"Gratiot","0","4","Michigan","4/4/20","2","2","26057","100"
"Hillsdale","4","38","Michigan","4/4/20","7","31","26059","442.86"
"Houghton","0","2","Michigan","4/4/20","0","2","26061","1"
"Huron","1","5","Michigan","4/4/20","1","4","26063","400"
"Ingham","20","174","Michigan","4/4/20","35","139","26065","397.14"
"Ionia","1","6","Michigan","4/4/20","2","4","26067","200"
"Iosco","0","3","Michigan","4/4/20","1","2","26069","200"
"Isabella","1","14","Michigan","4/4/20","4","10","26073","250"
"Jackson","9","90","Michigan","4/4/20","24","66","26075","275"
"Kalamazoo","5","50","Michigan","4/4/20","17","33","26077","194.12"
"Kalkaska","1","8","Michigan","4/4/20","4","4","26079","100"
"Kent","15","157","Michigan","4/4/20","54","103","26081","190.74"
"Lapeer","4","31","Michigan","4/4/20","4","27","26087","675"
"Leelanau","0","1","Michigan","4/4/20","1","0","26089","0"
"Lenawee","3","30","Michigan","4/4/20","11","19","26091","172.73"
"Livingston","15","153","Michigan","4/4/20","51","102","26093","200"
"Luce","0","1","Michigan","4/4/20","0","1","26095","1"
"Mackinac","0","2","Michigan","4/4/20","0","2","26097","1"
"Macomb","186","1840","Michigan","4/4/20","536","1304","26099","243.28"
"Manistee","1","5","Michigan","4/4/20","1","4","26101","400"
"Marquette","1","11","Michigan","4/4/20","1","10","26103","1000"
"Mason","0","1","Michigan","4/4/20","0","1","26105","1"
"Mecosta","0","4","Michigan","4/4/20","1","3","26107","300"
"Midland","1","22","Michigan","4/4/20","13","9","26111","69.23"
"Missaukee","0","1","Michigan","4/4/20","1","0","26113","0"
"Monroe","10","101","Michigan","4/4/20","34","67","26115","197.06"
"Montcalm","2","14","Michigan","4/4/20","3","11","26117","366.67"
"Muskegon","3","31","Michigan","4/4/20","7","24","26121","342.86"
"Newaygo","0","2","Michigan","4/4/20","1","1","26123","100"
"Oakland","266","3018","Michigan","4/4/20","1155","1863","26125","161.3"
"Oceana","0","3","Michigan","4/4/20","1","2","26127","200"
"Ogemaw","0","3","Michigan","4/4/20","2","1","26129","50"
"Osceola","0","4","Michigan","4/4/20","1","3","26133","300"
"Oscoda","0","2","Michigan","4/4/20","0","2","26135","1"
"Otsego","1","23","Michigan","4/4/20","14","9","26137","64.29"
"Ottawa","3","48","Michigan","4/4/20","25","23","26139","92"
"Out of MI","10","83","Michigan","4/4/20","15","68","80026","453.33"
"Roscommon","0","2","Michigan","4/4/20","1","1","26143","100"
"Saginaw","12","103","Michigan","4/4/20","19","84","26145","442.11"
"Sanilac","2","13","Michigan","4/4/20","2","11","26151","550"
"Shiawassee","3","24","Michigan","4/4/20","2","22","26155","1100"
"St. Clair","11","96","Michigan","4/4/20","22","74","26147","336.36"
"St. Joseph","1","9","Michigan","4/4/20","0","9","26149","1"
"Tuscola","2","20","Michigan","4/4/20","4","16","26157","400"
"Van Buren","2","16","Michigan","4/4/20","5","11","26159","220"
"Washtenaw","49","543","Michigan","4/4/20","201","342","26161","170.15"
"Wayne","641","6809","Michigan","4/4/20","2322","4487","26163","193.24"
"Wexford","1","5","Michigan","4/4/20","1","4","26165","400"
"Anoka","3","36","Minnesota","4/4/20","12","24","27003","200"
"Beltrami","0","5","Minnesota","4/4/20","2","3","27007","150"
"Benton","0","1","Minnesota","4/4/20","1","0","27009","0"
"Big Stone","0","1","Minnesota","4/4/20","1","0","27011","0"
"Blue Earth","1","14","Minnesota","4/4/20","7","7","27013","100"
"Brown","0","3","Minnesota","4/4/20","0","3","27015","1"
"Carlton","1","8","Minnesota","4/4/20","0","8","27017","1"
"Carver","0","10","Minnesota","4/4/20","9","1","27019","11.11"
"Cass","0","1","Minnesota","4/4/20","1","0","27021","0"
"Chisago","0","4","Minnesota","4/4/20","1","3","27025","300"
"Clay","1","13","Minnesota","4/4/20","4","9","27027","225"
"Clearwater","0","2","Minnesota","4/4/20","1","1","27029","100"
"Cottonwood","1","5","Minnesota","4/4/20","0","5","27033","1"
"Crow Wing","1","5","Minnesota","4/4/20","0","5","27035","1"
"Dakota","3","56","Minnesota","4/4/20","33","23","27037","69.7"
"Dodge","1","10","Minnesota","4/4/20","6","4","27039","66.67"
"Douglas","0","1","Minnesota","4/4/20","0","1","27041","1"
"Faribault","0","3","Minnesota","4/4/20","1","2","27043","200"
"Fillmore","1","9","Minnesota","4/4/20","5","4","27045","80"
"Freeborn","1","10","Minnesota","4/4/20","0","10","27047","1"
"Goodhue","1","8","Minnesota","4/4/20","2","6","27049","300"
"Hennepin","14","252","Minnesota","4/4/20","152","100","27053","65.79"
"Isanti","0","3","Minnesota","4/4/20","0","3","27059","1"
"Itasca","0","2","Minnesota","4/4/20","0","2","27061","1"
"Jackson","0","1","Minnesota","4/4/20","1","0","27063","0"
"Kandiyohi","0","2","Minnesota","4/4/20","1","1","27067","100"
"Koochiching","0","1","Minnesota","4/4/20","0","1","27071","1"
"Lac qui Parle","0","1","Minnesota","4/4/20","1","0","27073","0"
"Le Sueur","1","20","Minnesota","4/4/20","11","9","27079","81.82"
"Lincoln","0","1","Minnesota","4/4/20","1","0","27081","0"
"Lyon","0","3","Minnesota","4/4/20","0","3","27083","1"
"Mahnomen","0","1","Minnesota","4/4/20","1","0","27087","0"
"Martin","2","32","Minnesota","4/4/20","19","13","27091","68.42"
"McLeod","0","1","Minnesota","4/4/20","0","1","27085","1"
"Meeker","0","1","Minnesota","4/4/20","0","1","27093","1"
"Mower","1","17","Minnesota","4/4/20","11","6","27099","54.55"
"Nicollet","0","4","Minnesota","4/4/20","3","1","27103","33.33"
"Olmsted","7","88","Minnesota","4/4/20","37","51","27109","137.84"
"Otter Tail","0","1","Minnesota","4/4/20","0","1","27111","1"
"Polk","0","1","Minnesota","4/4/20","0","1","27119","1"
"Ramsey","5","79","Minnesota","4/4/20","42","37","27123","88.1"
"Renville","0","2","Minnesota","4/4/20","1","1","27129","100"
"Rice","0","4","Minnesota","4/4/20","3","1","27131","33.33"
"Scott","1","12","Minnesota","4/4/20","8","4","27139","50"
"Sherburne","1","9","Minnesota","4/4/20","5","4","27141","80"
"Sibley","0","1","Minnesota","4/4/20","1","0","27143","0"
"St. Louis","1","13","Minnesota","4/4/20","5","8","27137","160"
"Stearns","0","6","Minnesota","4/4/20","5","1","27145","20"
"Steele","0","8","Minnesota","4/4/20","5","3","27147","60"
"Traverse","0","2","Minnesota","4/4/20","0","2","27155","1"
"Wabasha","0","6","Minnesota","4/4/20","4","2","27157","50"
"Waseca","0","3","Minnesota","4/4/20","3","0","27161","0"
"Washington","4","54","Minnesota","4/4/20","25","29","27163","116"
"Watonwan","0","3","Minnesota","4/4/20","0","3","27165","1"
"Wilkin","0","2","Minnesota","4/4/20","1","1","27167","100"
"Winona","1","13","Minnesota","4/4/20","4","9","27169","225"
"Wright","0","8","Minnesota","4/4/20","5","3","27171","60"
"Yellow Medicine","0","1","Minnesota","4/4/20","0","1","27173","1"
"Adams","1","16","Mississippi","4/4/20","6","10","28001","166.67"
"Alcorn","1","6","Mississippi","4/4/20","1","5","28003","500"
"Amite","1","6","Mississippi","4/4/20","0","6","28005","1"
"Attala","1","14","Mississippi","4/4/20","9","5","28007","55.56"
"Benton","0","5","Mississippi","4/4/20","2","3","28009","150"
"Bolivar","3","34","Mississippi","4/4/20","11","23","28011","209.09"
"Calhoun","0","4","Mississippi","4/4/20","3","1","28013","33.33"
"Carroll","1","5","Mississippi","4/4/20","0","5","28015","1"
"Chickasaw","1","15","Mississippi","4/4/20","10","5","28017","50"
"Choctaw","1","8","Mississippi","4/4/20","4","4","28019","100"
"Claiborne","0","1","Mississippi","4/4/20","0","1","28021","1"
"Clarke","1","5","Mississippi","4/4/20","1","4","28023","400"
"Clay","1","7","Mississippi","4/4/20","2","5","28025","250"
"Coahoma","1","27","Mississippi","4/4/20","18","9","28027","50"
"Copiah","1","12","Mississippi","4/4/20","8","4","28029","50"
"Covington","0","4","Mississippi","4/4/20","1","3","28031","300"
"DeSoto","8","118","Mississippi","4/4/20","65","53","28033","81.54"
"Forrest","2","34","Mississippi","4/4/20","18","16","28035","88.89"
"Franklin","0","4","Mississippi","4/4/20","3","1","28037","33.33"
"George","0","4","Mississippi","4/4/20","1","3","28039","300"
"Grenada","0","4","Mississippi","4/4/20","2","2","28043","100"
"Hancock","3","30","Mississippi","4/4/20","9","21","28045","233.33"
"Harrison","5","70","Mississippi","4/4/20","38","32","28047","84.21"
"Hinds","12","140","Mississippi","4/4/20","58","82","28049","141.38"
"Holmes","1","17","Mississippi","4/4/20","13","4","28051","30.77"
"Humphreys","0","4","Mississippi","4/4/20","2","2","28053","100"
"Itawamba","0","3","Mississippi","4/4/20","3","0","28057","0"
"Jackson","7","79","Mississippi","4/4/20","33","46","28059","139.39"
"Jasper","0","3","Mississippi","4/4/20","0","3","28061","1"
"Jefferson","0","2","Mississippi","4/4/20","1","1","28063","100"
"Jones","1","9","Mississippi","4/4/20","3","6","28067","200"
"Kemper","0","4","Mississippi","4/4/20","1","3","28069","300"
"Lafayette","1","21","Mississippi","4/4/20","11","10","28071","90.91"
"Lamar","1","13","Mississippi","4/4/20","4","9","28073","225"
"Lauderdale","7","61","Mississippi","4/4/20","12","49","28075","408.33"
"Lawrence","0","4","Mississippi","4/4/20","5","-1","28077","-20"
"Leake","1","8","Mississippi","4/4/20","4","4","28079","100"
"Lee","2","28","Mississippi","4/4/20","17","11","28081","64.71"
"Leflore","1","22","Mississippi","4/4/20","15","7","28083","46.67"
"Lincoln","1","14","Mississippi","4/4/20","8","6","28085","75"
"Lowndes","0","13","Mississippi","4/4/20","10","3","28087","30"
"Madison","5","67","Mississippi","4/4/20","29","38","28089","131.03"
"Marion","0","6","Mississippi","4/4/20","3","3","28091","100"
"Marshall","1","20","Mississippi","4/4/20","11","9","28093","81.82"
"Monroe","1","12","Mississippi","4/4/20","3","9","28095","300"
"Montgomery","1","10","Mississippi","4/4/20","5","5","28097","100"
"Neshoba","0","6","Mississippi","4/4/20","3","3","28099","100"
"Newton","1","6","Mississippi","4/4/20","1","5","28101","500"
"Noxubee","0","5","Mississippi","4/4/20","2","3","28103","150"
"Oktibbeha","1","24","Mississippi","4/4/20","14","10","28105","71.43"
"Panola","1","10","Mississippi","4/4/20","4","6","28107","150"
"Pearl River","3","43","Mississippi","4/4/20","23","20","28109","86.96"
"Perry","2","13","Mississippi","4/4/20","2","11","28111","550"
"Pike","2","23","Mississippi","4/4/20","12","11","28113","91.67"
"Pontotoc","1","12","Mississippi","4/4/20","4","8","28115","200"
"Prentiss","1","9","Mississippi","4/4/20","2","7","28117","350"
"Quitman","0","5","Mississippi","4/4/20","4","1","28119","25"
"Rankin","5","66","Mississippi","4/4/20","31","35","28121","112.9"
"Scott","1","17","Mississippi","4/4/20","7","10","28123","142.86"
"Sharkey","0","2","Mississippi","4/4/20","1","1","28125","100"
"Simpson","0","5","Mississippi","4/4/20","2","3","28127","150"
"Smith","1","6","Mississippi","4/4/20","1","5","28129","500"
"Sunflower","2","18","Mississippi","4/4/20","7","11","28133","157.14"
"Tallahatchie","0","2","Mississippi","4/4/20","2","0","28135","0"
"Tate","1","14","Mississippi","4/4/20","8","6","28137","75"
"Tippah","2","31","Mississippi","4/4/20","18","13","28139","72.22"
"Tishomingo","0","1","Mississippi","4/4/20","0","1","28141","1"
"Tunica","1","15","Mississippi","4/4/20","6","9","28143","150"
"Union","0","6","Mississippi","4/4/20","3","3","28145","100"
"Walthall","1","12","Mississippi","4/4/20","5","7","28147","140"
"Warren","0","3","Mississippi","4/4/20","0","3","28149","1"
"Washington","3","31","Mississippi","4/4/20","13","18","28151","138.46"
"Wayne","0","2","Mississippi","4/4/20","0","2","28153","1"
"Webster","1","11","Mississippi","4/4/20","3","8","28155","266.67"
"Wilkinson","2","25","Mississippi","4/4/20","11","14","28157","127.27"
"Winston","1","11","Mississippi","4/4/20","4","7","28159","175"
"Yalobusha","1","9","Mississippi","4/4/20","3","6","28161","200"
"Yazoo","2","19","Mississippi","4/4/20","4","15","28163","375"
"Adair","1","10","Missouri","4/4/20","1","9","29001","900"
"Atchison","0","1","Missouri","4/4/20","1","0","29005","0"
"Barry","0","1","Missouri","4/4/20","1","0","29009","0"
"Bates","0","3","Missouri","4/4/20","1","2","29013","200"
"Benton","0","3","Missouri","4/4/20","1","2","29015","200"
"Bollinger","0","1","Missouri","4/4/20","1","0","29017","0"
"Boone","4","75","Missouri","4/4/20","49","26","29019","53.06"
"Buchanan","1","8","Missouri","4/4/20","3","5","29021","166.67"
"Butler","0","2","Missouri","4/4/20","0","2","29023","1"
"Caldwell","0","1","Missouri","4/4/20","0","1","29025","1"
"Callaway","2","18","Missouri","4/4/20","6","12","29027","200"
"Camden","2","20","Missouri","4/4/20","4","16","29029","400"
"Cape Girardeau","2","16","Missouri","4/4/20","5","11","29031","220"
"Carter","0","3","Missouri","4/4/20","2","1","29035","50"
"Cass","2","22","Missouri","4/4/20","8","14","29037","175"
"Cedar","1","5","Missouri","4/4/20","0","5","29039","1"
"Chariton","0","4","Missouri","4/4/20","1","3","29041","300"
"Christian","1","16","Missouri","4/4/20","7","9","29043","128.57"
"Clark","0","1","Missouri","4/4/20","0","1","29045","1"
"Clay","3","32","Missouri","4/4/20","10","22","29047","220"
"Clinton","1","7","Missouri","4/4/20","1","6","29049","600"
"Cole","2","28","Missouri","4/4/20","17","11","29051","64.71"
"Cooper","0","2","Missouri","4/4/20","1","1","29053","100"
"Crawford","0","2","Missouri","4/4/20","0","2","29055","1"
"DeKalb","0","1","Missouri","4/4/20","0","1","29063","1"
"Dunklin","1","7","Missouri","4/4/20","3","4","29069","133.33"
"Franklin","3","24","Missouri","4/4/20","6","18","29071","300"
"Gasconade","0","2","Missouri","4/4/20","0","2","29073","1"
"Greene","3","64","Missouri","4/4/20","41","23","29077","56.1"
"Harrison","0","2","Missouri","4/4/20","0","2","29081","1"
"Henry","0","1","Missouri","4/4/20","1","0","29083","0"
"Howell","0","1","Missouri","4/4/20","0","1","29091","1"
"Jackson","13","135","Missouri","4/4/20","43","92","29095","213.95"
"Jasper","1","11","Missouri","4/4/20","4","7","29097","175"
"Jefferson","7","69","Missouri","4/4/20","17","52","29099","305.88"
"Johnson","3","29","Missouri","4/4/20","9","20","29101","222.22"
"Kansas City","11","172","Missouri","4/4/20","94","78","00000","82.98"
"Lafayette","3","26","Missouri","4/4/20","4","22","29107","550"
"Lincoln","2","16","Missouri","4/4/20","2","14","29113","700"
"Livingston","0","1","Missouri","4/4/20","0","1","29117","1"
"Macon","0","3","Missouri","4/4/20","0","3","29121","1"
"Maries","0","2","Missouri","4/4/20","0","2","29125","1"
"McDonald","0","2","Missouri","4/4/20","1","1","29119","100"
"Moniteau","0","2","Missouri","4/4/20","3","-1","29135","-33.33"
"Montgomery","0","4","Missouri","4/4/20","3","1","29139","33.33"
"Morgan","0","1","Missouri","4/4/20","0","1","29141","1"
"New Madrid","0","1","Missouri","4/4/20","0","1","29143","1"
"Newton","0","6","Missouri","4/4/20","4","2","29145","50"
"Nodaway","0","1","Missouri","4/4/20","0","1","29147","1"
"Osage","0","2","Missouri","4/4/20","0","2","29151","1"
"Pemiscot","0","3","Missouri","4/4/20","1","2","29155","200"
"Perry","2","22","Missouri","4/4/20","7","15","29157","214.29"
"Pettis","0","2","Missouri","4/4/20","1","1","29159","100"
"Pike","0","2","Missouri","4/4/20","0","2","29163","1"
"Platte","1","14","Missouri","4/4/20","6","8","29165","133.33"
"Pulaski","1","10","Missouri","4/4/20","5","5","29169","100"
"Ralls","0","1","Missouri","4/4/20","1","0","29173","0"
"Randolph","1","7","Missouri","4/4/20","1","6","29175","600"
"Ray","0","3","Missouri","4/4/20","1","2","29177","200"
"Reynolds","0","2","Missouri","4/4/20","0","2","29179","1"
"Ripley","0","2","Missouri","4/4/20","0","2","29181","1"
"Saline","0","2","Missouri","4/4/20","0","2","29195","1"
"Scott","1","7","Missouri","4/4/20","3","4","29201","133.33"
"Shelby","0","1","Missouri","4/4/20","1","0","29205","0"
"St. Charles","16","151","Missouri","4/4/20","37","114","29183","308.11"
"St. Francois","1","14","Missouri","4/4/20","4","10","29187","250"
"St. Louis","94","995","Missouri","4/4/20","334","661","29189","197.9"
"St. Louis City","32","328","Missouri","4/4/20","102","226","29510","221.57"
"Ste. Genevieve","1","6","Missouri","4/4/20","0","6","29186","1"
"Stoddard","1","7","Missouri","4/4/20","1","6","29207","600"
"Stone","0","2","Missouri","4/4/20","0","2","29209","1"
"Taney","0","5","Missouri","4/4/20","2","3","29213","150"
"Texas","0","1","Missouri","4/4/20","1","0","29215","0"
"Warren","1","7","Missouri","4/4/20","0","7","29219","1"
"Webster","0","3","Missouri","4/4/20","0","3","29225","1"
"Wright","1","6","Missouri","4/4/20","1","5","29229","500"
"Beaverhead","0","1","Montana","4/4/20","0","1","30001","1"
"Broadwater","0","4","Montana","4/4/20","2","2","30007","100"
"Carbon","0","1","Montana","4/4/20","0","1","30009","1"
"Cascade","1","11","Montana","4/4/20","7","4","30013","57.14"
"Deer Lodge","0","3","Montana","4/4/20","0","3","30023","1"
"Flathead","2","20","Montana","4/4/20","6","14","30029","233.33"
"Gallatin","8","101","Montana","4/4/20","46","55","30031","119.57"
"Glacier","0","1","Montana","4/4/20","0","1","30035","1"
"Hill","0","1","Montana","4/4/20","1","0","30041","0"
"Jefferson","0","2","Montana","4/4/20","2","0","30043","0"
"Lake","0","4","Montana","4/4/20","1","3","30047","300"
"Lewis and Clark","1","13","Montana","4/4/20","9","4","30049","44.44"
"Liberty","0","1","Montana","4/4/20","0","1","30051","1"
"Lincoln","0","6","Montana","4/4/20","3","3","30053","100"
"Madison","0","6","Montana","4/4/20","3","3","30057","100"
"Meagher","0","1","Montana","4/4/20","1","0","30059","0"
"Missoula","1","18","Montana","4/4/20","9","9","30063","100"
"Musselshell","0","1","Montana","4/4/20","0","1","30065","1"
"Park","1","6","Montana","4/4/20","1","5","30067","500"
"Ravalli","0","2","Montana","4/4/20","1","1","30081","100"
"Roosevelt","0","1","Montana","4/4/20","1","0","30085","0"
"Silver Bow","0","11","Montana","4/4/20","8","3","30093","37.5"
"Toole","1","12","Montana","4/4/20","5","7","30101","140"
"Yellowstone","2","38","Montana","4/4/20","23","15","30111","65.22"
"Adams","1","8","Nebraska","4/4/20","2","6","31001","300"
"Antelope","0","1","Nebraska","4/4/20","0","1","31003","1"
"Buffalo","1","14","Nebraska","4/4/20","4","10","31019","250"
"Cass","0","2","Nebraska","4/4/20","2","0","31025","0"
"Cherry","0","1","Nebraska","4/4/20","0","1","31031","1"
"Colfax","0","1","Nebraska","4/4/20","0","1","31037","1"
"Cuming","0","1","Nebraska","4/4/20","0","1","31039","1"
"Dawson","0","1","Nebraska","4/4/20","1","0","31047","0"
"Dodge","1","6","Nebraska","4/4/20","2","4","31053","200"
"Douglas","11","131","Nebraska","4/4/20","51","80","31055","156.86"
"Gage","0","2","Nebraska","4/4/20","1","1","31067","100"
"Gosper","0","1","Nebraska","4/4/20","0","1","31073","1"
"Hall","5","40","Nebraska","4/4/20","3","37","31079","1233.33"
"Hamilton","1","4","Nebraska","4/4/20","0","4","31081","1"
"Kearney","0","1","Nebraska","4/4/20","1","0","31099","0"
"Kimball","1","5","Nebraska","4/4/20","0","5","31105","1"
"Knox","0","2","Nebraska","4/4/20","2","0","31107","0"
"Lancaster","2","18","Nebraska","4/4/20","4","14","31109","350"
"Lincoln","2","15","Nebraska","4/4/20","3","12","31111","400"
"Madison","1","5","Nebraska","4/4/20","1","4","31119","400"
"Merrick","0","2","Nebraska","4/4/20","0","2","31121","1"
"Nemaha","0","1","Nebraska","4/4/20","1","0","31127","0"
"Otoe","0","1","Nebraska","4/4/20","0","1","31131","1"
"Platte","1","4","Nebraska","4/4/20","0","4","31141","1"
"Sarpy","2","26","Nebraska","4/4/20","11","15","31153","136.36"
"Saunders","0","4","Nebraska","4/4/20","2","2","31155","100"
"Scotts Bluff","0","3","Nebraska","4/4/20","0","3","31157","1"
"Washington","2","19","Nebraska","4/4/20","5","14","31177","280"
"York","0","1","Nebraska","4/4/20","0","1","31185","1"
"Carson City","1","10","Nevada","4/4/20","5","5","32510","100"
"Clark","139","1418","Nevada","4/4/20","443","975","32003","220.09"
"Douglas","0","7","Nevada","4/4/20","5","2","32005","40"
"Elko","1","8","Nevada","4/4/20","2","6","32007","300"
"Humboldt","1","9","Nevada","4/4/20","1","8","32013","800"
"Lyon","0","3","Nevada","4/4/20","1","2","32019","200"
"Nye","1","7","Nevada","4/4/20","1","6","32023","600"
"Washoe","24","245","Nevada","4/4/20","75","170","32031","226.67"
"White Pine","0","1","Nevada","4/4/20","0","1","32033","1"
"Belknap","1","14","New Hampshire","4/4/20","9","5","33001","55.56"
"Carroll","1","17","New Hampshire","4/4/20","8","9","33003","112.5"
"Cheshire","1","9","New Hampshire","4/4/20","2","7","33005","350"
"Coos","0","1","New Hampshire","4/4/20","0","1","33007","1"
"Grafton","2","38","New Hampshire","4/4/20","26","12","33009","46.15"
"Hillsborough","22","194","New Hampshire","4/4/20","43","151","33011","351.16"
"Merrimack","4","36","New Hampshire","4/4/20","11","25","33013","227.27"
"Rockingham","16","190","New Hampshire","4/4/20","75","115","33015","153.33"
"Strafford","4","36","New Hampshire","4/4/20","11","25","33017","227.27"
"Sullivan","0","5","New Hampshire","4/4/20","2","3","33019","150"
"Atlantic","12","98","New Jersey","4/4/20","17","81","34001","476.47"
"Bergen","560","5760","New Jersey","4/4/20","1838","3922","34003","213.38"
"Burlington","51","469","New Jersey","4/4/20","115","354","34005","307.83"
"Camden","51","481","New Jersey","4/4/20","123","358","34007","291.06"
"Cape May","6","50","New Jersey","4/4/20","7","43","34009","614.29"
"Cumberland","4","40","New Jersey","4/4/20","11","29","34011","263.64"
"Essex","357","3584","New Jersey","4/4/20","1086","2498","34013","230.02"
"Gloucester","23","215","New Jersey","4/4/20","51","164","34015","321.57"
"Hudson","389","3491","New Jersey","4/4/20","771","2720","34017","352.79"
"Hunterdon","16","171","New Jersey","4/4/20","61","110","34019","180.33"
"Mercer","60","586","New Jersey","4/4/20","168","418","34021","248.81"
"Middlesex","253","2578","New Jersey","4/4/20","808","1770","34023","219.06"
"Monmouth","183","2065","New Jersey","4/4/20","781","1284","34025","164.4"
"Morris","168","1618","New Jersey","4/4/20","442","1176","34027","266.06"
"Ocean","197","2003","New Jersey","4/4/20","624","1379","34029","220.99"
"Passaic","321","2856","New Jersey","4/4/20","608","2248","34031","369.74"
"Salem","3","25","New Jersey","4/4/20","3","22","34033","733.33"
"Somerset","72","765","New Jersey","4/4/20","258","507","34035","196.51"
"Sussex","22","236","New Jersey","4/4/20","81","155","34037","191.36"
"Union","311","2916","New Jersey","4/4/20","742","2174","34039","292.99"
"Warren","19","182","New Jersey","4/4/20","51","131","34041","256.86"
"Bernalillo","16","202","New Mexico","4/4/20","93","109","35001","117.2"
"Catron","0","1","New Mexico","4/4/20","0","1","35003","1"
"Chaves","1","13","New Mexico","4/4/20","7","6","35005","85.71"
"Cibola","1","12","New Mexico","4/4/20","2","10","35006","500"
"Curry","1","6","New Mexico","4/4/20","1","5","35009","500"
"Dona Ana","1","22","New Mexico","4/4/20","17","5","35013","29.41"
"Eddy","0","4","New Mexico","4/4/20","3","1","35015","33.33"
"Grant","0","1","New Mexico","4/4/20","0","1","35017","1"
"Lea","0","2","New Mexico","4/4/20","2","0","35025","0"
"McKinley","4","31","New Mexico","4/4/20","5","26","35031","520"
"Otero","0","2","New Mexico","4/4/20","0","2","35035","1"
"Rio Arriba","0","5","New Mexico","4/4/20","3","2","35039","66.67"
"Roosevelt","0","1","New Mexico","4/4/20","1","0","35041","0"
"San Juan","6","58","New Mexico","4/4/20","18","40","35045","222.22"
"San Miguel","0","1","New Mexico","4/4/20","1","0","35047","0"
"Sandoval","7","66","New Mexico","4/4/20","15","51","35043","340"
"Santa Fe","3","52","New Mexico","4/4/20","29","23","35049","79.31"
"Socorro","0","4","New Mexico","4/4/20","2","2","35053","100"
"Taos","1","13","New Mexico","4/4/20","8","5","35055","62.5"
"Torrance","0","3","New Mexico","4/4/20","0","3","35057","1"
"Valencia","1","5","New Mexico","4/4/20","1","4","35061","400"
"Albany","14","293","New York","4/4/20","195","98","36001","50.26"
"Allegany","2","16","New York","4/4/20","2","14","36003","700"
"Broome","6","65","New York","4/4/20","23","42","36007","182.61"
"Cattaraugus","1","9","New York","4/4/20","1","8","36009","800"
"Cayuga","1","7","New York","4/4/20","2","5","36011","250"
"Chautauqua","1","10","New York","4/4/20","5","5","36013","100"
"Chemung","3","36","New York","4/4/20","12","24","36015","200"
"Chenango","4","39","New York","4/4/20","8","31","36017","387.5"
"Clinton","3","31","New York","4/4/20","12","19","36019","158.33"
"Columbia","4","57","New York","4/4/20","30","27","36021","90"
"Cortland","1","14","New York","4/4/20","7","7","36023","100"
"Delaware","3","26","New York","4/4/20","8","18","36025","225"
"Dutchess","97","938","New York","4/4/20","262","676","36027","258.02"
"Erie","70","808","New York","4/4/20","318","490","36029","154.09"
"Essex","0","7","New York","4/4/20","5","2","36031","40"
"Franklin","1","10","New York","4/4/20","5","5","36033","100"
"Fulton","1","9","New York","4/4/20","1","8","36035","800"
"Genesee","2","20","New York","4/4/20","7","13","36037","185.71"
"Greene","2","24","New York","4/4/20","7","17","36039","242.86"
"Hamilton","0","2","New York","4/4/20","2","0","36041","0"
"Herkimer","1","18","New York","4/4/20","9","9","36043","100"
"Jefferson","2","20","New York","4/4/20","6","14","36045","233.33"
"Lewis","0","2","New York","4/4/20","0","2","36049","1"
"Livingston","1","18","New York","4/4/20","10","8","36051","80"
"Madison","7","78","New York","4/4/20","28","50","36053","178.57"
"Monroe","44","512","New York","4/4/20","202","310","36055","153.47"
"Montgomery","1","13","New York","4/4/20","6","7","36057","116.67"
"Nassau","1116","13346","New York","4/4/20","5537","7809","36059","141.03"
"New York","4790","63306","New York","4/4/20","29776","33530","36061","112.61"
"Niagara","10","101","New York","4/4/20","33","68","36063","206.06"
"Oneida","8","80","New York","4/4/20","23","57","36065","247.83"
"Onondaga","29","349","New York","4/4/20","146","203","36067","139.04"
"Ontario","2","31","New York","4/4/20","16","15","36069","93.75"
"Orange","234","2741","New York","4/4/20","1101","1640","36071","148.96"
"Orleans","1","10","New York","4/4/20","3","7","36073","233.33"
"Oswego","3","28","New York","4/4/20","9","19","36075","211.11"
"Otsego","3","26","New York","4/4/20","7","19","36077","271.43"
"Putnam","22","283","New York","4/4/20","131","152","36079","116.03"
"Rensselaer","2","67","New York","4/4/20","51","16","36083","31.37"
"Rockland","425","4872","New York","4/4/20","1896","2976","36087","156.96"
"Saratoga","6","141","New York","4/4/20","96","45","36091","46.88"
"Schenectady","6","117","New York","4/4/20","72","45","36093","62.5"
"Schoharie","1","11","New York","4/4/20","5","6","36095","120"
"Schuyler","0","4","New York","4/4/20","1","3","36097","300"
"Seneca","1","6","New York","4/4/20","0","6","36099","1"
"St. Lawrence","6","52","New York","4/4/20","8","44","36089","550"
"Steuben","7","60","New York","4/4/20","13","47","36101","361.54"
"Suffolk","1033","11370","New York","4/4/20","4138","7232","36103","174.77"
"Sullivan","17","193","New York","4/4/20","72","121","36105","168.06"
"Tioga","0","8","New York","4/4/20","6","2","36107","33.33"
"Tompkins","6","93","New York","4/4/20","48","45","36109","93.75"
"Ulster","22","290","New York","4/4/20","133","157","36111","118.05"
"Warren","1","20","New York","4/4/20","13","7","36113","53.85"
"Washington","1","16","New York","4/4/20","9","7","36115","77.78"
"Wayne","3","30","New York","4/4/20","12","18","36117","150"
"Westchester","744","13081","New York","4/4/20","7875","5206","36119","66.11"
"Wyoming","2","18","New York","4/4/20","7","11","36121","157.14"
"Yates","0","1","New York","4/4/20","0","1","36123","1"
"Alamance","2","16","North Carolina","4/4/20","5","11","37001","220"
"Alexander","0","2","North Carolina","4/4/20","1","1","37003","100"
"Alleghany","0","2","North Carolina","4/4/20","1","1","37005","100"
"Anson","0","3","North Carolina","4/4/20","0","3","37007","1"
"Ashe","0","1","North Carolina","4/4/20","0","1","37009","1"
"Beaufort","1","9","North Carolina","4/4/20","3","6","37013","200"
"Bertie","1","7","North Carolina","4/4/20","3","4","37015","133.33"
"Bladen","0","1","North Carolina","4/4/20","0","1","37017","1"
"Brunswick","2","24","North Carolina","4/4/20","12","12","37019","100"
"Buncombe","2","31","North Carolina","4/4/20","17","14","37021","82.35"
"Burke","1","13","North Carolina","4/4/20","4","9","37023","225"
"Cabarrus","5","65","North Carolina","4/4/20","31","34","37025","109.68"
"Caldwell","0","5","North Carolina","4/4/20","3","2","37027","66.67"
"Carteret","1","16","North Carolina","4/4/20","7","9","37031","128.57"
"Caswell","0","1","North Carolina","4/4/20","1","0","37033","0"
"Catawba","2","22","North Carolina","4/4/20","10","12","37035","120"
"Chatham","1","21","North Carolina","4/4/20","12","9","37037","75"
"Cherokee","1","11","North Carolina","4/4/20","4","7","37039","175"
"Chowan","0","1","North Carolina","4/4/20","0","1","37041","1"
"Clay","0","3","North Carolina","4/4/20","0","3","37043","1"
"Cleveland","2","15","North Carolina","4/4/20","3","12","37045","400"
"Columbus","1","6","North Carolina","4/4/20","2","4","37047","200"
"Craven","1","14","North Carolina","4/4/20","4","10","37049","250"
"Cumberland","5","42","North Carolina","4/4/20","8","34","37051","425"
"Currituck","0","2","North Carolina","4/4/20","0","2","37053","1"
"Dare","0","5","North Carolina","4/4/20","2","3","37055","150"
"Davidson","6","53","North Carolina","4/4/20","14","39","37057","278.57"
"Davie","1","14","North Carolina","4/4/20","6","8","37059","133.33"
"Duplin","1","5","North Carolina","4/4/20","1","4","37061","400"
"Durham","10","182","North Carolina","4/4/20","113","69","37063","61.06"
"Edgecombe","1","5","North Carolina","4/4/20","1","4","37065","400"
"Forsyth","8","88","North Carolina","4/4/20","33","55","37067","166.67"
"Franklin","1","14","North Carolina","4/4/20","5","9","37069","180"
"Gaston","4","43","North Carolina","4/4/20","17","26","37071","152.94"
"Gates","0","1","North Carolina","4/4/20","0","1","37073","1"
"Granville","3","24","North Carolina","4/4/20","3","21","37077","700"
"Greene","0","5","North Carolina","4/4/20","3","2","37079","66.67"
"Guilford","9","94","North Carolina","4/4/20","34","60","37081","176.47"
"Halifax","1","10","North Carolina","4/4/20","1","9","37083","900"
"Harnett","2","24","North Carolina","4/4/20","11","13","37085","118.18"
"Haywood","0","2","North Carolina","4/4/20","0","2","37087","1"
"Henderson","2","25","North Carolina","4/4/20","9","16","37089","177.78"
"Hertford","0","4","North Carolina","4/4/20","3","1","37091","33.33"
"Hoke","1","10","North Carolina","4/4/20","2","8","37093","400"
"Hyde","0","0","North Carolina","4/4/20","1","-1","37095","-100"
"Iredell","3","42","North Carolina","4/4/20","18","24","37097","133.33"
"Jackson","0","2","North Carolina","4/4/20","1","1","37099","100"
"Johnston","3","32","North Carolina","4/4/20","9","23","37101","255.56"
"Lee","0","3","North Carolina","4/4/20","2","1","37105","50"
"Lenoir","1","7","North Carolina","4/4/20","3","4","37107","133.33"
"Lincoln","1","9","North Carolina","4/4/20","1","8","37109","800"
"Macon","0","1","North Carolina","4/4/20","0","1","37113","1"
"Martin","0","3","North Carolina","4/4/20","0","3","37117","1"
"McDowell","1","9","North Carolina","4/4/20","5","4","37111","80"
"Mecklenburg","50","650","North Carolina","4/4/20","299","351","37119","117.39"
"Mitchell","0","2","North Carolina","4/4/20","1","1","37121","100"
"Montgomery","1","10","North Carolina","4/4/20","3","7","37123","233.33"
"Moore","1","12","North Carolina","4/4/20","5","7","37125","140"
"Nash","2","18","North Carolina","4/4/20","4","14","37127","350"
"New Hanover","2","42","North Carolina","4/4/20","25","17","37129","68"
"Northampton","5","38","North Carolina","4/4/20","3","35","37131","1166.67"
"Onslow","2","16","North Carolina","4/4/20","4","12","37133","300"
"Orange","4","52","North Carolina","4/4/20","24","28","37135","116.67"
"Pamlico","0","3","North Carolina","4/4/20","0","3","37137","1"
"Pasquotank","1","8","North Carolina","4/4/20","1","7","37139","700"
"Pender","0","1","North Carolina","4/4/20","0","1","37141","1"
"Perquimans","0","1","North Carolina","4/4/20","1","0","37143","0"
"Person","0","4","North Carolina","4/4/20","1","3","37145","300"
"Pitt","4","35","North Carolina","4/4/20","10","25","37147","250"
"Polk","1","6","North Carolina","4/4/20","2","4","37149","200"
"Randolph","2","26","North Carolina","4/4/20","9","17","37151","188.89"
"Robeson","0","5","North Carolina","4/4/20","2","3","37155","150"
"Rockingham","1","5","North Carolina","4/4/20","0","5","37157","1"
"Rowan","5","44","North Carolina","4/4/20","12","32","37159","266.67"
"Rutherford","2","12","North Carolina","4/4/20","0","12","37161","1"
"Sampson","0","2","North Carolina","4/4/20","1","1","37163","100"
"Scotland","0","2","North Carolina","4/4/20","1","1","37165","100"
"Stanly","1","7","North Carolina","4/4/20","3","4","37167","133.33"
"Stokes","1","5","North Carolina","4/4/20","0","5","37169","1"
"Surry","0","3","North Carolina","4/4/20","1","2","37171","200"
"Swain","0","1","North Carolina","4/4/20","1","0","37173","0"
"Transylvania","0","5","North Carolina","4/4/20","3","2","37175","66.67"
"Union","5","67","North Carolina","4/4/20","34","33","37179","97.06"
"Vance","1","10","North Carolina","4/4/20","2","8","37181","400"
"Wake","23","283","North Carolina","4/4/20","123","160","37183","130.08"
"Warren","0","1","North Carolina","4/4/20","0","1","37185","1"
"Washington","0","3","North Carolina","4/4/20","0","3","37187","1"
"Watauga","0","8","North Carolina","4/4/20","5","3","37189","60"
"Wayne","1","12","North Carolina","4/4/20","3","9","37191","300"
"Wilkes","1","4","North Carolina","4/4/20","0","4","37193","1"
"Wilson","3","28","North Carolina","4/4/20","7","21","37195","300"
"Yadkin","1","6","North Carolina","4/4/20","1","5","37197","500"
"Barnes","0","2","North Dakota","4/4/20","2","0","38003","0"
"Burke","0","2","North Dakota","4/4/20","0","2","38013","1"
"Burleigh","1","34","North Dakota","4/4/20","28","6","38015","21.43"
"Cass","4","48","North Dakota","4/4/20","18","30","38017","166.67"
"Divide","0","1","North Dakota","4/4/20","1","0","38023","0"
"Dunn","0","1","North Dakota","4/4/20","1","0","38025","0"
"Eddy","0","1","North Dakota","4/4/20","0","1","38027","1"
"Foster","0","1","North Dakota","4/4/20","1","0","38031","0"
"Grand Forks","1","10","North Dakota","4/4/20","0","10","38035","1"
"Grant","0","1","North Dakota","4/4/20","0","1","38037","1"
"McHenry","0","1","North Dakota","4/4/20","1","0","38049","0"
"McIntosh","0","1","North Dakota","4/4/20","1","0","38051","0"
"McKenzie","0","2","North Dakota","4/4/20","0","2","38053","1"
"McLean","0","2","North Dakota","4/4/20","2","0","38055","0"
"Mercer","0","0","North Dakota","4/4/20","1","-1","38057","-100"
"Morton","0","16","North Dakota","4/4/20","13","3","38059","23.08"
"Mountrail","2","13","North Dakota","4/4/20","2","11","38061","550"
"Oliver","0","1","North Dakota","4/4/20","0","1","38065","1"
"Pierce","0","2","North Dakota","4/4/20","2","0","38069","0"
"Ramsey","0","3","North Dakota","4/4/20","3","0","38071","0"
"Sioux","0","1","North Dakota","4/4/20","1","0","38085","0"
"Slope","0","1","North Dakota","4/4/20","0","1","38087","1"
"Stark","2","22","North Dakota","4/4/20","9","13","38089","144.44"
"Walsh","0","1","North Dakota","4/4/20","1","0","38099","0"
"Ward","1","14","North Dakota","4/4/20","7","7","38101","100"
"Williams","1","5","North Dakota","4/4/20","0","5","38105","1"
"","1","8","Northern Mariana Islands","4/4/20","0","8",,"1"
"Adams","0","1","Ohio","4/4/20","0","1","39001","1"
"Allen","2","15","Ohio","4/4/20","2","13","39003","650"
"Ashland","0","3","Ohio","4/4/20","3","0","39005","0"
"Ashtabula","1","11","Ohio","4/4/20","6","5","39007","83.33"
"Athens","0","3","Ohio","4/4/20","2","1","39009","50"
"Auglaize","1","6","Ohio","4/4/20","1","5","39011","500"
"Belmont","1","17","Ohio","4/4/20","8","9","39013","112.5"
"Brown","0","3","Ohio","4/4/20","0","3","39015","1"
"Butler","5","59","Ohio","4/4/20","25","34","39017","136"
"Carroll","1","8","Ohio","4/4/20","3","5","39019","166.67"
"Champaign","0","5","Ohio","4/4/20","2","3","39021","150"
"Clark","1","7","Ohio","4/4/20","2","5","39023","250"
"Clermont","2","20","Ohio","4/4/20","8","12","39025","150"
"Clinton","1","7","Ohio","4/4/20","3","4","39027","133.33"
"Columbiana","4","36","Ohio","4/4/20","9","27","39029","300"
"Coshocton","1","8","Ohio","4/4/20","4","4","39031","100"
"Crawford","1","7","Ohio","4/4/20","2","5","39033","250"
"Cuyahoga","59","781","Ohio","4/4/20","370","411","39035","111.08"
"Darke","4","28","Ohio","4/4/20","1","27","39037","2700"
"Defiance","0","7","Ohio","4/4/20","5","2","39039","40"
"Delaware","6","69","Ohio","4/4/20","26","43","39041","165.38"
"Erie","0","6","Ohio","4/4/20","5","1","39043","20"
"Fairfield","3","36","Ohio","4/4/20","14","22","39045","157.14"
"Fayette","0","2","Ohio","4/4/20","1","1","39047","100"
"Franklin","48","557","Ohio","4/4/20","222","335","39049","150.9"
"Fulton","0","5","Ohio","4/4/20","2","3","39051","150"
"Gallia","0","4","Ohio","4/4/20","1","3","39053","300"
"Geauga","3","38","Ohio","4/4/20","14","24","39055","171.43"
"Greene","1","11","Ohio","4/4/20","3","8","39057","266.67"
"Guernsey","0","1","Ohio","4/4/20","0","1","39059","1"
"Hamilton","31","288","Ohio","4/4/20","71","217","39061","305.63"
"Hancock","1","9","Ohio","4/4/20","3","6","39063","200"
"Hardin","0","1","Ohio","4/4/20","0","1","39065","1"
"Highland","0","4","Ohio","4/4/20","1","3","39071","300"
"Holmes","0","1","Ohio","4/4/20","0","1","39075","1"
"Huron","0","6","Ohio","4/4/20","3","3","39077","100"
"Jefferson","1","14","Ohio","4/4/20","5","9","39081","180"
"Knox","1","6","Ohio","4/4/20","2","4","39083","200"
"Lake","7","76","Ohio","4/4/20","30","46","39085","153.33"
"Lawrence","1","7","Ohio","4/4/20","1","6","39087","600"
"Licking","5","50","Ohio","4/4/20","14","36","39089","257.14"
"Logan","0","3","Ohio","4/4/20","3","0","39091","0"
"Lorain","6","105","Ohio","4/4/20","65","40","39093","61.54"
"Lucas","29","272","Ohio","4/4/20","67","205","39095","305.97"
"Madison","2","15","Ohio","4/4/20","4","11","39097","275"
"Mahoning","24","250","Ohio","4/4/20","80","170","39099","212.5"
"Marion","1","12","Ohio","4/4/20","5","7","39101","140"
"Medina","5","74","Ohio","4/4/20","37","37","39103","100"
"Mercer","1","6","Ohio","4/4/20","2","4","39107","200"
"Miami","4","69","Ohio","4/4/20","38","31","39109","81.58"
"Montgomery","7","69","Ohio","4/4/20","20","49","39113","245"
"Morrow","0","3","Ohio","4/4/20","0","3","39117","1"
"Muskingum","0","4","Ohio","4/4/20","2","2","39119","100"
"Ottawa","1","5","Ohio","4/4/20","1","4","39123","400"
"Perry","0","3","Ohio","4/4/20","0","3","39127","1"
"Pickaway","2","20","Ohio","4/4/20","4","16","39129","400"
"Pike","0","1","Ohio","4/4/20","1","0","39131","0"
"Portage","8","74","Ohio","4/4/20","19","55","39133","289.47"
"Preble","1","4","Ohio","4/4/20","0","4","39135","1"
"Richland","1","14","Ohio","4/4/20","5","9","39139","180"
"Ross","1","4","Ohio","4/4/20","0","4","39141","1"
"Sandusky","0","5","Ohio","4/4/20","2","3","39143","150"
"Seneca","1","5","Ohio","4/4/20","1","4","39147","400"
"Shelby","1","10","Ohio","4/4/20","3","7","39149","233.33"
"Stark","10","92","Ohio","4/4/20","25","67","39151","268"
"Summit","15","184","Ohio","4/4/20","79","105","39153","132.91"
"Trumbull","9","90","Ohio","4/4/20","27","63","39155","233.33"
"Tuscarawas","2","19","Ohio","4/4/20","5","14","39157","280"
"Union","1","7","Ohio","4/4/20","3","4","39159","133.33"
"Van Wert","0","2","Ohio","4/4/20","1","1","39161","100"
"Warren","3","35","Ohio","4/4/20","16","19","39165","118.75"
"Washington","1","6","Ohio","4/4/20","2","4","39167","200"
"Wayne","3","25","Ohio","4/4/20","4","21","39169","525"
"Williams","0","1","Ohio","4/4/20","0","1","39171","1"
"Wood","2","23","Ohio","4/4/20","10","13","39173","130"
"Wyandot","1","5","Ohio","4/4/20","1","4","39175","400"
"Adair","2","14","Oklahoma","4/4/20","3","11","40001","366.67"
"Atoka","0","1","Oklahoma","4/4/20","0","1","40005","1"
"Beckham","0","1","Oklahoma","4/4/20","0","1","40009","1"
"Bryan","0","3","Oklahoma","4/4/20","1","2","40013","200"
"Caddo","0","4","Oklahoma","4/4/20","1","3","40015","300"
"Canadian","3","32","Oklahoma","4/4/20","11","21","40017","190.91"
"Carter","0","1","Oklahoma","4/4/20","1","0","40019","0"
"Cherokee","1","10","Oklahoma","4/4/20","1","9","40021","900"
"Choctaw","0","2","Oklahoma","4/4/20","1","1","40023","100"
"Cleveland","18","169","Oklahoma","4/4/20","46","123","40027","267.39"
"Comanche","4","37","Oklahoma","4/4/20","6","31","40031","516.67"
"Cotton","1","4","Oklahoma","4/4/20","0","4","40033","1"
"Craig","0","3","Oklahoma","4/4/20","1","2","40035","200"
"Creek","4","43","Oklahoma","4/4/20","16","27","40037","168.75"
"Custer","0","5","Oklahoma","4/4/20","3","2","40039","66.67"
"Delaware","1","11","Oklahoma","4/4/20","4","7","40041","175"
"Garfield","1","5","Oklahoma","4/4/20","0","5","40047","1"
"Garvin","1","11","Oklahoma","4/4/20","2","9","40049","450"
"Grady","1","6","Oklahoma","4/4/20","2","4","40051","200"
"Grant","0","1","Oklahoma","4/4/20","0","1","40053","1"
"Greer","1","6","Oklahoma","4/4/20","0","6","40055","1"
"Jackson","0","4","Oklahoma","4/4/20","1","3","40065","300"
"Kay","2","29","Oklahoma","4/4/20","18","11","40071","61.11"
"Kingfisher","0","3","Oklahoma","4/4/20","0","3","40073","1"
"Kiowa","0","1","Oklahoma","4/4/20","0","1","40075","1"
"Latimer","0","4","Oklahoma","4/4/20","1","3","40077","300"
"Le Flore","0","1","Oklahoma","4/4/20","1","0","40079","0"
"Lincoln","1","7","Oklahoma","4/4/20","3","4","40081","133.33"
"Logan","0","6","Oklahoma","4/4/20","3","3","40083","100"
"Love","0","2","Oklahoma","4/4/20","0","2","40085","1"
"Major","0","1","Oklahoma","4/4/20","0","1","40093","1"
"Mayes","1","7","Oklahoma","4/4/20","3","4","40097","133.33"
"McClain","1","11","Oklahoma","4/4/20","2","9","40087","450"
"McCurtain","0","1","Oklahoma","4/4/20","0","1","40089","1"
"Muskogee","1","17","Oklahoma","4/4/20","7","10","40101","142.86"
"Noble","0","5","Oklahoma","4/4/20","3","2","40103","66.67"
"Nowata","1","8","Oklahoma","4/4/20","1","7","40105","700"
"Oklahoma","21","256","Oklahoma","4/4/20","107","149","40109","139.25"
"Okmulgee","1","11","Oklahoma","4/4/20","2","9","40111","450"
"Osage","3","25","Oklahoma","4/4/20","6","19","40113","316.67"
"Ottawa","1","10","Oklahoma","4/4/20","4","6","40115","150"
"Out of OK","0","2","Oklahoma","4/4/20","0","2","80040","1"
"Pawnee","0","16","Oklahoma","4/4/20","14","2","40117","14.29"
"Payne","1","20","Oklahoma","4/4/20","12","8","40119","66.67"
"Pittsburg","0","3","Oklahoma","4/4/20","2","1","40121","50"
"Pontotoc","1","7","Oklahoma","4/4/20","3","4","40123","133.33"
"Pottawatomie","1","11","Oklahoma","4/4/20","2","9","40125","450"
"Rogers","2","12","Oklahoma","4/4/20","0","12","40131","1"
"Seminole","0","2","Oklahoma","4/4/20","0","2","40133","1"
"Sequoyah","0","4","Oklahoma","4/4/20","2","2","40135","100"
"Stephens","1","9","Oklahoma","4/4/20","2","7","40137","350"
"Texas","0","1","Oklahoma","4/4/20","0","1","40139","1"
"Tillman","0","1","Oklahoma","4/4/20","0","1","40141","1"
"Tulsa","23","221","Oklahoma","4/4/20","57","164","40143","287.72"
"Wagoner","5","40","Oklahoma","4/4/20","8","32","40145","400"
"Washington","3","33","Oklahoma","4/4/20","14","19","40147","135.71"
"Woodward","0","1","Oklahoma","4/4/20","0","1","40153","1"
"Benton","1","17","Oregon","4/4/20","8","9","41003","112.5"
"Clackamas","4","66","Oregon","4/4/20","36","30","41005","83.33"
"Clatsop","0","4","Oregon","4/4/20","3","1","41007","33.33"
"Columbia","0","1","Oregon","4/4/20","1","0","41009","0"
"Crook","0","1","Oregon","4/4/20","0","1","41013","1"
"Deschutes","2","36","Oregon","4/4/20","20","16","41017","80"
"Douglas","1","9","Oregon","4/4/20","4","5","41019","125"
"Grant","0","1","Oregon","4/4/20","1","0","41023","0"
"Hood River","0","3","Oregon","4/4/20","1","2","41027","200"
"Jackson","3","27","Oregon","4/4/20","8","19","41029","237.5"
"Josephine","1","12","Oregon","4/4/20","5","7","41033","140"
"Klamath","2","13","Oregon","4/4/20","2","11","41035","550"
"Lane","2","21","Oregon","4/4/20","9","12","41039","133.33"
"Lincoln","0","4","Oregon","4/4/20","1","3","41041","300"
"Linn","1","37","Oregon","4/4/20","32","5","41043","15.62"
"Malheur","0","2","Oregon","4/4/20","0","2","41045","1"
"Marion","12","178","Oregon","4/4/20","94","84","41047","89.36"
"Morrow","0","2","Oregon","4/4/20","1","1","41049","100"
"Multnomah","13","175","Oregon","4/4/20","81","94","41051","116.05"
"Polk","1","20","Oregon","4/4/20","11","9","41053","81.82"
"Tillamook","0","3","Oregon","4/4/20","1","2","41057","200"
"Umatilla","0","5","Oregon","4/4/20","4","1","41059","25"
"Union","0","3","Oregon","4/4/20","1","2","41061","200"
"Wallowa","0","1","Oregon","4/4/20","0","1","41063","1"
"Wasco","1","7","Oregon","4/4/20","2","5","41065","250"
"Washington","13","228","Oregon","4/4/20","140","88","41067","62.86"
"Yamhill","1","23","Oregon","4/4/20","13","10","41071","76.92"
"Adams","2","21","Pennsylvania","4/4/20","8","13","42001","162.5"
"Allegheny","48","552","Pennsylvania","4/4/20","219","333","42003","152.05"
"Armstrong","1","12","Pennsylvania","4/4/20","2","10","42005","500"
"Beaver","7","69","Pennsylvania","4/4/20","22","47","42007","213.64"
"Bedford","1","4","Pennsylvania","4/4/20","0","4","42009","1"
"Berks","24","235","Pennsylvania","4/4/20","65","170","42011","261.54"
"Blair","0","5","Pennsylvania","4/4/20","2","3","42013","150"
"Bradford","1","10","Pennsylvania","4/4/20","3","7","42015","233.33"
"Bucks","52","517","Pennsylvania","4/4/20","152","365","42017","240.13"
"Butler","6","84","Pennsylvania","4/4/20","41","43","42019","104.88"
"Cambria","1","6","Pennsylvania","4/4/20","1","5","42021","500"
"Cameron","0","1","Pennsylvania","4/4/20","1","0","42023","0"
"Carbon","6","46","Pennsylvania","4/4/20","3","43","42025","1433.33"
"Centre","3","39","Pennsylvania","4/4/20","15","24","42027","160"
"Chester","19","250","Pennsylvania","4/4/20","116","134","42029","115.52"
"Clarion","0","4","Pennsylvania","4/4/20","1","3","42031","300"
"Clearfield","1","7","Pennsylvania","4/4/20","2","5","42033","250"
"Clinton","0","1","Pennsylvania","4/4/20","0","1","42035","1"
"Columbia","2","20","Pennsylvania","4/4/20","4","16","42037","400"
"Crawford","0","5","Pennsylvania","4/4/20","2","3","42039","150"
"Cumberland","5","54","Pennsylvania","4/4/20","22","32","42041","145.45"
"Dauphin","11","99","Pennsylvania","4/4/20","23","76","42043","330.43"
"Delaware","56","616","Pennsylvania","4/4/20","226","390","42045","172.57"
"Erie","2","19","Pennsylvania","4/4/20","7","12","42049","171.43"
"Fayette","2","23","Pennsylvania","4/4/20","10","13","42051","130"
"Forest","0","2","Pennsylvania","4/4/20","0","2","42053","1"
"Franklin","3","27","Pennsylvania","4/4/20","7","20","42055","285.71"
"Greene","1","12","Pennsylvania","4/4/20","6","6","42059","100"
"Huntingdon","0","4","Pennsylvania","4/4/20","1","3","42061","300"
"Indiana","1","9","Pennsylvania","4/4/20","2","7","42063","350"
"Juniata","1","7","Pennsylvania","4/4/20","1","6","42067","600"
"Lackawanna","14","146","Pennsylvania","4/4/20","51","95","42069","186.27"
"Lancaster","35","291","Pennsylvania","4/4/20","45","246","42071","546.67"
"Lawrence","2","22","Pennsylvania","4/4/20","8","14","42073","175"
"Lebanon","10","87","Pennsylvania","4/4/20","15","72","42075","480"
"Lehigh","99","804","Pennsylvania","4/4/20","109","695","42077","637.61"
"Luzerne","83","648","Pennsylvania","4/4/20","65","583","42079","896.92"
"Lycoming","1","10","Pennsylvania","4/4/20","2","8","42081","400"
"McKean","0","1","Pennsylvania","4/4/20","1","0","42083","0"
"Mercer","1","14","Pennsylvania","4/4/20","6","8","42085","133.33"
"Mifflin","1","4","Pennsylvania","4/4/20","0","4","42087","1"
"Monroe","54","484","Pennsylvania","4/4/20","106","378","42089","356.6"
"Montgomery","82","982","Pennsylvania","4/4/20","411","571","42091","138.93"
"Montour","2","19","Pennsylvania","4/4/20","5","14","42093","280"
"Northampton","71","588","Pennsylvania","4/4/20","94","494","42095","525.53"
"Northumberland","1","9","Pennsylvania","4/4/20","1","8","42097","800"
"Perry","1","5","Pennsylvania","4/4/20","1","4","42099","400"
"Philadelphia","315","3008","Pennsylvania","4/4/20","803","2205","42101","274.6"
"Pike","10","97","Pennsylvania","4/4/20","27","70","42103","259.26"
"Potter","0","3","Pennsylvania","4/4/20","2","1","42105","50"
"Schuylkill","9","77","Pennsylvania","4/4/20","16","61","42107","381.25"
"Snyder","1","6","Pennsylvania","4/4/20","1","5","42109","500"
"Somerset","0","3","Pennsylvania","4/4/20","2","1","42111","50"
"Sullivan","0","1","Pennsylvania","4/4/20","0","1","42113","1"
"Susquehanna","1","5","Pennsylvania","4/4/20","1","4","42115","400"
"Tioga","0","3","Pennsylvania","4/4/20","1","2","42117","200"
"Union","1","5","Pennsylvania","4/4/20","0","5","42119","1"
"Venango","0","3","Pennsylvania","4/4/20","0","3","42121","1"
"Warren","0","1","Pennsylvania","4/4/20","1","0","42123","0"
"Washington","3","46","Pennsylvania","4/4/20","23","23","42125","100"
"Wayne","3","28","Pennsylvania","4/4/20","6","22","42127","366.67"
"Westmoreland","13","135","Pennsylvania","4/4/20","41","94","42129","229.27"
"Wyoming","1","5","Pennsylvania","4/4/20","0","5","42131","1"
"York","15","144","Pennsylvania","4/4/20","37","107","42133","289.19"
"","50","452","Puerto Rico","4/4/20","100","352",,"352"
"Bristol","2","21","Rhode Island","4/4/20","6","15","44001","250"
"Kent","7","59","Rhode Island","4/4/20","9","50","44003","555.56"
"Newport","3","33","Rhode Island","4/4/20","12","21","44005","175"
"Providence","47","418","Rhode Island","4/4/20","91","327","44007","359.34"
"Washington","3","34","Rhode Island","4/4/20","14","20","44009","142.86"
"Abbeville","0","6","South Carolina","4/4/20","3","3","45001","100"
"Aiken","2","24","South Carolina","4/4/20","7","17","45003","242.86"
"Allendale","0","2","South Carolina","4/4/20","0","2","45005","1"
"Anderson","6","68","South Carolina","4/4/20","24","44","45007","183.33"
"Bamberg","1","5","South Carolina","4/4/20","0","5","45009","1"
"Barnwell","0","2","South Carolina","4/4/20","0","2","45011","1"
"Beaufort","16","148","South Carolina","4/4/20","39","109","45013","279.49"
"Berkeley","5","45","South Carolina","4/4/20","13","32","45015","246.15"
"Calhoun","0","4","South Carolina","4/4/20","1","3","45017","300"
"Charleston","24","274","South Carolina","4/4/20","108","166","45019","153.7"
"Cherokee","0","2","South Carolina","4/4/20","0","2","45021","1"
"Chester","1","12","South Carolina","4/4/20","2","10","45023","500"
"Chesterfield","1","13","South Carolina","4/4/20","4","9","45025","225"
"Clarendon","5","45","South Carolina","4/4/20","7","38","45027","542.86"
"Colleton","1","9","South Carolina","4/4/20","4","5","45029","125"
"Darlington","2","19","South Carolina","4/4/20","8","11","45031","137.5"
"Dillon","0","1","South Carolina","4/4/20","1","0","45033","0"
"Dorchester","5","45","South Carolina","4/4/20","10","35","45035","350"
"Edgefield","1","5","South Carolina","4/4/20","1","4","45037","400"
"Fairfield","1","12","South Carolina","4/4/20","4","8","45039","200"
"Florence","3","35","South Carolina","4/4/20","12","23","45041","191.67"
"Georgetown","2","17","South Carolina","4/4/20","6","11","45043","183.33"
"Greenville","18","183","South Carolina","4/4/20","57","126","45045","221.05"
"Greenwood","1","10","South Carolina","4/4/20","3","7","45047","233.33"
"Hampton","0","1","South Carolina","4/4/20","0","1","45049","1"
"Horry","5","63","South Carolina","4/4/20","28","35","45051","125"
"Jasper","1","9","South Carolina","4/4/20","3","6","45053","200"
"Kershaw","9","141","South Carolina","4/4/20","77","64","45055","83.12"
"Lancaster","4","39","South Carolina","4/4/20","9","30","45057","333.33"
"Laurens","1","6","South Carolina","4/4/20","2","4","45059","200"
"Lee","2","16","South Carolina","4/4/20","5","11","45061","220"
"Lexington","9","95","South Carolina","4/4/20","30","65","45063","216.67"
"Marion","0","2","South Carolina","4/4/20","1","1","45067","100"
"Marlboro","0","3","South Carolina","4/4/20","1","2","45069","200"
"McCormick","0","1","South Carolina","4/4/20","0","1","45065","1"
"Newberry","1","8","South Carolina","4/4/20","2","6","45071","300"
"Oconee","1","8","South Carolina","4/4/20","3","5","45073","166.67"
"Orangeburg","2","26","South Carolina","4/4/20","14","12","45075","85.71"
"Pickens","1","17","South Carolina","4/4/20","10","7","45077","70"
"Richland","23","242","South Carolina","4/4/20","81","161","45079","198.77"
"Saluda","0","4","South Carolina","4/4/20","1","3","45081","300"
"Spartanburg","7","72","South Carolina","4/4/20","21","51","45083","242.86"
"Sumter","8","79","South Carolina","4/4/20","24","55","45085","229.17"
"Union","1","9","South Carolina","4/4/20","1","8","45087","800"
"Williamsburg","1","9","South Carolina","4/4/20","2","7","45089","350"
"York","7","81","South Carolina","4/4/20","31","50","45091","161.29"
"Aurora","0","1","South Dakota","4/4/20","1","0","46003","0"
"Beadle","1","21","South Dakota","4/4/20","16","5","46005","31.25"
"Bon Homme","0","1","South Dakota","4/4/20","1","0","46009","0"
"Brookings","0","3","South Dakota","4/4/20","1","2","46011","200"
"Brown","1","9","South Dakota","4/4/20","2","7","46013","350"
"Charles Mix","0","2","South Dakota","4/4/20","1","1","46023","100"
"Clark","0","1","South Dakota","4/4/20","0","1","46025","1"
"Clay","0","3","South Dakota","4/4/20","0","3","46027","1"
"Codington","1","9","South Dakota","4/4/20","2","7","46029","350"
"Davison","0","3","South Dakota","4/4/20","2","1","46035","50"
"Deuel","0","1","South Dakota","4/4/20","1","0","46039","0"
"Fall River","0","1","South Dakota","4/4/20","0","1","46047","1"
"Faulk","0","1","South Dakota","4/4/20","1","0","46049","0"
"Hamlin","0","1","South Dakota","4/4/20","1","0","46057","0"
"Hughes","0","3","South Dakota","4/4/20","1","2","46065","200"
"Hutchinson","0","2","South Dakota","4/4/20","2","0","46067","0"
"Lake","0","1","South Dakota","4/4/20","0","1","46079","1"
"Lawrence","1","9","South Dakota","4/4/20","2","7","46081","350"
"Lincoln","3","21","South Dakota","4/4/20","3","18","46083","600"
"Lyman","0","1","South Dakota","4/4/20","1","0","46085","0"
"Marshall","0","1","South Dakota","4/4/20","0","1","46091","1"
"McCook","0","2","South Dakota","4/4/20","2","0","46087","0"
"Meade","0","1","South Dakota","4/4/20","1","0","46093","0"
"Minnehaha","9","81","South Dakota","4/4/20","21","60","46099","285.71"
"Pennington","0","6","South Dakota","4/4/20","3","3","46103","100"
"Roberts","1","4","South Dakota","4/4/20","0","4","46109","1"
"Spink","0","2","South Dakota","4/4/20","0","2","46115","1"
"Todd","0","1","South Dakota","4/4/20","1","0","46121","0"
"Turner","0","3","South Dakota","4/4/20","0","3","46125","1"
"Union","0","3","South Dakota","4/4/20","1","2","46127","200"
"Yankton","2","14","South Dakota","4/4/20","1","13","46135","1300"
"Anderson","1","10","Tennessee","4/4/20","5","5","47001","100"
"Bedford","1","8","Tennessee","4/4/20","1","7","47003","700"
"Benton","0","4","Tennessee","4/4/20","3","1","47005","33.33"
"Bledsoe","0","2","Tennessee","4/4/20","2","0","47007","0"
"Blount","4","34","Tennessee","4/4/20","9","25","47009","277.78"
"Bradley","2","21","Tennessee","4/4/20","5","16","47011","320"
"Campbell","0","5","Tennessee","4/4/20","4","1","47013","25"
"Cannon","0","4","Tennessee","4/4/20","3","1","47015","33.33"
"Carroll","0","6","Tennessee","4/4/20","4","2","47017","50"
"Carter","0","3","Tennessee","4/4/20","1","2","47019","200"
"Cheatham","1","12","Tennessee","4/4/20","7","5","47021","71.43"
"Chester","1","6","Tennessee","4/4/20","2","4","47023","200"
"Claiborne","0","2","Tennessee","4/4/20","2","0","47025","0"
"Clay","0","1","Tennessee","4/4/20","0","1","47027","1"
"Cocke","0","1","Tennessee","4/4/20","1","0","47029","0"
"Coffee","1","4","Tennessee","4/4/20","0","4","47031","1"
"Cumberland","2","23","Tennessee","4/4/20","6","17","47035","283.33"
"Davidson","52","741","Tennessee","4/4/20","376","365","47037","97.07"
"Decatur","0","0","Tennessee","4/4/20","1","-1","47039","-100"
"DeKalb","0","5","Tennessee","4/4/20","3","2","47041","66.67"
"Dickson","2","22","Tennessee","4/4/20","11","11","47043","100"
"Dyer","1","7","Tennessee","4/4/20","3","4","47045","133.33"
"Fayette","2","18","Tennessee","4/4/20","4","14","47047","350"
"Fentress","0","1","Tennessee","4/4/20","0","1","47049","1"
"Franklin","1","12","Tennessee","4/4/20","3","9","47051","300"
"Gibson","1","8","Tennessee","4/4/20","2","6","47053","300"
"Giles","0","3","Tennessee","4/4/20","0","3","47055","1"
"Grainger","0","3","Tennessee","4/4/20","0","3","47057","1"
"Greene","1","16","Tennessee","4/4/20","8","8","47059","100"
"Grundy","1","12","Tennessee","4/4/20","2","10","47061","500"
"Hamblen","0","4","Tennessee","4/4/20","2","2","47063","100"
"Hamilton","5","71","Tennessee","4/4/20","35","36","47065","102.86"
"Hardeman","1","6","Tennessee","4/4/20","1","5","47069","500"
"Hardin","0","2","Tennessee","4/4/20","1","1","47071","100"
"Hawkins","1","9","Tennessee","4/4/20","2","7","47073","350"
"Haywood","0","2","Tennessee","4/4/20","0","2","47075","1"
"Henry","1","4","Tennessee","4/4/20","0","4","47079","1"
"Hickman","0","1","Tennessee","4/4/20","0","1","47081","1"
"Houston","0","2","Tennessee","4/4/20","2","0","47083","0"
"Humphreys","0","3","Tennessee","4/4/20","0","3","47085","1"
"Jackson","0","3","Tennessee","4/4/20","0","3","47087","1"
"Jefferson","0","6","Tennessee","4/4/20","5","1","47089","20"
"Johnson","0","2","Tennessee","4/4/20","0","2","47091","1"
"Knox","9","99","Tennessee","4/4/20","33","66","47093","200"
"Lauderdale","0","2","Tennessee","4/4/20","0","2","47097","1"
"Lawrence","0","3","Tennessee","4/4/20","0","3","47099","1"
"Lewis","0","2","Tennessee","4/4/20","2","0","47101","0"
"Lincoln","1","5","Tennessee","4/4/20","1","4","47103","400"
"Loudon","1","13","Tennessee","4/4/20","6","7","47105","116.67"
"Macon","1","7","Tennessee","4/4/20","2","5","47111","250"
"Madison","2","19","Tennessee","4/4/20","3","16","47113","533.33"
"Marion","2","16","Tennessee","4/4/20","4","12","47115","300"
"Marshall","1","4","Tennessee","4/4/20","0","4","47117","1"
"Maury","2","21","Tennessee","4/4/20","8","13","47119","162.5"
"McMinn","0","3","Tennessee","4/4/20","3","0","47107","0"
"McNairy","0","3","Tennessee","4/4/20","0","3","47109","1"
"Meigs","0","2","Tennessee","4/4/20","1","1","47121","100"
"Monroe","0","6","Tennessee","4/4/20","3","3","47123","100"
"Montgomery","5","46","Tennessee","4/4/20","11","35","47125","318.18"
"Morgan","0","4","Tennessee","4/4/20","1","3","47129","300"
"Obion","0","2","Tennessee","4/4/20","0","2","47131","1"
"Out of TN","10","218","Tennessee","4/4/20","148","70","80047","47.3"
"Overton","0","2","Tennessee","4/4/20","2","0","47133","0"
"Perry","0","3","Tennessee","4/4/20","2","1","47135","50"
"Polk","0","3","Tennessee","4/4/20","0","3","47139","1"
"Putnam","5","52","Tennessee","4/4/20","17","35","47141","205.88"
"Roane","1","5","Tennessee","4/4/20","1","4","47145","400"
"Robertson","4","51","Tennessee","4/4/20","23","28","47147","121.74"
"Rutherford","13","140","Tennessee","4/4/20","46","94","47149","204.35"
"Scott","0","3","Tennessee","4/4/20","2","1","47151","50"
"Sequatchie","0","2","Tennessee","4/4/20","0","2","47153","1"
"Sevier","1","13","Tennessee","4/4/20","6","7","47155","116.67"
"Shelby","59","689","Tennessee","4/4/20","275","414","47157","150.55"
"Smith","0","3","Tennessee","4/4/20","1","2","47159","200"
"Stewart","0","1","Tennessee","4/4/20","0","1","47161","1"
"Sullivan","2","18","Tennessee","4/4/20","6","12","47163","200"
"Sumner","31","301","Tennessee","4/4/20","82","219","47165","267.07"
"Tipton","3","31","Tennessee","4/4/20","11","20","47167","181.82"
"Trousdale","1","7","Tennessee","4/4/20","1","6","47169","600"
"Unicoi","0","1","Tennessee","4/4/20","1","0","47171","0"
"Union","0","1","Tennessee","4/4/20","1","0","47173","0"
"Warren","0","1","Tennessee","4/4/20","0","1","47177","1"
"Washington","1","22","Tennessee","4/4/20","14","8","47179","57.14"
"Wayne","0","2","Tennessee","4/4/20","0","2","47181","1"
"Weakley","0","1","Tennessee","4/4/20","1","0","47183","0"
"White","0","2","Tennessee","4/4/20","1","1","47185","100"
"Williamson","21","239","Tennessee","4/4/20","95","144","47187","151.58"
"Wilson","9","82","Tennessee","4/4/20","20","62","47189","310"
"Anderson","0","1","Texas","4/4/20","0","1","48001","1"
"Andrews","0","1","Texas","4/4/20","1","0","48003","0"
"Angelina","1","10","Texas","4/4/20","1","9","48005","900"
"Atascosa","0","2","Texas","4/4/20","2","0","48013","0"
"Austin","0","4","Texas","4/4/20","1","3","48015","300"
"Bastrop","1","10","Texas","4/4/20","4","6","48021","150"
"Bell","4","58","Texas","4/4/20","28","30","48027","107.14"
"Bexar","31","342","Texas","4/4/20","125","217","48029","173.6"
"Blanco","0","2","Texas","4/4/20","1","1","48031","100"
"Bowie","2","17","Texas","4/4/20","3","14","48037","466.67"
"Brazoria","12","144","Texas","4/4/20","61","83","48039","136.07"
"Brazos","5","75","Texas","4/4/20","40","35","48041","87.5"
"Brown","0","4","Texas","4/4/20","3","1","48049","33.33"
"Burleson","0","2","Texas","4/4/20","1","1","48051","100"
"Burnet","0","4","Texas","4/4/20","1","3","48053","300"
"Caldwell","0","3","Texas","4/4/20","1","2","48055","200"
"Calhoun","1","8","Texas","4/4/20","3","5","48057","166.67"
"Cameron","7","62","Texas","4/4/20","13","49","48061","376.92"
"Camp","0","1","Texas","4/4/20","0","1","48063","1"
"Cass","0","4","Texas","4/4/20","2","2","48067","100"
"Castro","0","11","Texas","4/4/20","8","3","48069","37.5"
"Chambers","1","11","Texas","4/4/20","3","8","48071","266.67"
"Cherokee","1","6","Texas","4/4/20","1","5","48073","500"
"Clay","0","1","Texas","4/4/20","0","1","48077","1"
"Collin","20","256","Texas","4/4/20","118","138","48085","116.95"
"Colorado","0","2","Texas","4/4/20","0","2","48089","1"
"Comal","2","21","Texas","4/4/20","9","12","48091","133.33"
"Comanche","0","2","Texas","4/4/20","1","1","48093","100"
"Coryell","0","4","Texas","4/4/20","1","3","48099","300"
"Crane","0","2","Texas","4/4/20","1","1","48103","100"
"Dallas","95","1105","Texas","4/4/20","439","666","48113","151.71"
"Dawson","0","5","Texas","4/4/20","3","2","48115","66.67"
"Deaf Smith","0","3","Texas","4/4/20","2","1","48117","50"
"Denton","18","273","Texas","4/4/20","148","125","48121","84.46"
"DeWitt","0","6","Texas","4/4/20","3","3","48123","100"
"Donley","1","5","Texas","4/4/20","0","5","48129","1"
"Eastland","0","3","Texas","4/4/20","4","-1","48133","-25"
"Ector","3","22","Texas","4/4/20","1","21","48135","2100"
"El Paso","9","103","Texas","4/4/20","38","65","48141","171.05"
"Ellis","2","29","Texas","4/4/20","13","16","48139","123.08"
"Erath","1","9","Texas","4/4/20","1","8","48143","800"
"Falls","0","1","Texas","4/4/20","1","0","48145","0"
"Fannin","0","2","Texas","4/4/20","1","1","48147","100"
"Fayette","1","10","Texas","4/4/20","1","9","48149","900"
"Fort Bend","22","255","Texas","4/4/20","101","154","48157","152.48"
"Franklin","0","1","Texas","4/4/20","0","1","48159","1"
"Gaines","0","1","Texas","4/4/20","1","0","48165","0"
"Galveston","12","136","Texas","4/4/20","49","87","48167","177.55"
"Gillespie","0","2","Texas","4/4/20","0","2","48171","1"
"Goliad","0","1","Texas","4/4/20","0","1","48175","1"
"Gonzales","0","1","Texas","4/4/20","0","1","48177","1"
"Gray","1","5","Texas","4/4/20","0","5","48179","1"
"Grayson","1","12","Texas","4/4/20","2","10","48181","500"
"Gregg","2","16","Texas","4/4/20","4","12","48183","300"
"Grimes","0","3","Texas","4/4/20","2","1","48185","50"
"Guadalupe","3","26","Texas","4/4/20","8","18","48187","225"
"Hale","1","6","Texas","4/4/20","1","5","48189","500"
"Hardin","1","15","Texas","4/4/20","6","9","48199","150"
"Harris","120","1284","Texas","4/4/20","445","839","48201","188.54"
"Harrison","1","5","Texas","4/4/20","1","4","48203","400"
"Hays","5","50","Texas","4/4/20","13","37","48209","284.62"
"Hemphill","0","1","Texas","4/4/20","0","1","48211","1"
"Henderson","0","1","Texas","4/4/20","0","1","48213","1"
"Hidalgo","10","86","Texas","4/4/20","18","68","48215","377.78"
"Hill","1","5","Texas","4/4/20","0","5","48217","1"
"Hockley","0","7","Texas","4/4/20","7","0","48219","0"
"Hood","1","9","Texas","4/4/20","3","6","48221","200"
"Hopkins","0","3","Texas","4/4/20","1","2","48223","200"
"Hunt","1","8","Texas","4/4/20","1","7","48231","700"
"Hutchinson","0","2","Texas","4/4/20","0","2","48233","1"
"Jackson","0","3","Texas","4/4/20","1","2","48239","200"
"Jasper","0","3","Texas","4/4/20","0","3","48241","1"
"Jefferson","4","40","Texas","4/4/20","12","28","48245","233.33"
"Jim Wells","0","2","Texas","4/4/20","0","2","48249","1"
"Johnson","2","21","Texas","4/4/20","8","13","48251","162.5"
"Karnes","0","2","Texas","4/4/20","1","1","48255","100"
"Kaufman","1","10","Texas","4/4/20","2","8","48257","400"
"Kendall","0","9","Texas","4/4/20","6","3","48259","50"
"Kerr","0","2","Texas","4/4/20","0","2","48265","1"
"Kleberg","0","2","Texas","4/4/20","1","1","48273","100"
"Lamar","1","5","Texas","4/4/20","1","4","48277","400"
"Lamb","0","1","Texas","4/4/20","1","0","48279","0"
"Lampasas","0","1","Texas","4/4/20","0","1","48281","1"
"Lavaca","0","2","Texas","4/4/20","3","-1","48285","-33.33"
"Lee","0","2","Texas","4/4/20","0","2","48287","1"
"Leon","0","2","Texas","4/4/20","0","2","48289","1"
"Liberty","0","5","Texas","4/4/20","2","3","48291","150"
"Limestone","0","3","Texas","4/4/20","1","2","48293","200"
"Live Oak","0","3","Texas","4/4/20","0","3","48297","1"
"Llano","0","3","Texas","4/4/20","2","1","48299","50"
"Lubbock","15","138","Texas","4/4/20","31","107","48303","345.16"
"Lynn","0","3","Texas","4/4/20","1","2","48305","200"
"Martin","0","1","Texas","4/4/20","1","0","48317","0"
"Mason","0","1","Texas","4/4/20","0","1","48319","1"
"Matagorda","4","36","Texas","4/4/20","11","25","48321","227.27"
"Maverick","0","4","Texas","4/4/20","1","3","48323","300"
"McLennan","2","50","Texas","4/4/20","34","16","48309","47.06"
"Medina","0","3","Texas","4/4/20","3","0","48325","0"
"Midland","2","22","Texas","4/4/20","11","11","48329","100"
"Milam","0","2","Texas","4/4/20","2","0","48331","0"
"Montague","0","1","Texas","4/4/20","1","0","48337","0"
"Montgomery","11","142","Texas","4/4/20","63","79","48339","125.4"
"Moore","1","6","Texas","4/4/20","0","6","48341","1"
"Morris","0","1","Texas","4/4/20","1","0","48343","0"
"Nacogdoches","2","15","Texas","4/4/20","1","14","48347","1400"
"Navarro","1","5","Texas","4/4/20","1","4","48349","400"
"Newton","0","1","Texas","4/4/20","0","1","48351","1"
"Nueces","4","47","Texas","4/4/20","21","26","48355","123.81"
"Oldham","0","2","Texas","4/4/20","2","0","48359","0"
"Orange","1","7","Texas","4/4/20","1","6","48361","600"
"Palo Pinto","0","1","Texas","4/4/20","0","1","48363","1"
"Panola","1","4","Texas","4/4/20","0","4","48365","1"
"Parker","0","6","Texas","4/4/20","4","2","48367","50"
"Polk","1","7","Texas","4/4/20","1","6","48373","600"
"Potter","3","24","Texas","4/4/20","3","21","48375","700"
"Randall","3","24","Texas","4/4/20","3","21","48381","700"
"Reeves","0","1","Texas","4/4/20","0","1","48389","1"
"Robertson","0","2","Texas","4/4/20","2","0","48395","0"
"Rockwall","1","11","Texas","4/4/20","3","8","48397","266.67"
"Rusk","1","11","Texas","4/4/20","2","9","48401","450"
"San Augustine","1","4","Texas","4/4/20","0","4","48405","1"
"San Jacinto","0","1","Texas","4/4/20","1","0","48407","0"
"San Patricio","0","4","Texas","4/4/20","2","2","48409","100"
"Shelby","1","11","Texas","4/4/20","1","10","48419","1000"
"Smith","4","57","Texas","4/4/20","27","30","48423","111.11"
"Starr","0","5","Texas","4/4/20","2","3","48427","150"
"Swisher","0","1","Texas","4/4/20","1","0","48437","0"
"Tarrant","39","404","Texas","4/4/20","128","276","48439","215.62"
"Taylor","3","27","Texas","4/4/20","3","24","48441","800"
"Terry","0","4","Texas","4/4/20","4","0","48445","0"
"Titus","0","1","Texas","4/4/20","0","1","48449","1"
"Tom Green","2","20","Texas","4/4/20","3","17","48451","566.67"
"Travis","36","430","Texas","4/4/20","179","251","48453","140.22"
"Trinity","0","2","Texas","4/4/20","0","2","48455","1"
"Tyler","0","2","Texas","4/4/20","0","2","48457","1"
"Upshur","0","3","Texas","4/4/20","0","3","48459","1"
"Uvalde","0","4","Texas","4/4/20","1","3","48463","300"
"Val Verde","0","5","Texas","4/4/20","5","0","48465","0"
"Van Zandt","0","4","Texas","4/4/20","1","3","48467","300"
"Victoria","4","32","Texas","4/4/20","3","29","48469","966.67"
"Walker","1","8","Texas","4/4/20","3","5","48471","166.67"
"Waller","1","8","Texas","4/4/20","0","8","48473","1"
"Washington","2","17","Texas","4/4/20","6","11","48477","183.33"
"Webb","8","83","Texas","4/4/20","25","58","48479","232"
"Wharton","1","9","Texas","4/4/20","3","6","48481","200"
"Wichita","3","46","Texas","4/4/20","23","23","48485","100"
"Willacy","1","5","Texas","4/4/20","1","4","48489","400"
"Williamson","5","71","Texas","4/4/20","34","37","48491","108.82"
"Wilson","1","6","Texas","4/4/20","2","4","48493","200"
"Wise","0","3","Texas","4/4/20","0","3","48497","1"
"Wood","0","1","Texas","4/4/20","0","1","48499","1"
"Young","0","3","Texas","4/4/20","1","2","48503","200"
"Bear River","1","10","Utah","4/4/20","4","6","00000","150"
"Cache","2","16","Utah","4/4/20","5","11","49005","220"
"Carbon","0","1","Utah","4/4/20","0","1","49007","1"
"Davis","11","137","Utah","4/4/20","59","78","49011","132.2"
"Duchesne","0","1","Utah","4/4/20","0","1","49013","1"
"Emery","0","1","Utah","4/4/20","0","1","49015","1"
"Garfield","0","1","Utah","4/4/20","0","1","49017","1"
"Grand","0","1","Utah","4/4/20","0","1","49019","1"
"Iron","2","12","Utah","4/4/20","0","12","49021","1"
"Kane","0","1","Utah","4/4/20","0","1","49025","1"
"Out of UT","-2","0","Utah","4/4/20","14","-14","80049","-100"
"Salt Lake","53","650","Utah","4/4/20","276","374","49035","135.51"
"San Juan","1","5","Utah","4/4/20","1","4","49037","400"
"Summit","15","230","Utah","4/4/20","127","103","49043","81.1"
"Tooele","1","17","Utah","4/4/20","8","9","49045","112.5"
"Uintah","0","1","Utah","4/4/20","0","1","49047","1"
"Utah","22","186","Utah","4/4/20","30","156","49049","520"
"Wasatch","5","70","Utah","4/4/20","36","34","49051","94.44"
"Washington","2","25","Utah","4/4/20","13","12","49053","92.31"
"Weber-Morgan","5","63","Utah","4/4/20","29","34","00000","117.24"
"Addison","3","34","Vermont","4/4/20","15","19","50001","126.67"
"Bennington","1","23","Vermont","4/4/20","15","8","50003","53.33"
"Caledonia","0","5","Vermont","4/4/20","2","3","50005","150"
"Chittenden","20","245","Vermont","4/4/20","105","140","50007","133.33"
"Franklin","2","23","Vermont","4/4/20","7","16","50011","228.57"
"Lamoille","1","17","Vermont","4/4/20","9","8","50015","88.89"
"Orange","0","4","Vermont","4/4/20","3","1","50017","33.33"
"Orleans","0","8","Vermont","4/4/20","5","3","50019","60"
"Rutland","3","24","Vermont","4/4/20","6","18","50021","300"
"Washington","2","21","Vermont","4/4/20","10","11","50023","110"
"Windham","2","25","Vermont","4/4/20","9","16","50025","177.78"
"Windsor","0","21","Vermont","4/4/20","18","3","50027","16.67"
"","3","40","Virgin Islands","4/4/20","22","18",,"81.82"
"Accomack","1","8","Virginia","4/4/20","2","6","51001","300"
"Albemarle","2","27","Virginia","4/4/20","16","11","51003","68.75"
"Alexandria","7","68","Virginia","4/4/20","20","48","51510","240"
"Alleghany","0","2","Virginia","4/4/20","0","2","51005","1"
"Amelia","1","6","Virginia","4/4/20","1","5","51007","500"
"Amherst","1","6","Virginia","4/4/20","2","4","51009","200"
"Arlington","11","150","Virginia","4/4/20","75","75","51013","100"
"Augusta","1","7","Virginia","4/4/20","0","7","51015","1"
"Bedford","0","4","Virginia","4/4/20","3","1","51019","33.33"
"Botetourt","2","14","Virginia","4/4/20","1","13","51023","1300"
"Bristol","0","1","Virginia","4/4/20","1","0","51520","0"
"Brunswick","0","1","Virginia","4/4/20","0","1","51025","1"
"Buckingham","1","4","Virginia","4/4/20","0","4","51029","1"
"Buena Vista","0","1","Virginia","4/4/20","0","1","51530","1"
"Campbell","0","2","Virginia","4/4/20","0","2","51031","1"
"Caroline","0","1","Virginia","4/4/20","0","1","51033","1"
"Carroll","0","1","Virginia","4/4/20","0","1","51035","1"
"Charles City","0","4","Virginia","4/4/20","1","3","51036","300"
"Charlotte","0","1","Virginia","4/4/20","0","1","51037","1"
"Charlottesville","1","21","Virginia","4/4/20","12","9","51540","75"
"Chesapeake","8","65","Virginia","4/4/20","7","58","51550","828.57"
"Chesterfield","13","106","Virginia","4/4/20","12","94","51041","783.33"
"Clarke","0","2","Virginia","4/4/20","0","2","51043","1"
"Covington","0","1","Virginia","4/4/20","0","1","51580","1"
"Culpeper","1","8","Virginia","4/4/20","2","6","51047","300"
"Cumberland","0","2","Virginia","4/4/20","0","2","51049","1"
"Danville","1","12","Virginia","4/4/20","4","8","51590","200"
"Emporia","0","2","Virginia","4/4/20","0","2","51595","1"
"Fairfax","33","387","Virginia","4/4/20","156","231","51059","148.08"
"Fauquier","1","10","Virginia","4/4/20","6","4","51061","66.67"
"Fluvanna","0","5","Virginia","4/4/20","3","2","51065","66.67"
"Franklin","1","10","Virginia","4/4/20","1","9","51067","900"
"Franklin City","1","4","Virginia","4/4/20","0","4","51620","1"
"Frederick","3","24","Virginia","4/4/20","4","20","51069","500"
"Fredericksburg","1","7","Virginia","4/4/20","1","6","51630","600"
"Galax","0","1","Virginia","4/4/20","1","0","51640","0"
"Gloucester","0","9","Virginia","4/4/20","6","3","51073","50"
"Goochland","1","10","Virginia","4/4/20","5","5","51075","100"
"Greene","0","2","Virginia","4/4/20","1","1","51079","100"
"Greensville","1","4","Virginia","4/4/20","0","4","51081","1"
"Halifax","0","1","Virginia","4/4/20","1","0","51083","0"
"Hampton","5","39","Virginia","4/4/20","7","32","51650","457.14"
"Hanover","1","12","Virginia","4/4/20","3","9","51085","300"
"Harrisonburg","2","22","Virginia","4/4/20","5","17","51660","340"
"Henrico","20","174","Virginia","4/4/20","31","143","51087","461.29"
"Henry","0","3","Virginia","4/4/20","0","3","51089","1"
"Hopewell","1","9","Virginia","4/4/20","1","8","51670","800"
"Isle of Wight","2","18","Virginia","4/4/20","3","15","51093","500"
"James City","7","111","Virginia","4/4/20","65","46","51095","70.77"
"King and Queen","0","1","Virginia","4/4/20","0","1","51097","1"
"King George","1","8","Virginia","4/4/20","2","6","51099","300"
"King William","0","1","Virginia","4/4/20","0","1","51101","1"
"Lancaster","0","1","Virginia","4/4/20","1","0","51103","0"
"Lee","0","2","Virginia","4/4/20","2","0","51105","0"
"Lexington","0","3","Virginia","4/4/20","0","3","51678","1"
"Loudoun","14","150","Virginia","4/4/20","54","96","51107","177.78"
"Louisa","1","13","Virginia","4/4/20","6","7","51109","116.67"
"Lynchburg","1","10","Virginia","4/4/20","2","8","51680","400"
"Madison","0","2","Virginia","4/4/20","3","-1","51113","-33.33"
"Manassas","1","14","Virginia","4/4/20","4","10","51683","250"
"Manassas Park","0","2","Virginia","4/4/20","0","2","51685","1"
"Mathews","0","2","Virginia","4/4/20","2","0","51115","0"
"Mecklenburg","1","8","Virginia","4/4/20","4","4","51117","100"
"Montgomery","1","6","Virginia","4/4/20","1","5","51121","500"
"Nelson","0","2","Virginia","4/4/20","2","0","51125","0"
"New Kent","1","8","Virginia","4/4/20","1","7","51127","700"
"Newport News","5","48","Virginia","4/4/20","13","35","51700","269.23"
"Norfolk","6","55","Virginia","4/4/20","10","45","51710","450"
"Northampton","0","2","Virginia","4/4/20","1","1","51131","100"
"Northumberland","0","3","Virginia","4/4/20","2","1","51133","50"
"Nottoway","0","1","Virginia","4/4/20","1","0","51135","0"
"Orange","1","5","Virginia","4/4/20","1","4","51137","400"
"Page","0","2","Virginia","4/4/20","0","2","51139","1"
"Petersburg","1","10","Virginia","4/4/20","0","10","51730","1"
"Pittsylvania","0","2","Virginia","4/4/20","1","1","51143","100"
"Poquoson","0","3","Virginia","4/4/20","2","1","51735","50"
"Portsmouth","3","26","Virginia","4/4/20","4","22","51740","550"
"Powhatan","0","4","Virginia","4/4/20","1","3","51145","300"
"Prince Edward","0","3","Virginia","4/4/20","2","1","51147","50"
"Prince George","2","16","Virginia","4/4/20","2","14","51149","700"
"Prince William","15","159","Virginia","4/4/20","56","103","51153","183.93"
"Pulaski","0","1","Virginia","4/4/20","0","1","51155","1"
"Radford","0","1","Virginia","4/4/20","1","0","51750","0"
"Richmond City","11","96","Virginia","4/4/20","20","76","51760","380"
"Roanoke","0","5","Virginia","4/4/20","2","3","51161","150"
"Roanoke City","1","10","Virginia","4/4/20","0","10","51770","1"
"Rockbridge","0","3","Virginia","4/4/20","2","1","51163","50"
"Rockingham","2","15","Virginia","4/4/20","4","11","51165","275"
"Salem","0","1","Virginia","4/4/20","0","1","51775","1"
"Shenandoah","1","10","Virginia","4/4/20","3","7","51171","233.33"
"Smyth","0","2","Virginia","4/4/20","0","2","51173","1"
"Southampton","1","5","Virginia","4/4/20","1","4","51175","400"
"Spotsylvania","2","18","Virginia","4/4/20","3","15","51177","500"
"Stafford","4","38","Virginia","4/4/20","11","27","51179","245.45"
"Staunton","0","1","Virginia","4/4/20","0","1","51790","1"
"Suffolk","3","20","Virginia","4/4/20","1","19","51800","1900"
"Surry","0","3","Virginia","4/4/20","0","3","51181","1"
"Sussex","0","3","Virginia","4/4/20","0","3","51183","1"
"Tazewell","0","2","Virginia","4/4/20","0","2","51185","1"
"Virginia Beach","18","160","Virginia","4/4/20","35","125","51810","357.14"
"Warren","0","4","Virginia","4/4/20","2","2","51187","100"
"Washington","0","3","Virginia","4/4/20","1","2","51191","200"
"Waynesboro","0","2","Virginia","4/4/20","0","2","51820","1"
"Westmoreland","0","2","Virginia","4/4/20","0","2","51193","1"
"Williamsburg","1","10","Virginia","4/4/20","6","4","51830","66.67"
"Winchester","1","10","Virginia","4/4/20","0","10","51840","1"
"Wythe","0","2","Virginia","4/4/20","0","2","51197","1"
"York","1","19","Virginia","4/4/20","9","10","51199","111.11"
"Adams","2","20","Washington","4/4/20","5","15","53001","300"
"Asotin","0","1","Washington","4/4/20","0","1","53003","1"
"Benton","16","151","Washington","4/4/20","42","109","53005","259.52"
"Chelan","2","24","Washington","4/4/20","13","11","53007","84.62"
"Clallam","0","8","Washington","4/4/20","5","3","53009","60"
"Clark","8","137","Washington","4/4/20","82","55","53011","67.07"
"Columbia","0","1","Washington","4/4/20","1","0","53013","0"
"Cowlitz","1","18","Washington","4/4/20","10","8","53015","80"
"Douglas","1","9","Washington","4/4/20","5","4","53017","80"
"Ferry","0","1","Washington","4/4/20","1","0","53019","0"
"Franklin","5","46","Washington","4/4/20","12","34","53021","283.33"
"Grant","5","77","Washington","4/4/20","44","33","53025","75"
"Grays Harbor","0","3","Washington","4/4/20","1","2","53027","200"
"Island","6","122","Washington","4/4/20","80","42","53029","52.5"
"Jefferson","1","19","Washington","4/4/20","11","8","53031","72.73"
"King","117","2898","Washington","4/4/20","2077","821","53033","39.53"
"Kitsap","8","99","Washington","4/4/20","42","57","53035","135.71"
"Kittitas","0","10","Washington","4/4/20","8","2","53037","25"
"Klickitat","0","9","Washington","4/4/20","7","2","53039","28.57"
"Lewis","1","13","Washington","4/4/20","7","6","53041","85.71"
"Lincoln","0","1","Washington","4/4/20","1","0","53043","0"
"Mason","2","13","Washington","4/4/20","2","11","53045","550"
"Okanogan","0","6","Washington","4/4/20","3","3","53047","100"
"Pend Oreille","0","1","Washington","4/4/20","0","1","53051","1"
"Pierce","56","620","Washington","4/4/20","231","389","53053","168.4"
"San Juan","0","6","Washington","4/4/20","3","3","53055","100"
"Skagit","10","161","Washington","4/4/20","91","70","53057","76.92"
"Skamania","0","1","Washington","4/4/20","1","0","53059","0"
"Snohomish","84","1503","Washington","4/4/20","913","590","53061","64.62"
"Spokane","14","209","Washington","4/4/20","108","101","53063","93.52"
"Stevens","0","5","Washington","4/4/20","3","2","53065","66.67"
"Thurston","5","64","Washington","4/4/20","27","37","53067","137.04"
"Wahkiakum","0","1","Washington","4/4/20","0","1","53069","1"
"Walla Walla","1","8","Washington","4/4/20","4","4","53071","100"
"Whatcom","14","199","Washington","4/4/20","102","97","53073","95.1"
"Whitman","1","11","Washington","4/4/20","6","5","53075","83.33"
"Yakima","30","289","Washington","4/4/20","82","207","53077","252.44"
"Barbour","0","2","West Virginia","4/4/20","0","2","54001","1"
"Berkeley","6","49","West Virginia","4/4/20","9","40","54003","444.44"
"Cabell","1","5","West Virginia","4/4/20","0","5","54011","1"
"Greenbrier","0","3","West Virginia","4/4/20","1","2","54025","200"
"Hancock","1","6","West Virginia","4/4/20","1","5","54029","500"
"Hardy","0","2","West Virginia","4/4/20","0","2","54031","1"
"Harrison","2","19","West Virginia","4/4/20","4","15","54033","375"
"Jackson","1","13","West Virginia","4/4/20","6","7","54035","116.67"
"Jefferson","2","17","West Virginia","4/4/20","4","13","54037","325"
"Kanawha","4","48","West Virginia","4/4/20","17","31","54039","182.35"
"Logan","1","5","West Virginia","4/4/20","1","4","54045","400"
"Marion","1","13","West Virginia","4/4/20","3","10","54049","333.33"
"Marshall","0","4","West Virginia","4/4/20","3","1","54051","33.33"
"Mason","0","4","West Virginia","4/4/20","3","1","54053","33.33"
"Mercer","0","3","West Virginia","4/4/20","2","1","54055","50"
"Mineral","0","2","West Virginia","4/4/20","0","2","54057","1"
"Monongalia","2","40","West Virginia","4/4/20","23","17","54061","73.91"
"Morgan","0","1","West Virginia","4/4/20","0","1","54065","1"
"Ohio","1","11","West Virginia","4/4/20","6","5","54069","83.33"
"Pendleton","0","1","West Virginia","4/4/20","0","1","54071","1"
"Pleasants","0","1","West Virginia","4/4/20","1","0","54073","0"
"Preston","1","5","West Virginia","4/4/20","1","4","54077","400"
"Putnam","0","5","West Virginia","4/4/20","3","2","54079","66.67"
"Raleigh","0","4","West Virginia","4/4/20","3","1","54081","33.33"
"Randolph","0","3","West Virginia","4/4/20","0","3","54083","1"
"Roane","0","2","West Virginia","4/4/20","0","2","54087","1"
"Tucker","0","3","West Virginia","4/4/20","2","1","54093","50"
"Upshur","0","1","West Virginia","4/4/20","1","0","54097","0"
"Wetzel","0","2","West Virginia","4/4/20","0","2","54103","1"
"Wirt","0","1","West Virginia","4/4/20","0","1","54105","1"
"Wood","1","7","West Virginia","4/4/20","2","5","54107","250"
"Adams","0","1","Wisconsin","4/4/20","0","1","55001","1"
"Ashland","0","1","Wisconsin","4/4/20","0","1","55003","1"
"Barron","0","1","Wisconsin","4/4/20","0","1","55005","1"
"Bayfield","0","3","Wisconsin","4/4/20","2","1","55007","50"
"Brown","3","24","Wisconsin","4/4/20","6","18","55009","300"
"Buffalo","0","2","Wisconsin","4/4/20","0","2","55011","1"
"Calumet","0","3","Wisconsin","4/4/20","1","2","55015","200"
"Chippewa","1","14","Wisconsin","4/4/20","4","10","55017","250"
"Clark","0","6","Wisconsin","4/4/20","3","3","55019","100"
"Columbia","2","18","Wisconsin","4/4/20","7","11","55021","157.14"
"Crawford","0","1","Wisconsin","4/4/20","0","1","55023","1"
"Dane","14","269","Wisconsin","4/4/20","172","97","55025","56.4"
"Dodge","1","14","Wisconsin","4/4/20","6","8","55027","133.33"
"Door","0","2","Wisconsin","4/4/20","0","2","55029","1"
"Douglas","0","7","Wisconsin","4/4/20","6","1","55031","16.67"
"Dunn","0","5","Wisconsin","4/4/20","2","3","55033","150"
"Eau Claire","1","16","Wisconsin","4/4/20","7","9","55035","128.57"
"Fond du Lac","1","30","Wisconsin","4/4/20","20","10","55039","50"
"Grant","0","2","Wisconsin","4/4/20","1","1","55043","100"
"Green","1","8","Wisconsin","4/4/20","4","4","55045","100"
"Iowa","0","3","Wisconsin","4/4/20","3","0","55049","0"
"Iron","0","1","Wisconsin","4/4/20","1","0","55051","0"
"Jackson","0","2","Wisconsin","4/4/20","0","2","55053","1"
"Jefferson","1","13","Wisconsin","4/4/20","8","5","55055","62.5"
"Juneau","0","4","Wisconsin","4/4/20","2","2","55057","100"
"Kenosha","8","81","Wisconsin","4/4/20","24","57","55059","237.5"
"La Crosse","1","19","Wisconsin","4/4/20","15","4","55063","26.67"
"Manitowoc","0","1","Wisconsin","4/4/20","0","1","55071","1"
"Marathon","1","9","Wisconsin","4/4/20","1","8","55073","800"
"Marinette","0","2","Wisconsin","4/4/20","1","1","55075","100"
"Marquette","0","2","Wisconsin","4/4/20","0","2","55077","1"
"Menominee","0","1","Wisconsin","4/4/20","0","1","55078","1"
"Milwaukee","69","1023","Wisconsin","4/4/20","541","482","55079","89.09"
"Monroe","0","3","Wisconsin","4/4/20","1","2","55081","200"
"Oconto","0","1","Wisconsin","4/4/20","0","1","55083","1"
"Oneida","0","3","Wisconsin","4/4/20","1","2","55085","200"
"Outagamie","2","19","Wisconsin","4/4/20","4","15","55087","375"
"Ozaukee","2","50","Wisconsin","4/4/20","33","17","55089","51.52"
"Pepin","1","7","Wisconsin","4/4/20","0","7","55091","1"
"Pierce","0","7","Wisconsin","4/4/20","4","3","55093","75"
"Portage","0","3","Wisconsin","4/4/20","1","2","55097","200"
"Racine","4","41","Wisconsin","4/4/20","16","25","55101","156.25"
"Richland","0","2","Wisconsin","4/4/20","2","0","55103","0"
"Rock","1","20","Wisconsin","4/4/20","12","8","55105","66.67"
"Rusk","0","1","Wisconsin","4/4/20","0","1","55107","1"
"Sauk","1","18","Wisconsin","4/4/20","11","7","55111","63.64"
"Sheboygan","2","20","Wisconsin","4/4/20","8","12","55117","150"
"St. Croix","0","7","Wisconsin","4/4/20","4","3","55109","75"
"Trempealeau","0","1","Wisconsin","4/4/20","0","1","55121","1"
"Vilas","0","3","Wisconsin","4/4/20","2","1","55125","50"
"Walworth","1","15","Wisconsin","4/4/20","6","9","55127","150"
"Washington","3","52","Wisconsin","4/4/20","31","21","55131","67.74"
"Waukesha","10","141","Wisconsin","4/4/20","72","69","55133","95.83"
"Waupaca","0","2","Wisconsin","4/4/20","1","1","55135","100"
"Winnebago","2","24","Wisconsin","4/4/20","7","17","55139","242.86"
"Wood","0","2","Wisconsin","4/4/20","2","0","55141","0"
"Albany","0","4","Wyoming","4/4/20","1","3","56001","300"
"Campbell","1","7","Wyoming","4/4/20","1","6","56005","600"
"Carbon","0","4","Wyoming","4/4/20","3","1","56007","33.33"
"Converse","0","3","Wyoming","4/4/20","1","2","56009","200"
"Fremont","2","36","Wyoming","4/4/20","20","16","56013","80"
"Goshen","0","2","Wyoming","4/4/20","1","1","56015","100"
"Johnson","0","8","Wyoming","4/4/20","5","3","56019","60"
"Laramie","3","42","Wyoming","4/4/20","19","23","56021","121.05"
"Lincoln","0","1","Wyoming","4/4/20","0","1","56023","1"
"Natrona","2","23","Wyoming","4/4/20","8","15","56025","187.5"
"Park","0","1","Wyoming","4/4/20","1","0","56029","0"
"Sheridan","1","11","Wyoming","4/4/20","6","5","56033","83.33"
"Sublette","0","1","Wyoming","4/4/20","1","0","56035","0"
"Sweetwater","0","4","Wyoming","4/4/20","1","3","56037","300"
"Teton","3","36","Wyoming","4/4/20","13","23","56039","176.92"
"Uinta","0","2","Wyoming","4/4/20","0","2","56041","1"
"Washakie","0","2","Wyoming","4/4/20","1","1","56043","100"
