"Locality","DailyAvgNewCasesPast7Days","TotalCases","State","Date","TotalCases7DaysAgo","NewCasesPast7Days","FIPS-Code","PercentIncreaseTotalCasesPast7Days"
"Autauga","1","25","Alabama","4/18/20","19","6","01001","31.58"
"Baldwin","6","109","Alabama","4/18/20","66","43","01003","65.15"
"Barbour","1","18","Alabama","4/18/20","9","9","01005","100"
"Bibb","2","26","Alabama","4/18/20","13","13","01007","100"
"Blount","1","20","Alabama","4/18/20","12","8","01009","66.67"
"Bullock","1","9","Alabama","4/18/20","4","5","01011","125"
"Butler","1","13","Alabama","4/18/20","6","7","01013","116.67"
"Calhoun","1","66","Alabama","4/18/20","57","9","01015","15.79"
"Chambers","8","240","Alabama","4/18/20","181","59","01017","32.6"
"Cherokee","1","12","Alabama","4/18/20","7","5","01019","71.43"
"Chilton","1","39","Alabama","4/18/20","30","9","01021","30"
"Choctaw","1","14","Alabama","4/18/20","8","6","01023","75"
"Clarke","1","24","Alabama","4/18/20","15","9","01025","60"
"Clay","1","17","Alabama","4/18/20","12","5","01027","41.67"
"Cleburne","0","12","Alabama","4/18/20","12","0","01029","0"
"Coffee","5","55","Alabama","4/18/20","17","38","01031","223.53"
"Colbert","1","15","Alabama","4/18/20","8","7","01033","87.5"
"Conecuh","1","10","Alabama","4/18/20","3","7","01035","233.33"
"Coosa","2","22","Alabama","4/18/20","11","11","01037","100"
"Covington","1","21","Alabama","4/18/20","11","10","01039","90.91"
"Crenshaw","1","6","Alabama","4/18/20","2","4","01041","200"
"Cullman","2","42","Alabama","4/18/20","31","11","01043","35.48"
"Dale","2","17","Alabama","4/18/20","6","11","01045","183.33"
"Dallas","2","22","Alabama","4/18/20","10","12","01047","120"
"DeKalb","3","40","Alabama","4/18/20","21","19","01049","90.48"
"Elmore","4","58","Alabama","4/18/20","30","28","01051","93.33"
"Escambia","0","12","Alabama","4/18/20","9","3","01053","33.33"
"Etowah","3","93","Alabama","4/18/20","74","19","01055","25.68"
"Fayette","0","4","Alabama","4/18/20","3","1","01057","33.33"
"Franklin","1","17","Alabama","4/18/20","8","9","01059","112.5"
"Geneva","1","4","Alabama","4/18/20","0","4","01061","1"
"Greene","2","29","Alabama","4/18/20","14","15","01063","107.14"
"Hale","2","23","Alabama","4/18/20","11","12","01065","109.09"
"Henry","1","17","Alabama","4/18/20","10","7","01067","70"
"Houston","4","63","Alabama","4/18/20","37","26","01069","70.27"
"Jackson","2","38","Alabama","4/18/20","22","16","01071","72.73"
"Jefferson","13","671","Alabama","4/18/20","579","92","01073","15.89"
"Lamar","0","8","Alabama","4/18/20","7","1","01075","14.29"
"Lauderdale","0","23","Alabama","4/18/20","21","2","01077","9.52"
"Lawrence","0","9","Alabama","4/18/20","8","1","01079","12.5"
"Lee","12","305","Alabama","4/18/20","218","87","01081","39.91"
"Limestone","1","40","Alabama","4/18/20","36","4","01083","11.11"
"Lowndes","2","27","Alabama","4/18/20","14","13","01085","92.86"
"Macon","2","24","Alabama","4/18/20","11","13","01087","118.18"
"Madison","2","197","Alabama","4/18/20","186","11","01089","5.91"
"Marengo","1","25","Alabama","4/18/20","19","6","01091","31.58"
"Marion","3","60","Alabama","4/18/20","42","18","01093","42.86"
"Marshall","8","138","Alabama","4/18/20","82","56","01095","68.29"
"Mobile","33","637","Alabama","4/18/20","408","229","01097","56.13"
"Monroe","0","8","Alabama","4/18/20","6","2","01099","33.33"
"Montgomery","16","215","Alabama","4/18/20","102","113","01101","110.78"
"Morgan","1","45","Alabama","4/18/20","37","8","01103","21.62"
"Perry","1","9","Alabama","4/18/20","4","5","01105","125"
"Pickens","2","32","Alabama","4/18/20","21","11","01107","52.38"
"Pike","2","34","Alabama","4/18/20","18","16","01109","88.89"
"Randolph","3","51","Alabama","4/18/20","27","24","01111","88.89"
"Russell","3","41","Alabama","4/18/20","22","19","01113","86.36"
"Shelby","9","257","Alabama","4/18/20","193","64","01117","33.16"
"St. Clair","2","53","Alabama","4/18/20","38","15","01115","39.47"
"Sumter","2","35","Alabama","4/18/20","19","16","01119","84.21"
"Talladega","2","44","Alabama","4/18/20","32","12","01121","37.5"
"Tallapoosa","17","179","Alabama","4/18/20","61","118","01123","193.44"
"Tuscaloosa","6","141","Alabama","4/18/20","99","42","01125","42.42"
"Walker","1","83","Alabama","4/18/20","78","5","01127","6.41"
"Washington","0","15","Alabama","4/18/20","12","3","01129","25"
"Wilcox","3","45","Alabama","4/18/20","24","21","01131","87.5"
"Winston","1","9","Alabama","4/18/20","4","5","01133","125"
"Anchorage","4","151","Alaska","4/18/20","121","30","02020","24.79"
"Bethel","0","1","Alaska","4/18/20","1","0","02050","0"
"Fairbanks North Star","0","79","Alaska","4/18/20","76","3","02090","3.95"
"Juneau","1","24","Alaska","4/18/20","15","9","02110","60"
"Kenai Peninsula","1","19","Alaska","4/18/20","15","4","02122","26.67"
"Ketchikan Gateway","0","15","Alaska","4/18/20","14","1","02130","7.14"
"Kodiak Island","0","1","Alaska","4/18/20","0","1","02150","1"
"Matanuska-Susitna","1","17","Alaska","4/18/20","10","7","02170","70"
"Nome","0","1","Alaska","4/18/20","0","1","02180","1"
"Petersburg","0","2","Alaska","4/18/20","2","0","02195","0"
"Prince of Wales-Hyder","0","2","Alaska","4/18/20","1","1","02198","100"
"Southeast Fairbanks","0","1","Alaska","4/18/20","1","0","02240","0"
"Yukon-Koyukuk","0","1","Alaska","4/18/20","1","0","02290","0"
"Apache","15","169","Arizona","4/18/20","66","103","04001","156.06"
"Cochise","1","22","Arizona","4/18/20","13","9","04003","69.23"
"Coconino","11","314","Arizona","4/18/20","238","76","04005","31.93"
"Gila","1","7","Arizona","4/18/20","3","4","04007","133.33"
"Graham","0","2","Arizona","4/18/20","2","0","04009","0"
"Greenlee","0","2","Arizona","4/18/20","2","0","04011","0"
"La Paz","0","5","Arizona","4/18/20","4","1","04012","25"
"Maricopa","86","2491","Arizona","4/18/20","1891","600","04013","31.73"
"Mohave","3","52","Arizona","4/18/20","30","22","04015","73.33"
"Navajo","19","452","Arizona","4/18/20","321","131","04017","40.81"
"Pima","38","856","Arizona","4/18/20","591","265","04019","44.84"
"Pinal","13","235","Arizona","4/18/20","146","89","04021","60.96"
"Santa Cruz","1","16","Arizona","4/18/20","8","8","04023","100"
"Yavapai","1","72","Arizona","4/18/20","63","9","04025","14.29"
"Yuma","2","29","Arizona","4/18/20","15","14","04027","93.33"
"Arkansas","0","2","Arkansas","4/18/20","2","0","05001","0"
"Ashley","0","11","Arkansas","4/18/20","10","1","05003","10"
"Baxter","0","5","Arkansas","4/18/20","4","1","05005","25"
"Benton","2","62","Arkansas","4/18/20","47","15","05007","31.91"
"Boone","0","3","Arkansas","4/18/20","3","0","05009","0"
"Bradley","0","7","Arkansas","4/18/20","6","1","05011","16.67"
"Carroll","0","2","Arkansas","4/18/20","2","0","05015","0"
"Chicot","0","7","Arkansas","4/18/20","5","2","05017","40"
"Clark","0","27","Arkansas","4/18/20","27","0","05019","0"
"Clay","0","1","Arkansas","4/18/20","1","0","05021","0"
"Cleburne","0","70","Arkansas","4/18/20","69","1","05023","1.45"
"Cleveland","0","8","Arkansas","4/18/20","8","0","05025","0"
"Columbia","0","4","Arkansas","4/18/20","3","1","05027","33.33"
"Conway","0","5","Arkansas","4/18/20","4","1","05029","25"
"Craighead","2","42","Arkansas","4/18/20","31","11","05031","35.48"
"Crawford","0","4","Arkansas","4/18/20","3","1","05033","33.33"
"Crittenden","6","133","Arkansas","4/18/20","89","44","05035","49.44"
"Cross","0","8","Arkansas","4/18/20","6","2","05037","33.33"
"Dallas","0","1","Arkansas","4/18/20","1","0","05039","0"
"Desha","0","6","Arkansas","4/18/20","6","0","05041","0"
"Drew","0","6","Arkansas","4/18/20","6","0","05043","0"
"Faulkner","0","60","Arkansas","4/18/20","57","3","05045","5.26"
"Franklin","0","1","Arkansas","4/18/20","1","0","05047","0"
"Garland","5","106","Arkansas","4/18/20","72","34","05051","47.22"
"Grant","0","11","Arkansas","4/18/20","9","2","05053","22.22"
"Greene","0","9","Arkansas","4/18/20","6","3","05055","50"
"Hempstead","0","4","Arkansas","4/18/20","4","0","05057","0"
"Hot Spring","0","8","Arkansas","4/18/20","8","0","05059","0"
"Howard","1","12","Arkansas","4/18/20","6","6","05061","100"
"Independence","0","7","Arkansas","4/18/20","5","2","05063","40"
"Izard","0","2","Arkansas","4/18/20","1","1","05065","100"
"Jackson","0","1","Arkansas","4/18/20","0","1","05067","1"
"Jefferson","3","114","Arkansas","4/18/20","91","23","05069","25.27"
"Johnson","1","21","Arkansas","4/18/20","13","8","05071","61.54"
"Lafayette","0","4","Arkansas","4/18/20","2","2","05073","100"
"Lawrence","2","25","Arkansas","4/18/20","10","15","05075","150"
"Lee","0","3","Arkansas","4/18/20","2","1","05077","50"
"Lincoln","14","110","Arkansas","4/18/20","10","100","05079","1000"
"Logan","0","3","Arkansas","4/18/20","2","1","05083","50"
"Lonoke","0","30","Arkansas","4/18/20","27","3","05085","11.11"
"Madison","0","1","Arkansas","4/18/20","1","0","05087","0"
"Marion","0","1","Arkansas","4/18/20","1","0","05089","0"
"Miller","1","29","Arkansas","4/18/20","22","7","05091","31.82"
"Mississippi","0","8","Arkansas","4/18/20","7","1","05093","14.29"
"Monroe","0","2","Arkansas","4/18/20","1","1","05095","100"
"Nevada","0","1","Arkansas","4/18/20","1","0","05099","0"
"Newton","0","2","Arkansas","4/18/20","1","1","05101","100"
"Ouachita","0","5","Arkansas","4/18/20","5","0","05103","0"
"Perry","0","3","Arkansas","4/18/20","2","1","05105","50"
"Phillips","0","4","Arkansas","4/18/20","3","1","05107","33.33"
"Pike","0","2","Arkansas","4/18/20","2","0","05109","0"
"Poinsett","0","10","Arkansas","4/18/20","7","3","05111","42.86"
"Polk","0","7","Arkansas","4/18/20","6","1","05113","16.67"
"Pope","1","35","Arkansas","4/18/20","26","9","05115","34.62"
"Prairie","0","2","Arkansas","4/18/20","2","0","05117","0"
"Pulaski","17","368","Arkansas","4/18/20","249","119","05119","47.79"
"Randolph","0","11","Arkansas","4/18/20","8","3","05121","37.5"
"Saline","1","41","Arkansas","4/18/20","32","9","05125","28.12"
"Scott","0","1","Arkansas","4/18/20","1","0","05127","0"
"Searcy","0","6","Arkansas","4/18/20","6","0","05129","0"
"Sebastian","0","11","Arkansas","4/18/20","10","1","05131","10"
"Sevier","0","8","Arkansas","4/18/20","6","2","05133","33.33"
"Sharp","0","2","Arkansas","4/18/20","2","0","05135","0"
"St. Francis","5","64","Arkansas","4/18/20","31","33","05123","106.45"
"Stone","0","7","Arkansas","4/18/20","7","0","05137","0"
"Union","1","23","Arkansas","4/18/20","18","5","05139","27.78"
"Van Buren","0","26","Arkansas","4/18/20","26","0","05141","0"
"Washington","1","45","Arkansas","4/18/20","37","8","05143","21.62"
"White","0","29","Arkansas","4/18/20","28","1","05145","3.57"
"Woodruff","0","1","Arkansas","4/18/20","1","0","05147","0"
"Yell","0","2","Arkansas","4/18/20","1","1","05149","100"
"Alameda","44","1114","California","4/18/20","806","308","06001","38.21"
"Alpine","0","2","California","4/18/20","2","0","06003","0"
"Amador","0","7","California","4/18/20","7","0","06005","0"
"Butte","0","16","California","4/18/20","14","2","06007","14.29"
"Calaveras","1","12","California","4/18/20","8","4","06009","50"
"Colusa","0","3","California","4/18/20","3","0","06011","0"
"Contra Costa","22","685","California","4/18/20","530","155","06013","29.25"
"Del Norte","0","2","California","4/18/20","2","0","06015","0"
"El Dorado","1","36","California","4/18/20","32","4","06017","12.5"
"Fresno","17","311","California","4/18/20","191","120","06019","62.83"
"Glenn","0","4","California","4/18/20","3","1","06021","33.33"
"Humboldt","0","52","California","4/18/20","50","2","06023","4"
"Imperial","11","155","California","4/18/20","79","76","06025","96.2"
"Inyo","1","18","California","4/18/20","12","6","06027","50"
"Kern","34","610","California","4/18/20","371","239","06029","64.42"
"Kings","2","20","California","4/18/20","9","11","06031","122.22"
"Lake","0","6","California","4/18/20","4","2","06033","50"
"Los Angeles","510","12021","California","4/18/20","8453","3568","06037","42.21"
"Madera","0","33","California","4/18/20","32","1","06039","3.12"
"Marin","5","187","California","4/18/20","154","33","06041","21.43"
"Mendocino","0","5","California","4/18/20","4","1","06045","25"
"Merced","4","86","California","4/18/20","59","27","06047","45.76"
"Mono","0","23","California","4/18/20","21","2","06051","9.52"
"Monterey","6","119","California","4/18/20","79","40","06053","50.63"
"Napa","2","47","California","4/18/20","32","15","06055","46.88"
"Nevada","0","36","California","4/18/20","34","2","06057","5.88"
"Orange","48","1556","California","4/18/20","1221","335","06059","27.44"
"Placer","1","131","California","4/18/20","123","8","06061","6.5"
"Plumas","0","4","California","4/18/20","4","0","06063","0"
"Riverside","147","2457","California","4/18/20","1431","1026","06065","71.7"
"Sacramento","37","914","California","4/18/20","653","261","06067","39.97"
"San Benito","1","44","California","4/18/20","35","9","06069","25.71"
"San Bernardino","58","1219","California","4/18/20","810","409","06071","50.49"
"San Diego","66","2158","California","4/18/20","1693","465","06073","27.47"
"San Francisco","40","1137","California","4/18/20","857","280","06075","32.67"
"San Joaquin","20","400","California","4/18/20","257","143","06077","55.64"
"San Luis Obispo","3","131","California","4/18/20","110","21","06079","19.09"
"San Mateo","27","838","California","4/18/20","652","186","06081","28.53"
"Santa Barbara","16","373","California","4/18/20","260","113","06083","43.46"
"Santa Clara","55","1870","California","4/18/20","1484","386","06085","26.01"
"Santa Cruz","3","101","California","4/18/20","80","21","06087","26.25"
"Shasta","0","26","California","4/18/20","24","2","06089","8.33"
"Siskiyou","0","5","California","4/18/20","5","0","06093","0"
"Solano","7","169","California","4/18/20","121","48","06095","39.67"
"Sonoma","5","180","California","4/18/20","145","35","06097","24.14"
"Stanislaus","13","206","California","4/18/20","116","90","06099","77.59"
"Sutter","-2","25","California","4/18/20","37","-12","06101","-32.43"
"Tehama","0","1","California","4/18/20","1","0","06103","0"
"Tulare","28","397","California","4/18/20","203","194","06107","95.57"
"Tuolumne","0","2","California","4/18/20","1","1","06109","100"
"Ventura","14","396","California","4/18/20","298","98","06111","32.89"
"Yolo","7","126","California","4/18/20","75","51","06113","68"
"Yuba","0","15","California","4/18/20","15","0","06115","0"
"Adams","43","894","Colorado","4/18/20","593","301","08001","50.76"
"Alamosa","0","7","Colorado","4/18/20","7","0","08003","0"
"Arapahoe","71","1498","Colorado","4/18/20","998","500","08005","50.1"
"Archuleta","0","7","Colorado","4/18/20","6","1","08007","16.67"
"Baca","0","10","Colorado","4/18/20","10","0","08009","0"
"Boulder","14","342","Colorado","4/18/20","246","96","08013","39.02"
"Broomfield","4","101","Colorado","4/18/20","74","27","08014","36.49"
"Chaffee","1","37","Colorado","4/18/20","28","9","08015","32.14"
"Clear Creek","0","11","Colorado","4/18/20","11","0","08019","0"
"Costilla","0","3","Colorado","4/18/20","3","0","08023","0"
"Crowley","0","2","Colorado","4/18/20","2","0","08025","0"
"Custer","0","2","Colorado","4/18/20","2","0","08027","0"
"Delta","2","19","Colorado","4/18/20","6","13","08029","216.67"
"Denver","77","1723","Colorado","4/18/20","1182","541","08031","45.77"
"Douglas","10","360","Colorado","4/18/20","292","68","08035","23.29"
"Eagle","7","483","Colorado","4/18/20","433","50","08037","11.55"
"El Paso","20","721","Colorado","4/18/20","578","143","08041","24.74"
"Elbert","1","23","Colorado","4/18/20","14","9","08039","64.29"
"Fremont","0","9","Colorado","4/18/20","6","3","08043","50"
"Garfield","2","70","Colorado","4/18/20","54","16","08045","29.63"
"Gilpin","0","1","Colorado","4/18/20","1","0","08047","0"
"Grand","0","4","Colorado","4/18/20","4","0","08049","0"
"Gunnison","2","114","Colorado","4/18/20","102","12","08051","11.76"
"Hinsdale","0","3","Colorado","4/18/20","1","2","08053","200"
"Huerfano","0","1","Colorado","4/18/20","1","0","08055","0"
"Jefferson","31","930","Colorado","4/18/20","713","217","08059","30.43"
"Kit Carson","1","14","Colorado","4/18/20","7","7","08063","100"
"La Plata","1","52","Colorado","4/18/20","43","9","08067","20.93"
"Lake","1","8","Colorado","4/18/20","4","4","08065","100"
"Larimer","7","231","Colorado","4/18/20","180","51","08069","28.33"
"Las Animas","0","3","Colorado","4/18/20","2","1","08071","50"
"Lincoln","0","3","Colorado","4/18/20","1","2","08073","200"
"Logan","1","17","Colorado","4/18/20","13","4","08075","30.77"
"Mesa","0","34","Colorado","4/18/20","34","0","08077","0"
"Mineral","0","2","Colorado","4/18/20","2","0","08079","0"
"Moffat","0","4","Colorado","4/18/20","3","1","08081","33.33"
"Montezuma","0","13","Colorado","4/18/20","11","2","08083","18.18"
"Montrose","3","72","Colorado","4/18/20","50","22","08085","44"
"Morgan","13","147","Colorado","4/18/20","56","91","08087","162.5"
"Otero","0","6","Colorado","4/18/20","5","1","08089","20"
"Ouray","0","5","Colorado","4/18/20","4","1","08091","25"
"Park","0","6","Colorado","4/18/20","6","0","08093","0"
"Phillips","0","5","Colorado","4/18/20","4","1","08095","25"
"Pitkin","1","57","Colorado","4/18/20","49","8","08097","16.33"
"Prowers","0","1","Colorado","4/18/20","1","0","08099","0"
"Pueblo","4","84","Colorado","4/18/20","53","31","08101","58.49"
"Rio Blanco","0","1","Colorado","4/18/20","1","0","08103","0"
"Rio Grande","0","7","Colorado","4/18/20","5","2","08105","40"
"Routt","2","49","Colorado","4/18/20","35","14","08107","40"
"Saguache","0","3","Colorado","4/18/20","3","0","08109","0"
"San Miguel","0","13","Colorado","4/18/20","12","1","08113","8.33"
"Summit","4","93","Colorado","4/18/20","68","25","08117","36.76"
"Teller","1","18","Colorado","4/18/20","12","6","08119","50"
"Washington","1","6","Colorado","4/18/20","2","4","08121","200"
"Weld","49","1029","Colorado","4/18/20","683","346","08123","50.66"
"Yuma","0","2","Colorado","4/18/20","2","0","08125","0"
"Fairfield","279","7363","Connecticut","4/18/20","5407","1956","09001","36.18"
"Hartford","195","3196","Connecticut","4/18/20","1832","1364","09003","74.45"
"Litchfield","29","593","Connecticut","4/18/20","388","205","09005","52.84"
"Middlesex","23","448","Connecticut","4/18/20","290","158","09007","54.48"
"New Haven","290","4743","Connecticut","4/18/20","2715","2028","09009","74.7"
"New London","19","315","Connecticut","4/18/20","185","130","09011","70.27"
"Tolland","14","270","Connecticut","4/18/20","171","99","09013","57.89"
"Windham","4","97","Connecticut","4/18/20","66","31","09015","46.97"
"Kent","23","417","Delaware","4/18/20","255","162","10001","63.53"
"New Castle","57","1205","Delaware","4/18/20","807","398","10003","49.32"
"Sussex","69","886","Delaware","4/18/20","404","482","10005","119.31"
"","0","49","Diamond Princess","4/18/20","49","0",,"0"
"District of Columbia","127","2666","District of Columbia","4/18/20","1778","888","11001","49.94"
"Alachua","4","205","Florida","4/18/20","174","31","12001","17.82"
"Baker","0","17","Florida","4/18/20","17","0","12003","0"
"Bay","2","48","Florida","4/18/20","36","12","12005","33.33"
"Bradford","3","42","Florida","4/18/20","24","18","12007","75"
"Brevard","13","210","Florida","4/18/20","120","90","12009","75"
"Broward","147","3838","Florida","4/18/20","2806","1032","12011","36.78"
"Calhoun","0","6","Florida","4/18/20","5","1","12013","20"
"Charlotte","4","138","Florida","4/18/20","107","31","12015","28.97"
"Citrus","2","82","Florida","4/18/20","66","16","12017","24.24"
"Clay","9","223","Florida","4/18/20","158","65","12019","41.14"
"Collier","16","457","Florida","4/18/20","344","113","12021","32.85"
"Columbia","2","36","Florida","4/18/20","24","12","12023","50"
"DeSoto","0","23","Florida","4/18/20","20","3","12027","15"
"Dixie","0","3","Florida","4/18/20","2","1","12029","50"
"Duval","29","835","Florida","4/18/20","635","200","12031","31.5"
"Escambia","14","304","Florida","4/18/20","206","98","12033","47.57"
"Flagler","3","66","Florida","4/18/20","44","22","12035","50"
"Franklin","0","2","Florida","4/18/20","2","0","12037","0"
"Gadsden","5","48","Florida","4/18/20","14","34","12039","242.86"
"Gilchrist","0","4","Florida","4/18/20","4","0","12041","0"
"Glades","0","5","Florida","4/18/20","4","1","12043","25"
"Gulf","0","1","Florida","4/18/20","1","0","12045","0"
"Hamilton","0","3","Florida","4/18/20","2","1","12047","50"
"Hardee","0","4","Florida","4/18/20","3","1","12049","33.33"
"Hendry","3","39","Florida","4/18/20","16","23","12051","143.75"
"Hernando","3","84","Florida","4/18/20","65","19","12053","29.23"
"Highlands","2","66","Florida","4/18/20","51","15","12055","29.41"
"Hillsborough","36","943","Florida","4/18/20","690","253","12057","36.67"
"Holmes","0","5","Florida","4/18/20","2","3","12059","150"
"Indian River","2","83","Florida","4/18/20","70","13","12061","18.57"
"Jackson","0","8","Florida","4/18/20","5","3","12063","60"
"Jefferson","2","24","Florida","4/18/20","9","15","12065","166.67"
"Lafayette","0","1","Florida","4/18/20","1","0","12067","0"
"Lake","8","203","Florida","4/18/20","149","54","12069","36.24"
"Lee","22","739","Florida","4/18/20","584","155","12071","26.54"
"Leon","8","169","Florida","4/18/20","112","57","12073","50.89"
"Levy","1","11","Florida","4/18/20","6","5","12075","83.33"
"Liberty","0","2","Florida","4/18/20","1","1","12077","100"
"Madison","1","20","Florida","4/18/20","14","6","12079","42.86"
"Manatee","23","362","Florida","4/18/20","203","159","12081","78.33"
"Marion","5","118","Florida","4/18/20","83","35","12083","42.17"
"Martin","5","148","Florida","4/18/20","115","33","12085","28.7"
"Miami-Dade","365","9045","Florida","4/18/20","6487","2558","12086","39.43"
"Monroe","2","73","Florida","4/18/20","58","15","12087","25.86"
"Nassau","1","42","Florida","4/18/20","33","9","12089","27.27"
"Okaloosa","5","127","Florida","4/18/20","91","36","12091","39.56"
"Okeechobee","0","6","Florida","4/18/20","5","1","12093","20"
"Orange","38","1180","Florida","4/18/20","914","266","12095","29.1"
"Osceola","12","403","Florida","4/18/20","317","86","12097","27.13"
"Palm Beach","100","2138","Florida","4/18/20","1441","697","12099","48.37"
"Pasco","7","198","Florida","4/18/20","148","50","12101","33.78"
"Pinellas","20","587","Florida","4/18/20","444","143","12103","32.21"
"Polk","11","320","Florida","4/18/20","242","78","12105","32.23"
"Putnam","4","55","Florida","4/18/20","29","26","12107","89.66"
"Santa Rosa","4","133","Florida","4/18/20","105","28","12113","26.67"
"Sarasota","9","279","Florida","4/18/20","219","60","12115","27.4"
"Seminole","10","315","Florida","4/18/20","242","73","12117","30.17"
"St. Johns","3","188","Florida","4/18/20","167","21","12109","12.57"
"St. Lucie","7","196","Florida","4/18/20","148","48","12111","32.43"
"Sumter","5","144","Florida","4/18/20","107","37","12119","34.58"
"Suwannee","3","90","Florida","4/18/20","66","24","12121","36.36"
"Taylor","0","1","Florida","4/18/20","1","0","12123","0"
"Union","0","2","Florida","4/18/20","2","0","12125","0"
"Volusia","14","291","Florida","4/18/20","195","96","12127","49.23"
"Wakulla","1","14","Florida","4/18/20","7","7","12129","100"
"Walton","1","32","Florida","4/18/20","27","5","12131","18.52"
"Washington","0","5","Florida","4/18/20","3","2","12133","66.67"
"Appling","1","18","Georgia","4/18/20","9","9","13001","100"
"Atkinson","0","5","Georgia","4/18/20","2","3","13003","150"
"Bacon","0","17","Georgia","4/18/20","14","3","13005","21.43"
"Baker","1","16","Georgia","4/18/20","12","4","13007","33.33"
"Baldwin","9","108","Georgia","4/18/20","44","64","13009","145.45"
"Banks","1","13","Georgia","4/18/20","7","6","13011","85.71"
"Barrow","5","87","Georgia","4/18/20","51","36","13013","70.59"
"Bartow","5","246","Georgia","4/18/20","209","37","13015","17.7"
"Ben Hill","1","13","Georgia","4/18/20","8","5","13017","62.5"
"Berrien","1","10","Georgia","4/18/20","6","4","13019","66.67"
"Bibb","18","192","Georgia","4/18/20","63","129","13021","204.76"
"Bleckley","1","6","Georgia","4/18/20","1","5","13023","500"
"Brantley","2","18","Georgia","4/18/20","7","11","13025","157.14"
"Brooks","1","23","Georgia","4/18/20","18","5","13027","27.78"
"Bryan","0","31","Georgia","4/18/20","28","3","13029","10.71"
"Bulloch","1","26","Georgia","4/18/20","16","10","13031","62.5"
"Burke","2","41","Georgia","4/18/20","28","13","13033","46.43"
"Butts","2","41","Georgia","4/18/20","27","14","13035","51.85"
"Calhoun","2","57","Georgia","4/18/20","41","16","13037","39.02"
"Camden","1","27","Georgia","4/18/20","20","7","13039","35"
"Candler","0","5","Georgia","4/18/20","4","1","13043","25"
"Carroll","10","270","Georgia","4/18/20","201","69","13045","34.33"
"Catoosa","1","19","Georgia","4/18/20","12","7","13047","58.33"
"Charlton","0","5","Georgia","4/18/20","2","3","13049","150"
"Chatham","5","177","Georgia","4/18/20","142","35","13051","24.65"
"Chattahoochee","0","6","Georgia","4/18/20","3","3","13053","100"
"Chattooga","1","9","Georgia","4/18/20","5","4","13055","80"
"Cherokee","13","276","Georgia","4/18/20","182","94","13057","51.65"
"Clarke","3","106","Georgia","4/18/20","82","24","13059","29.27"
"Clay","1","20","Georgia","4/18/20","15","5","13061","33.33"
"Clayton","25","505","Georgia","4/18/20","331","174","13063","52.57"
"Clinch","1","7","Georgia","4/18/20","3","4","13065","133.33"
"Cobb","58","1100","Georgia","4/18/20","696","404","13067","58.05"
"Coffee","3","75","Georgia","4/18/20","53","22","13069","41.51"
"Colquitt","6","119","Georgia","4/18/20","80","39","13071","48.75"
"Columbia","4","97","Georgia","4/18/20","66","31","13073","46.97"
"Cook","1","12","Georgia","4/18/20","6","6","13075","100"
"Coweta","8","156","Georgia","4/18/20","101","55","13077","54.46"
"Crawford","1","13","Georgia","4/18/20","3","10","13079","333.33"
"Crisp","7","114","Georgia","4/18/20","67","47","13081","70.15"
"Dade","1","8","Georgia","4/18/20","2","6","13083","300"
"Dawson","2","42","Georgia","4/18/20","25","17","13085","68"
"Decatur","4","55","Georgia","4/18/20","27","28","13087","103.7"
"DeKalb","80","1396","Georgia","4/18/20","835","561","13089","67.19"
"Dodge","1","19","Georgia","4/18/20","9","10","13091","111.11"
"Dooly","4","69","Georgia","4/18/20","40","29","13093","72.5"
"Dougherty","47","1406","Georgia","4/18/20","1076","330","13095","30.67"
"Douglas","11","226","Georgia","4/18/20","147","79","13097","53.74"
"Early","8","165","Georgia","4/18/20","106","59","13099","55.66"
"Echols","0","4","Georgia","4/18/20","2","2","13101","100"
"Effingham","1","25","Georgia","4/18/20","20","5","13103","25"
"Elbert","1","7","Georgia","4/18/20","3","4","13105","133.33"
"Emanuel","1","12","Georgia","4/18/20","7","5","13107","71.43"
"Evans","0","2","Georgia","4/18/20","0","2","13109","1"
"Fannin","1","15","Georgia","4/18/20","9","6","13111","66.67"
"Fayette","6","135","Georgia","4/18/20","94","41","13113","43.62"
"Floyd","2","121","Georgia","4/18/20","105","16","13115","15.24"
"Forsyth","10","188","Georgia","4/18/20","121","67","13117","55.37"
"Franklin","1","10","Georgia","4/18/20","4","6","13119","150"
"Fulton","90","2054","Georgia","4/18/20","1422","632","13121","44.44"
"Gilmer","1","10","Georgia","4/18/20","6","4","13123","66.67"
"Glynn","2","48","Georgia","4/18/20","33","15","13127","45.45"
"Gordon","4","57","Georgia","4/18/20","29","28","13129","96.55"
"Grady","2","27","Georgia","4/18/20","15","12","13131","80"
"Greene","2","42","Georgia","4/18/20","25","17","13133","68"
"Gwinnett","54","1050","Georgia","4/18/20","675","375","13135","55.56"
"Habersham","8","72","Georgia","4/18/20","14","58","13137","414.29"
"Hall","47","607","Georgia","4/18/20","275","332","13139","120.73"
"Hancock","0","6","Georgia","4/18/20","3","3","13141","100"
"Haralson","1","20","Georgia","4/18/20","15","5","13143","33.33"
"Harris","3","37","Georgia","4/18/20","19","18","13145","94.74"
"Hart","0","5","Georgia","4/18/20","3","2","13147","66.67"
"Heard","1","7","Georgia","4/18/20","3","4","13149","133.33"
"Henry","15","353","Georgia","4/18/20","249","104","13151","41.77"
"Houston","7","164","Georgia","4/18/20","113","51","13153","45.13"
"Irwin","1","15","Georgia","4/18/20","11","4","13155","36.36"
"Jackson","3","47","Georgia","4/18/20","26","21","13157","80.77"
"Jasper","1","14","Georgia","4/18/20","6","8","13159","133.33"
"Jeff Davis","1","5","Georgia","4/18/20","1","4","13161","400"
"Jefferson","1","11","Georgia","4/18/20","6","5","13163","83.33"
"Jenkins","0","12","Georgia","4/18/20","9","3","13165","33.33"
"Johnson","3","33","Georgia","4/18/20","15","18","13167","120"
"Jones","1","16","Georgia","4/18/20","11","5","13169","45.45"
"Lamar","1","24","Georgia","4/18/20","15","9","13171","60"
"Lanier","0","6","Georgia","4/18/20","5","1","13173","20"
"Laurens","2","41","Georgia","4/18/20","28","13","13175","46.43"
"Lee","5","272","Georgia","4/18/20","234","38","13177","16.24"
"Liberty","2","32","Georgia","4/18/20","16","16","13179","100"
"Lincoln","0","9","Georgia","4/18/20","8","1","13181","12.5"
"Long","0","2","Georgia","4/18/20","1","1","13183","100"
"Lowndes","4","87","Georgia","4/18/20","59","28","13185","47.46"
"Lumpkin","2","22","Georgia","4/18/20","9","13","13187","144.44"
"Macon","4","47","Georgia","4/18/20","19","28","13193","147.37"
"Madison","1","14","Georgia","4/18/20","10","4","13195","40"
"Marion","2","26","Georgia","4/18/20","10","16","13197","160"
"McDuffie","2","37","Georgia","4/18/20","20","17","13189","85"
"McIntosh","0","4","Georgia","4/18/20","3","1","13191","33.33"
"Meriwether","3","40","Georgia","4/18/20","22","18","13199","81.82"
"Miller","1","20","Georgia","4/18/20","10","10","13201","100"
"Mitchell","11","212","Georgia","4/18/20","135","77","13205","57.04"
"Monroe","0","15","Georgia","4/18/20","12","3","13207","25"
"Montgomery","0","2","Georgia","4/18/20","0","2","13209","1"
"Morgan","1","21","Georgia","4/18/20","14","7","13211","50"
"Murray","1","18","Georgia","4/18/20","14","4","13213","28.57"
"Muscogee","10","211","Georgia","4/18/20","144","67","13215","46.53"
"Newton","6","121","Georgia","4/18/20","77","44","13217","57.14"
"Oconee","2","48","Georgia","4/18/20","36","12","13219","33.33"
"Oglethorpe","3","32","Georgia","4/18/20","12","20","13221","166.67"
"Out of GA","116","815","Georgia","4/18/20","0","815","80013","1"
"Paulding","8","132","Georgia","4/18/20","76","56","13223","73.68"
"Peach","2","32","Georgia","4/18/20","21","11","13225","52.38"
"Pickens","1","16","Georgia","4/18/20","10","6","13227","60"
"Pierce","1","51","Georgia","4/18/20","45","6","13229","13.33"
"Pike","2","30","Georgia","4/18/20","15","15","13231","100"
"Polk","1","29","Georgia","4/18/20","21","8","13233","38.1"
"Pulaski","1","16","Georgia","4/18/20","9","7","13235","77.78"
"Putnam","2","18","Georgia","4/18/20","5","13","13237","260"
"Quitman","0","3","Georgia","4/18/20","3","0","13239","0"
"Rabun","0","7","Georgia","4/18/20","6","1","13241","16.67"
"Randolph","5","141","Georgia","4/18/20","103","38","13243","36.89"
"Richmond","17","258","Georgia","4/18/20","138","120","13245","86.96"
"Rockdale","4","119","Georgia","4/18/20","91","28","13247","30.77"
"Schley","0","15","Georgia","4/18/20","12","3","13249","25"
"Screven","1","11","Georgia","4/18/20","5","6","13251","120"
"Seminole","1","20","Georgia","4/18/20","14","6","13253","42.86"
"Spalding","9","126","Georgia","4/18/20","65","61","13255","93.85"
"Stephens","2","30","Georgia","4/18/20","17","13","13257","76.47"
"Stewart","1","15","Georgia","4/18/20","6","9","13259","150"
"Sumter","13","311","Georgia","4/18/20","222","89","13261","40.09"
"Talbot","1","16","Georgia","4/18/20","9","7","13263","77.78"
"Tattnall","0","5","Georgia","4/18/20","3","2","13267","66.67"
"Taylor","0","10","Georgia","4/18/20","7","3","13269","42.86"
"Telfair","1","14","Georgia","4/18/20","9","5","13271","55.56"
"Terrell","6","145","Georgia","4/18/20","104","41","13273","39.42"
"Thomas","6","115","Georgia","4/18/20","74","41","13275","55.41"
"Tift","4","82","Georgia","4/18/20","57","25","13277","43.86"
"Toombs","1","20","Georgia","4/18/20","11","9","13279","81.82"
"Towns","1","10","Georgia","4/18/20","3","7","13281","233.33"
"Treutlen","0","1","Georgia","4/18/20","1","0","13283","0"
"Troup","4","82","Georgia","4/18/20","55","27","13285","49.09"
"Turner","3","51","Georgia","4/18/20","29","22","13287","75.86"
"Twiggs","0","4","Georgia","4/18/20","2","2","13289","100"
"Union","0","10","Georgia","4/18/20","7","3","13291","42.86"
"Upson","17","170","Georgia","4/18/20","51","119","13293","233.33"
"Walker","1","13","Georgia","4/18/20","6","7","13295","116.67"
"Walton","3","58","Georgia","4/18/20","36","22","13297","61.11"
"Ware","4","80","Georgia","4/18/20","50","30","13299","60"
"Warren","1","10","Georgia","4/18/20","6","4","13301","66.67"
"Washington","0","24","Georgia","4/18/20","21","3","13303","14.29"
"Wayne","0","7","Georgia","4/18/20","4","3","13305","75"
"Webster","0","5","Georgia","4/18/20","3","2","13307","66.67"
"Wheeler","0","3","Georgia","4/18/20","2","1","13309","50"
"White","1","20","Georgia","4/18/20","11","9","13311","81.82"
"Whitfield","3","43","Georgia","4/18/20","24","19","13313","79.17"
"Wilcox","5","40","Georgia","4/18/20","5","35","13315","700"
"Wilkes","1","11","Georgia","4/18/20","6","5","13317","83.33"
"Wilkinson","1","20","Georgia","4/18/20","10","10","13319","100"
"Worth","6","119","Georgia","4/18/20","78","41","13321","52.56"
"","0","103","Grand Princess","4/18/20","103","0",,"0"
"","0","136","Guam","4/18/20","133","3",,"2.26"
"Hawaii","4","61","Hawaii","4/18/20","31","30","15001","96.77"
"Honolulu","6","382","Hawaii","4/18/20","343","39","15003","11.37"
"Kauai","0","21","Hawaii","4/18/20","19","2","15007","10.53"
"Maui","5","104","Hawaii","4/18/20","66","38","15009","57.58"
"Out of HI","1","6","Hawaii","4/18/20","2","4","80015","200"
"Ada","11","593","Idaho","4/18/20","513","80","16001","15.59"
"Adams","0","1","Idaho","4/18/20","1","0","16003","0"
"Bannock","0","8","Idaho","4/18/20","5","3","16005","60"
"Bingham","0","3","Idaho","4/18/20","2","1","16011","50"
"Blaine","3","475","Idaho","4/18/20","452","23","16013","5.09"
"Bonner","0","4","Idaho","4/18/20","4","0","16017","0"
"Bonneville","2","24","Idaho","4/18/20","11","13","16019","118.18"
"Camas","0","1","Idaho","4/18/20","1","0","16025","0"
"Canyon","6","187","Idaho","4/18/20","145","42","16027","28.97"
"Caribou","0","1","Idaho","4/18/20","1","0","16029","0"
"Cassia","0","10","Idaho","4/18/20","7","3","16031","42.86"
"Custer","0","2","Idaho","4/18/20","2","0","16037","0"
"Elmore","1","21","Idaho","4/18/20","16","5","16039","31.25"
"Fremont","0","2","Idaho","4/18/20","2","0","16043","0"
"Gem","0","10","Idaho","4/18/20","9","1","16045","11.11"
"Gooding","0","7","Idaho","4/18/20","5","2","16047","40"
"Idaho","0","3","Idaho","4/18/20","3","0","16049","0"
"Jefferson","0","5","Idaho","4/18/20","4","1","16051","25"
"Jerome","2","44","Idaho","4/18/20","28","16","16053","57.14"
"Kootenai","1","50","Idaho","4/18/20","44","6","16055","13.64"
"Latah","0","3","Idaho","4/18/20","3","0","16057","0"
"Lincoln","0","16","Idaho","4/18/20","14","2","16063","14.29"
"Madison","0","8","Idaho","4/18/20","5","3","16065","60"
"Minidoka","1","10","Idaho","4/18/20","4","6","16067","150"
"Nez Perce","2","30","Idaho","4/18/20","19","11","16069","57.89"
"Owyhee","0","4","Idaho","4/18/20","4","0","16073","0"
"Payette","0","10","Idaho","4/18/20","8","2","16075","25"
"Power","0","2","Idaho","4/18/20","2","0","16077","0"
"Teton","0","8","Idaho","4/18/20","6","2","16081","33.33"
"Twin Falls","5","110","Idaho","4/18/20","73","37","16083","50.68"
"Valley","0","2","Idaho","4/18/20","2","0","16085","0"
"Washington","0","1","Idaho","4/18/20","1","0","16087","0"
"Adams","1","31","Illinois","4/18/20","25","6","17001","24"
"Alexander","0","1","Illinois","4/18/20","0","1","17003","1"
"Bond","0","4","Illinois","4/18/20","4","0","17005","0"
"Boone","3","29","Illinois","4/18/20","7","22","17007","314.29"
"Bureau","0","8","Illinois","4/18/20","5","3","17011","60"
"Calhoun","0","1","Illinois","4/18/20","1","0","17013","0"
"Carroll","0","6","Illinois","4/18/20","5","1","17015","20"
"Champaign","1","93","Illinois","4/18/20","85","8","17019","9.41"
"Christian","0","25","Illinois","4/18/20","24","1","17021","4.17"
"Clark","0","4","Illinois","4/18/20","3","1","17023","33.33"
"Clay","0","1","Illinois","4/18/20","0","1","17025","1"
"Clinton","1","44","Illinois","4/18/20","37","7","17027","18.92"
"Coles","1","14","Illinois","4/18/20","5","9","17029","180"
"Cook","997","20395","Illinois","4/18/20","13417","6978","17031","52.01"
"Crawford","0","5","Illinois","4/18/20","4","1","17033","25"
"Cumberland","0","2","Illinois","4/18/20","2","0","17035","0"
"De Witt","0","1","Illinois","4/18/20","1","0","17039","0"
"DeKalb","3","54","Illinois","4/18/20","33","21","17037","63.64"
"Douglas","0","12","Illinois","4/18/20","11","1","17041","9.09"
"DuPage","85","1642","Illinois","4/18/20","1048","594","17043","56.68"
"Effingham","0","4","Illinois","4/18/20","3","1","17049","33.33"
"Fayette","1","13","Illinois","4/18/20","9","4","17051","44.44"
"Ford","0","5","Illinois","4/18/20","4","1","17053","25"
"Franklin","0","5","Illinois","4/18/20","3","2","17055","66.67"
"Fulton","0","1","Illinois","4/18/20","1","0","17057","0"
"Gallatin","0","2","Illinois","4/18/20","1","1","17059","100"
"Greene","0","1","Illinois","4/18/20","1","0","17061","0"
"Grundy","1","26","Illinois","4/18/20","17","9","17063","52.94"
"Hamilton","0","1","Illinois","4/18/20","0","1","17065","1"
"Hancock","0","3","Illinois","4/18/20","1","2","17067","200"
"Henderson","0","2","Illinois","4/18/20","0","2","17071","1"
"Henry","1","30","Illinois","4/18/20","22","8","17073","36.36"
"Iroquois","1","12","Illinois","4/18/20","8","4","17075","50"
"Jackson","2","42","Illinois","4/18/20","30","12","17077","40"
"Jasper","1","7","Illinois","4/18/20","3","4","17079","133.33"
"Jefferson","1","12","Illinois","4/18/20","6","6","17081","100"
"Jersey","0","8","Illinois","4/18/20","6","2","17083","33.33"
"Jo Daviess","0","12","Illinois","4/18/20","10","2","17085","20"
"Johnson","0","2","Illinois","4/18/20","0","2","17087","1"
"Kane","29","582","Illinois","4/18/20","376","206","17089","54.79"
"Kankakee","12","272","Illinois","4/18/20","185","87","17091","47.03"
"Kendall","5","135","Illinois","4/18/20","103","32","17093","31.07"
"Knox","0","5","Illinois","4/18/20","2","3","17095","150"
"Lake","106","2073","Illinois","4/18/20","1331","742","17097","55.75"
"LaSalle","1","27","Illinois","4/18/20","18","9","17099","50"
"Lawrence","0","2","Illinois","4/18/20","2","0","17101","0"
"Lee","1","17","Illinois","4/18/20","12","5","17103","41.67"
"Livingston","0","17","Illinois","4/18/20","15","2","17105","13.33"
"Logan","0","4","Illinois","4/18/20","3","1","17107","33.33"
"Macon","5","55","Illinois","4/18/20","23","32","17115","139.13"
"Macoupin","1","21","Illinois","4/18/20","14","7","17117","50"
"Madison","9","169","Illinois","4/18/20","103","66","17119","64.08"
"Marion","1","19","Illinois","4/18/20","13","6","17121","46.15"
"Marshall","0","3","Illinois","4/18/20","1","2","17123","200"
"Mason","0","4","Illinois","4/18/20","3","1","17125","33.33"
"Massac","0","3","Illinois","4/18/20","2","1","17127","50"
"McDonough","0","3","Illinois","4/18/20","1","2","17109","200"
"McHenry","17","340","Illinois","4/18/20","220","120","17111","54.55"
"McLean","1","83","Illinois","4/18/20","75","8","17113","10.67"
"Menard","0","3","Illinois","4/18/20","2","1","17129","50"
"Mercer","0","5","Illinois","4/18/20","2","3","17131","150"
"Monroe","1","52","Illinois","4/18/20","43","9","17133","20.93"
"Montgomery","1","13","Illinois","4/18/20","8","5","17135","62.5"
"Morgan","0","12","Illinois","4/18/20","10","2","17137","20"
"Moultrie","0","2","Illinois","4/18/20","3","-1","17139","-33.33"
"Ogle","5","48","Illinois","4/18/20","16","32","17141","200"
"Peoria","2","37","Illinois","4/18/20","23","14","17143","60.87"
"Perry","0","1","Illinois","4/18/20","1","0","17145","0"
"Piatt","0","7","Illinois","4/18/20","6","1","17147","16.67"
"Pike","0","1","Illinois","4/18/20","1","0","17149","0"
"Pulaski","1","9","Illinois","4/18/20","4","5","17153","125"
"Randolph","2","54","Illinois","4/18/20","37","17","17157","45.95"
"Richland","0","2","Illinois","4/18/20","1","1","17159","100"
"Rock Island","15","187","Illinois","4/18/20","84","103","17161","122.62"
"Saline","0","3","Illinois","4/18/20","3","0","17165","0"
"Sangamon","3","61","Illinois","4/18/20","43","18","17167","41.86"
"Schuyler","0","1","Illinois","4/18/20","1","0","17169","0"
"Shelby","0","4","Illinois","4/18/20","3","1","17173","33.33"
"St. Clair","13","265","Illinois","4/18/20","173","92","17163","53.18"
"Stark","0","1","Illinois","4/18/20","1","0","17175","0"
"Stephenson","1","12","Illinois","4/18/20","8","4","17177","50"
"Tazewell","3","41","Illinois","4/18/20","18","23","17179","127.78"
"Union","1","5","Illinois","4/18/20","0","5","17181","1"
"Vermilion","0","9","Illinois","4/18/20","7","2","17183","28.57"
"Wabash","0","1","Illinois","4/18/20","2","-1","17185","-50"
"Warren","0","4","Illinois","4/18/20","1","3","17187","300"
"Washington","1","6","Illinois","4/18/20","2","4","17189","200"
"Wayne","0","1","Illinois","4/18/20","0","1","17191","1"
"Whiteside","2","36","Illinois","4/18/20","25","11","17195","44"
"Will","68","1603","Illinois","4/18/20","1126","477","17197","42.36"
"Williamson","0","13","Illinois","4/18/20","10","3","17199","30"
"Winnebago","13","172","Illinois","4/18/20","80","92","17201","115"
"Woodford","1","11","Illinois","4/18/20","7","4","17203","57.14"
"Adams","0","7","Indiana","4/18/20","4","3","18001","75"
"Allen","22","293","Indiana","4/18/20","136","157","18003","115.44"
"Bartholomew","3","131","Indiana","4/18/20","108","23","18005","21.3"
"Benton","1","4","Indiana","4/18/20","0","4","18007","1"
"Blackford","0","6","Indiana","4/18/20","5","1","18009","20"
"Boone","7","151","Indiana","4/18/20","103","48","18011","46.6"
"Brown","0","14","Indiana","4/18/20","12","2","18013","16.67"
"Carroll","0","6","Indiana","4/18/20","5","1","18015","20"
"Cass","4","52","Indiana","4/18/20","23","29","18017","126.09"
"Clark","8","160","Indiana","4/18/20","106","54","18019","50.94"
"Clay","1","15","Indiana","4/18/20","11","4","18021","36.36"
"Clinton","1","16","Indiana","4/18/20","11","5","18023","45.45"
"Crawford","0","12","Indiana","4/18/20","12","0","18025","0"
"Daviess","3","29","Indiana","4/18/20","9","20","18027","222.22"
"Dearborn","1","65","Indiana","4/18/20","59","6","18029","10.17"
"Decatur","6","166","Indiana","4/18/20","123","43","18031","34.96"
"DeKalb","1","13","Indiana","4/18/20","5","8","18033","160"
"Delaware","4","92","Indiana","4/18/20","63","29","18035","46.03"
"Dubois","0","14","Indiana","4/18/20","11","3","18037","27.27"
"Elkhart","11","148","Indiana","4/18/20","71","77","18039","108.45"
"Fayette","0","21","Indiana","4/18/20","20","1","18041","5"
"Floyd","5","137","Indiana","4/18/20","105","32","18043","30.48"
"Fountain","0","5","Indiana","4/18/20","3","2","18045","66.67"
"Franklin","3","89","Indiana","4/18/20","67","22","18047","32.84"
"Fulton","0","5","Indiana","4/18/20","3","2","18049","66.67"
"Gibson","0","5","Indiana","4/18/20","4","1","18051","25"
"Grant","3","55","Indiana","4/18/20","35","20","18053","57.14"
"Greene","4","42","Indiana","4/18/20","14","28","18055","200"
"Hamilton","17","563","Indiana","4/18/20","443","120","18057","27.09"
"Hancock","3","135","Indiana","4/18/20","112","23","18059","20.54"
"Harrison","4","85","Indiana","4/18/20","54","31","18061","57.41"
"Hendricks","19","435","Indiana","4/18/20","301","134","18063","44.52"
"Henry","1","29","Indiana","4/18/20","22","7","18065","31.82"
"Howard","3","68","Indiana","4/18/20","46","22","18067","47.83"
"Huntington","0","6","Indiana","4/18/20","6","0","18069","0"
"Jackson","3","84","Indiana","4/18/20","64","20","18071","31.25"
"Jasper","1","21","Indiana","4/18/20","16","5","18073","31.25"
"Jay","1","8","Indiana","4/18/20","4","4","18075","100"
"Jefferson","1","18","Indiana","4/18/20","13","5","18077","38.46"
"Jennings","1","63","Indiana","4/18/20","54","9","18079","16.67"
"Johnson","15","393","Indiana","4/18/20","287","106","18081","36.93"
"Knox","1","17","Indiana","4/18/20","13","4","18083","30.77"
"Kosciusko","1","22","Indiana","4/18/20","17","5","18085","29.41"
"LaGrange","1","15","Indiana","4/18/20","10","5","18087","50"
"Lake","60","1095","Indiana","4/18/20","676","419","18089","61.98"
"LaPorte","15","134","Indiana","4/18/20","31","103","18091","332.26"
"Lawrence","2","77","Indiana","4/18/20","63","14","18093","22.22"
"Madison","13","323","Indiana","4/18/20","235","88","18095","37.45"
"Marion","126","3624","Indiana","4/18/20","2742","882","18097","32.17"
"Marshall","1","22","Indiana","4/18/20","14","8","18099","57.14"
"Martin","0","5","Indiana","4/18/20","2","3","18101","150"
"Miami","1","21","Indiana","4/18/20","15","6","18103","40"
"Monroe","5","113","Indiana","4/18/20","75","38","18105","50.67"
"Montgomery","1","25","Indiana","4/18/20","21","4","18107","19.05"
"Morgan","2","111","Indiana","4/18/20","94","17","18109","18.09"
"Newton","3","31","Indiana","4/18/20","9","22","18111","244.44"
"Noble","3","34","Indiana","4/18/20","14","20","18113","142.86"
"Ohio","0","1","Indiana","4/18/20","1","0","18115","0"
"Orange","1","25","Indiana","4/18/20","16","9","18117","56.25"
"Owen","0","21","Indiana","4/18/20","18","3","18119","16.67"
"Parke","0","7","Indiana","4/18/20","7","0","18121","0"
"Perry","0","5","Indiana","4/18/20","3","2","18123","66.67"
"Pike","0","1","Indiana","4/18/20","0","1","18125","1"
"Porter","9","168","Indiana","4/18/20","107","61","18127","57.01"
"Posey","0","6","Indiana","4/18/20","5","1","18129","20"
"Pulaski","0","1","Indiana","4/18/20","1","0","18131","0"
"Putnam","3","50","Indiana","4/18/20","32","18","18133","56.25"
"Randolph","1","12","Indiana","4/18/20","8","4","18135","50"
"Ripley","0","80","Indiana","4/18/20","81","-1","18137","-1.23"
"Rush","1","19","Indiana","4/18/20","13","6","18139","46.15"
"Scott","1","22","Indiana","4/18/20","14","8","18143","57.14"
"Shelby","4","99","Indiana","4/18/20","68","31","18145","45.59"
"Spencer","0","4","Indiana","4/18/20","2","2","18147","100"
"St. Joseph","29","388","Indiana","4/18/20","186","202","18141","108.6"
"Starke","0","11","Indiana","4/18/20","8","3","18149","37.5"
"Steuben","1","17","Indiana","4/18/20","12","5","18151","41.67"
"Sullivan","0","7","Indiana","4/18/20","5","2","18153","40"
"Switzerland","0","13","Indiana","4/18/20","13","0","18155","0"
"Tippecanoe","2","55","Indiana","4/18/20","43","12","18157","27.91"
"Tipton","0","10","Indiana","4/18/20","9","1","18159","11.11"
"Union","0","6","Indiana","4/18/20","5","1","18161","20"
"Vanderburgh","4","80","Indiana","4/18/20","53","27","18163","50.94"
"Vermillion","0","5","Indiana","4/18/20","3","2","18165","66.67"
"Vigo","1","51","Indiana","4/18/20","41","10","18167","24.39"
"Wabash","0","9","Indiana","4/18/20","7","2","18169","28.57"
"Warren","1","6","Indiana","4/18/20","2","4","18171","200"
"Warrick","3","55","Indiana","4/18/20","34","21","18173","61.76"
"Washington","1","28","Indiana","4/18/20","23","5","18175","21.74"
"Wayne","1","23","Indiana","4/18/20","17","6","18177","35.29"
"Wells","0","5","Indiana","4/18/20","3","2","18179","66.67"
"White","0","6","Indiana","4/18/20","3","3","18181","100"
"Whitley","1","15","Indiana","4/18/20","11","4","18183","36.36"
"Adair","0","1","Iowa","4/18/20","1","0","19001","0"
"Allamakee","2","34","Iowa","4/18/20","21","13","19005","61.9"
"Appanoose","0","2","Iowa","4/18/20","1","1","19007","100"
"Audubon","0","1","Iowa","4/18/20","1","0","19009","0"
"Benton","1","21","Iowa","4/18/20","16","5","19011","31.25"
"Black Hawk","18","166","Iowa","4/18/20","41","125","19013","304.88"
"Boone","0","4","Iowa","4/18/20","4","0","19015","0"
"Bremer","3","26","Iowa","4/18/20","3","23","19017","766.67"
"Buchanan","0","8","Iowa","4/18/20","6","2","19019","33.33"
"Buena Vista","0","2","Iowa","4/18/20","2","0","19021","0"
"Butler","0","1","Iowa","4/18/20","1","0","19023","0"
"Carroll","0","1","Iowa","4/18/20","1","0","19027","0"
"Cass","0","1","Iowa","4/18/20","0","1","19029","1"
"Cedar","1","25","Iowa","4/18/20","20","5","19031","25"
"Cerro Gordo","0","14","Iowa","4/18/20","13","1","19033","7.69"
"Chickasaw","0","2","Iowa","4/18/20","2","0","19037","0"
"Clarke","0","3","Iowa","4/18/20","2","1","19039","50"
"Clay","0","2","Iowa","4/18/20","2","0","19041","0"
"Clayton","0","7","Iowa","4/18/20","7","0","19043","0"
"Clinton","2","40","Iowa","4/18/20","28","12","19045","42.86"
"Crawford","0","6","Iowa","4/18/20","6","0","19047","0"
"Dallas","1","45","Iowa","4/18/20","37","8","19049","21.62"
"Delaware","0","2","Iowa","4/18/20","2","0","19055","0"
"Des Moines","1","8","Iowa","4/18/20","3","5","19057","166.67"
"Dickinson","0","1","Iowa","4/18/20","1","0","19059","0"
"Dubuque","2","43","Iowa","4/18/20","32","11","19061","34.38"
"Fayette","0","6","Iowa","4/18/20","4","2","19065","50"
"Franklin","0","1","Iowa","4/18/20","1","0","19069","0"
"Greene","0","1","Iowa","4/18/20","1","0","19073","0"
"Grundy","0","2","Iowa","4/18/20","1","1","19075","100"
"Guthrie","0","4","Iowa","4/18/20","1","3","19077","300"
"Hamilton","0","2","Iowa","4/18/20","2","0","19079","0"
"Hancock","0","3","Iowa","4/18/20","3","0","19081","0"
"Hardin","0","2","Iowa","4/18/20","1","1","19083","100"
"Harrison","0","12","Iowa","4/18/20","12","0","19085","0"
"Henry","1","27","Iowa","4/18/20","19","8","19087","42.11"
"Howard","0","4","Iowa","4/18/20","1","3","19089","300"
"Iowa","0","10","Iowa","4/18/20","7","3","19095","42.86"
"Jackson","0","4","Iowa","4/18/20","4","0","19097","0"
"Jasper","3","33","Iowa","4/18/20","10","23","19099","230"
"Jefferson","0","4","Iowa","4/18/20","4","0","19101","0"
"Johnson","10","265","Iowa","4/18/20","194","71","19103","36.6"
"Jones","1","14","Iowa","4/18/20","8","6","19105","75"
"Keokuk","0","4","Iowa","4/18/20","2","2","19107","100"
"Kossuth","0","1","Iowa","4/18/20","1","0","19109","0"
"Lee","0","3","Iowa","4/18/20","1","2","19111","200"
"Linn","14","332","Iowa","4/18/20","235","97","19113","41.28"
"Louisa","15","177","Iowa","4/18/20","70","107","19115","152.86"
"Lyon","0","5","Iowa","4/18/20","2","3","19119","150"
"Madison","0","3","Iowa","4/18/20","2","1","19121","50"
"Mahaska","0","7","Iowa","4/18/20","4","3","19123","75"
"Marion","0","4","Iowa","4/18/20","3","1","19125","33.33"
"Marshall","8","83","Iowa","4/18/20","28","55","19127","196.43"
"Mills","0","2","Iowa","4/18/20","1","1","19129","100"
"Mitchell","0","2","Iowa","4/18/20","2","0","19131","0"
"Monona","0","6","Iowa","4/18/20","6","0","19133","0"
"Montgomery","0","1","Iowa","4/18/20","1","0","19137","0"
"Muscatine","12","176","Iowa","4/18/20","91","85","19139","93.41"
"O'Brien","0","3","Iowa","4/18/20","3","0","19141","0"
"Osceola","0","3","Iowa","4/18/20","1","2","19143","200"
"Page","0","3","Iowa","4/18/20","3","0","19145","0"
"Plymouth","1","8","Iowa","4/18/20","4","4","19149","100"
"Polk","19","293","Iowa","4/18/20","163","130","19153","79.75"
"Pottawattamie","1","18","Iowa","4/18/20","12","6","19155","50"
"Poweshiek","0","8","Iowa","4/18/20","6","2","19157","33.33"
"Scott","7","159","Iowa","4/18/20","111","48","19163","43.24"
"Shelby","0","9","Iowa","4/18/20","6","3","19165","50"
"Sioux","0","7","Iowa","4/18/20","7","0","19167","0"
"Story","1","17","Iowa","4/18/20","7","10","19169","142.86"
"Tama","7","123","Iowa","4/18/20","77","46","19171","59.74"
"Taylor","0","1","Iowa","4/18/20","1","0","19173","0"
"Union","0","1","Iowa","4/18/20","1","0","19175","0"
"Van Buren","0","8","Iowa","4/18/20","6","2","19177","33.33"
"Wapello","0","7","Iowa","4/18/20","4","3","19179","75"
"Warren","0","18","Iowa","4/18/20","15","3","19181","20"
"Washington","5","113","Iowa","4/18/20","79","34","19183","43.04"
"Webster","0","3","Iowa","4/18/20","2","1","19187","50"
"Winnebago","0","2","Iowa","4/18/20","2","0","19189","0"
"Winneshiek","0","5","Iowa","4/18/20","5","0","19191","0"
"Woodbury","2","35","Iowa","4/18/20","18","17","19193","94.44"
"Worth","0","1","Iowa","4/18/20","1","0","19195","0"
"Wright","0","1","Iowa","4/18/20","1","0","19197","0"
"Anderson","0","0","Kansas","4/18/20","1","-1","20003","-100"
"Atchison","0","4","Kansas","4/18/20","3","1","20005","33.33"
"Barber","0","1","Kansas","4/18/20","1","0","20007","0"
"Barton","0","6","Kansas","4/18/20","4","2","20009","50"
"Bourbon","0","7","Kansas","4/18/20","7","0","20011","0"
"Butler","1","12","Kansas","4/18/20","8","4","20015","50"
"Chase","0","1","Kansas","4/18/20","0","1","20017","1"
"Chautauqua","0","3","Kansas","4/18/20","3","0","20019","0"
"Cherokee","0","7","Kansas","4/18/20","6","1","20021","16.67"
"Clay","0","2","Kansas","4/18/20","1","1","20027","100"
"Cloud","0","3","Kansas","4/18/20","3","0","20029","0"
"Coffey","1","46","Kansas","4/18/20","38","8","20031","21.05"
"Cowley","0","1","Kansas","4/18/20","1","0","20035","0"
"Crawford","0","6","Kansas","4/18/20","6","0","20037","0"
"Dickinson","0","1","Kansas","4/18/20","0","1","20041","1"
"Doniphan","0","1","Kansas","4/18/20","1","0","20043","0"
"Douglas","1","43","Kansas","4/18/20","39","4","20045","10.26"
"Ellis","0","4","Kansas","4/18/20","1","3","20051","300"
"Finney","2","31","Kansas","4/18/20","15","16","20055","106.67"
"Ford","15","107","Kansas","4/18/20","5","102","20057","2040"
"Franklin","0","12","Kansas","4/18/20","12","0","20059","0"
"Geary","1","9","Kansas","4/18/20","5","4","20061","80"
"Gove","0","1","Kansas","4/18/20","1","0","20063","0"
"Greenwood","0","2","Kansas","4/18/20","1","1","20073","100"
"Hamilton","0","1","Kansas","4/18/20","1","0","20075","0"
"Harvey","0","5","Kansas","4/18/20","4","1","20079","25"
"Jackson","0","1","Kansas","4/18/20","1","0","20085","0"
"Jefferson","0","5","Kansas","4/18/20","5","0","20087","0"
"Jewell","0","3","Kansas","4/18/20","2","1","20089","50"
"Johnson","12","369","Kansas","4/18/20","283","86","20091","30.39"
"Labette","0","20","Kansas","4/18/20","18","2","20099","11.11"
"Leavenworth","7","123","Kansas","4/18/20","75","48","20103","64"
"Linn","0","6","Kansas","4/18/20","5","1","20107","20"
"Lyon","4","57","Kansas","4/18/20","27","30","20111","111.11"
"Marion","0","5","Kansas","4/18/20","3","2","20115","66.67"
"McPherson","0","15","Kansas","4/18/20","13","2","20113","15.38"
"Miami","0","4","Kansas","4/18/20","3","1","20121","33.33"
"Mitchell","0","2","Kansas","4/18/20","2","0","20123","0"
"Montgomery","0","12","Kansas","4/18/20","14","-2","20125","-14.29"
"Morris","0","2","Kansas","4/18/20","2","0","20127","0"
"Morton","0","2","Kansas","4/18/20","1","1","20129","100"
"Neosho","0","2","Kansas","4/18/20","2","0","20133","0"
"Osage","0","4","Kansas","4/18/20","3","1","20139","33.33"
"Osborne","0","2","Kansas","4/18/20","2","0","20141","0"
"Ottawa","0","3","Kansas","4/18/20","3","0","20143","0"
"Phillips","0","1","Kansas","4/18/20","1","0","20147","0"
"Pottawatomie","0","6","Kansas","4/18/20","5","1","20149","20"
"Pratt","0","1","Kansas","4/18/20","1","0","20151","0"
"Reno","0","14","Kansas","4/18/20","11","3","20155","27.27"
"Republic","0","4","Kansas","4/18/20","4","0","20157","0"
"Riley","1","27","Kansas","4/18/20","20","7","20161","35"
"Rooks","0","4","Kansas","4/18/20","2","2","20163","100"
"Saline","1","15","Kansas","4/18/20","8","7","20169","87.5"
"Scott","0","1","Kansas","4/18/20","1","0","20171","0"
"Sedgwick","7","238","Kansas","4/18/20","191","47","20173","24.61"
"Seward","5","35","Kansas","4/18/20","3","32","20175","1066.67"
"Shawnee","2","90","Kansas","4/18/20","73","17","20177","23.29"
"Sherman","0","1","Kansas","4/18/20","0","1","20181","1"
"Smith","0","2","Kansas","4/18/20","0","2","20183","1"
"Stafford","0","1","Kansas","4/18/20","1","0","20185","0"
"Stanton","0","3","Kansas","4/18/20","0","3","20187","1"
"Stevens","0","3","Kansas","4/18/20","2","1","20189","50"
"Sumner","0","3","Kansas","4/18/20","2","1","20191","50"
"Wabaunsee","0","1","Kansas","4/18/20","1","0","20197","0"
"Wilson","0","1","Kansas","4/18/20","0","1","20205","1"
"Woodson","0","5","Kansas","4/18/20","3","2","20207","66.67"
"Wyandotte","14","412","Kansas","4/18/20","315","97","20209","30.79"
"Adair","6","47","Kentucky","4/18/20","6","41","21001","683.33"
"Allen","0","4","Kentucky","4/18/20","3","1","21003","33.33"
"Anderson","1","7","Kentucky","4/18/20","3","4","21005","133.33"
"Ballard","0","3","Kentucky","4/18/20","1","2","21007","200"
"Barren","1","6","Kentucky","4/18/20","1","5","21009","500"
"Bath","0","3","Kentucky","4/18/20","1","2","21011","200"
"Boone","7","74","Kentucky","4/18/20","23","51","21015","221.74"
"Bourbon","0","7","Kentucky","4/18/20","4","3","21017","75"
"Boyd","2","29","Kentucky","4/18/20","17","12","21019","70.59"
"Boyle","1","13","Kentucky","4/18/20","9","4","21021","44.44"
"Bracken","1","7","Kentucky","4/18/20","1","6","21023","600"
"Breathitt","0","2","Kentucky","4/18/20","1","1","21025","100"
"Breckinridge","0","6","Kentucky","4/18/20","3","3","21027","100"
"Bullitt","2","31","Kentucky","4/18/20","14","17","21029","121.43"
"Butler","9","62","Kentucky","4/18/20","2","60","21031","3000"
"Caldwell","1","11","Kentucky","4/18/20","5","6","21033","120"
"Calloway","2","21","Kentucky","4/18/20","8","13","21035","162.5"
"Campbell","4","55","Kentucky","4/18/20","29","26","21037","89.66"
"Carroll","0","2","Kentucky","4/18/20","2","0","21041","0"
"Carter","0","4","Kentucky","4/18/20","1","3","21043","300"
"Casey","0","1","Kentucky","4/18/20","0","1","21045","1"
"Christian","5","79","Kentucky","4/18/20","45","34","21047","75.56"
"Clark","1","18","Kentucky","4/18/20","11","7","21049","63.64"
"Clinton","0","2","Kentucky","4/18/20","1","1","21053","100"
"Crittenden","0","3","Kentucky","4/18/20","3","0","21055","0"
"Cumberland","0","2","Kentucky","4/18/20","1","1","21057","100"
"Daviess","4","109","Kentucky","4/18/20","79","30","21059","37.97"
"Edmonson","0","7","Kentucky","4/18/20","5","2","21061","40"
"Fayette","10","218","Kentucky","4/18/20","148","70","21067","47.3"
"Fleming","0","2","Kentucky","4/18/20","0","2","21069","1"
"Floyd","1","4","Kentucky","4/18/20","0","4","21071","1"
"Franklin","2","21","Kentucky","4/18/20","10","11","21073","110"
"Gallatin","0","1","Kentucky","4/18/20","0","1","21077","1"
"Garrard","0","1","Kentucky","4/18/20","0","1","21079","1"
"Grant","2","16","Kentucky","4/18/20","3","13","21081","433.33"
"Graves","5","41","Kentucky","4/18/20","5","36","21083","720"
"Grayson","1","8","Kentucky","4/18/20","2","6","21085","300"
"Green","0","1","Kentucky","4/18/20","1","0","21087","0"
"Greenup","1","10","Kentucky","4/18/20","2","8","21089","400"
"Hancock","1","6","Kentucky","4/18/20","2","4","21091","200"
"Hardin","3","29","Kentucky","4/18/20","9","20","21093","222.22"
"Harrison","0","16","Kentucky","4/18/20","14","2","21097","14.29"
"Hart","0","1","Kentucky","4/18/20","1","0","21099","0"
"Henderson","1","28","Kentucky","4/18/20","23","5","21101","21.74"
"Henry","0","3","Kentucky","4/18/20","3","0","21103","0"
"Hopkins","7","109","Kentucky","4/18/20","57","52","21107","91.23"
"Jackson","6","43","Kentucky","4/18/20","3","40","21109","1333.33"
"Jefferson","44","689","Kentucky","4/18/20","380","309","21111","81.32"
"Jessamine","2","33","Kentucky","4/18/20","18","15","21113","83.33"
"Johnson","0","1","Kentucky","4/18/20","1","0","21115","0"
"Kenton","11","128","Kentucky","4/18/20","54","74","21117","137.04"
"Knott","0","3","Kentucky","4/18/20","0","3","21119","1"
"Knox","1","4","Kentucky","4/18/20","0","4","21121","1"
"Larue","0","5","Kentucky","4/18/20","3","2","21123","66.67"
"Laurel","1","13","Kentucky","4/18/20","5","8","21125","160"
"Lawrence","0","1","Kentucky","4/18/20","1","0","21127","0"
"Leslie","0","2","Kentucky","4/18/20","1","1","21131","100"
"Letcher","0","1","Kentucky","4/18/20","1","0","21133","0"
"Lewis","0","2","Kentucky","4/18/20","2","0","21135","0"
"Lincoln","1","4","Kentucky","4/18/20","0","4","21137","1"
"Livingston","0","1","Kentucky","4/18/20","0","1","21139","1"
"Logan","0","8","Kentucky","4/18/20","5","3","21141","60"
"Lyon","1","13","Kentucky","4/18/20","6","7","21143","116.67"
"Madison","1","21","Kentucky","4/18/20","14","7","21151","50"
"Marion","1","13","Kentucky","4/18/20","4","9","21155","225"
"Marshall","1","12","Kentucky","4/18/20","8","4","21157","50"
"Martin","0","2","Kentucky","4/18/20","1","1","21159","100"
"Mason","0","6","Kentucky","4/18/20","3","3","21161","100"
"McCracken","2","29","Kentucky","4/18/20","16","13","21145","81.25"
"McCreary","1","9","Kentucky","4/18/20","3","6","21147","200"
"McLean","0","7","Kentucky","4/18/20","5","2","21149","40"
"Meade","0","2","Kentucky","4/18/20","2","0","21163","0"
"Menifee","0","3","Kentucky","4/18/20","3","0","21165","0"
"Mercer","1","9","Kentucky","4/18/20","4","5","21167","125"
"Monroe","0","3","Kentucky","4/18/20","2","1","21171","50"
"Montgomery","0","9","Kentucky","4/18/20","7","2","21173","28.57"
"Morgan","0","1","Kentucky","4/18/20","0","1","21175","1"
"Muhlenberg","5","58","Kentucky","4/18/20","26","32","21177","123.08"
"Nelson","1","13","Kentucky","4/18/20","7","6","21179","85.71"
"Nicholas","0","1","Kentucky","4/18/20","1","0","21181","0"
"Ohio","1","13","Kentucky","4/18/20","8","5","21183","62.5"
"Oldham","2","23","Kentucky","4/18/20","11","12","21185","109.09"
"Owsley","0","2","Kentucky","4/18/20","0","2","21189","1"
"Pendleton","0","5","Kentucky","4/18/20","3","2","21191","66.67"
"Perry","0","4","Kentucky","4/18/20","3","1","21193","33.33"
"Pike","1","6","Kentucky","4/18/20","1","5","21195","500"
"Powell","0","1","Kentucky","4/18/20","1","0","21197","0"
"Pulaski","1","35","Kentucky","4/18/20","26","9","21199","34.62"
"Rockcastle","1","11","Kentucky","4/18/20","6","5","21203","83.33"
"Rowan","0","2","Kentucky","4/18/20","0","2","21205","1"
"Russell","1","12","Kentucky","4/18/20","4","8","21207","200"
"Scott","1","23","Kentucky","4/18/20","15","8","21209","53.33"
"Shelby","2","23","Kentucky","4/18/20","11","12","21211","109.09"
"Simpson","1","21","Kentucky","4/18/20","14","7","21213","50"
"Spencer","1","8","Kentucky","4/18/20","3","5","21215","166.67"
"Taylor","0","5","Kentucky","4/18/20","3","2","21217","66.67"
"Todd","1","11","Kentucky","4/18/20","3","8","21219","266.67"
"Trigg","1","4","Kentucky","4/18/20","0","4","21221","1"
"Trimble","0","2","Kentucky","4/18/20","0","2","21223","1"
"Union","1","8","Kentucky","4/18/20","3","5","21225","166.67"
"Warren","9","87","Kentucky","4/18/20","24","63","21227","262.5"
"Washington","0","3","Kentucky","4/18/20","3","0","21229","0"
"Wayne","0","6","Kentucky","4/18/20","4","2","21231","50"
"Webster","1","13","Kentucky","4/18/20","7","6","21233","85.71"
"Whitley","1","8","Kentucky","4/18/20","1","7","21235","700"
"Woodford","1","19","Kentucky","4/18/20","9","10","21239","111.11"
"Acadia","2","110","Louisiana","4/18/20","98","12","22001","12.24"
"Allen","1","79","Louisiana","4/18/20","71","8","22003","11.27"
"Ascension","12","496","Louisiana","4/18/20","415","81","22005","19.52"
"Assumption","5","143","Louisiana","4/18/20","109","34","22007","31.19"
"Avoyelles","1","68","Louisiana","4/18/20","61","7","22009","11.48"
"Beauregard","1","35","Louisiana","4/18/20","27","8","22011","29.63"
"Bienville","5","65","Louisiana","4/18/20","30","35","22013","116.67"
"Bossier","7","230","Louisiana","4/18/20","178","52","22015","29.21"
"Caddo","39","1244","Louisiana","4/18/20","974","270","22017","27.72"
"Calcasieu","9","309","Louisiana","4/18/20","248","61","22019","24.6"
"Caldwell","0","15","Louisiana","4/18/20","18","-3","22021","-16.67"
"Cameron","0","2","Louisiana","4/18/20","2","0","22023","0"
"Catahoula","0","23","Louisiana","4/18/20","20","3","22025","15"
"Claiborne","1","50","Louisiana","4/18/20","41","9","22027","21.95"
"Concordia","1","25","Louisiana","4/18/20","17","8","22029","47.06"
"De Soto","5","152","Louisiana","4/18/20","114","38","22031","33.33"
"East Baton Rouge","45","1476","Louisiana","4/18/20","1158","318","22033","27.46"
"East Carroll","0","1","Louisiana","4/18/20","1","0","22035","0"
"East Feliciana","3","90","Louisiana","4/18/20","67","23","22037","34.33"
"Evangeline","1","43","Louisiana","4/18/20","34","9","22039","26.47"
"Franklin","4","78","Louisiana","4/18/20","47","31","22041","65.96"
"Grant","0","12","Louisiana","4/18/20","11","1","22043","9.09"
"Iberia","7","176","Louisiana","4/18/20","128","48","22045","37.5"
"Iberville","8","270","Louisiana","4/18/20","214","56","22047","26.17"
"Jackson","1","14","Louisiana","4/18/20","8","6","22049","75"
"Jefferson","95","5543","Louisiana","4/18/20","4877","666","22051","13.66"
"Jefferson Davis","3","53","Louisiana","4/18/20","35","18","22053","51.43"
"Lafayette","11","414","Louisiana","4/18/20","337","77","22055","22.85"
"Lafourche","15","560","Louisiana","4/18/20","454","106","22057","23.35"
"LaSalle","0","13","Louisiana","4/18/20","10","3","22059","30"
"Lincoln","2","49","Louisiana","4/18/20","37","12","22061","32.43"
"Livingston","5","144","Louisiana","4/18/20","109","35","22063","32.11"
"Madison","0","4","Louisiana","4/18/20","2","2","22065","100"
"Morehouse","1","35","Louisiana","4/18/20","31","4","22067","12.9"
"Natchitoches","3","53","Louisiana","4/18/20","33","20","22069","60.61"
"Orleans","60","5953","Louisiana","4/18/20","5535","418","22071","7.55"
"Ouachita","19","483","Louisiana","4/18/20","350","133","22073","38"
"Plaquemines","3","156","Louisiana","4/18/20","136","20","22075","14.71"
"Pointe Coupee","3","64","Louisiana","4/18/20","40","24","22077","60"
"Rapides","6","201","Louisiana","4/18/20","159","42","22079","26.42"
"Red River","1","19","Louisiana","4/18/20","9","10","22081","111.11"
"Richland","1","27","Louisiana","4/18/20","19","8","22083","42.11"
"Sabine","1","13","Louisiana","4/18/20","8","5","22085","62.5"
"St. Bernard","7","409","Louisiana","4/18/20","358","51","22087","14.25"
"St. Charles","12","487","Louisiana","4/18/20","401","86","22089","21.45"
"St. Helena","1","19","Louisiana","4/18/20","13","6","22091","46.15"
"St. James","3","217","Louisiana","4/18/20","197","20","22093","10.15"
"St. John the Baptist","14","637","Louisiana","4/18/20","538","99","22095","18.4"
"St. Landry","3","133","Louisiana","4/18/20","109","24","22097","22.02"
"St. Martin","6","187","Louisiana","4/18/20","146","41","22099","28.08"
"St. Mary","5","143","Louisiana","4/18/20","105","38","22101","36.19"
"St. Tammany","20","987","Louisiana","4/18/20","845","142","22103","16.8"
"Tangipahoa","17","440","Louisiana","4/18/20","318","122","22105","38.36"
"Tensas","0","1","Louisiana","4/18/20","1","0","22107","0"
"Terrebonne","9","310","Louisiana","4/18/20","248","62","22109","25"
"Union","4","75","Louisiana","4/18/20","45","30","22111","66.67"
"Vermilion","1","30","Louisiana","4/18/20","24","6","22113","25"
"Vernon","0","14","Louisiana","4/18/20","14","0","22115","0"
"Washington","7","188","Louisiana","4/18/20","142","46","22117","32.39"
"Webster","2","76","Louisiana","4/18/20","60","16","22119","26.67"
"West Baton Rouge","3","86","Louisiana","4/18/20","66","20","22121","30.3"
"West Carroll","0","4","Louisiana","4/18/20","4","0","22123","0"
"West Feliciana","4","74","Louisiana","4/18/20","45","29","22125","64.44"
"Winn","1","16","Louisiana","4/18/20","9","7","22127","77.78"
"Androscoggin","1","35","Maine","4/18/20","27","8","23001","29.63"
"Aroostook","0","2","Maine","4/18/20","2","0","23003","0"
"Cumberland","12","369","Maine","4/18/20","284","85","23005","29.93"
"Franklin","1","11","Maine","4/18/20","7","4","23007","57.14"
"Hancock","0","6","Maine","4/18/20","4","2","23009","50"
"Kennebec","9","96","Maine","4/18/20","31","65","23011","209.68"
"Knox","0","12","Maine","4/18/20","10","2","23013","20"
"Lincoln","0","12","Maine","4/18/20","9","3","23015","33.33"
"Oxford","0","13","Maine","4/18/20","13","0","23017","0"
"Penobscot","1","41","Maine","4/18/20","34","7","23019","20.59"
"Sagadahoc","0","15","Maine","4/18/20","15","0","23023","0"
"Somerset","1","15","Maine","4/18/20","6","9","23025","150"
"Waldo","2","42","Maine","4/18/20","27","15","23027","55.56"
"Washington","0","2","Maine","4/18/20","1","1","23029","100"
"York","5","175","Maine","4/18/20","143","32","23031","22.38"
"Allegany","3","33","Maryland","4/18/20","11","22","24001","200"
"Anne Arundel","56","1005","Maryland","4/18/20","615","390","24003","63.41"
"Baltimore","70","1664","Maryland","4/18/20","1173","491","24005","41.86"
"Baltimore City","89","1378","Maryland","4/18/20","756","622","24510","82.28"
"Calvert","4","109","Maryland","4/18/20","82","27","24009","32.93"
"Caroline","3","33","Maryland","4/18/20","15","18","24011","120"
"Carroll","13","308","Maryland","4/18/20","214","94","24013","43.93"
"Cecil","9","131","Maryland","4/18/20","66","65","24015","98.48"
"Charles","16","347","Maryland","4/18/20","235","112","24017","47.66"
"Dorchester","2","20","Maryland","4/18/20","8","12","24019","150"
"Frederick","31","557","Maryland","4/18/20","341","216","24021","63.34"
"Garrett","0","4","Maryland","4/18/20","4","0","24023","0"
"Harford","11","195","Maryland","4/18/20","120","75","24025","62.5"
"Howard","22","508","Maryland","4/18/20","351","157","24027","44.73"
"Kent","1","16","Maryland","4/18/20","10","6","24029","60"
"Montgomery","124","2404","Maryland","4/18/20","1537","867","24031","56.41"
"Prince George's","177","3160","Maryland","4/18/20","1923","1237","24033","64.33"
"Queen Anne's","1","24","Maryland","4/18/20","19","5","24035","26.32"
"Somerset","1","10","Maryland","4/18/20","4","6","24039","150"
"St. Mary's","7","119","Maryland","4/18/20","73","46","24037","63.01"
"Talbot","0","16","Maryland","4/18/20","13","3","24041","23.08"
"Washington","6","116","Maryland","4/18/20","72","44","24043","61.11"
"Wicomico","15","138","Maryland","4/18/20","33","105","24045","318.18"
"Worcester","2","31","Maryland","4/18/20","19","12","24047","63.16"
"Barnstable","17","599","Massachusetts","4/18/20","480","119","25001","24.79"
"Berkshire","8","392","Massachusetts","4/18/20","336","56","25003","16.67"
"Bristol","77","1733","Massachusetts","4/18/20","1191","542","25005","45.51"
"Dukes and Nantucket","1","25","Massachusetts","4/18/20","21","4","00000","19.05"
"Essex","301","5001","Massachusetts","4/18/20","2896","2105","25009","72.69"
"Franklin","6","182","Massachusetts","4/18/20","138","44","25011","31.88"
"Hampden","105","2283","Massachusetts","4/18/20","1545","738","25013","47.77"
"Hampshire","16","317","Massachusetts","4/18/20","204","113","25015","55.39"
"Middlesex","507","8422","Massachusetts","4/18/20","4872","3550","25017","72.87"
"Norfolk","192","3740","Massachusetts","4/18/20","2395","1345","25021","56.16"
"Plymouth","131","2725","Massachusetts","4/18/20","1809","916","25023","50.64"
"Suffolk","411","7803","Massachusetts","4/18/20","4926","2877","25025","58.4"
"Worcester","168","3000","Massachusetts","4/18/20","1822","1178","25027","64.65"
"Alcona","0","2","Michigan","4/18/20","0","2","26001","1"
"Allegan","3","50","Michigan","4/18/20","26","24","26005","92.31"
"Alpena","0","4","Michigan","4/18/20","1","3","26007","300"
"Antrim","0","9","Michigan","4/18/20","8","1","26009","12.5"
"Arenac","1","11","Michigan","4/18/20","4","7","26011","175"
"Barry","2","25","Michigan","4/18/20","10","15","26015","150"
"Bay","4","88","Michigan","4/18/20","58","30","26017","51.72"
"Benzie","0","2","Michigan","4/18/20","0","2","26019","1"
"Berrien","11","251","Michigan","4/18/20","176","75","26021","42.61"
"Branch","1","38","Michigan","4/18/20","28","10","26023","35.71"
"Calhoun","10","152","Michigan","4/18/20","81","71","26025","87.65"
"Cass","2","31","Michigan","4/18/20","19","12","26027","63.16"
"Charlevoix","0","13","Michigan","4/18/20","11","2","26029","18.18"
"Cheboygan","1","18","Michigan","4/18/20","14","4","26031","28.57"
"Chippewa","0","2","Michigan","4/18/20","0","2","26033","1"
"Clare","1","8","Michigan","4/18/20","4","4","26035","100"
"Clinton","2","108","Michigan","4/18/20","95","13","26037","13.68"
"Crawford","3","28","Michigan","4/18/20","10","18","26039","180"
"Delta","0","13","Michigan","4/18/20","10","3","26041","30"
"Dickinson","0","3","Michigan","4/18/20","3","0","26043","0"
"Eaton","3","97","Michigan","4/18/20","74","23","26045","31.08"
"Emmet","0","25","Michigan","4/18/20","25","0","26047","0"
"Federal Correctional Institution (FCI)","6","45","Michigan","4/18/20","0","45","00000","1"
"Genesee","46","1263","Michigan","4/18/20","941","322","26049","34.22"
"Gladwin","1","9","Michigan","4/18/20","4","5","26051","125"
"Gogebic","0","4","Michigan","4/18/20","4","0","26053","0"
"Grand Traverse","0","19","Michigan","4/18/20","18","1","26055","5.56"
"Gratiot","0","8","Michigan","4/18/20","8","0","26057","0"
"Hillsdale","2","91","Michigan","4/18/20","76","15","26059","19.74"
"Houghton","0","2","Michigan","4/18/20","1","1","26061","100"
"Huron","1","16","Michigan","4/18/20","10","6","26063","60"
"Ingham","9","316","Michigan","4/18/20","250","66","26065","26.4"
"Ionia","1","24","Michigan","4/18/20","14","10","26067","71.43"
"Iosco","1","13","Michigan","4/18/20","6","7","26069","116.67"
"Isabella","2","65","Michigan","4/18/20","50","15","26073","30"
"Jackson","12","246","Michigan","4/18/20","164","82","26075","50"
"Kalamazoo","12","170","Michigan","4/18/20","89","81","26077","91.01"
"Kalkaska","2","26","Michigan","4/18/20","15","11","26079","73.33"
"Kent","33","529","Michigan","4/18/20","295","234","26081","79.32"
"Lake","0","3","Michigan","4/18/20","2","1","26085","50"
"Lapeer","7","149","Michigan","4/18/20","101","48","26087","47.52"
"Leelanau","0","7","Michigan","4/18/20","4","3","26089","75"
"Lenawee","4","78","Michigan","4/18/20","51","27","26091","52.94"
"Livingston","11","320","Michigan","4/18/20","246","74","26093","30.08"
"Luce","0","1","Michigan","4/18/20","1","0","26095","0"
"Mackinac","0","4","Michigan","4/18/20","4","0","26097","0"
"Macomb","155","4257","Michigan","4/18/20","3169","1088","26099","34.33"
"Manistee","0","12","Michigan","4/18/20","10","2","26101","20"
"Marquette","1","29","Michigan","4/18/20","21","8","26103","38.1"
"Mason","0","5","Michigan","4/18/20","3","2","26105","66.67"
"Mecosta","0","15","Michigan","4/18/20","12","3","26107","25"
"Menominee","0","1","Michigan","4/18/20","1","0","26109","0"
"Michigan Department of Corrections (MDOC)","79","550","Michigan","4/18/20","0","550","00000","1"
"Midland","3","62","Michigan","4/18/20","42","20","26111","47.62"
"Missaukee","1","6","Michigan","4/18/20","1","5","26113","500"
"Monroe","6","226","Michigan","4/18/20","184","42","26115","22.83"
"Montcalm","0","25","Michigan","4/18/20","22","3","26117","13.64"
"Montmorency","1","4","Michigan","4/18/20","0","4","26119","1"
"Muskegon","11","136","Michigan","4/18/20","57","79","26121","138.6"
"Newaygo","0","9","Michigan","4/18/20","8","1","26123","12.5"
"Oakland","191","6470","Michigan","4/18/20","5132","1338","26125","26.07"
"Oceana","0","3","Michigan","4/18/20","3","0","26127","0"
"Ogemaw","0","6","Michigan","4/18/20","5","1","26129","20"
"Osceola","0","8","Michigan","4/18/20","6","2","26133","33.33"
"Oscoda","0","4","Michigan","4/18/20","4","0","26135","0"
"Otsego","4","65","Michigan","4/18/20","34","31","26137","91.18"
"Ottawa","6","130","Michigan","4/18/20","90","40","26139","44.44"
"Out of MI","-9","74","Michigan","4/18/20","140","-66","80026","-47.14"
"Presque Isle","0","2","Michigan","4/18/20","2","0","26141","0"
"Roscommon","0","10","Michigan","4/18/20","8","2","26143","25"
"Saginaw","20","395","Michigan","4/18/20","254","141","26145","55.51"
"Sanilac","1","33","Michigan","4/18/20","24","9","26151","37.5"
"Schoolcraft","0","3","Michigan","4/18/20","2","1","26153","50"
"Shiawassee","9","102","Michigan","4/18/20","42","60","26155","142.86"
"St. Clair","8","274","Michigan","4/18/20","216","58","26147","26.85"
"St. Joseph","1","24","Michigan","4/18/20","20","4","26149","20"
"Tuscola","3","61","Michigan","4/18/20","42","19","26157","45.24"
"Van Buren","2","43","Michigan","4/18/20","30","13","26159","43.33"
"Washtenaw","28","962","Michigan","4/18/20","766","196","26161","25.59"
"Wayne","362","13582","Michigan","4/18/20","11045","2537","26163","22.97"
"Wexford","0","9","Michigan","4/18/20","8","1","26165","12.5"
"Aitkin","0","1","Minnesota","4/18/20","0","1","27001","1"
"Anoka","4","85","Minnesota","4/18/20","58","27","27003","46.55"
"Becker","0","1","Minnesota","4/18/20","0","1","27005","1"
"Beltrami","0","5","Minnesota","4/18/20","5","0","27007","0"
"Benton","0","4","Minnesota","4/18/20","1","3","27009","300"
"Big Stone","0","1","Minnesota","4/18/20","1","0","27011","0"
"Blue Earth","0","23","Minnesota","4/18/20","22","1","27013","4.55"
"Brown","0","7","Minnesota","4/18/20","7","0","27015","0"
"Carlton","2","34","Minnesota","4/18/20","19","15","27017","78.95"
"Carver","0","14","Minnesota","4/18/20","12","2","27019","16.67"
"Cass","0","4","Minnesota","4/18/20","3","1","27021","33.33"
"Chisago","0","7","Minnesota","4/18/20","6","1","27025","16.67"
"Clay","3","48","Minnesota","4/18/20","29","19","27027","65.52"
"Clearwater","0","3","Minnesota","4/18/20","2","1","27029","50"
"Cottonwood","0","6","Minnesota","4/18/20","5","1","27033","20"
"Crow Wing","1","17","Minnesota","4/18/20","13","4","27035","30.77"
"Dakota","4","113","Minnesota","4/18/20","87","26","27037","29.89"
"Dodge","0","17","Minnesota","4/18/20","15","2","27039","13.33"
"Douglas","0","1","Minnesota","4/18/20","1","0","27041","0"
"Faribault","0","4","Minnesota","4/18/20","4","0","27043","0"
"Fillmore","0","11","Minnesota","4/18/20","10","1","27045","10"
"Freeborn","1","31","Minnesota","4/18/20","22","9","27047","40.91"
"Goodhue","0","19","Minnesota","4/18/20","16","3","27049","18.75"
"Hennepin","59","875","Minnesota","4/18/20","464","411","27053","88.58"
"Houston","0","1","Minnesota","4/18/20","1","0","27055","0"
"Isanti","0","5","Minnesota","4/18/20","4","1","27059","25"
"Itasca","0","2","Minnesota","4/18/20","2","0","27061","0"
"Jackson","0","2","Minnesota","4/18/20","1","1","27063","100"
"Kandiyohi","0","2","Minnesota","4/18/20","2","0","27067","0"
"Kittson","0","1","Minnesota","4/18/20","0","1","27069","1"
"Koochiching","0","1","Minnesota","4/18/20","1","0","27071","0"
"Lac qui Parle","0","1","Minnesota","4/18/20","1","0","27073","0"
"Le Sueur","0","22","Minnesota","4/18/20","20","2","27079","10"
"Lincoln","0","2","Minnesota","4/18/20","2","0","27081","0"
"Lyon","0","5","Minnesota","4/18/20","5","0","27083","0"
"Mahnomen","0","1","Minnesota","4/18/20","1","0","27087","0"
"Martin","0","39","Minnesota","4/18/20","37","2","27091","5.41"
"McLeod","0","3","Minnesota","4/18/20","2","1","27085","50"
"Meeker","0","3","Minnesota","4/18/20","2","1","27093","50"
"Mille Lacs","0","1","Minnesota","4/18/20","0","1","27095","1"
"Mower","0","26","Minnesota","4/18/20","23","3","27099","13.04"
"Murray","0","3","Minnesota","4/18/20","1","2","27101","200"
"Nicollet","0","7","Minnesota","4/18/20","6","1","27103","16.67"
"Nobles","5","36","Minnesota","4/18/20","1","35","27105","3500"
"Norman","0","2","Minnesota","4/18/20","0","2","27107","1"
"Olmsted","6","177","Minnesota","4/18/20","132","45","27109","34.09"
"Otter Tail","0","5","Minnesota","4/18/20","4","1","27111","25"
"Pine","1","10","Minnesota","4/18/20","3","7","27115","233.33"
"Pipestone","0","2","Minnesota","4/18/20","1","1","27117","100"
"Polk","0","2","Minnesota","4/18/20","1","1","27119","100"
"Ramsey","9","192","Minnesota","4/18/20","132","60","27123","45.45"
"Red Lake","0","1","Minnesota","4/18/20","0","1","27125","1"
"Redwood","0","1","Minnesota","4/18/20","1","0","27127","0"
"Renville","0","3","Minnesota","4/18/20","3","0","27129","0"
"Rice","0","6","Minnesota","4/18/20","4","2","27131","50"
"Rock","0","3","Minnesota","4/18/20","0","3","27133","1"
"Roseau","0","1","Minnesota","4/18/20","1","0","27135","0"
"Scott","0","23","Minnesota","4/18/20","20","3","27139","15"
"Sherburne","0","12","Minnesota","4/18/20","9","3","27141","33.33"
"Sibley","0","1","Minnesota","4/18/20","1","0","27143","0"
"St. Louis","1","46","Minnesota","4/18/20","37","9","27137","24.32"
"Stearns","1","16","Minnesota","4/18/20","7","9","27145","128.57"
"Steele","0","9","Minnesota","4/18/20","9","0","27147","0"
"Swift","0","1","Minnesota","4/18/20","1","0","27151","0"
"Todd","0","2","Minnesota","4/18/20","0","2","27153","1"
"Traverse","0","2","Minnesota","4/18/20","2","0","27155","0"
"Wabasha","0","8","Minnesota","4/18/20","6","2","27157","33.33"
"Waseca","0","3","Minnesota","4/18/20","3","0","27161","0"
"Washington","2","92","Minnesota","4/18/20","77","15","27163","19.48"
"Watonwan","0","4","Minnesota","4/18/20","4","0","27165","0"
"Wilkin","0","8","Minnesota","4/18/20","7","1","27167","14.29"
"Winona","4","57","Minnesota","4/18/20","26","31","27169","119.23"
"Wright","1","23","Minnesota","4/18/20","16","7","27171","43.75"
"Yellow Medicine","0","3","Minnesota","4/18/20","2","1","27173","50"
"Adams","3","73","Mississippi","4/18/20","49","24","28001","48.98"
"Alcorn","0","7","Mississippi","4/18/20","7","0","28003","0"
"Amite","1","16","Mississippi","4/18/20","11","5","28005","45.45"
"Attala","2","34","Mississippi","4/18/20","18","16","28007","88.89"
"Benton","0","5","Mississippi","4/18/20","5","0","28009","0"
"Bolivar","2","79","Mississippi","4/18/20","65","14","28011","21.54"
"Calhoun","3","36","Mississippi","4/18/20","14","22","28013","157.14"
"Carroll","0","10","Mississippi","4/18/20","7","3","28015","42.86"
"Chickasaw","3","40","Mississippi","4/18/20","22","18","28017","81.82"
"Choctaw","0","11","Mississippi","4/18/20","10","1","28019","10"
"Claiborne","0","8","Mississippi","4/18/20","5","3","28021","60"
"Clarke","1","22","Mississippi","4/18/20","13","9","28023","69.23"
"Clay","1","24","Mississippi","4/18/20","17","7","28025","41.18"
"Coahoma","1","46","Mississippi","4/18/20","38","8","28027","21.05"
"Copiah","2","41","Mississippi","4/18/20","28","13","28029","46.43"
"Covington","2","28","Mississippi","4/18/20","12","16","28031","133.33"
"DeSoto","8","220","Mississippi","4/18/20","163","57","28033","34.97"
"Forrest","7","137","Mississippi","4/18/20","86","51","28035","59.3"
"Franklin","1","15","Mississippi","4/18/20","10","5","28037","50"
"George","0","10","Mississippi","4/18/20","7","3","28039","42.86"
"Greene","0","3","Mississippi","4/18/20","2","1","28041","50"
"Grenada","1","19","Mississippi","4/18/20","10","9","28043","90"
"Hancock","2","50","Mississippi","4/18/20","38","12","28045","31.58"
"Harrison","5","144","Mississippi","4/18/20","107","37","28047","34.58"
"Hinds","13","325","Mississippi","4/18/20","234","91","28049","38.89"
"Holmes","2","58","Mississippi","4/18/20","42","16","28051","38.1"
"Humphreys","0","12","Mississippi","4/18/20","9","3","28053","33.33"
"Itawamba","2","21","Mississippi","4/18/20","9","12","28057","133.33"
"Jackson","9","201","Mississippi","4/18/20","139","62","28059","44.6"
"Jasper","1","22","Mississippi","4/18/20","12","10","28061","83.33"
"Jefferson","0","4","Mississippi","4/18/20","4","0","28063","0"
"Jefferson Davis","0","8","Mississippi","4/18/20","5","3","28065","60"
"Jones","5","63","Mississippi","4/18/20","30","33","28067","110"
"Kemper","0","17","Mississippi","4/18/20","14","3","28069","21.43"
"Lafayette","2","40","Mississippi","4/18/20","29","11","28071","37.93"
"Lamar","4","59","Mississippi","4/18/20","31","28","28073","90.32"
"Lauderdale","8","190","Mississippi","4/18/20","133","57","28075","42.86"
"Lawrence","1","14","Mississippi","4/18/20","6","8","28077","133.33"
"Leake","5","64","Mississippi","4/18/20","27","37","28079","137.04"
"Lee","2","54","Mississippi","4/18/20","42","12","28081","28.57"
"Leflore","4","75","Mississippi","4/18/20","44","31","28083","70.45"
"Lincoln","9","102","Mississippi","4/18/20","41","61","28085","148.78"
"Lowndes","1","32","Mississippi","4/18/20","22","10","28087","45.45"
"Madison","4","127","Mississippi","4/18/20","99","28","28089","28.28"
"Marion","3","39","Mississippi","4/18/20","17","22","28091","129.41"
"Marshall","1","39","Mississippi","4/18/20","30","9","28093","30"
"Monroe","4","62","Mississippi","4/18/20","31","31","28095","100"
"Montgomery","0","15","Mississippi","4/18/20","14","1","28097","7.14"
"Neshoba","4","55","Mississippi","4/18/20","26","29","28099","111.54"
"Newton","1","21","Mississippi","4/18/20","12","9","28101","75"
"Noxubee","2","20","Mississippi","4/18/20","6","14","28103","233.33"
"Oktibbeha","1","43","Mississippi","4/18/20","36","7","28105","19.44"
"Panola","1","30","Mississippi","4/18/20","22","8","28107","36.36"
"Pearl River","5","119","Mississippi","4/18/20","82","37","28109","45.12"
"Perry","1","22","Mississippi","4/18/20","16","6","28111","37.5"
"Pike","7","97","Mississippi","4/18/20","47","50","28113","106.38"
"Pontotoc","0","17","Mississippi","4/18/20","14","3","28115","21.43"
"Prentiss","1","16","Mississippi","4/18/20","12","4","28117","33.33"
"Quitman","0","13","Mississippi","4/18/20","12","1","28119","8.33"
"Rankin","5","130","Mississippi","4/18/20","94","36","28121","38.3"
"Scott","8","106","Mississippi","4/18/20","52","54","28123","103.85"
"Sharkey","0","3","Mississippi","4/18/20","3","0","28125","0"
"Simpson","1","14","Mississippi","4/18/20","7","7","28127","100"
"Smith","2","39","Mississippi","4/18/20","23","16","28129","69.57"
"Stone","1","17","Mississippi","4/18/20","9","8","28131","88.89"
"Sunflower","2","46","Mississippi","4/18/20","35","11","28133","31.43"
"Tallahatchie","1","8","Mississippi","4/18/20","3","5","28135","166.67"
"Tate","1","29","Mississippi","4/18/20","23","6","28137","26.09"
"Tippah","0","46","Mississippi","4/18/20","43","3","28139","6.98"
"Tishomingo","0","3","Mississippi","4/18/20","2","1","28141","50"
"Tunica","2","30","Mississippi","4/18/20","19","11","28143","57.89"
"Union","0","9","Mississippi","4/18/20","7","2","28145","28.57"
"Walthall","1","23","Mississippi","4/18/20","16","7","28147","43.75"
"Warren","1","18","Mississippi","4/18/20","11","7","28149","63.64"
"Washington","3","70","Mississippi","4/18/20","49","21","28151","42.86"
"Wayne","0","10","Mississippi","4/18/20","8","2","28153","25"
"Webster","0","15","Mississippi","4/18/20","14","1","28155","7.14"
"Wilkinson","2","55","Mississippi","4/18/20","42","13","28157","30.95"
"Winston","2","29","Mississippi","4/18/20","18","11","28159","61.11"
"Yalobusha","0","15","Mississippi","4/18/20","13","2","28161","15.38"
"Yazoo","4","85","Mississippi","4/18/20","58","27","28163","46.55"
"Adair","0","12","Missouri","4/18/20","11","1","29001","9.09"
"Andrew","0","1","Missouri","4/18/20","1","0","29003","0"
"Atchison","0","2","Missouri","4/18/20","1","1","29005","100"
"Barry","0","3","Missouri","4/18/20","2","1","29009","50"
"Bates","0","6","Missouri","4/18/20","6","0","29013","0"
"Benton","0","3","Missouri","4/18/20","3","0","29015","0"
"Bollinger","0","3","Missouri","4/18/20","3","0","29017","0"
"Boone","2","93","Missouri","4/18/20","79","14","29019","17.72"
"Buchanan","1","30","Missouri","4/18/20","20","10","29021","50"
"Butler","1","23","Missouri","4/18/20","13","10","29023","76.92"
"Caldwell","0","2","Missouri","4/18/20","1","1","29025","100"
"Callaway","0","21","Missouri","4/18/20","21","0","29027","0"
"Camden","1","32","Missouri","4/18/20","26","6","29029","23.08"
"Cape Girardeau","1","36","Missouri","4/18/20","28","8","29031","28.57"
"Carter","0","3","Missouri","4/18/20","3","0","29035","0"
"Cass","3","53","Missouri","4/18/20","34","19","29037","55.88"
"Cedar","0","5","Missouri","4/18/20","5","0","29039","0"
"Chariton","0","4","Missouri","4/18/20","4","0","29041","0"
"Christian","0","19","Missouri","4/18/20","17","2","29043","11.76"
"Clark","0","1","Missouri","4/18/20","1","0","29045","0"
"Clay","1","56","Missouri","4/18/20","46","10","29047","21.74"
"Clinton","0","11","Missouri","4/18/20","11","0","29049","0"
"Cole","1","44","Missouri","4/18/20","36","8","29051","22.22"
"Cooper","0","4","Missouri","4/18/20","4","0","29053","0"
"Crawford","0","6","Missouri","4/18/20","4","2","29055","50"
"Dallas","0","2","Missouri","4/18/20","2","0","29059","0"
"Daviess","0","2","Missouri","4/18/20","0","2","29061","1"
"DeKalb","0","3","Missouri","4/18/20","3","0","29063","0"
"Dunklin","1","19","Missouri","4/18/20","13","6","29069","46.15"
"Franklin","2","95","Missouri","4/18/20","83","12","29071","14.46"
"Gasconade","0","2","Missouri","4/18/20","2","0","29073","0"
"Gentry","0","1","Missouri","4/18/20","1","0","29075","0"
"Greene","2","88","Missouri","4/18/20","77","11","29077","14.29"
"Harrison","0","6","Missouri","4/18/20","6","0","29081","0"
"Henry","0","6","Missouri","4/18/20","4","2","29083","50"
"Holt","0","1","Missouri","4/18/20","0","1","29087","1"
"Howard","0","2","Missouri","4/18/20","1","1","29089","100"
"Howell","0","5","Missouri","4/18/20","4","1","29091","25"
"Iron","0","1","Missouri","4/18/20","1","0","29093","0"
"Jackson","7","268","Missouri","4/18/20","217","51","29095","23.5"
"Jasper","1","28","Missouri","4/18/20","22","6","29097","27.27"
"Jefferson","9","183","Missouri","4/18/20","117","66","29099","56.41"
"Johnson","1","48","Missouri","4/18/20","41","7","29101","17.07"
"Kansas City","16","412","Missouri","4/18/20","300","112","00000","37.33"
"Lafayette","0","29","Missouri","4/18/20","28","1","29107","3.57"
"Lincoln","1","35","Missouri","4/18/20","26","9","29113","34.62"
"Linn","0","5","Missouri","4/18/20","3","2","29115","66.67"
"Livingston","0","2","Missouri","4/18/20","1","1","29117","100"
"Macon","0","2","Missouri","4/18/20","2","0","29121","0"
"Madison","0","1","Missouri","4/18/20","1","0","29123","0"
"Maries","0","2","Missouri","4/18/20","2","0","29125","0"
"McDonald","0","4","Missouri","4/18/20","4","0","29119","0"
"Miller","0","1","Missouri","4/18/20","0","1","29131","1"
"Moniteau","5","36","Missouri","4/18/20","4","32","29135","800"
"Montgomery","0","7","Missouri","4/18/20","6","1","29139","16.67"
"Morgan","0","2","Missouri","4/18/20","1","1","29141","100"
"New Madrid","0","8","Missouri","4/18/20","6","2","29143","33.33"
"Newton","0","9","Missouri","4/18/20","8","1","29145","12.5"
"Nodaway","0","3","Missouri","4/18/20","2","1","29147","50"
"Oregon","0","1","Missouri","4/18/20","1","0","29149","0"
"Osage","0","4","Missouri","4/18/20","4","0","29151","0"
"Pemiscot","1","12","Missouri","4/18/20","4","8","29155","200"
"Perry","1","41","Missouri","4/18/20","34","7","29157","20.59"
"Pettis","1","13","Missouri","4/18/20","4","9","29159","225"
"Phelps","0","1","Missouri","4/18/20","1","0","29161","0"
"Pike","0","6","Missouri","4/18/20","6","0","29163","0"
"Platte","0","27","Missouri","4/18/20","25","2","29165","8"
"Polk","0","1","Missouri","4/18/20","1","0","29167","0"
"Pulaski","3","29","Missouri","4/18/20","11","18","29169","163.64"
"Ralls","0","1","Missouri","4/18/20","1","0","29173","0"
"Randolph","0","8","Missouri","4/18/20","8","0","29175","0"
"Ray","0","7","Missouri","4/18/20","7","0","29177","0"
"Reynolds","0","2","Missouri","4/18/20","2","0","29179","0"
"Ripley","0","4","Missouri","4/18/20","3","1","29181","33.33"
"Saline","5","60","Missouri","4/18/20","22","38","29195","172.73"
"Scotland","0","4","Missouri","4/18/20","3","1","29199","33.33"
"Scott","5","49","Missouri","4/18/20","14","35","29201","250"
"Shelby","0","1","Missouri","4/18/20","1","0","29205","0"
"St. Charles","13","438","Missouri","4/18/20","348","90","29183","25.86"
"St. Clair","0","2","Missouri","4/18/20","2","0","29185","0"
"St. Francois","0","24","Missouri","4/18/20","21","3","29187","14.29"
"St. Louis","70","2295","Missouri","4/18/20","1804","491","29189","27.22"
"St. Louis City","24","810","Missouri","4/18/20","645","165","29510","25.58"
"Ste. Genevieve","0","7","Missouri","4/18/20","6","1","29186","16.67"
"Stoddard","1","16","Missouri","4/18/20","9","7","29207","77.78"
"Stone","0","3","Missouri","4/18/20","4","-1","29209","-25"
"Taney","0","9","Missouri","4/18/20","7","2","29213","28.57"
"Vernon","0","4","Missouri","4/18/20","3","1","29217","33.33"
"Warren","1","21","Missouri","4/18/20","13","8","29219","61.54"
"Washington","0","4","Missouri","4/18/20","1","3","29221","300"
"Webster","1","8","Missouri","4/18/20","4","4","29225","100"
"Worth","0","1","Missouri","4/18/20","1","0","29227","0"
"Wright","0","9","Missouri","4/18/20","7","2","29229","28.57"
"Beaverhead","0","1","Montana","4/18/20","1","0","30001","0"
"Big Horn","0","3","Montana","4/18/20","1","2","30003","200"
"Broadwater","0","4","Montana","4/18/20","4","0","30007","0"
"Carbon","0","6","Montana","4/18/20","6","0","30009","0"
"Cascade","0","13","Montana","4/18/20","13","0","30013","0"
"Deer Lodge","0","3","Montana","4/18/20","3","0","30023","0"
"Flathead","0","37","Montana","4/18/20","34","3","30029","8.82"
"Gallatin","1","142","Montana","4/18/20","135","7","30031","5.19"
"Glacier","0","4","Montana","4/18/20","3","1","30035","33.33"
"Golden Valley","0","3","Montana","4/18/20","1","2","30037","200"
"Hill","0","1","Montana","4/18/20","1","0","30041","0"
"Jefferson","0","2","Montana","4/18/20","2","0","30043","0"
"Lake","0","5","Montana","4/18/20","5","0","30047","0"
"Lewis and Clark","0","16","Montana","4/18/20","16","0","30049","0"
"Liberty","0","1","Montana","4/18/20","1","0","30051","0"
"Lincoln","0","7","Montana","4/18/20","7","0","30053","0"
"Madison","0","8","Montana","4/18/20","8","0","30057","0"
"Meagher","0","1","Montana","4/18/20","1","0","30059","0"
"Missoula","1","35","Montana","4/18/20","29","6","30063","20.69"
"Musselshell","0","1","Montana","4/18/20","1","0","30065","0"
"Park","0","7","Montana","4/18/20","7","0","30067","0"
"Pondera","0","1","Montana","4/18/20","0","1","30073","1"
"Ravalli","0","5","Montana","4/18/20","3","2","30081","66.67"
"Richland","0","3","Montana","4/18/20","3","0","30083","0"
"Roosevelt","0","6","Montana","4/18/20","3","3","30085","100"
"Silver Bow","0","11","Montana","4/18/20","11","0","30093","0"
"Stillwater","0","1","Montana","4/18/20","1","0","30095","0"
"Toole","1","29","Montana","4/18/20","20","9","30101","45"
"Yellowstone","2","70","Montana","4/18/20","57","13","30111","22.81"
"Adams","6","85","Nebraska","4/18/20","45","40","31001","88.89"
"Antelope","0","1","Nebraska","4/18/20","1","0","31003","0"
"Box Butte","0","1","Nebraska","4/18/20","1","0","31013","0"
"Buffalo","2","47","Nebraska","4/18/20","33","14","31019","42.42"
"Burt","0","1","Nebraska","4/18/20","1","0","31021","0"
"Butler","0","1","Nebraska","4/18/20","0","1","31023","1"
"Cass","0","3","Nebraska","4/18/20","3","0","31025","0"
"Cherry","0","1","Nebraska","4/18/20","1","0","31031","0"
"Cheyenne","0","4","Nebraska","4/18/20","2","2","31033","100"
"Clay","0","3","Nebraska","4/18/20","2","1","31035","50"
"Colfax","0","4","Nebraska","4/18/20","4","0","31037","0"
"Cuming","0","2","Nebraska","4/18/20","2","0","31039","0"
"Custer","1","18","Nebraska","4/18/20","13","5","31041","38.46"
"Dakota","3","22","Nebraska","4/18/20","0","22","31043","1"
"Dawson","4","30","Nebraska","4/18/20","3","27","31047","900"
"Dodge","1","12","Nebraska","4/18/20","7","5","31053","71.43"
"Douglas","5","266","Nebraska","4/18/20","228","38","31055","16.67"
"Franklin","0","3","Nebraska","4/18/20","2","1","31061","50"
"Gage","0","27","Nebraska","4/18/20","25","2","31067","8"
"Gosper","0","3","Nebraska","4/18/20","1","2","31073","200"
"Hall","39","403","Nebraska","4/18/20","129","274","31079","212.4"
"Hamilton","1","16","Nebraska","4/18/20","10","6","31081","60"
"Howard","0","2","Nebraska","4/18/20","0","2","31093","1"
"Johnson","0","2","Nebraska","4/18/20","1","1","31097","100"
"Kearney","0","3","Nebraska","4/18/20","3","0","31099","0"
"Kimball","0","9","Nebraska","4/18/20","9","0","31105","0"
"Knox","0","2","Nebraska","4/18/20","2","0","31107","0"
"Lancaster","2","63","Nebraska","4/18/20","50","13","31109","26"
"Lincoln","0","18","Nebraska","4/18/20","17","1","31111","5.88"
"Madison","0","7","Nebraska","4/18/20","6","1","31119","16.67"
"Merrick","1","6","Nebraska","4/18/20","2","4","31121","200"
"Morrill","0","1","Nebraska","4/18/20","0","1","31123","1"
"Nance","0","1","Nebraska","4/18/20","0","1","31125","1"
"Nemaha","0","1","Nebraska","4/18/20","1","0","31127","0"
"Otoe","0","1","Nebraska","4/18/20","1","0","31131","0"
"Phelps","0","1","Nebraska","4/18/20","1","0","31137","0"
"Pierce","0","1","Nebraska","4/18/20","1","0","31139","0"
"Platte","0","6","Nebraska","4/18/20","6","0","31141","0"
"Polk","1","5","Nebraska","4/18/20","1","4","31143","400"
"Red Willow","0","1","Nebraska","4/18/20","0","1","31145","1"
"Saline","1","4","Nebraska","4/18/20","0","4","31151","1"
"Sarpy","1","48","Nebraska","4/18/20","41","7","31153","17.07"
"Saunders","0","6","Nebraska","4/18/20","5","1","31155","20"
"Scotts Bluff","1","18","Nebraska","4/18/20","12","6","31157","50"
"Seward","0","1","Nebraska","4/18/20","1","0","31159","0"
"Stanton","0","1","Nebraska","4/18/20","1","0","31167","0"
"Washington","0","20","Nebraska","4/18/20","20","0","31177","0"
"Wayne","0","1","Nebraska","4/18/20","1","0","31179","0"
"Webster","0","1","Nebraska","4/18/20","1","0","31181","0"
"York","0","6","Nebraska","4/18/20","3","3","31185","100"
"Carson City","2","28","Nevada","4/18/20","16","12","32510","75"
"Churchill","0","3","Nevada","4/18/20","0","3","32001","1"
"Clark","105","2882","Nevada","4/18/20","2144","738","32003","34.42"
"Douglas","1","14","Nevada","4/18/20","10","4","32005","40"
"Elko","0","12","Nevada","4/18/20","11","1","32007","9.09"
"Humboldt","1","26","Nevada","4/18/20","18","8","32013","44.44"
"Lincoln","0","0","Nevada","4/18/20","1","-1","32017","-100"
"Lyon","1","15","Nevada","4/18/20","6","9","32019","150"
"Nye","2","21","Nevada","4/18/20","10","11","32023","110"
"Washoe","28","588","Nevada","4/18/20","389","199","32031","51.16"
"White Pine","0","3","Nevada","4/18/20","1","2","32033","200"
"Belknap","1","25","New Hampshire","4/18/20","21","4","33001","19.05"
"Carroll","0","30","New Hampshire","4/18/20","28","2","33003","7.14"
"Cheshire","2","28","New Hampshire","4/18/20","17","11","33005","64.71"
"Coos","0","2","New Hampshire","4/18/20","2","0","33007","0"
"Grafton","0","45","New Hampshire","4/18/20","43","2","33009","4.65"
"Hillsborough","30","552","New Hampshire","4/18/20","344","208","33011","60.47"
"Merrimack","4","92","New Hampshire","4/18/20","66","26","33013","39.39"
"Rockingham","23","466","New Hampshire","4/18/20","305","161","33015","52.79"
"Strafford","6","92","New Hampshire","4/18/20","53","39","33017","73.58"
"Sullivan","1","10","New Hampshire","4/18/20","6","4","33019","66.67"
"Atlantic","22","382","New Jersey","4/18/20","230","152","34001","66.09"
"Bergen","400","12163","New Jersey","4/18/20","9362","2801","34003","29.92"
"Burlington","61","1456","New Jersey","4/18/20","1031","425","34005","41.22"
"Camden","105","1918","New Jersey","4/18/20","1180","738","34007","62.54"
"Cape May","10","199","New Jersey","4/18/20","129","70","34009","54.26"
"Cumberland","17","272","New Jersey","4/18/20","154","118","34011","76.62"
"Essex","413","9901","New Jersey","4/18/20","7007","2894","34013","41.3"
"Gloucester","28","683","New Jersey","4/18/20","487","196","34015","40.25"
"Hudson","444","9956","New Jersey","4/18/20","6851","3105","34017","45.32"
"Hunterdon","13","391","New Jersey","4/18/20","301","90","34019","29.9"
"Mercer","112","2215","New Jersey","4/18/20","1434","781","34021","54.46"
"Middlesex","317","7624","New Jersey","4/18/20","5406","2218","34023","41.03"
"Monmouth","125","4528","New Jersey","4/18/20","3651","877","34025","24.02"
"Morris","151","3984","New Jersey","4/18/20","2925","1059","34027","36.21"
"Ocean","164","4548","New Jersey","4/18/20","3403","1145","34029","33.65"
"Passaic","377","7936","New Jersey","4/18/20","5295","2641","34031","49.88"
"Salem","7","105","New Jersey","4/18/20","56","49","34033","87.5"
"Somerset","92","2283","New Jersey","4/18/20","1642","641","34035","39.04"
"Sussex","24","626","New Jersey","4/18/20","456","170","34037","37.28"
"Union","442","8959","New Jersey","4/18/20","5865","3094","34039","52.75"
"Warren","26","543","New Jersey","4/18/20","362","181","34041","50"
"Bernalillo","17","527","New Mexico","4/18/20","407","120","35001","29.48"
"Catron","0","1","New Mexico","4/18/20","1","0","35003","0"
"Chaves","0","21","New Mexico","4/18/20","18","3","35005","16.67"
"Cibola","1","33","New Mexico","4/18/20","24","9","35006","37.5"
"Colfax","0","4","New Mexico","4/18/20","1","3","35007","300"
"Curry","0","10","New Mexico","4/18/20","9","1","35009","11.11"
"Dona Ana","3","67","New Mexico","4/18/20","44","23","35013","52.27"
"Eddy","0","9","New Mexico","4/18/20","6","3","35015","50"
"Grant","1","13","New Mexico","4/18/20","7","6","35017","85.71"
"Guadalupe","0","1","New Mexico","4/18/20","0","1","35019","1"
"Hidalgo","0","0","New Mexico","4/18/20","1","-1","35023","-100"
"Lea","0","2","New Mexico","4/18/20","2","0","35025","0"
"Lincoln","0","1","New Mexico","4/18/20","1","0","35027","0"
"Los Alamos","0","6","New Mexico","4/18/20","4","2","35028","50"
"Luna","0","3","New Mexico","4/18/20","2","1","35029","50"
"McKinley","35","356","New Mexico","4/18/20","113","243","35031","215.04"
"Otero","0","3","New Mexico","4/18/20","3","0","35035","0"
"Quay","0","2","New Mexico","4/18/20","0","2","35037","1"
"Rio Arriba","0","10","New Mexico","4/18/20","7","3","35039","42.86"
"Roosevelt","0","1","New Mexico","4/18/20","1","0","35041","0"
"San Juan","17","260","New Mexico","4/18/20","142","118","35045","83.1"
"San Miguel","0","2","New Mexico","4/18/20","1","1","35047","100"
"Sandoval","19","311","New Mexico","4/18/20","177","134","35043","75.71"
"Santa Fe","1","82","New Mexico","4/18/20","72","10","35049","13.89"
"Socorro","1","20","New Mexico","4/18/20","10","10","35053","100"
"Taos","0","15","New Mexico","4/18/20","15","0","35055","0"
"Torrance","0","12","New Mexico","4/18/20","9","3","35057","33.33"
"Valencia","2","26","New Mexico","4/18/20","14","12","35061","85.71"
"Albany","29","648","New York","4/18/20","446","202","36001","45.29"
"Allegany","1","30","New York","4/18/20","26","4","36003","15.38"
"Broome","10","186","New York","4/18/20","117","69","36007","58.97"
"Cattaraugus","2","34","New York","4/18/20","19","15","36009","78.95"
"Cayuga","1","36","New York","4/18/20","28","8","36011","28.57"
"Chautauqua","0","25","New York","4/18/20","22","3","36013","13.64"
"Chemung","2","72","New York","4/18/20","60","12","36015","20"
"Chenango","2","77","New York","4/18/20","61","16","36017","26.23"
"Clinton","1","48","New York","4/18/20","43","5","36019","11.63"
"Columbia","3","105","New York","4/18/20","87","18","36021","20.69"
"Cortland","1","25","New York","4/18/20","17","8","36023","47.06"
"Delaware","1","49","New York","4/18/20","39","10","36025","25.64"
"Dutchess","65","2201","New York","4/18/20","1744","457","36027","26.2"
"Erie","74","2023","New York","4/18/20","1506","517","36029","34.33"
"Essex","1","16","New York","4/18/20","12","4","36031","33.33"
"Franklin","0","13","New York","4/18/20","11","2","36033","18.18"
"Fulton","1","27","New York","4/18/20","21","6","36035","28.57"
"Genesee","3","87","New York","4/18/20","67","20","36037","29.85"
"Greene","6","82","New York","4/18/20","37","45","36039","121.62"
"Hamilton","0","3","New York","4/18/20","3","0","36041","0"
"Herkimer","1","47","New York","4/18/20","37","10","36043","27.03"
"Jefferson","1","50","New York","4/18/20","44","6","36045","13.64"
"Lewis","0","8","New York","4/18/20","6","2","36049","33.33"
"Livingston","1","37","New York","4/18/20","30","7","36051","23.33"
"Madison","2","117","New York","4/18/20","102","15","36053","14.71"
"Monroe","34","1008","New York","4/18/20","767","241","36055","31.42"
"Montgomery","1","34","New York","4/18/20","29","5","36057","17.24"
"Nassau","942","29180","New York","4/18/20","22584","6596","36059","29.21"
"New York","4718","131334","New York","4/18/20","98308","33026","36061","33.59"
"Niagara","10","234","New York","4/18/20","167","67","36063","40.12"
"Oneida","12","268","New York","4/18/20","181","87","36065","48.07"
"Onondaga","20","598","New York","4/18/20","456","142","36067","31.14"
"Ontario","2","69","New York","4/18/20","56","13","36069","23.21"
"Orange","238","6514","New York","4/18/20","4847","1667","36071","34.39"
"Orleans","2","41","New York","4/18/20","24","17","36073","70.83"
"Oswego","1","45","New York","4/18/20","37","8","36075","21.62"
"Otsego","1","47","New York","4/18/20","43","4","36077","9.3"
"Putnam","34","732","New York","4/18/20","494","238","36079","48.18"
"Rensselaer","9","164","New York","4/18/20","102","62","36083","60.78"
"Rockland","242","9171","New York","4/18/20","7477","1694","36087","22.66"
"Saratoga","8","244","New York","4/18/20","187","57","36091","30.48"
"Schenectady","14","295","New York","4/18/20","194","101","36093","52.06"
"Schoharie","1","20","New York","4/18/20","12","8","36095","66.67"
"Schuyler","0","8","New York","4/18/20","5","3","36097","60"
"Seneca","0","18","New York","4/18/20","16","2","36099","12.5"
"St. Lawrence","2","98","New York","4/18/20","82","16","36089","19.51"
"Steuben","9","181","New York","4/18/20","117","64","36101","54.7"
"Suffolk","832","26143","New York","4/18/20","20321","5822","36103","28.65"
"Sullivan","26","524","New York","4/18/20","340","184","36105","54.12"
"Tioga","2","32","New York","4/18/20","19","13","36107","68.42"
"Tompkins","2","119","New York","4/18/20","108","11","36109","10.19"
"Ulster","42","880","New York","4/18/20","589","291","36111","49.41"
"Warren","7","94","New York","4/18/20","44","50","36113","113.64"
"Washington","3","52","New York","4/18/20","31","21","36115","67.74"
"Wayne","1","49","New York","4/18/20","42","7","36117","16.67"
"Westchester","636","23179","New York","4/18/20","18729","4450","36119","23.76"
"Wyoming","2","44","New York","4/18/20","31","13","36121","41.94"
"Yates","1","9","New York","4/18/20","2","7","36123","350"
"Alamance","2","48","North Carolina","4/18/20","34","14","37001","41.18"
"Alexander","0","3","North Carolina","4/18/20","2","1","37003","50"
"Alleghany","0","2","North Carolina","4/18/20","2","0","37005","0"
"Anson","1","16","North Carolina","4/18/20","10","6","37007","60"
"Ashe","0","4","North Carolina","4/18/20","4","0","37009","0"
"Beaufort","0","14","North Carolina","4/18/20","13","1","37013","7.69"
"Bertie","1","20","North Carolina","4/18/20","12","8","37015","66.67"
"Bladen","0","2","North Carolina","4/18/20","1","1","37017","100"
"Brunswick","0","36","North Carolina","4/18/20","34","2","37019","5.88"
"Buncombe","1","47","North Carolina","4/18/20","37","10","37021","27.03"
"Burke","1","66","North Carolina","4/18/20","61","5","37023","8.2"
"Cabarrus","14","207","North Carolina","4/18/20","107","100","37025","93.46"
"Caldwell","1","22","North Carolina","4/18/20","17","5","37027","29.41"
"Carteret","0","24","North Carolina","4/18/20","21","3","37031","14.29"
"Caswell","1","7","North Carolina","4/18/20","3","4","37033","133.33"
"Catawba","1","43","North Carolina","4/18/20","33","10","37035","30.3"
"Chatham","9","101","North Carolina","4/18/20","37","64","37037","172.97"
"Cherokee","1","16","North Carolina","4/18/20","11","5","37039","45.45"
"Chowan","0","6","North Carolina","4/18/20","3","3","37041","100"
"Clay","0","5","North Carolina","4/18/20","4","1","37043","25"
"Cleveland","1","42","North Carolina","4/18/20","35","7","37045","20"
"Columbus","3","55","North Carolina","4/18/20","31","24","37047","77.42"
"Craven","1","33","North Carolina","4/18/20","24","9","37049","37.5"
"Cumberland","4","113","North Carolina","4/18/20","82","31","37051","37.8"
"Currituck","0","3","North Carolina","4/18/20","3","0","37053","0"
"Dare","0","15","North Carolina","4/18/20","13","2","37055","15.38"
"Davidson","1","94","North Carolina","4/18/20","85","9","37057","10.59"
"Davie","0","23","North Carolina","4/18/20","22","1","37059","4.55"
"Duplin","1","23","North Carolina","4/18/20","15","8","37061","53.33"
"Durham","18","399","North Carolina","4/18/20","275","124","37063","45.09"
"Edgecombe","4","49","North Carolina","4/18/20","22","27","37065","122.73"
"Forsyth","2","126","North Carolina","4/18/20","115","11","37067","9.57"
"Franklin","6","69","North Carolina","4/18/20","27","42","37069","155.56"
"Gaston","4","110","North Carolina","4/18/20","80","30","37071","37.5"
"Gates","0","4","North Carolina","4/18/20","4","0","37073","0"
"Granville","3","109","North Carolina","4/18/20","89","20","37077","22.47"
"Greene","1","14","North Carolina","4/18/20","10","4","37079","40"
"Guilford","6","176","North Carolina","4/18/20","134","42","37081","31.34"
"Halifax","2","32","North Carolina","4/18/20","21","11","37083","52.38"
"Harnett","2","55","North Carolina","4/18/20","38","17","37085","44.74"
"Haywood","0","5","North Carolina","4/18/20","3","2","37087","66.67"
"Henderson","6","108","North Carolina","4/18/20","68","40","37089","58.82"
"Hertford","0","7","North Carolina","4/18/20","4","3","37091","75"
"Hoke","1","23","North Carolina","4/18/20","18","5","37093","27.78"
"Iredell","1","81","North Carolina","4/18/20","71","10","37097","14.08"
"Jackson","0","5","North Carolina","4/18/20","2","3","37099","150"
"Johnston","4","121","North Carolina","4/18/20","92","29","37101","31.52"
"Jones","0","9","North Carolina","4/18/20","6","3","37103","50"
"Lee","3","30","North Carolina","4/18/20","8","22","37105","275"
"Lenoir","1","18","North Carolina","4/18/20","14","4","37107","28.57"
"Lincoln","1","20","North Carolina","4/18/20","15","5","37109","33.33"
"Macon","0","2","North Carolina","4/18/20","2","0","37113","0"
"Martin","0","8","North Carolina","4/18/20","5","3","37117","60"
"McDowell","1","20","North Carolina","4/18/20","16","4","37111","25"
"Mecklenburg","31","1153","North Carolina","4/18/20","935","218","37119","23.32"
"Mitchell","0","5","North Carolina","4/18/20","4","1","37121","25"
"Montgomery","1","17","North Carolina","4/18/20","13","4","37123","30.77"
"Moore","1","93","North Carolina","4/18/20","84","9","37125","10.71"
"Nash","3","53","North Carolina","4/18/20","32","21","37127","65.62"
"New Hanover","2","68","North Carolina","4/18/20","55","13","37129","23.64"
"Northampton","1","70","North Carolina","4/18/20","61","9","37131","14.75"
"Onslow","0","37","North Carolina","4/18/20","34","3","37133","8.82"
"Orange","6","183","North Carolina","4/18/20","141","42","37135","29.79"
"Pamlico","0","6","North Carolina","4/18/20","5","1","37137","20"
"Pasquotank","1","20","North Carolina","4/18/20","15","5","37139","33.33"
"Pender","0","6","North Carolina","4/18/20","5","1","37141","20"
"Perquimans","1","8","North Carolina","4/18/20","4","4","37143","100"
"Person","1","16","North Carolina","4/18/20","8","8","37145","100"
"Pitt","4","89","North Carolina","4/18/20","62","27","37147","43.55"
"Polk","0","10","North Carolina","4/18/20","9","1","37149","11.11"
"Randolph","3","69","North Carolina","4/18/20","51","18","37151","35.29"
"Richmond","2","18","North Carolina","4/18/20","7","11","37153","157.14"
"Robeson","2","22","North Carolina","4/18/20","7","15","37155","214.29"
"Rockingham","0","16","North Carolina","4/18/20","14","2","37157","14.29"
"Rowan","20","244","North Carolina","4/18/20","105","139","37159","132.38"
"Rutherford","4","65","North Carolina","4/18/20","37","28","37161","75.68"
"Sampson","1","19","North Carolina","4/18/20","11","8","37163","72.73"
"Scotland","0","11","North Carolina","4/18/20","9","2","37165","22.22"
"Stanly","1","20","North Carolina","4/18/20","14","6","37167","42.86"
"Stokes","0","10","North Carolina","4/18/20","10","0","37169","0"
"Surry","1","17","North Carolina","4/18/20","10","7","37171","70"
"Transylvania","0","7","North Carolina","4/18/20","6","1","37175","16.67"
"Tyrrell","1","4","North Carolina","4/18/20","0","4","37177","1"
"Union","6","141","North Carolina","4/18/20","101","40","37179","39.6"
"Vance","2","30","North Carolina","4/18/20","19","11","37181","57.89"
"Wake","22","579","North Carolina","4/18/20","424","155","37183","36.56"
"Warren","0","3","North Carolina","4/18/20","3","0","37185","0"
"Washington","1","19","North Carolina","4/18/20","15","4","37187","26.67"
"Watauga","0","8","North Carolina","4/18/20","8","0","37189","0"
"Wayne","44","378","North Carolina","4/18/20","69","309","37191","447.83"
"Wilkes","0","4","North Carolina","4/18/20","4","0","37193","0"
"Wilson","7","109","North Carolina","4/18/20","58","51","37195","87.93"
"Yadkin","0","11","North Carolina","4/18/20","10","1","37197","10"
"Barnes","0","3","North Dakota","4/18/20","2","1","38003","50"
"Bowman","0","1","North Dakota","4/18/20","1","0","38011","0"
"Burke","0","2","North Dakota","4/18/20","2","0","38013","0"
"Burleigh","2","61","North Dakota","4/18/20","49","12","38015","24.49"
"Cass","15","197","North Dakota","4/18/20","95","102","38017","107.37"
"Divide","0","1","North Dakota","4/18/20","1","0","38023","0"
"Dunn","1","6","North Dakota","4/18/20","2","4","38025","200"
"Eddy","0","1","North Dakota","4/18/20","1","0","38027","0"
"Emmons","0","1","North Dakota","4/18/20","1","0","38029","0"
"Foster","0","1","North Dakota","4/18/20","1","0","38031","0"
"Grand Forks","13","99","North Dakota","4/18/20","11","88","38035","800"
"Grant","0","1","North Dakota","4/18/20","1","0","38037","0"
"McHenry","0","1","North Dakota","4/18/20","1","0","38049","0"
"McIntosh","0","1","North Dakota","4/18/20","1","0","38051","0"
"McKenzie","1","10","North Dakota","4/18/20","6","4","38053","66.67"
"McLean","0","3","North Dakota","4/18/20","2","1","38055","50"
"Morton","0","21","North Dakota","4/18/20","19","2","38059","10.53"
"Mountrail","1","29","North Dakota","4/18/20","21","8","38061","38.1"
"Oliver","0","1","North Dakota","4/18/20","1","0","38065","0"
"Pierce","0","2","North Dakota","4/18/20","2","0","38069","0"
"Ramsey","0","3","North Dakota","4/18/20","3","0","38071","0"
"Richland","0","5","North Dakota","4/18/20","2","3","38077","150"
"Rolette","0","1","North Dakota","4/18/20","1","0","38079","0"
"Sargent","0","1","North Dakota","4/18/20","1","0","38081","0"
"Sioux","0","1","North Dakota","4/18/20","1","0","38085","0"
"Slope","0","3","North Dakota","4/18/20","3","0","38087","0"
"Stark","1","38","North Dakota","4/18/20","30","8","38089","26.67"
"Stutsman","0","1","North Dakota","4/18/20","1","0","38093","0"
"Walsh","0","3","North Dakota","4/18/20","3","0","38099","0"
"Ward","0","20","North Dakota","4/18/20","20","0","38101","0"
"Williams","0","10","North Dakota","4/18/20","8","2","38105","25"
"","0","14","Northern Mariana Islands","4/18/20","11","3",,"27.27"
"Adams","0","3","Ohio","4/18/20","3","0","39001","0"
"Allen","6","70","Ohio","4/18/20","27","43","39003","159.26"
"Ashland","0","5","Ohio","4/18/20","5","0","39005","0"
"Ashtabula","6","64","Ohio","4/18/20","24","40","39007","166.67"
"Athens","0","3","Ohio","4/18/20","3","0","39009","0"
"Auglaize","1","22","Ohio","4/18/20","14","8","39011","57.14"
"Belmont","3","68","Ohio","4/18/20","49","19","39013","38.78"
"Brown","1","9","Ohio","4/18/20","5","4","39015","80"
"Butler","7","164","Ohio","4/18/20","115","49","39017","42.61"
"Carroll","1","15","Ohio","4/18/20","11","4","39019","36.36"
"Champaign","0","7","Ohio","4/18/20","6","1","39021","16.67"
"Clark","1","26","Ohio","4/18/20","18","8","39023","44.44"
"Clermont","4","71","Ohio","4/18/20","41","30","39025","73.17"
"Clinton","2","26","Ohio","4/18/20","15","11","39027","73.33"
"Columbiana","9","161","Ohio","4/18/20","96","65","39029","67.71"
"Coshocton","0","16","Ohio","4/18/20","15","1","39031","6.67"
"Crawford","3","36","Ohio","4/18/20","13","23","39033","176.92"
"Cuyahoga","49","1453","Ohio","4/18/20","1113","340","39035","30.55"
"Darke","2","55","Ohio","4/18/20","42","13","39037","30.95"
"Defiance","0","13","Ohio","4/18/20","11","2","39039","18.18"
"Delaware","4","119","Ohio","4/18/20","89","30","39041","33.71"
"Erie","2","27","Ohio","4/18/20","10","17","39043","170"
"Fairfield","3","97","Ohio","4/18/20","78","19","39045","24.36"
"Fayette","1","13","Ohio","4/18/20","7","6","39047","85.71"
"Franklin","73","1403","Ohio","4/18/20","894","509","39049","56.94"
"Fulton","1","14","Ohio","4/18/20","6","8","39051","133.33"
"Gallia","0","6","Ohio","4/18/20","4","2","39053","50"
"Geauga","6","98","Ohio","4/18/20","53","45","39055","84.91"
"Greene","2","39","Ohio","4/18/20","24","15","39057","62.5"
"Guernsey","1","10","Ohio","4/18/20","5","5","39059","100"
"Hamilton","25","701","Ohio","4/18/20","529","172","39061","32.51"
"Hancock","1","30","Ohio","4/18/20","20","10","39063","50"
"Hardin","2","15","Ohio","4/18/20","4","11","39065","275"
"Harrison","0","2","Ohio","4/18/20","0","2","39067","1"
"Henry","0","3","Ohio","4/18/20","1","2","39069","200"
"Highland","0","7","Ohio","4/18/20","6","1","39071","16.67"
"Hocking","0","4","Ohio","4/18/20","2","2","39073","100"
"Holmes","0","3","Ohio","4/18/20","3","0","39075","0"
"Huron","0","15","Ohio","4/18/20","15","0","39077","0"
"Jackson","0","4","Ohio","4/18/20","2","2","39079","100"
"Jefferson","0","26","Ohio","4/18/20","23","3","39081","13.04"
"Knox","0","11","Ohio","4/18/20","9","2","39083","22.22"
"Lake","3","131","Ohio","4/18/20","112","19","39085","16.96"
"Lawrence","1","20","Ohio","4/18/20","15","5","39087","33.33"
"Licking","2","94","Ohio","4/18/20","80","14","39089","17.5"
"Logan","1","13","Ohio","4/18/20","7","6","39091","85.71"
"Lorain","19","291","Ohio","4/18/20","161","130","39093","80.75"
"Lucas","33","724","Ohio","4/18/20","490","234","39095","47.76"
"Madison","1","30","Ohio","4/18/20","23","7","39097","30.43"
"Mahoning","28","572","Ohio","4/18/20","375","197","39099","52.53"
"Marion","133","983","Ohio","4/18/20","49","934","39101","1906.12"
"Medina","4","132","Ohio","4/18/20","107","25","39103","23.36"
"Meigs","0","2","Ohio","4/18/20","1","1","39105","100"
"Mercer","0","13","Ohio","4/18/20","12","1","39107","8.33"
"Miami","2","129","Ohio","4/18/20","116","13","39109","11.21"
"Monroe","0","2","Ohio","4/18/20","2","0","39111","0"
"Montgomery","8","229","Ohio","4/18/20","175","54","39113","30.86"
"Morgan","0","3","Ohio","4/18/20","2","1","39115","50"
"Morrow","2","19","Ohio","4/18/20","8","11","39117","137.5"
"Muskingum","0","8","Ohio","4/18/20","8","0","39119","0"
"Noble","0","3","Ohio","4/18/20","1","2","39121","200"
"Ottawa","2","27","Ohio","4/18/20","10","17","39123","170"
"Paulding","0","5","Ohio","4/18/20","3","2","39125","66.67"
"Perry","0","9","Ohio","4/18/20","8","1","39127","12.5"
"Pickaway","36","302","Ohio","4/18/20","51","251","39129","492.16"
"Pike","0","1","Ohio","4/18/20","1","0","39131","0"
"Portage","5","168","Ohio","4/18/20","134","34","39133","25.37"
"Preble","1","21","Ohio","4/18/20","11","10","39135","90.91"
"Putnam","2","14","Ohio","4/18/20","0","14","39137","1"
"Richland","4","60","Ohio","4/18/20","34","26","39139","76.47"
"Ross","3","33","Ohio","4/18/20","13","20","39141","153.85"
"Sandusky","1","17","Ohio","4/18/20","10","7","39143","70"
"Scioto","0","7","Ohio","4/18/20","4","3","39145","75"
"Seneca","0","11","Ohio","4/18/20","8","3","39147","37.5"
"Shelby","0","28","Ohio","4/18/20","25","3","39149","12"
"Stark","13","221","Ohio","4/18/20","133","88","39151","66.17"
"Summit","14","340","Ohio","4/18/20","243","97","39153","39.92"
"Trumbull","11","231","Ohio","4/18/20","155","76","39155","49.03"
"Tuscarawas","1","31","Ohio","4/18/20","26","5","39157","19.23"
"Union","0","12","Ohio","4/18/20","10","2","39159","20"
"Van Wert","0","2","Ohio","4/18/20","2","0","39161","0"
"Warren","5","112","Ohio","4/18/20","74","38","39165","51.35"
"Washington","3","57","Ohio","4/18/20","36","21","39167","58.33"
"Wayne","5","77","Ohio","4/18/20","40","37","39169","92.5"
"Williams","1","7","Ohio","4/18/20","3","4","39171","133.33"
"Wood","4","80","Ohio","4/18/20","52","28","39173","53.85"
"Wyandot","1","17","Ohio","4/18/20","10","7","39175","70"
"Adair","0","29","Oklahoma","4/18/20","27","2","40001","7.41"
"Alfalfa","0","1","Oklahoma","4/18/20","0","1","40003","1"
"Atoka","0","1","Oklahoma","4/18/20","1","0","40005","0"
"Beaver","0","1","Oklahoma","4/18/20","1","0","40007","0"
"Beckham","0","2","Oklahoma","4/18/20","1","1","40009","100"
"Bryan","0","5","Oklahoma","4/18/20","3","2","40013","66.67"
"Caddo","6","48","Oklahoma","4/18/20","9","39","40015","433.33"
"Canadian","1","65","Oklahoma","4/18/20","56","9","40017","16.07"
"Carter","0","1","Oklahoma","4/18/20","1","0","40019","0"
"Cherokee","1","22","Oklahoma","4/18/20","18","4","40021","22.22"
"Choctaw","0","3","Oklahoma","4/18/20","2","1","40023","50"
"Cleveland","8","301","Oklahoma","4/18/20","247","54","40027","21.86"
"Comanche","1","57","Oklahoma","4/18/20","49","8","40031","16.33"
"Cotton","0","5","Oklahoma","4/18/20","4","1","40033","25"
"Craig","0","7","Oklahoma","4/18/20","6","1","40035","16.67"
"Creek","1","58","Oklahoma","4/18/20","54","4","40037","7.41"
"Custer","0","7","Oklahoma","4/18/20","5","2","40039","40"
"Delaware","7","74","Oklahoma","4/18/20","24","50","40041","208.33"
"Dewey","0","2","Oklahoma","4/18/20","1","1","40043","100"
"Garfield","0","9","Oklahoma","4/18/20","6","3","40047","50"
"Garvin","0","10","Oklahoma","4/18/20","10","0","40049","0"
"Grady","1","16","Oklahoma","4/18/20","11","5","40051","45.45"
"Grant","0","2","Oklahoma","4/18/20","2","0","40053","0"
"Greer","0","50","Oklahoma","4/18/20","48","2","40055","4.17"
"Jackson","0","6","Oklahoma","4/18/20","7","-1","40065","-14.29"
"Jefferson","0","1","Oklahoma","4/18/20","1","0","40067","0"
"Johnston","0","2","Oklahoma","4/18/20","0","2","40069","1"
"Kay","1","46","Oklahoma","4/18/20","42","4","40071","9.52"
"Kingfisher","0","6","Oklahoma","4/18/20","5","1","40073","20"
"Kiowa","0","2","Oklahoma","4/18/20","1","1","40075","100"
"Latimer","0","4","Oklahoma","4/18/20","4","0","40077","0"
"Le Flore","0","5","Oklahoma","4/18/20","3","2","40079","66.67"
"Lincoln","0","11","Oklahoma","4/18/20","11","0","40081","0"
"Logan","0","8","Oklahoma","4/18/20","7","1","40083","14.29"
"Love","0","2","Oklahoma","4/18/20","2","0","40085","0"
"Major","0","2","Oklahoma","4/18/20","1","1","40093","100"
"Marshall","0","1","Oklahoma","4/18/20","1","0","40095","0"
"Mayes","1","19","Oklahoma","4/18/20","13","6","40097","46.15"
"McClain","0","20","Oklahoma","4/18/20","18","2","40087","11.11"
"McCurtain","1","7","Oklahoma","4/18/20","2","5","40089","250"
"McIntosh","0","2","Oklahoma","4/18/20","1","1","40091","100"
"Muskogee","1","25","Oklahoma","4/18/20","21","4","40101","19.05"
"Noble","0","6","Oklahoma","4/18/20","6","0","40103","0"
"Nowata","0","11","Oklahoma","4/18/20","10","1","40105","10"
"Okfuskee","0","1","Oklahoma","4/18/20","1","0","40107","0"
"Oklahoma","10","497","Oklahoma","4/18/20","425","72","40109","16.94"
"Okmulgee","0","14","Oklahoma","4/18/20","13","1","40111","7.69"
"Osage","2","61","Oklahoma","4/18/20","45","16","40113","35.56"
"Ottawa","1","24","Oklahoma","4/18/20","16","8","40115","50"
"Pawnee","0","28","Oklahoma","4/18/20","26","2","40117","7.69"
"Payne","1","34","Oklahoma","4/18/20","28","6","40119","21.43"
"Pittsburg","1","14","Oklahoma","4/18/20","8","6","40121","75"
"Pontotoc","0","10","Oklahoma","4/18/20","9","1","40123","11.11"
"Pottawatomie","1","32","Oklahoma","4/18/20","25","7","40125","28"
"Rogers","1","30","Oklahoma","4/18/20","24","6","40131","25"
"Seminole","0","7","Oklahoma","4/18/20","6","1","40133","16.67"
"Sequoyah","0","10","Oklahoma","4/18/20","9","1","40135","11.11"
"Stephens","0","15","Oklahoma","4/18/20","13","2","40137","15.38"
"Texas","1","9","Oklahoma","4/18/20","3","6","40139","200"
"Tillman","0","1","Oklahoma","4/18/20","1","0","40141","0"
"Tulsa","8","376","Oklahoma","4/18/20","323","53","40143","16.41"
"Wagoner","6","107","Oklahoma","4/18/20","67","40","40145","59.7"
"Washington","6","124","Oklahoma","4/18/20","83","41","40147","49.4"
"Woodward","0","1","Oklahoma","4/18/20","1","0","40153","0"
"Benton","1","27","Oregon","4/18/20","21","6","41003","28.57"
"Clackamas","5","154","Oregon","4/18/20","116","38","41005","32.76"
"Clatsop","0","6","Oregon","4/18/20","6","0","41007","0"
"Columbia","1","14","Oregon","4/18/20","10","4","41009","40"
"Coos","0","1","Oregon","4/18/20","0","1","41011","1"
"Crook","0","1","Oregon","4/18/20","1","0","41013","0"
"Curry","0","4","Oregon","4/18/20","3","1","41015","33.33"
"Deschutes","2","63","Oregon","4/18/20","51","12","41017","23.53"
"Douglas","1","22","Oregon","4/18/20","12","10","41019","83.33"
"Grant","0","1","Oregon","4/18/20","1","0","41023","0"
"Hood River","0","4","Oregon","4/18/20","4","0","41027","0"
"Jackson","1","49","Oregon","4/18/20","44","5","41029","11.36"
"Jefferson","0","1","Oregon","4/18/20","0","1","41031","1"
"Josephine","0","19","Oregon","4/18/20","17","2","41033","11.76"
"Klamath","1","31","Oregon","4/18/20","24","7","41035","29.17"
"Lane","2","46","Oregon","4/18/20","34","12","41039","35.29"
"Lincoln","0","4","Oregon","4/18/20","4","0","41041","0"
"Linn","1","59","Oregon","4/18/20","49","10","41043","20.41"
"Malheur","0","5","Oregon","4/18/20","2","3","41045","150"
"Marion","13","335","Oregon","4/18/20","246","89","41047","36.18"
"Morrow","0","5","Oregon","4/18/20","5","0","41049","0"
"Multnomah","25","493","Oregon","4/18/20","317","176","41051","55.52"
"Polk","0","32","Oregon","4/18/20","29","3","41053","10.34"
"Sherman","0","1","Oregon","4/18/20","1","0","41055","0"
"Tillamook","0","6","Oregon","4/18/20","4","2","41057","50"
"Umatilla","2","25","Oregon","4/18/20","11","14","41059","127.27"
"Union","0","4","Oregon","4/18/20","3","1","41061","33.33"
"Wallowa","0","1","Oregon","4/18/20","1","0","41063","0"
"Wasco","0","10","Oregon","4/18/20","7","3","41065","42.86"
"Washington","10","387","Oregon","4/18/20","320","67","41067","20.94"
"Yamhill","1","34","Oregon","4/18/20","28","6","41071","21.43"
"Adams","4","74","Pennsylvania","4/18/20","44","30","42001","68.18"
"Allegheny","25","1009","Pennsylvania","4/18/20","836","173","42003","20.69"
"Armstrong","1","36","Pennsylvania","4/18/20","26","10","42005","38.46"
"Beaver","19","278","Pennsylvania","4/18/20","143","135","42007","94.41"
"Bedford","1","14","Pennsylvania","4/18/20","5","9","42009","180"
"Berks","117","1748","Pennsylvania","4/18/20","930","818","42011","87.96"
"Blair","1","14","Pennsylvania","4/18/20","10","4","42013","40"
"Bradford","1","24","Pennsylvania","4/18/20","18","6","42015","33.33"
"Bucks","83","1689","Pennsylvania","4/18/20","1107","582","42017","52.57"
"Butler","5","160","Pennsylvania","4/18/20","128","32","42019","25"
"Cambria","1","17","Pennsylvania","4/18/20","13","4","42021","30.77"
"Cameron","0","1","Pennsylvania","4/18/20","1","0","42023","0"
"Carbon","5","136","Pennsylvania","4/18/20","98","38","42025","38.78"
"Centre","1","73","Pennsylvania","4/18/20","69","4","42027","5.8"
"Chester","38","796","Pennsylvania","4/18/20","532","264","42029","49.62"
"Clarion","0","18","Pennsylvania","4/18/20","15","3","42031","20"
"Clearfield","0","9","Pennsylvania","4/18/20","9","0","42033","0"
"Clinton","1","11","Pennsylvania","4/18/20","7","4","42035","57.14"
"Columbia","12","184","Pennsylvania","4/18/20","99","85","42037","85.86"
"Crawford","0","16","Pennsylvania","4/18/20","15","1","42039","6.67"
"Cumberland","10","176","Pennsylvania","4/18/20","105","71","42041","67.62"
"Dauphin","19","343","Pennsylvania","4/18/20","213","130","42043","61.03"
"Delaware","115","2317","Pennsylvania","4/18/20","1510","807","42045","53.44"
"Elk","0","2","Pennsylvania","4/18/20","2","0","42047","0"
"Erie","3","58","Pennsylvania","4/18/20","39","19","42049","48.72"
"Fayette","2","66","Pennsylvania","4/18/20","50","16","42051","32"
"Forest","0","7","Pennsylvania","4/18/20","5","2","42053","40"
"Franklin","7","106","Pennsylvania","4/18/20","59","47","42055","79.66"
"Fulton","0","2","Pennsylvania","4/18/20","1","1","42057","100"
"Greene","0","24","Pennsylvania","4/18/20","23","1","42059","4.35"
"Huntingdon","0","12","Pennsylvania","4/18/20","10","2","42061","20"
"Indiana","1","47","Pennsylvania","4/18/20","40","7","42063","17.5"
"Jefferson","0","2","Pennsylvania","4/18/20","1","1","42065","100"
"Juniata","4","66","Pennsylvania","4/18/20","38","28","42067","73.68"
"Lackawanna","33","620","Pennsylvania","4/18/20","392","228","42069","58.16"
"Lancaster","59","1113","Pennsylvania","4/18/20","698","415","42071","59.46"
"Lawrence","2","60","Pennsylvania","4/18/20","46","14","42073","30.43"
"Lebanon","32","458","Pennsylvania","4/18/20","232","226","42075","97.41"
"Lehigh","74","2141","Pennsylvania","4/18/20","1620","521","42077","32.16"
"Luzerne","49","1712","Pennsylvania","4/18/20","1372","340","42079","24.78"
"Lycoming","2","36","Pennsylvania","4/18/20","20","16","42081","80"
"McKean","0","4","Pennsylvania","4/18/20","2","2","42083","100"
"Mercer","3","57","Pennsylvania","4/18/20","38","19","42085","50"
"Mifflin","1","19","Pennsylvania","4/18/20","10","9","42087","90"
"Monroe","24","943","Pennsylvania","4/18/20","774","169","42089","21.83"
"Montgomery","104","2781","Pennsylvania","4/18/20","2053","728","42091","35.46"
"Montour","2","49","Pennsylvania","4/18/20","37","12","42093","32.43"
"Northampton","51","1396","Pennsylvania","4/18/20","1039","357","42095","34.36"
"Northumberland","5","67","Pennsylvania","4/18/20","31","36","42097","116.13"
"Perry","1","20","Pennsylvania","4/18/20","16","4","42099","25"
"Philadelphia","427","9014","Pennsylvania","4/18/20","6022","2992","42101","49.68"
"Pike","12","295","Pennsylvania","4/18/20","208","87","42103","41.83"
"Potter","0","4","Pennsylvania","4/18/20","4","0","42105","0"
"Schuylkill","11","254","Pennsylvania","4/18/20","179","75","42107","41.9"
"Snyder","2","27","Pennsylvania","4/18/20","16","11","42109","68.75"
"Somerset","1","17","Pennsylvania","4/18/20","10","7","42111","70"
"Sullivan","0","1","Pennsylvania","4/18/20","1","0","42113","0"
"Susquehanna","5","59","Pennsylvania","4/18/20","23","36","42115","156.52"
"Tioga","0","14","Pennsylvania","4/18/20","12","2","42117","16.67"
"Union","2","27","Pennsylvania","4/18/20","14","13","42119","92.86"
"Venango","0","6","Pennsylvania","4/18/20","6","0","42121","0"
"Warren","0","1","Pennsylvania","4/18/20","1","0","42123","0"
"Washington","2","79","Pennsylvania","4/18/20","66","13","42125","19.7"
"Wayne","4","84","Pennsylvania","4/18/20","57","27","42127","47.37"
"Westmoreland","9","280","Pennsylvania","4/18/20","218","62","42129","28.44"
"Wyoming","1","16","Pennsylvania","4/18/20","8","8","42131","100"
"York","24","463","Pennsylvania","4/18/20","293","170","42133","58.02"
"","47","1118","Puerto Rico","4/18/20","788","330",,"41.88"
"Bristol","3","57","Rhode Island","4/18/20","39","18","44001","46.15"
"Kent","19","299","Rhode Island","4/18/20","169","130","44003","76.92"
"Newport","4","103","Rhode Island","4/18/20","74","29","44005","39.19"
"Providence","204","2703","Rhode Island","4/18/20","1278","1425","44007","111.5"
"Washington","6","183","Rhode Island","4/18/20","140","43","44009","30.71"
"Abbeville","1","15","South Carolina","4/18/20","9","6","45001","66.67"
"Aiken","2","67","South Carolina","4/18/20","50","17","45003","34"
"Allendale","0","6","South Carolina","4/18/20","4","2","45005","50"
"Anderson","4","133","South Carolina","4/18/20","102","31","45007","30.39"
"Bamberg","0","7","South Carolina","4/18/20","7","0","45009","0"
"Barnwell","0","5","South Carolina","4/18/20","5","0","45011","0"
"Beaufort","4","220","South Carolina","4/18/20","191","29","45013","15.18"
"Berkeley","8","124","South Carolina","4/18/20","67","57","45015","85.07"
"Calhoun","0","6","South Carolina","4/18/20","6","0","45017","0"
"Charleston","8","385","South Carolina","4/18/20","331","54","45019","16.31"
"Cherokee","1","13","South Carolina","4/18/20","8","5","45021","62.5"
"Chester","1","23","South Carolina","4/18/20","18","5","45023","27.78"
"Chesterfield","2","35","South Carolina","4/18/20","22","13","45025","59.09"
"Clarendon","3","109","South Carolina","4/18/20","85","24","45027","28.24"
"Colleton","1","23","South Carolina","4/18/20","15","8","45029","53.33"
"Darlington","3","59","South Carolina","4/18/20","37","22","45031","59.46"
"Dillon","2","17","South Carolina","4/18/20","5","12","45033","240"
"Dorchester","2","84","South Carolina","4/18/20","67","17","45035","25.37"
"Edgefield","0","11","South Carolina","4/18/20","10","1","45037","10"
"Fairfield","1","25","South Carolina","4/18/20","21","4","45039","19.05"
"Florence","9","128","South Carolina","4/18/20","66","62","45041","93.94"
"Georgetown","0","34","South Carolina","4/18/20","32","2","45043","6.25"
"Greenville","23","486","South Carolina","4/18/20","325","161","45045","49.54"
"Greenwood","2","34","South Carolina","4/18/20","17","17","45047","100"
"Hampton","2","20","South Carolina","4/18/20","6","14","45049","233.33"
"Horry","6","176","South Carolina","4/18/20","132","44","45051","33.33"
"Jasper","1","16","South Carolina","4/18/20","12","4","45053","33.33"
"Kershaw","2","195","South Carolina","4/18/20","178","17","45055","9.55"
"Lancaster","2","73","South Carolina","4/18/20","62","11","45057","17.74"
"Laurens","1","19","South Carolina","4/18/20","13","6","45059","46.15"
"Lee","2","40","South Carolina","4/18/20","27","13","45061","48.15"
"Lexington","10","271","South Carolina","4/18/20","202","69","45063","34.16"
"Marion","1","13","South Carolina","4/18/20","6","7","45067","116.67"
"Marlboro","2","25","South Carolina","4/18/20","13","12","45069","92.31"
"McCormick","0","6","South Carolina","4/18/20","3","3","45065","100"
"Newberry","1","23","South Carolina","4/18/20","13","10","45071","76.92"
"Oconee","0","16","South Carolina","4/18/20","13","3","45073","23.08"
"Orangeburg","1","41","South Carolina","4/18/20","37","4","45075","10.81"
"Pickens","1","38","South Carolina","4/18/20","28","10","45077","35.71"
"Richland","21","626","South Carolina","4/18/20","479","147","45079","30.69"
"Saluda","0","10","South Carolina","4/18/20","7","3","45081","42.86"
"Spartanburg","6","211","South Carolina","4/18/20","170","41","45083","24.12"
"Sumter","5","181","South Carolina","4/18/20","146","35","45085","23.97"
"Union","0","23","South Carolina","4/18/20","22","1","45087","4.55"
"Williamsburg","1","20","South Carolina","4/18/20","15","5","45089","33.33"
"York","4","156","South Carolina","4/18/20","127","29","45091","22.83"
"Aurora","0","1","South Dakota","4/18/20","1","0","46003","0"
"Beadle","0","21","South Dakota","4/18/20","21","0","46005","0"
"Bon Homme","0","4","South Dakota","4/18/20","3","1","46009","33.33"
"Brookings","0","9","South Dakota","4/18/20","6","3","46011","50"
"Brown","1","18","South Dakota","4/18/20","14","4","46013","28.57"
"Charles Mix","0","4","South Dakota","4/18/20","3","1","46023","33.33"
"Clark","0","1","South Dakota","4/18/20","1","0","46025","0"
"Clay","0","5","South Dakota","4/18/20","6","-1","46027","-16.67"
"Codington","0","13","South Dakota","4/18/20","12","1","46029","8.33"
"Corson","0","1","South Dakota","4/18/20","1","0","46031","0"
"Davison","0","3","South Dakota","4/18/20","3","0","46035","0"
"Day","0","1","South Dakota","4/18/20","0","1","46037","1"
"Deuel","0","1","South Dakota","4/18/20","1","0","46039","0"
"Fall River","0","1","South Dakota","4/18/20","1","0","46047","0"
"Faulk","0","1","South Dakota","4/18/20","1","0","46049","0"
"Hamlin","0","2","South Dakota","4/18/20","1","1","46057","100"
"Hughes","0","5","South Dakota","4/18/20","4","1","46065","25"
"Hutchinson","0","2","South Dakota","4/18/20","2","0","46067","0"
"Hyde","0","1","South Dakota","4/18/20","0","1","46069","1"
"Jerauld","0","4","South Dakota","4/18/20","3","1","46073","33.33"
"Lake","0","3","South Dakota","4/18/20","2","1","46079","50"
"Lawrence","0","9","South Dakota","4/18/20","9","0","46081","0"
"Lincoln","7","86","South Dakota","4/18/20","39","47","46083","120.51"
"Lyman","0","2","South Dakota","4/18/20","2","0","46085","0"
"Marshall","0","1","South Dakota","4/18/20","1","0","46091","0"
"McCook","0","3","South Dakota","4/18/20","2","1","46087","50"
"Meade","0","1","South Dakota","4/18/20","1","0","46093","0"
"Miner","0","1","South Dakota","4/18/20","1","0","46097","0"
"Minnehaha","120","1276","South Dakota","4/18/20","438","838","46099","191.32"
"Moody","0","1","South Dakota","4/18/20","0","1","46101","1"
"Oglala Lakota","0","1","South Dakota","4/18/20","1","0","46102","0"
"Pennington","0","10","South Dakota","4/18/20","8","2","46103","25"
"Roberts","0","4","South Dakota","4/18/20","4","0","46109","0"
"Sanborn","0","3","South Dakota","4/18/20","1","2","46111","200"
"Spink","0","3","South Dakota","4/18/20","3","0","46115","0"
"Sully","0","1","South Dakota","4/18/20","0","1","46119","1"
"Todd","0","1","South Dakota","4/18/20","1","0","46121","0"
"Turner","0","5","South Dakota","4/18/20","5","0","46125","0"
"Union","0","5","South Dakota","4/18/20","4","1","46127","25"
"Walworth","1","5","South Dakota","4/18/20","0","5","46129","1"
"Yankton","0","23","South Dakota","4/18/20","20","3","46135","15"
"Anderson","1","16","Tennessee","4/18/20","12","4","47001","33.33"
"Bedford","4","48","Tennessee","4/18/20","17","31","47003","182.35"
"Benton","0","4","Tennessee","4/18/20","4","0","47005","0"
"Bledsoe","1","8","Tennessee","4/18/20","3","5","47007","166.67"
"Blount","0","46","Tennessee","4/18/20","46","0","47009","0"
"Bradley","1","38","Tennessee","4/18/20","31","7","47011","22.58"
"Campbell","0","13","Tennessee","4/18/20","10","3","47013","30"
"Cannon","0","9","Tennessee","4/18/20","7","2","47015","28.57"
"Carroll","0","13","Tennessee","4/18/20","10","3","47017","30"
"Carter","0","5","Tennessee","4/18/20","3","2","47019","66.67"
"Cheatham","1","21","Tennessee","4/18/20","17","4","47021","23.53"
"Chester","0","6","Tennessee","4/18/20","6","0","47023","0"
"Claiborne","0","5","Tennessee","4/18/20","3","2","47025","66.67"
"Clay","0","5","Tennessee","4/18/20","2","3","47027","150"
"Cocke","1","11","Tennessee","4/18/20","3","8","47029","266.67"
"Coffee","1","18","Tennessee","4/18/20","11","7","47031","63.64"
"Cumberland","2","56","Tennessee","4/18/20","40","16","47035","40"
"Davidson","51","1465","Tennessee","4/18/20","1111","354","47037","31.86"
"Decatur","1","5","Tennessee","4/18/20","1","4","47039","400"
"DeKalb","0","10","Tennessee","4/18/20","9","1","47041","11.11"
"Dickson","2","42","Tennessee","4/18/20","30","12","47043","40"
"Dyer","1","24","Tennessee","4/18/20","18","6","47045","33.33"
"Fayette","2","44","Tennessee","4/18/20","30","14","47047","46.67"
"Fentress","0","4","Tennessee","4/18/20","2","2","47049","100"
"Franklin","0","23","Tennessee","4/18/20","22","1","47051","4.55"
"Gibson","1","27","Tennessee","4/18/20","19","8","47053","42.11"
"Giles","0","5","Tennessee","4/18/20","3","2","47055","66.67"
"Grainger","0","4","Tennessee","4/18/20","4","0","47057","0"
"Greene","1","30","Tennessee","4/18/20","26","4","47059","15.38"
"Grundy","1","25","Tennessee","4/18/20","21","4","47061","19.05"
"Hamblen","0","7","Tennessee","4/18/20","4","3","47063","75"
"Hamilton","1","114","Tennessee","4/18/20","105","9","47065","8.57"
"Hardeman","0","7","Tennessee","4/18/20","7","0","47069","0"
"Hardin","0","4","Tennessee","4/18/20","2","2","47071","100"
"Hawkins","1","27","Tennessee","4/18/20","22","5","47073","22.73"
"Haywood","0","12","Tennessee","4/18/20","13","-1","47075","-7.69"
"Henderson","0","2","Tennessee","4/18/20","2","0","47077","0"
"Henry","0","9","Tennessee","4/18/20","6","3","47079","50"
"Hickman","0","2","Tennessee","4/18/20","2","0","47081","0"
"Houston","0","4","Tennessee","4/18/20","3","1","47083","33.33"
"Humphreys","0","4","Tennessee","4/18/20","4","0","47085","0"
"Jackson","0","6","Tennessee","4/18/20","5","1","47087","20"
"Jefferson","0","16","Tennessee","4/18/20","14","2","47089","14.29"
"Johnson","0","2","Tennessee","4/18/20","2","0","47091","0"
"Knox","4","194","Tennessee","4/18/20","169","25","47093","14.79"
"Lake","1","4","Tennessee","4/18/20","0","4","47095","1"
"Lauderdale","1","13","Tennessee","4/18/20","8","5","47097","62.5"
"Lawrence","0","15","Tennessee","4/18/20","12","3","47099","25"
"Lewis","0","2","Tennessee","4/18/20","2","0","47101","0"
"Lincoln","0","9","Tennessee","4/18/20","8","1","47103","12.5"
"Loudon","1","21","Tennessee","4/18/20","16","5","47105","31.25"
"Macon","1","31","Tennessee","4/18/20","23","8","47111","34.78"
"Madison","4","83","Tennessee","4/18/20","56","27","47113","48.21"
"Marion","1","28","Tennessee","4/18/20","24","4","47115","16.67"
"Marshall","1","13","Tennessee","4/18/20","9","4","47117","44.44"
"Maury","0","34","Tennessee","4/18/20","32","2","47119","6.25"
"McMinn","0","6","Tennessee","4/18/20","4","2","47107","50"
"McNairy","0","9","Tennessee","4/18/20","9","0","47109","0"
"Meigs","0","3","Tennessee","4/18/20","3","0","47121","0"
"Monroe","0","10","Tennessee","4/18/20","8","2","47123","25"
"Montgomery","3","108","Tennessee","4/18/20","88","20","47125","22.73"
"Moore","0","1","Tennessee","4/18/20","0","1","47127","1"
"Morgan","0","5","Tennessee","4/18/20","5","0","47129","0"
"Obion","0","9","Tennessee","4/18/20","7","2","47131","28.57"
"Out of TN","-2","259","Tennessee","4/18/20","276","-17","80047","-6.16"
"Overton","0","7","Tennessee","4/18/20","5","2","47133","40"
"Perry","0","6","Tennessee","4/18/20","3","3","47135","100"
"Polk","0","5","Tennessee","4/18/20","5","0","47139","0"
"Putnam","1","94","Tennessee","4/18/20","85","9","47141","10.59"
"Rhea","0","1","Tennessee","4/18/20","0","1","47143","1"
"Roane","0","8","Tennessee","4/18/20","5","3","47145","60"
"Robertson","3","105","Tennessee","4/18/20","81","24","47147","29.63"
"Rutherford","9","295","Tennessee","4/18/20","235","60","47149","25.53"
"Scott","0","11","Tennessee","4/18/20","8","3","47151","37.5"
"Sequatchie","0","3","Tennessee","4/18/20","1","2","47153","200"
"Sevier","0","24","Tennessee","4/18/20","21","3","47155","14.29"
"Shelby","76","1682","Tennessee","4/18/20","1147","535","47157","46.64"
"Smith","1","12","Tennessee","4/18/20","7","5","47159","71.43"
"Stewart","0","5","Tennessee","4/18/20","4","1","47161","25"
"Sullivan","1","45","Tennessee","4/18/20","37","8","47163","21.62"
"Sumner","9","497","Tennessee","4/18/20","435","62","47165","14.25"
"Tipton","2","55","Tennessee","4/18/20","44","11","47167","25"
"Trousdale","0","20","Tennessee","4/18/20","17","3","47169","17.65"
"Unicoi","0","1","Tennessee","4/18/20","1","0","47171","0"
"Union","0","3","Tennessee","4/18/20","3","0","47173","0"
"Van Buren","0","1","Tennessee","4/18/20","0","1","47175","1"
"Warren","0","4","Tennessee","4/18/20","4","0","47177","0"
"Washington","1","46","Tennessee","4/18/20","37","9","47179","24.32"
"Wayne","0","2","Tennessee","4/18/20","2","0","47181","0"
"Weakley","0","6","Tennessee","4/18/20","5","1","47183","20"
"White","0","4","Tennessee","4/18/20","3","1","47185","33.33"
"Williamson","3","336","Tennessee","4/18/20","312","24","47187","7.69"
"Wilson","5","171","Tennessee","4/18/20","135","36","47189","26.67"
"Anderson","0","6","Texas","4/18/20","3","3","48001","100"
"Andrews","1","19","Texas","4/18/20","11","8","48003","72.73"
"Angelina","1","23","Texas","4/18/20","16","7","48005","43.75"
"Aransas","0","2","Texas","4/18/20","2","0","48007","0"
"Armstrong","0","1","Texas","4/18/20","0","1","48011","1"
"Atascosa","0","10","Texas","4/18/20","8","2","48013","25"
"Austin","1","12","Texas","4/18/20","8","4","48015","50"
"Bandera","0","4","Texas","4/18/20","2","2","48019","100"
"Bastrop","2","42","Texas","4/18/20","26","16","48021","61.54"
"Bee","0","5","Texas","4/18/20","2","3","48025","150"
"Bell","5","126","Texas","4/18/20","91","35","48027","38.46"
"Bexar","42","959","Texas","4/18/20","665","294","48029","44.21"
"Blanco","0","5","Texas","4/18/20","4","1","48031","25"
"Bosque","0","1","Texas","4/18/20","0","1","48035","1"
"Bowie","4","56","Texas","4/18/20","30","26","48037","86.67"
"Brazoria","12","302","Texas","4/18/20","216","86","48039","39.81"
"Brazos","5","169","Texas","4/18/20","134","35","48041","26.12"
"Brown","0","12","Texas","4/18/20","10","2","48049","20"
"Burleson","0","9","Texas","4/18/20","6","3","48051","50"
"Burnet","0","8","Texas","4/18/20","6","2","48053","33.33"
"Caldwell","0","7","Texas","4/18/20","6","1","48055","16.67"
"Calhoun","1","21","Texas","4/18/20","14","7","48057","50"
"Callahan","0","1","Texas","4/18/20","1","0","48059","0"
"Cameron","17","279","Texas","4/18/20","159","120","48061","75.47"
"Camp","0","6","Texas","4/18/20","3","3","48063","100"
"Cass","1","10","Texas","4/18/20","4","6","48067","150"
"Castro","0","11","Texas","4/18/20","11","0","48069","0"
"Chambers","2","35","Texas","4/18/20","24","11","48071","45.83"
"Cherokee","1","10","Texas","4/18/20","6","4","48073","66.67"
"Clay","0","3","Texas","4/18/20","2","1","48077","50"
"Collin","14","522","Texas","4/18/20","425","97","48085","22.82"
"Colorado","0","8","Texas","4/18/20","7","1","48089","14.29"
"Comal","1","43","Texas","4/18/20","37","6","48091","16.22"
"Comanche","0","3","Texas","4/18/20","3","0","48093","0"
"Concho","0","1","Texas","4/18/20","1","0","48095","0"
"Cooke","0","4","Texas","4/18/20","1","3","48097","300"
"Coryell","6","75","Texas","4/18/20","34","41","48099","120.59"
"Crane","0","2","Texas","4/18/20","2","0","48103","0"
"Crosby","0","1","Texas","4/18/20","1","0","48107","0"
"Dallam","0","3","Texas","4/18/20","1","2","48111","200"
"Dallas","97","2324","Texas","4/18/20","1644","680","48113","41.36"
"Dawson","1","12","Texas","4/18/20","7","5","48115","71.43"
"Deaf Smith","1","11","Texas","4/18/20","7","4","48117","57.14"
"Delta","0","1","Texas","4/18/20","1","0","48119","0"
"Denton","19","585","Texas","4/18/20","454","131","48121","28.85"
"DeWitt","1","13","Texas","4/18/20","9","4","48123","44.44"
"Dickens","0","1","Texas","4/18/20","2","-1","48125","-50"
"Dimmit","0","1","Texas","4/18/20","1","0","48127","0"
"Donley","0","23","Texas","4/18/20","23","0","48129","0"
"Duval","0","1","Texas","4/18/20","0","1","48131","1"
"Eastland","0","3","Texas","4/18/20","3","0","48133","0"
"Ector","3","58","Texas","4/18/20","40","18","48135","45"
"El Paso","33","482","Texas","4/18/20","252","230","48141","91.27"
"Ellis","2","83","Texas","4/18/20","66","17","48139","25.76"
"Erath","0","13","Texas","4/18/20","13","0","48143","0"
"Falls","0","1","Texas","4/18/20","1","0","48145","0"
"Fannin","0","7","Texas","4/18/20","5","2","48147","40"
"Fayette","1","15","Texas","4/18/20","9","6","48149","66.67"
"Floyd","0","2","Texas","4/18/20","1","1","48153","100"
"Fort Bend","34","755","Texas","4/18/20","518","237","48157","45.75"
"Franklin","0","1","Texas","4/18/20","1","0","48159","0"
"Freestone","0","3","Texas","4/18/20","0","3","48161","1"
"Frio","0","1","Texas","4/18/20","1","0","48163","0"
"Gaines","0","2","Texas","4/18/20","1","1","48165","100"
"Galveston","14","438","Texas","4/18/20","341","97","48167","28.45"
"Gillespie","0","1","Texas","4/18/20","1","0","48171","0"
"Goliad","0","5","Texas","4/18/20","4","1","48175","25"
"Gonzales","0","2","Texas","4/18/20","2","0","48177","0"
"Gray","1","17","Texas","4/18/20","13","4","48179","30.77"
"Grayson","0","19","Texas","4/18/20","17","2","48181","11.76"
"Gregg","2","51","Texas","4/18/20","40","11","48183","27.5"
"Grimes","1","10","Texas","4/18/20","6","4","48185","66.67"
"Guadalupe","1","53","Texas","4/18/20","47","6","48187","12.77"
"Hale","0","11","Texas","4/18/20","11","0","48189","0"
"Hamilton","0","5","Texas","4/18/20","3","2","48193","66.67"
"Hansford","0","1","Texas","4/18/20","1","0","48195","0"
"Hardin","4","75","Texas","4/18/20","47","28","48199","59.57"
"Harris","156","4653","Texas","4/18/20","3561","1092","48201","30.67"
"Harrison","4","42","Texas","4/18/20","14","28","48203","200"
"Hays","6","121","Texas","4/18/20","82","39","48209","47.56"
"Hemphill","0","1","Texas","4/18/20","1","0","48211","0"
"Henderson","0","13","Texas","4/18/20","10","3","48213","30"
"Hidalgo","9","242","Texas","4/18/20","181","61","48215","33.7"
"Hill","0","10","Texas","4/18/20","8","2","48217","25"
"Hockley","0","15","Texas","4/18/20","13","2","48219","15.38"
"Hood","1","17","Texas","4/18/20","13","4","48221","30.77"
"Hopkins","0","4","Texas","4/18/20","4","0","48223","0"
"Houston","0","3","Texas","4/18/20","0","3","48225","1"
"Howard","0","1","Texas","4/18/20","1","0","48227","0"
"Hunt","1","25","Texas","4/18/20","16","9","48231","56.25"
"Hutchinson","1","7","Texas","4/18/20","2","5","48233","250"
"Jack","0","3","Texas","4/18/20","1","2","48237","200"
"Jackson","0","4","Texas","4/18/20","4","0","48239","0"
"Jasper","0","9","Texas","4/18/20","7","2","48241","28.57"
"Jefferson","10","171","Texas","4/18/20","100","71","48245","71"
"Jim Wells","0","2","Texas","4/18/20","2","0","48249","0"
"Johnson","2","39","Texas","4/18/20","28","11","48251","39.29"
"Jones","0","3","Texas","4/18/20","2","1","48253","50"
"Karnes","0","3","Texas","4/18/20","2","1","48255","50"
"Kaufman","2","42","Texas","4/18/20","26","16","48257","61.54"
"Kendall","1","14","Texas","4/18/20","10","4","48259","40"
"Kerr","0","4","Texas","4/18/20","2","2","48265","100"
"Kleberg","0","5","Texas","4/18/20","2","3","48273","150"
"Knox","0","1","Texas","4/18/20","1","0","48275","0"
"La Salle","0","1","Texas","4/18/20","0","1","48283","1"
"Lamar","0","7","Texas","4/18/20","8","-1","48277","-12.5"
"Lamb","0","2","Texas","4/18/20","1","1","48279","100"
"Lampasas","0","2","Texas","4/18/20","2","0","48281","0"
"Lavaca","0","4","Texas","4/18/20","4","0","48285","0"
"Lee","0","2","Texas","4/18/20","2","0","48287","0"
"Leon","0","5","Texas","4/18/20","3","2","48289","66.67"
"Liberty","2","29","Texas","4/18/20","17","12","48291","70.59"
"Limestone","0","11","Texas","4/18/20","11","0","48293","0"
"Live Oak","0","3","Texas","4/18/20","3","0","48297","0"
"Llano","0","3","Texas","4/18/20","3","0","48299","0"
"Lubbock","23","407","Texas","4/18/20","249","158","48303","63.45"
"Lynn","0","5","Texas","4/18/20","5","0","48305","0"
"Madison","0","2","Texas","4/18/20","1","1","48313","100"
"Marion","0","3","Texas","4/18/20","0","3","48315","1"
"Martin","0","2","Texas","4/18/20","2","0","48317","0"
"Mason","0","1","Texas","4/18/20","1","0","48319","0"
"Matagorda","0","51","Texas","4/18/20","49","2","48321","4.08"
"Maverick","0","12","Texas","4/18/20","9","3","48323","33.33"
"McCulloch","0","3","Texas","4/18/20","3","0","48307","0"
"McLennan","1","76","Texas","4/18/20","68","8","48309","11.76"
"Medina","0","15","Texas","4/18/20","12","3","48325","25"
"Midland","2","42","Texas","4/18/20","31","11","48329","35.48"
"Milam","0","9","Texas","4/18/20","7","2","48331","28.57"
"Mitchell","0","1","Texas","4/18/20","1","0","48335","0"
"Montague","0","5","Texas","4/18/20","2","3","48337","150"
"Montgomery","17","370","Texas","4/18/20","251","119","48339","47.41"
"Moore","11","99","Texas","4/18/20","21","78","48341","371.43"
"Morris","0","4","Texas","4/18/20","3","1","48343","33.33"
"Motley","0","1","Texas","4/18/20","0","1","48345","1"
"Nacogdoches","8","88","Texas","4/18/20","31","57","48347","183.87"
"Navarro","1","20","Texas","4/18/20","12","8","48349","66.67"
"Newton","0","2","Texas","4/18/20","2","0","48351","0"
"Nueces","2","89","Texas","4/18/20","72","17","48355","23.61"
"Oldham","0","3","Texas","4/18/20","3","0","48359","0"
"Orange","3","53","Texas","4/18/20","33","20","48361","60.61"
"Palo Pinto","0","7","Texas","4/18/20","4","3","48363","75"
"Panola","4","38","Texas","4/18/20","13","25","48365","192.31"
"Parker","1","21","Texas","4/18/20","13","8","48367","61.54"
"Pecos","1","5","Texas","4/18/20","1","4","48371","400"
"Polk","1","14","Texas","4/18/20","9","5","48373","55.56"
"Potter","6","110","Texas","4/18/20","66","44","48375","66.67"
"Rains","0","2","Texas","4/18/20","1","1","48379","100"
"Randall","5","97","Texas","4/18/20","60","37","48381","61.67"
"Red River","0","1","Texas","4/18/20","0","1","48387","1"
"Reeves","0","2","Texas","4/18/20","1","1","48389","100"
"Roberts","0","2","Texas","4/18/20","0","2","48393","1"
"Robertson","0","2","Texas","4/18/20","2","0","48395","0"
"Rockwall","3","39","Texas","4/18/20","20","19","48397","95"
"Rusk","2","28","Texas","4/18/20","14","14","48401","100"
"Sabine","0","1","Texas","4/18/20","0","1","48403","1"
"San Augustine","1","14","Texas","4/18/20","9","5","48405","55.56"
"San Jacinto","1","10","Texas","4/18/20","5","5","48407","100"
"San Patricio","0","8","Texas","4/18/20","7","1","48409","14.29"
"Scurry","0","2","Texas","4/18/20","0","2","48415","1"
"Shelby","4","60","Texas","4/18/20","34","26","48419","76.47"
"Sherman","1","7","Texas","4/18/20","0","7","48421","1"
"Smith","3","116","Texas","4/18/20","93","23","48423","24.73"
"Starr","0","7","Texas","4/18/20","7","0","48427","0"
"Stephens","0","1","Texas","4/18/20","1","0","48429","0"
"Swisher","0","4","Texas","4/18/20","3","1","48437","33.33"
"Tarrant","75","1229","Texas","4/18/20","705","524","48439","74.33"
"Taylor","10","126","Texas","4/18/20","55","71","48441","129.09"
"Terry","0","10","Texas","4/18/20","7","3","48445","42.86"
"Titus","0","8","Texas","4/18/20","6","2","48449","33.33"
"Tom Green","1","41","Texas","4/18/20","35","6","48451","17.14"
"Travis","55","1074","Texas","4/18/20","690","384","48453","55.65"
"Trinity","1","7","Texas","4/18/20","3","4","48455","133.33"
"Tyler","0","6","Texas","4/18/20","4","2","48457","50"
"Upshur","0","9","Texas","4/18/20","6","3","48459","50"
"Uvalde","0","6","Texas","4/18/20","6","0","48463","0"
"Val Verde","0","12","Texas","4/18/20","10","2","48465","20"
"Van Zandt","0","12","Texas","4/18/20","10","2","48467","20"
"Victoria","2","89","Texas","4/18/20","76","13","48469","17.11"
"Walker","7","68","Texas","4/18/20","17","51","48471","300"
"Waller","1","23","Texas","4/18/20","14","9","48473","64.29"
"Washington","2","50","Texas","4/18/20","36","14","48477","38.89"
"Webb","12","253","Texas","4/18/20","171","82","48479","47.95"
"Wharton","1","34","Texas","4/18/20","24","10","48481","41.67"
"Wichita","1","58","Texas","4/18/20","54","4","48485","7.41"
"Wilbarger","0","1","Texas","4/18/20","0","1","48487","1"
"Willacy","0","8","Texas","4/18/20","5","3","48489","60"
"Williamson","5","146","Texas","4/18/20","110","36","48491","32.73"
"Wilson","1","19","Texas","4/18/20","10","9","48493","90"
"Winkler","0","3","Texas","4/18/20","1","2","48495","200"
"Wise","1","9","Texas","4/18/20","5","4","48497","80"
"Wood","0","6","Texas","4/18/20","5","1","48499","20"
"Young","0","4","Texas","4/18/20","3","1","48503","33.33"
"Zapata","0","6","Texas","4/18/20","3","3","48505","100"
"Zavala","0","1","Texas","4/18/20","0","1","48507","1"
"Bear River","6","52","Utah","4/18/20","12","40","00000","333.33"
"Cache","-5","0","Utah","4/18/20","34","-34","49005","-100"
"Carbon","0","0","Utah","4/18/20","2","-2","49007","-100"
"Davis","5","230","Utah","4/18/20","193","37","49011","19.17"
"Duchesne","0","0","Utah","4/18/20","3","-3","49013","-100"
"Emery","0","0","Utah","4/18/20","2","-2","49015","-100"
"Garfield","0","0","Utah","4/18/20","1","-1","49017","-100"
"Grand","0","0","Utah","4/18/20","1","-1","49019","-100"
"Iron","-2","0","Utah","4/18/20","13","-13","49021","-100"
"Kane","0","0","Utah","4/18/20","3","-3","49025","-100"
"Salt Lake","68","1547","Utah","4/18/20","1071","476","49035","44.44"
"San Juan","1","18","Utah","4/18/20","8","10","49037","125"
"Summit","2","316","Utah","4/18/20","300","16","49043","5.33"
"Tooele","1","39","Utah","4/18/20","31","8","49045","25.81"
"Uintah","-1","0","Utah","4/18/20","6","-6","49047","-100"
"Utah","17","417","Utah","4/18/20","295","122","49049","41.36"
"Wasatch","2","109","Utah","4/18/20","98","11","49051","11.22"
"Washington","5","77","Utah","4/18/20","41","36","49053","87.8"
"Weber-Morgan","3","112","Utah","4/18/20","93","19","00000","20.43"
"Addison","1","61","Vermont","4/18/20","54","7","50001","12.96"
"Bennington","1","37","Vermont","4/18/20","31","6","50003","19.35"
"Caledonia","0","10","Vermont","4/18/20","8","2","50005","25"
"Chittenden","5","384","Vermont","4/18/20","351","33","50007","9.4"
"Essex","0","1","Vermont","4/18/20","1","0","50009","0"
"Franklin","1","90","Vermont","4/18/20","80","10","50011","12.5"
"Grand Isle","0","3","Vermont","4/18/20","3","0","50013","0"
"Lamoille","0","23","Vermont","4/18/20","21","2","50015","9.52"
"Orange","0","5","Vermont","4/18/20","5","0","50017","0"
"Orleans","0","9","Vermont","4/18/20","8","1","50019","12.5"
"Rutland","1","42","Vermont","4/18/20","35","7","50021","20"
"Washington","0","31","Vermont","4/18/20","28","3","50023","10.71"
"Windham","2","63","Vermont","4/18/20","50","13","50025","26"
"Windsor","1","34","Vermont","4/18/20","25","9","50027","36"
"","0","53","Virgin Islands","4/18/20","51","2",,"3.92"
"Accomack","3","33","Virginia","4/18/20","15","18","51001","120"
"Albemarle","1","56","Virginia","4/18/20","46","10","51003","21.74"
"Alexandria","24","354","Virginia","4/18/20","188","166","51510","88.3"
"Alleghany","0","4","Virginia","4/18/20","4","0","51005","0"
"Amelia","1","13","Virginia","4/18/20","9","4","51007","44.44"
"Amherst","0","10","Virginia","4/18/20","10","0","51009","0"
"Appomattox","0","7","Virginia","4/18/20","7","0","51011","0"
"Arlington","24","520","Virginia","4/18/20","349","171","51013","49"
"Augusta","1","22","Virginia","4/18/20","17","5","51015","29.41"
"Bedford","0","17","Virginia","4/18/20","15","2","51019","13.33"
"Botetourt","0","23","Virginia","4/18/20","22","1","51023","4.55"
"Bristol","0","1","Virginia","4/18/20","1","0","51520","0"
"Brunswick","1","12","Virginia","4/18/20","3","9","51025","300"
"Buchanan","1","12","Virginia","4/18/20","2","10","51027","500"
"Buckingham","2","25","Virginia","4/18/20","14","11","51029","78.57"
"Buena Vista","0","5","Virginia","4/18/20","4","1","51530","25"
"Campbell","0","9","Virginia","4/18/20","9","0","51031","0"
"Caroline","1","13","Virginia","4/18/20","6","7","51033","116.67"
"Carroll","0","3","Virginia","4/18/20","3","0","51035","0"
"Charles City","0","11","Virginia","4/18/20","8","3","51036","37.5"
"Charlotte","1","8","Virginia","4/18/20","2","6","51037","300"
"Charlottesville","1","41","Virginia","4/18/20","31","10","51540","32.26"
"Chesapeake","6","154","Virginia","4/18/20","115","39","51550","33.91"
"Chesterfield","15","310","Virginia","4/18/20","203","107","51041","52.71"
"Clarke","0","6","Virginia","4/18/20","3","3","51043","100"
"Colonial Heights","2","23","Virginia","4/18/20","6","17","51570","283.33"
"Covington","0","1","Virginia","4/18/20","1","0","51580","0"
"Craig","0","2","Virginia","4/18/20","2","0","51045","0"
"Culpeper","3","39","Virginia","4/18/20","17","22","51047","129.41"
"Cumberland","0","10","Virginia","4/18/20","8","2","51049","25"
"Danville","1","24","Virginia","4/18/20","20","4","51590","20"
"Dinwiddie","0","7","Virginia","4/18/20","6","1","51053","16.67"
"Emporia","0","7","Virginia","4/18/20","7","0","51595","0"
"Essex","0","2","Virginia","4/18/20","0","2","51057","1"
"Fairfax","98","1633","Virginia","4/18/20","946","687","51059","72.62"
"Fairfax City","0","3","Virginia","4/18/20","1","2","51600","200"
"Fauquier","2","36","Virginia","4/18/20","25","11","51061","44"
"Floyd","0","1","Virginia","4/18/20","1","0","51063","0"
"Fluvanna","7","66","Virginia","4/18/20","19","47","51065","247.37"
"Franklin","0","15","Virginia","4/18/20","14","1","51067","7.14"
"Franklin City","1","12","Virginia","4/18/20","6","6","51620","100"
"Frederick","3","81","Virginia","4/18/20","63","18","51069","28.57"
"Fredericksburg","1","15","Virginia","4/18/20","11","4","51630","36.36"
"Galax","0","1","Virginia","4/18/20","1","0","51640","0"
"Giles","0","4","Virginia","4/18/20","2","2","51071","100"
"Gloucester","0","21","Virginia","4/18/20","20","1","51073","5"
"Goochland","4","55","Virginia","4/18/20","26","29","51075","111.54"
"Greene","1","8","Virginia","4/18/20","4","4","51079","100"
"Greensville","1","18","Virginia","4/18/20","8","10","51081","125"
"Halifax","0","8","Virginia","4/18/20","7","1","51083","14.29"
"Hampton","2","79","Virginia","4/18/20","64","15","51650","23.44"
"Hanover","6","79","Virginia","4/18/20","38","41","51085","107.89"
"Harrisonburg","22","233","Virginia","4/18/20","79","154","51660","194.94"
"Henrico","27","559","Virginia","4/18/20","368","191","51087","51.9"
"Henry","0","10","Virginia","4/18/20","8","2","51089","25"
"Hopewell","0","16","Virginia","4/18/20","14","2","51670","14.29"
"Isle of Wight","8","83","Virginia","4/18/20","28","55","51093","196.43"
"James City","2","139","Virginia","4/18/20","126","13","51095","10.32"
"King and Queen","0","2","Virginia","4/18/20","2","0","51097","0"
"King George","1","18","Virginia","4/18/20","13","5","51099","38.46"
"King William","0","2","Virginia","4/18/20","2","0","51101","0"
"Lancaster","0","1","Virginia","4/18/20","1","0","51103","0"
"Lee","0","7","Virginia","4/18/20","6","1","51105","16.67"
"Lexington","0","3","Virginia","4/18/20","3","0","51678","0"
"Loudoun","17","413","Virginia","4/18/20","296","117","51107","39.53"
"Louisa","1","33","Virginia","4/18/20","25","8","51109","32"
"Lunenburg","0","3","Virginia","4/18/20","3","0","51111","0"
"Lynchburg","1","38","Virginia","4/18/20","31","7","51680","22.58"
"Madison","0","8","Virginia","4/18/20","6","2","51113","33.33"
"Manassas","7","82","Virginia","4/18/20","34","48","51683","141.18"
"Manassas Park","2","21","Virginia","4/18/20","10","11","51685","110"
"Mathews","0","3","Virginia","4/18/20","2","1","51115","50"
"Mecklenburg","2","64","Virginia","4/18/20","53","11","51117","20.75"
"Middlesex","0","3","Virginia","4/18/20","3","0","51119","0"
"Montgomery","2","42","Virginia","4/18/20","31","11","51121","35.48"
"Nelson","0","5","Virginia","4/18/20","4","1","51125","25"
"New Kent","1","17","Virginia","4/18/20","12","5","51127","41.67"
"Newport News","4","102","Virginia","4/18/20","75","27","51700","36"
"Norfolk","3","109","Virginia","4/18/20","90","19","51710","21.11"
"Northampton","0","5","Virginia","4/18/20","4","1","51131","25"
"Northumberland","0","5","Virginia","4/18/20","4","1","51133","25"
"Norton","0","1","Virginia","4/18/20","0","1","51720","1"
"Nottoway","0","6","Virginia","4/18/20","4","2","51135","50"
"Orange","1","20","Virginia","4/18/20","13","7","51137","53.85"
"Page","1","13","Virginia","4/18/20","6","7","51139","116.67"
"Petersburg","1","21","Virginia","4/18/20","17","4","51730","23.53"
"Pittsylvania","0","6","Virginia","4/18/20","4","2","51143","50"
"Poquoson","0","6","Virginia","4/18/20","6","0","51735","0"
"Portsmouth","2","65","Virginia","4/18/20","49","16","51740","32.65"
"Powhatan","1","9","Virginia","4/18/20","5","4","51145","80"
"Prince Edward","1","17","Virginia","4/18/20","8","9","51147","112.5"
"Prince George","0","28","Virginia","4/18/20","26","2","51149","7.69"
"Prince William","44","700","Virginia","4/18/20","390","310","51153","79.49"
"Pulaski","1","8","Virginia","4/18/20","4","4","51155","100"
"Radford","0","1","Virginia","4/18/20","1","0","51750","0"
"Rappahannock","0","1","Virginia","4/18/20","1","0","51157","0"
"Richmond","0","8","Virginia","4/18/20","5","3","51159","60"
"Richmond City","9","211","Virginia","4/18/20","148","63","51760","42.57"
"Roanoke","1","20","Virginia","4/18/20","13","7","51161","53.85"
"Roanoke City","1","24","Virginia","4/18/20","17","7","51770","41.18"
"Rockbridge","0","5","Virginia","4/18/20","3","2","51163","66.67"
"Rockingham","8","100","Virginia","4/18/20","44","56","51165","127.27"
"Russell","0","2","Virginia","4/18/20","1","1","51167","100"
"Salem","1","6","Virginia","4/18/20","1","5","51775","500"
"Scott","0","4","Virginia","4/18/20","3","1","51169","33.33"
"Shenandoah","3","39","Virginia","4/18/20","16","23","51171","143.75"
"Smyth","0","12","Virginia","4/18/20","9","3","51173","33.33"
"Southampton","1","9","Virginia","4/18/20","5","4","51175","80"
"Spotsylvania","4","72","Virginia","4/18/20","47","25","51177","53.19"
"Stafford","11","143","Virginia","4/18/20","67","76","51179","113.43"
"Staunton","1","5","Virginia","4/18/20","1","4","51790","400"
"Suffolk","6","81","Virginia","4/18/20","40","41","51800","102.5"
"Surry","0","3","Virginia","4/18/20","3","0","51181","0"
"Sussex","0","11","Virginia","4/18/20","8","3","51183","37.5"
"Tazewell","0","4","Virginia","4/18/20","4","0","51185","0"
"Virginia Beach","5","271","Virginia","4/18/20","236","35","51810","14.83"
"Warren","1","24","Virginia","4/18/20","15","9","51187","60"
"Washington","0","27","Virginia","4/18/20","24","3","51191","12.5"
"Waynesboro","0","7","Virginia","4/18/20","5","2","51820","40"
"Westmoreland","0","10","Virginia","4/18/20","8","2","51193","25"
"Williamsburg","0","19","Virginia","4/18/20","17","2","51830","11.76"
"Winchester","1","25","Virginia","4/18/20","19","6","51840","31.58"
"Wise","1","18","Virginia","4/18/20","8","10","51195","125"
"Wythe","0","8","Virginia","4/18/20","7","1","51197","14.29"
"York","2","38","Virginia","4/18/20","27","11","51199","40.74"
"Adams","1","40","Washington","4/18/20","30","10","53001","33.33"
"Asotin","1","11","Washington","4/18/20","4","7","53003","175"
"Benton","9","306","Washington","4/18/20","244","62","53005","25.41"
"Chelan","2","67","Washington","4/18/20","53","14","53007","26.42"
"Clallam","1","15","Washington","4/18/20","11","4","53009","36.36"
"Clark","8","277","Washington","4/18/20","220","57","53011","25.91"
"Columbia","0","1","Washington","4/18/20","1","0","53013","0"
"Cowlitz","1","29","Washington","4/18/20","23","6","53015","26.09"
"Douglas","3","34","Washington","4/18/20","16","18","53017","112.5"
"Ferry","0","1","Washington","4/18/20","1","0","53019","0"
"Franklin","10","177","Washington","4/18/20","107","70","53021","65.42"
"Grant","4","140","Washington","4/18/20","110","30","53025","27.27"
"Grays Harbor","1","12","Washington","4/18/20","8","4","53027","50"
"Island","1","165","Washington","4/18/20","157","8","53029","5.1"
"Jefferson","0","28","Washington","4/18/20","28","0","53031","0"
"King","91","4902","Washington","4/18/20","4262","640","53033","15.02"
"Kitsap","1","135","Washington","4/18/20","128","7","53035","5.47"
"Kittitas","0","14","Washington","4/18/20","15","-1","53037","-6.67"
"Klickitat","1","16","Washington","4/18/20","12","4","53039","33.33"
"Lewis","0","19","Washington","4/18/20","18","1","53041","5.56"
"Lincoln","0","2","Washington","4/18/20","2","0","53043","0"
"Mason","1","22","Washington","4/18/20","18","4","53045","22.22"
"Okanogan","0","15","Washington","4/18/20","14","1","53047","7.14"
"Pacific","0","1","Washington","4/18/20","1","0","53049","0"
"Pend Oreille","0","2","Washington","4/18/20","1","1","53051","100"
"Pierce","23","1086","Washington","4/18/20","922","164","53053","17.79"
"San Juan","0","15","Washington","4/18/20","13","2","53055","15.38"
"Skagit","6","226","Washington","4/18/20","185","41","53057","22.16"
"Skamania","0","3","Washington","4/18/20","3","0","53059","0"
"Snohomish","37","2093","Washington","4/18/20","1835","258","53061","14.06"
"Spokane","7","302","Washington","4/18/20","251","51","53063","20.32"
"Stevens","0","8","Washington","4/18/20","6","2","53065","33.33"
"Thurston","1","89","Washington","4/18/20","81","8","53067","9.88"
"Wahkiakum","0","2","Washington","4/18/20","2","0","53069","0"
"Walla Walla","1","27","Washington","4/18/20","20","7","53071","35"
"Whatcom","2","276","Washington","4/18/20","261","15","53073","5.75"
"Whitman","0","15","Washington","4/18/20","12","3","53075","25"
"Yakima","35","759","Washington","4/18/20","511","248","53077","48.53"
"Barbour","0","4","West Virginia","4/18/20","4","0","54001","0"
"Berkeley","2","106","West Virginia","4/18/20","89","17","54003","19.1"
"Boone","0","2","West Virginia","4/18/20","1","1","54005","100"
"Braxton","0","1","West Virginia","4/18/20","1","0","54007","0"
"Brooke","0","3","West Virginia","4/18/20","3","0","54009","0"
"Cabell","1","29","West Virginia","4/18/20","21","8","54011","38.1"
"Fayette","0","4","West Virginia","4/18/20","2","2","54019","100"
"Grant","0","1","West Virginia","4/18/20","0","1","54023","1"
"Greenbrier","0","3","West Virginia","4/18/20","3","0","54025","0"
"Hampshire","0","6","West Virginia","4/18/20","4","2","54027","50"
"Hancock","0","7","West Virginia","4/18/20","7","0","54029","0"
"Hardy","0","3","West Virginia","4/18/20","2","1","54031","50"
"Harrison","0","28","West Virginia","4/18/20","28","0","54033","0"
"Jackson","3","43","West Virginia","4/18/20","23","20","54035","86.96"
"Jefferson","2","60","West Virginia","4/18/20","46","14","54037","30.43"
"Kanawha","3","106","West Virginia","4/18/20","82","24","54039","29.27"
"Lewis","0","2","West Virginia","4/18/20","2","0","54041","0"
"Lincoln","0","1","West Virginia","4/18/20","0","1","54043","1"
"Logan","0","8","West Virginia","4/18/20","8","0","54045","0"
"Marion","1","42","West Virginia","4/18/20","32","10","54049","31.25"
"Marshall","0","8","West Virginia","4/18/20","6","2","54051","33.33"
"Mason","0","10","West Virginia","4/18/20","7","3","54053","42.86"
"McDowell","0","6","West Virginia","4/18/20","4","2","54047","50"
"Mercer","0","8","West Virginia","4/18/20","8","0","54055","0"
"Mineral","1","8","West Virginia","4/18/20","4","4","54057","100"
"Mingo","0","2","West Virginia","4/18/20","0","2","54059","1"
"Monongalia","1","84","West Virginia","4/18/20","78","6","54061","7.69"
"Monroe","0","2","West Virginia","4/18/20","1","1","54063","100"
"Morgan","0","8","West Virginia","4/18/20","6","2","54065","33.33"
"Nicholas","0","3","West Virginia","4/18/20","2","1","54067","50"
"Ohio","0","23","West Virginia","4/18/20","21","2","54069","9.52"
"Pendleton","0","2","West Virginia","4/18/20","1","1","54071","100"
"Pleasants","0","1","West Virginia","4/18/20","1","0","54073","0"
"Preston","0","7","West Virginia","4/18/20","6","1","54077","16.67"
"Putnam","1","14","West Virginia","4/18/20","10","4","54079","40"
"Raleigh","0","7","West Virginia","4/18/20","5","2","54081","40"
"Randolph","0","4","West Virginia","4/18/20","4","0","54083","0"
"Roane","0","2","West Virginia","4/18/20","2","0","54087","0"
"Summers","0","1","West Virginia","4/18/20","0","1","54089","1"
"Taylor","0","5","West Virginia","4/18/20","3","2","54091","66.67"
"Tucker","0","4","West Virginia","4/18/20","3","1","54093","33.33"
"Tyler","0","3","West Virginia","4/18/20","3","0","54095","0"
"Upshur","0","4","West Virginia","4/18/20","3","1","54097","33.33"
"Wayne","8","75","West Virginia","4/18/20","17","58","54099","341.18"
"Wetzel","0","3","West Virginia","4/18/20","3","0","54103","0"
"Wirt","0","2","West Virginia","4/18/20","2","0","54105","0"
"Wood","2","29","West Virginia","4/18/20","18","11","54107","61.11"
"Wyoming","0","1","West Virginia","4/18/20","1","0","54109","0"
"Adams","0","4","Wisconsin","4/18/20","2","2","55001","100"
"Ashland","0","2","Wisconsin","4/18/20","1","1","55003","100"
"Barron","0","6","Wisconsin","4/18/20","6","0","55005","0"
"Bayfield","0","3","Wisconsin","4/18/20","3","0","55007","0"
"Brown","21","204","Wisconsin","4/18/20","60","144","55009","240"
"Buffalo","0","4","Wisconsin","4/18/20","3","1","55011","33.33"
"Calumet","0","5","Wisconsin","4/18/20","4","1","55015","25"
"Chippewa","0","21","Wisconsin","4/18/20","18","3","55017","16.67"
"Clark","1","14","Wisconsin","4/18/20","7","7","55019","100"
"Columbia","0","27","Wisconsin","4/18/20","24","3","55021","12.5"
"Crawford","0","3","Wisconsin","4/18/20","3","0","55023","0"
"Dane","4","358","Wisconsin","4/18/20","327","31","55025","9.48"
"Dodge","0","19","Wisconsin","4/18/20","18","1","55027","5.56"
"Door","0","9","Wisconsin","4/18/20","9","0","55029","0"
"Douglas","0","8","Wisconsin","4/18/20","7","1","55031","14.29"
"Dunn","0","9","Wisconsin","4/18/20","9","0","55033","0"
"Eau Claire","0","22","Wisconsin","4/18/20","21","1","55035","4.76"
"Florence","0","2","Wisconsin","4/18/20","2","0","55037","0"
"Fond du Lac","1","62","Wisconsin","4/18/20","52","10","55039","19.23"
"Grant","1","15","Wisconsin","4/18/20","5","10","55043","200"
"Green","0","9","Wisconsin","4/18/20","9","0","55045","0"
"Green Lake","0","1","Wisconsin","4/18/20","0","1","55047","1"
"Iowa","0","6","Wisconsin","4/18/20","4","2","55049","50"
"Iron","0","2","Wisconsin","4/18/20","2","0","55051","0"
"Jackson","0","11","Wisconsin","4/18/20","10","1","55053","10"
"Jefferson","1","27","Wisconsin","4/18/20","22","5","55055","22.73"
"Juneau","1","10","Wisconsin","4/18/20","5","5","55057","100"
"Kenosha","10","236","Wisconsin","4/18/20","163","73","55059","44.79"
"Kewaunee","1","8","Wisconsin","4/18/20","1","7","55061","700"
"La Crosse","0","25","Wisconsin","4/18/20","25","0","55063","0"
"Lafayette","0","3","Wisconsin","4/18/20","3","0","55065","0"
"Manitowoc","0","6","Wisconsin","4/18/20","3","3","55071","100"
"Marathon","1","17","Wisconsin","4/18/20","13","4","55073","30.77"
"Marinette","0","5","Wisconsin","4/18/20","3","2","55075","66.67"
"Marquette","0","3","Wisconsin","4/18/20","2","1","55077","50"
"Menominee","0","1","Wisconsin","4/18/20","1","0","55078","0"
"Milwaukee","59","2065","Wisconsin","4/18/20","1653","412","55079","24.92"
"Monroe","1","13","Wisconsin","4/18/20","8","5","55081","62.5"
"Oconto","0","4","Wisconsin","4/18/20","3","1","55083","33.33"
"Oneida","0","6","Wisconsin","4/18/20","5","1","55085","20"
"Outagamie","1","33","Wisconsin","4/18/20","29","4","55087","13.79"
"Ozaukee","1","79","Wisconsin","4/18/20","72","7","55089","9.72"
"Pierce","0","7","Wisconsin","4/18/20","7","0","55093","0"
"Polk","0","4","Wisconsin","4/18/20","1","3","55095","300"
"Portage","0","4","Wisconsin","4/18/20","4","0","55097","0"
"Price","0","1","Wisconsin","4/18/20","1","0","55099","0"
"Racine","8","164","Wisconsin","4/18/20","105","59","55101","56.19"
"Richland","0","8","Wisconsin","4/18/20","5","3","55103","60"
"Rock","2","68","Wisconsin","4/18/20","53","15","55105","28.3"
"Rusk","0","4","Wisconsin","4/18/20","3","1","55107","33.33"
"Sauk","1","32","Wisconsin","4/18/20","25","7","55111","28"
"Sawyer","0","2","Wisconsin","4/18/20","1","1","55113","100"
"Shawano","0","6","Wisconsin","4/18/20","5","1","55115","20"
"Sheboygan","1","39","Wisconsin","4/18/20","34","5","55117","14.71"
"St. Croix","0","11","Wisconsin","4/18/20","8","3","55109","37.5"
"Trempealeau","0","1","Wisconsin","4/18/20","1","0","55121","0"
"Vilas","0","4","Wisconsin","4/18/20","4","0","55125","0"
"Walworth","8","89","Wisconsin","4/18/20","35","54","55127","154.29"
"Washburn","0","1","Wisconsin","4/18/20","0","1","55129","1"
"Washington","2","82","Wisconsin","4/18/20","71","11","55131","15.49"
"Waukesha","8","259","Wisconsin","4/18/20","201","58","55133","28.86"
"Waupaca","0","4","Wisconsin","4/18/20","3","1","55135","33.33"
"Waushara","0","2","Wisconsin","4/18/20","2","0","55137","0"
"Winnebago","2","38","Wisconsin","4/18/20","25","13","55139","52"
"Wood","0","2","Wisconsin","4/18/20","2","0","55141","0"
"Albany","0","6","Wyoming","4/18/20","5","1","56001","20"
"Big Horn","0","1","Wyoming","4/18/20","0","1","56003","1"
"Campbell","0","13","Wyoming","4/18/20","11","2","56005","18.18"
"Carbon","0","4","Wyoming","4/18/20","4","0","56007","0"
"Converse","0","8","Wyoming","4/18/20","6","2","56009","33.33"
"Crook","0","4","Wyoming","4/18/20","3","1","56011","33.33"
"Fremont","1","47","Wyoming","4/18/20","39","8","56013","20.51"
"Goshen","0","3","Wyoming","4/18/20","3","0","56015","0"
"Hot Springs","0","1","Wyoming","4/18/20","1","0","56017","0"
"Johnson","0","11","Wyoming","4/18/20","10","1","56019","10"
"Laramie","2","70","Wyoming","4/18/20","58","12","56021","20.69"
"Lincoln","0","5","Wyoming","4/18/20","5","0","56023","0"
"Natrona","1","38","Wyoming","4/18/20","32","6","56025","18.75"
"Niobrara","0","1","Wyoming","4/18/20","1","0","56027","0"
"Park","0","1","Wyoming","4/18/20","1","0","56029","0"
"Sheridan","0","12","Wyoming","4/18/20","12","0","56033","0"
"Sublette","0","1","Wyoming","4/18/20","1","0","56035","0"
"Sweetwater","0","10","Wyoming","4/18/20","7","3","56037","42.86"
"Teton","1","62","Wyoming","4/18/20","53","9","56039","16.98"
"Uinta","0","6","Wyoming","4/18/20","4","2","56041","50"
"Washakie","0","5","Wyoming","4/18/20","5","0","56043","0"
