"Locality","DailyAvgNewCasesPast7Days","TotalCases","State","Date","TotalCases7DaysAgo","NewCasesPast7Days","FIPS-Code","PercentIncreaseTotalCasesPast7Days"
"Autauga","1","19","Alabama","4/13/20","12","7","01001","58.33"
"Baldwin","5","72","Alabama","4/13/20","38","34","01003","89.47"
"Barbour","1","10","Alabama","4/13/20","2","8","01005","400"
"Bibb","1","17","Alabama","4/13/20","7","10","01007","142.86"
"Blount","1","14","Alabama","4/13/20","10","4","01009","40"
"Bullock","0","5","Alabama","4/13/20","2","3","01011","150"
"Butler","1","8","Alabama","4/13/20","1","7","01013","700"
"Calhoun","4","61","Alabama","4/13/20","34","27","01015","79.41"
"Chambers","17","212","Alabama","4/13/20","94","118","01017","125.53"
"Cherokee","0","9","Alabama","4/13/20","6","3","01019","50"
"Chilton","2","33","Alabama","4/13/20","19","14","01021","73.68"
"Choctaw","1","10","Alabama","4/13/20","5","5","01023","100"
"Clarke","1","19","Alabama","4/13/20","9","10","01025","111.11"
"Clay","1","14","Alabama","4/13/20","9","5","01027","55.56"
"Cleburne","0","12","Alabama","4/13/20","9","3","01029","33.33"
"Coffee","4","36","Alabama","4/13/20","8","28","01031","350"
"Colbert","1","10","Alabama","4/13/20","6","4","01033","66.67"
"Conecuh","0","5","Alabama","4/13/20","2","3","01035","150"
"Coosa","1","18","Alabama","4/13/20","8","10","01037","125"
"Covington","1","13","Alabama","4/13/20","4","9","01039","225"
"Crenshaw","0","3","Alabama","4/13/20","2","1","01041","50"
"Cullman","3","39","Alabama","4/13/20","20","19","01043","95"
"Dale","1","12","Alabama","4/13/20","4","8","01045","200"
"Dallas","1","14","Alabama","4/13/20","7","7","01047","100"
"DeKalb","2","27","Alabama","4/13/20","14","13","01049","92.86"
"Elmore","2","35","Alabama","4/13/20","19","16","01051","84.21"
"Escambia","1","8","Alabama","4/13/20","3","5","01053","166.67"
"Etowah","5","77","Alabama","4/13/20","41","36","01055","87.8"
"Fayette","0","4","Alabama","4/13/20","1","3","01057","300"
"Franklin","1","10","Alabama","4/13/20","6","4","01059","66.67"
"Geneva","0","1","Alabama","4/13/20","0","1","01061","1"
"Greene","1","18","Alabama","4/13/20","8","10","01063","125"
"Hale","2","15","Alabama","4/13/20","4","11","01065","275"
"Henry","1","13","Alabama","4/13/20","4","9","01067","225"
"Houston","4","47","Alabama","4/13/20","22","25","01069","113.64"
"Jackson","1","26","Alabama","4/13/20","17","9","01071","52.94"
"Jefferson","27","612","Alabama","4/13/20","423","189","01073","44.68"
"Lamar","0","8","Alabama","4/13/20","5","3","01075","60"
"Lauderdale","1","22","Alabama","4/13/20","16","6","01077","37.5"
"Lawrence","0","8","Alabama","4/13/20","8","0","01079","0"
"Lee","20","250","Alabama","4/13/20","113","137","01081","121.24"
"Limestone","1","37","Alabama","4/13/20","33","4","01083","12.12"
"Lowndes","1","15","Alabama","4/13/20","6","9","01085","150"
"Macon","1","15","Alabama","4/13/20","5","10","01087","200"
"Madison","7","187","Alabama","4/13/20","141","46","01089","32.62"
"Marengo","1","22","Alabama","4/13/20","13","9","01091","69.23"
"Marion","5","56","Alabama","4/13/20","19","37","01093","194.74"
"Marshall","10","102","Alabama","4/13/20","33","69","01095","209.09"
"Mobile","46","468","Alabama","4/13/20","143","325","01097","227.27"
"Monroe","0","7","Alabama","4/13/20","5","2","01099","40"
"Montgomery","9","135","Alabama","4/13/20","71","64","01101","90.14"
"Morgan","2","42","Alabama","4/13/20","29","13","01103","44.83"
"Perry","1","6","Alabama","4/13/20","1","5","01105","500"
"Pickens","2","23","Alabama","4/13/20","12","11","01107","91.67"
"Pike","1","21","Alabama","4/13/20","14","7","01109","50"
"Randolph","4","40","Alabama","4/13/20","12","28","01111","233.33"
"Russell","2","27","Alabama","4/13/20","10","17","01113","170"
"Shelby","12","230","Alabama","4/13/20","147","83","01117","56.46"
"St. Clair","2","43","Alabama","4/13/20","31","12","01115","38.71"
"Sumter","2","21","Alabama","4/13/20","8","13","01119","162.5"
"Talladega","3","38","Alabama","4/13/20","20","18","01121","90"
"Tallapoosa","10","101","Alabama","4/13/20","30","71","01123","236.67"
"Tuscaloosa","7","121","Alabama","4/13/20","73","48","01125","65.75"
"Walker","4","84","Alabama","4/13/20","54","30","01127","55.56"
"Washington","1","12","Alabama","4/13/20","5","7","01129","140"
"Wilcox","3","31","Alabama","4/13/20","12","19","01131","158.33"
"Winston","0","4","Alabama","4/13/20","3","1","01133","33.33"
"Anchorage","6","131","Alaska","4/13/20","88","43","02020","48.86"
"Bethel","0","1","Alaska","4/13/20","0","1","02050","1"
"Fairbanks North Star","4","79","Alaska","4/13/20","53","26","02090","49.06"
"Juneau","0","17","Alaska","4/13/20","14","3","02110","21.43"
"Kenai Peninsula","0","15","Alaska","4/13/20","13","2","02122","15.38"
"Ketchikan Gateway","0","15","Alaska","4/13/20","14","1","02130","7.14"
"Matanuska-Susitna","1","14","Alaska","4/13/20","4","10","02170","250"
"Petersburg","0","2","Alaska","4/13/20","2","0","02195","0"
"Prince of Wales-Hyder","0","1","Alaska","4/13/20","0","1","02198","1"
"Southeast Fairbanks","0","1","Alaska","4/13/20","1","0","02240","0"
"Yukon-Koyukuk","0","1","Alaska","4/13/20","1","0","02290","0"
"Apache","9","89","Arizona","4/13/20","25","64","04001","256"
"Cochise","1","16","Arizona","4/13/20","9","7","04003","77.78"
"Coconino","12","253","Arizona","4/13/20","167","86","04005","51.5"
"Gila","0","3","Arizona","4/13/20","3","0","04007","0"
"Graham","0","2","Arizona","4/13/20","2","0","04009","0"
"Greenlee","0","2","Arizona","4/13/20","1","1","04011","100"
"La Paz","0","4","Arizona","4/13/20","3","1","04012","33.33"
"Maricopa","84","2020","Arizona","4/13/20","1433","587","04013","40.96"
"Mohave","3","40","Arizona","4/13/20","20","20","04015","100"
"Navajo","19","345","Arizona","4/13/20","210","135","04017","64.29"
"Pima","36","668","Arizona","4/13/20","415","253","04019","60.96"
"Pinal","9","168","Arizona","4/13/20","106","62","04021","58.49"
"Santa Cruz","1","10","Arizona","4/13/20","4","6","04023","150"
"Yavapai","2","65","Arizona","4/13/20","49","16","04025","32.65"
"Yuma","1","20","Arizona","4/13/20","13","7","04027","53.85"
"Arkansas","0","2","Arkansas","4/13/20","1","1","05001","100"
"Ashley","1","11","Arkansas","4/13/20","1","10","05003","1000"
"Baxter","0","4","Arkansas","4/13/20","1","3","05005","300"
"Benton","1","50","Arkansas","4/13/20","42","8","05007","19.05"
"Boone","0","3","Arkansas","4/13/20","1","2","05009","200"
"Bradley","0","7","Arkansas","4/13/20","4","3","05011","75"
"Carroll","0","2","Arkansas","4/13/20","1","1","05015","100"
"Chicot","0","5","Arkansas","4/13/20","2","3","05017","150"
"Clark","0","26","Arkansas","4/13/20","27","-1","05019","-3.7"
"Clay","0","1","Arkansas","4/13/20","0","1","05021","1"
"Cleburne","1","70","Arkansas","4/13/20","65","5","05023","7.69"
"Cleveland","0","8","Arkansas","4/13/20","7","1","05025","14.29"
"Columbia","0","3","Arkansas","4/13/20","1","2","05027","200"
"Conway","0","4","Arkansas","4/13/20","1","3","05029","300"
"Craighead","2","36","Arkansas","4/13/20","20","16","05031","80"
"Crawford","0","4","Arkansas","4/13/20","1","3","05033","300"
"Crittenden","7","103","Arkansas","4/13/20","53","50","05035","94.34"
"Cross","0","7","Arkansas","4/13/20","5","2","05037","40"
"Dallas","0","1","Arkansas","4/13/20","1","0","05039","0"
"Desha","0","6","Arkansas","4/13/20","5","1","05041","20"
"Drew","0","6","Arkansas","4/13/20","5","1","05043","20"
"Faulkner","1","57","Arkansas","4/13/20","47","10","05045","21.28"
"Franklin","0","1","Arkansas","4/13/20","0","1","05047","1"
"Garland","9","101","Arkansas","4/13/20","41","60","05051","146.34"
"Grant","1","10","Arkansas","4/13/20","3","7","05053","233.33"
"Greene","1","6","Arkansas","4/13/20","1","5","05055","500"
"Hempstead","1","5","Arkansas","4/13/20","1","4","05057","400"
"Hot Spring","0","8","Arkansas","4/13/20","7","1","05059","14.29"
"Howard","1","9","Arkansas","4/13/20","5","4","05061","80"
"Independence","0","6","Arkansas","4/13/20","5","1","05063","20"
"Izard","0","2","Arkansas","4/13/20","0","2","05065","1"
"Jefferson","5","100","Arkansas","4/13/20","62","38","05069","61.29"
"Johnson","1","13","Arkansas","4/13/20","8","5","05071","62.5"
"Lafayette","0","3","Arkansas","4/13/20","1","2","05073","200"
"Lawrence","1","11","Arkansas","4/13/20","1","10","05075","1000"
"Lee","0","2","Arkansas","4/13/20","1","1","05077","100"
"Lincoln","7","56","Arkansas","4/13/20","7","49","05079","700"
"Logan","0","2","Arkansas","4/13/20","0","2","05083","1"
"Lonoke","2","29","Arkansas","4/13/20","17","12","05085","70.59"
"Madison","0","1","Arkansas","4/13/20","0","1","05087","1"
"Marion","0","1","Arkansas","4/13/20","0","1","05089","1"
"Miller","2","24","Arkansas","4/13/20","8","16","05091","200"
"Mississippi","1","7","Arkansas","4/13/20","1","6","05093","600"
"Monroe","0","2","Arkansas","4/13/20","1","1","05095","100"
"Nevada","0","1","Arkansas","4/13/20","1","0","05099","0"
"Newton","0","1","Arkansas","4/13/20","1","0","05101","0"
"Ouachita","1","5","Arkansas","4/13/20","1","4","05103","400"
"Perry","0","2","Arkansas","4/13/20","1","1","05105","100"
"Phillips","0","4","Arkansas","4/13/20","1","3","05107","300"
"Pike","0","2","Arkansas","4/13/20","1","1","05109","100"
"Poinsett","0","7","Arkansas","4/13/20","5","2","05111","40"
"Polk","0","6","Arkansas","4/13/20","5","1","05113","20"
"Pope","3","31","Arkansas","4/13/20","13","18","05115","138.46"
"Prairie","0","2","Arkansas","4/13/20","1","1","05117","100"
"Pulaski","16","273","Arkansas","4/13/20","161","112","05119","69.57"
"Randolph","1","8","Arkansas","4/13/20","1","7","05121","700"
"Saline","0","32","Arkansas","4/13/20","29","3","05125","10.34"
"Scott","0","1","Arkansas","4/13/20","1","0","05127","0"
"Searcy","0","6","Arkansas","4/13/20","5","1","05129","20"
"Sebastian","0","11","Arkansas","4/13/20","8","3","05131","37.5"
"Sevier","0","8","Arkansas","4/13/20","6","2","05133","33.33"
"Sharp","0","2","Arkansas","4/13/20","1","1","05135","100"
"St. Francis","3","34","Arkansas","4/13/20","11","23","05123","209.09"
"Stone","0","7","Arkansas","4/13/20","5","2","05137","40"
"Union","1","17","Arkansas","4/13/20","12","5","05139","41.67"
"Van Buren","1","26","Arkansas","4/13/20","21","5","05141","23.81"
"Washington","2","43","Arkansas","4/13/20","29","14","05143","48.28"
"White","0","28","Arkansas","4/13/20","25","3","05145","12"
"Woodruff","0","1","Arkansas","4/13/20","1","0","05147","0"
"Yell","0","1","Arkansas","4/13/20","1","0","05149","0"
"Alameda","43","888","California","4/13/20","588","300","06001","51.02"
"Alpine","0","2","California","4/13/20","1","1","06003","100"
"Amador","1","7","California","4/13/20","3","4","06005","133.33"
"Butte","0","14","California","4/13/20","11","3","06007","27.27"
"Calaveras","0","8","California","4/13/20","5","3","06009","60"
"Colusa","0","3","California","4/13/20","2","1","06011","50"
"Contra Costa","19","552","California","4/13/20","417","135","06013","32.37"
"Del Norte","0","2","California","4/13/20","2","0","06015","0"
"El Dorado","1","32","California","4/13/20","22","10","06017","45.45"
"Fresno","13","201","California","4/13/20","108","93","06019","86.11"
"Glenn","0","3","California","4/13/20","2","1","06021","50"
"Humboldt","1","50","California","4/13/20","44","6","06023","13.64"
"Imperial","3","87","California","4/13/20","65","22","06025","33.85"
"Inyo","0","12","California","4/13/20","11","1","06027","9.09"
"Kern","28","436","California","4/13/20","239","197","06029","82.43"
"Kings","1","10","California","4/13/20","5","5","06031","100"
"Lake","0","4","California","4/13/20","1","3","06033","300"
"Los Angeles","437","9433","California","4/13/20","6377","3056","06037","47.92"
"Madera","1","33","California","4/13/20","28","5","06039","17.86"
"Marin","3","164","California","4/13/20","141","23","06041","16.31"
"Mendocino","0","4","California","4/13/20","4","0","06045","0"
"Merced","5","65","California","4/13/20","29","36","06047","124.14"
"Mono","1","23","California","4/13/20","19","4","06051","21.05"
"Monterey","4","87","California","4/13/20","62","25","06053","40.32"
"Napa","2","34","California","4/13/20","22","12","06055","54.55"
"Nevada","0","34","California","4/13/20","32","2","06057","6.25"
"Orange","57","1283","California","4/13/20","882","401","06059","45.46"
"Placer","3","127","California","4/13/20","106","21","06061","19.81"
"Plumas","0","4","California","4/13/20","3","1","06063","33.33"
"Riverside","96","1619","California","4/13/20","946","673","06065","71.14"
"Sacramento","40","739","California","4/13/20","462","277","06067","59.96"
"San Benito","2","35","California","4/13/20","23","12","06069","52.17"
"San Bernardino","73","887","California","4/13/20","373","514","06071","137.8"
"San Diego","68","1804","California","4/13/20","1326","478","06073","36.05"
"San Francisco","53","957","California","4/13/20","583","374","06075","64.15"
"San Joaquin","12","293","California","4/13/20","206","87","06077","42.23"
"San Luis Obispo","3","117","California","4/13/20","95","22","06079","23.16"
"San Mateo","17","701","California","4/13/20","579","122","06081","21.07"
"Santa Barbara","13","267","California","4/13/20","174","93","06083","53.45"
"Santa Clara","66","1666","California","4/13/20","1207","459","06085","38.03"
"Santa Cruz","3","91","California","4/13/20","69","22","06087","31.88"
"Shasta","1","24","California","4/13/20","20","4","06089","20"
"Siskiyou","0","5","California","4/13/20","4","1","06093","25"
"Solano","7","121","California","4/13/20","73","48","06095","65.75"
"Sonoma","5","147","California","4/13/20","111","36","06097","32.43"
"Stanislaus","9","131","California","4/13/20","71","60","06099","84.51"
"Sutter","3","37","California","4/13/20","16","21","06101","131.25"
"Tehama","0","1","California","4/13/20","1","0","06103","0"
"Tulare","18","264","California","4/13/20","135","129","06107","95.56"
"Tuolumne","0","1","California","4/13/20","2","-1","06109","-50"
"Ventura","13","314","California","4/13/20","221","93","06111","42.08"
"Yolo","8","93","California","4/13/20","37","56","06113","151.35"
"Yuba","1","15","California","4/13/20","11","4","06115","36.36"
"Adams","47","693","Colorado","4/13/20","367","326","08001","88.83"
"Alamosa","0","7","Colorado","4/13/20","4","3","08003","75"
"Arapahoe","70","1142","Colorado","4/13/20","652","490","08005","75.15"
"Archuleta","0","6","Colorado","4/13/20","6","0","08007","0"
"Baca","0","10","Colorado","4/13/20","9","1","08009","11.11"
"Boulder","14","284","Colorado","4/13/20","189","95","08013","50.26"
"Broomfield","4","81","Colorado","4/13/20","50","31","08014","62"
"Chaffee","1","28","Colorado","4/13/20","22","6","08015","27.27"
"Clear Creek","1","11","Colorado","4/13/20","6","5","08019","83.33"
"Costilla","0","3","Colorado","4/13/20","3","0","08023","0"
"Crowley","0","2","Colorado","4/13/20","1","1","08025","100"
"Custer","0","2","Colorado","4/13/20","2","0","08027","0"
"Delta","0","7","Colorado","4/13/20","5","2","08029","40"
"Denver","71","1346","Colorado","4/13/20","847","499","08031","58.91"
"Douglas","11","304","Colorado","4/13/20","227","77","08035","33.92"
"Eagle","15","457","Colorado","4/13/20","355","102","08037","28.73"
"El Paso","29","641","Colorado","4/13/20","441","200","08041","45.35"
"Elbert","1","16","Colorado","4/13/20","9","7","08039","77.78"
"Fremont","1","8","Colorado","4/13/20","3","5","08043","166.67"
"Garfield","2","58","Colorado","4/13/20","47","11","08045","23.4"
"Gilpin","0","1","Colorado","4/13/20","0","1","08047","1"
"Grand","0","4","Colorado","4/13/20","4","0","08049","0"
"Gunnison","1","99","Colorado","4/13/20","95","4","08051","4.21"
"Hinsdale","0","2","Colorado","4/13/20","1","1","08053","100"
"Huerfano","0","1","Colorado","4/13/20","1","0","08055","0"
"Jefferson","35","787","Colorado","4/13/20","540","247","08059","45.74"
"Kit Carson","0","8","Colorado","4/13/20","5","3","08063","60"
"La Plata","2","44","Colorado","4/13/20","32","12","08067","37.5"
"Lake","0","4","Colorado","4/13/20","3","1","08065","33.33"
"Larimer","5","193","Colorado","4/13/20","158","35","08069","22.15"
"Las Animas","0","2","Colorado","4/13/20","1","1","08071","100"
"Lincoln","0","2","Colorado","4/13/20","1","1","08073","100"
"Logan","0","13","Colorado","4/13/20","11","2","08075","18.18"
"Mesa","1","35","Colorado","4/13/20","25","10","08077","40"
"Mineral","0","2","Colorado","4/13/20","2","0","08079","0"
"Moffat","0","3","Colorado","4/13/20","3","0","08081","0"
"Montezuma","1","12","Colorado","4/13/20","8","4","08083","50"
"Montrose","4","59","Colorado","4/13/20","34","25","08085","73.53"
"Morgan","8","75","Colorado","4/13/20","19","56","08087","294.74"
"Otero","0","5","Colorado","4/13/20","4","1","08089","25"
"Ouray","0","4","Colorado","4/13/20","2","2","08091","100"
"Park","0","6","Colorado","4/13/20","5","1","08093","20"
"Phillips","0","4","Colorado","4/13/20","3","1","08095","33.33"
"Pitkin","1","49","Colorado","4/13/20","39","10","08097","25.64"
"Prowers","0","1","Colorado","4/13/20","0","1","08099","1"
"Pueblo","3","64","Colorado","4/13/20","42","22","08101","52.38"
"Rio Blanco","0","1","Colorado","4/13/20","1","0","08103","0"
"Rio Grande","0","5","Colorado","4/13/20","5","0","08105","0"
"Routt","2","41","Colorado","4/13/20","29","12","08107","41.38"
"Saguache","0","3","Colorado","4/13/20","3","0","08109","0"
"San Miguel","0","12","Colorado","4/13/20","10","2","08113","20"
"Summit","3","77","Colorado","4/13/20","58","19","08117","32.76"
"Teller","1","15","Colorado","4/13/20","11","4","08119","36.36"
"Washington","0","2","Colorado","4/13/20","1","1","08121","100"
"Weld","43","808","Colorado","4/13/20","504","304","08123","60.32"
"Yuma","0","2","Colorado","4/13/20","2","0","08125","0"
"Fairfield","326","6004","Connecticut","4/13/20","3719","2285","09001","61.44"
"Hartford","194","2243","Connecticut","4/13/20","882","1361","09003","154.31"
"Litchfield","31","446","Connecticut","4/13/20","230","216","09005","93.91"
"Middlesex","29","339","Connecticut","4/13/20","135","204","09007","151.11"
"New Haven","270","3358","Connecticut","4/13/20","1468","1890","09009","128.75"
"New London","22","222","Connecticut","4/13/20","65","157","09011","241.54"
"Tolland","13","195","Connecticut","4/13/20","103","92","09013","89.32"
"Windham","6","83","Connecticut","4/13/20","40","43","09015","107.5"
"Kent","23","288","Delaware","4/13/20","128","160","10001","125"
"New Castle","60","919","Delaware","4/13/20","496","423","10003","85.28"
"Sussex","56","551","Delaware","4/13/20","159","392","10005","246.54"
"","0","49","Diamond Princess","4/13/20","49","0",,"0"
"District of Columbia","123","1955","District of Columbia","4/13/20","1097","858","11001","78.21"
"Alachua","8","187","Florida","4/13/20","131","56","12001","42.75"
"Baker","1","17","Florida","4/13/20","13","4","12003","30.77"
"Bay","2","38","Florida","4/13/20","24","14","12005","58.33"
"Bradford","3","30","Florida","4/13/20","8","22","12007","275"
"Brevard","9","148","Florida","4/13/20","88","60","12009","68.18"
"Broward","159","3177","Florida","4/13/20","2067","1110","12011","53.7"
"Calhoun","0","5","Florida","4/13/20","3","2","12013","66.67"
"Charlotte","9","119","Florida","4/13/20","55","64","12015","116.36"
"Citrus","4","72","Florida","4/13/20","45","27","12017","60"
"Clay","12","165","Florida","4/13/20","81","84","12019","103.7"
"Collier","19","376","Florida","4/13/20","246","130","12021","52.85"
"Columbia","2","27","Florida","4/13/20","13","14","12023","107.69"
"DeSoto","1","22","Florida","4/13/20","14","8","12027","57.14"
"Dixie","0","2","Florida","4/13/20","1","1","12029","100"
"Duval","31","691","Florida","4/13/20","475","216","12031","45.47"
"Escambia","15","241","Florida","4/13/20","136","105","12033","77.21"
"Flagler","2","45","Florida","4/13/20","32","13","12035","40.62"
"Franklin","0","2","Florida","4/13/20","2","0","12037","0"
"Gadsden","4","36","Florida","4/13/20","5","31","12039","620"
"Gilchrist","1","4","Florida","4/13/20","0","4","12041","1"
"Glades","0","5","Florida","4/13/20","4","1","12043","25"
"Gulf","0","1","Florida","4/13/20","1","0","12045","0"
"Hamilton","0","2","Florida","4/13/20","1","1","12047","100"
"Hardee","0","3","Florida","4/13/20","2","1","12049","50"
"Hendry","2","22","Florida","4/13/20","9","13","12051","144.44"
"Hernando","3","71","Florida","4/13/20","48","23","12053","47.92"
"Highlands","4","61","Florida","4/13/20","35","26","12055","74.29"
"Hillsborough","35","813","Florida","4/13/20","571","242","12057","42.38"
"Holmes","0","2","Florida","4/13/20","1","1","12059","100"
"Indian River","2","77","Florida","4/13/20","61","16","12061","26.23"
"Jackson","0","6","Florida","4/13/20","4","2","12063","50"
"Jefferson","1","12","Florida","4/13/20","3","9","12065","300"
"Lafayette","0","1","Florida","4/13/20","0","1","12067","1"
"Lake","8","162","Florida","4/13/20","104","58","12069","55.77"
"Lee","35","642","Florida","4/13/20","397","245","12071","61.71"
"Leon","13","150","Florida","4/13/20","59","91","12073","154.24"
"Levy","0","7","Florida","4/13/20","4","3","12075","75"
"Liberty","0","2","Florida","4/13/20","0","2","12077","1"
"Madison","0","14","Florida","4/13/20","11","3","12079","27.27"
"Manatee","15","252","Florida","4/13/20","144","108","12081","75"
"Marion","7","101","Florida","4/13/20","53","48","12083","90.57"
"Martin","7","129","Florida","4/13/20","83","46","12085","55.42"
"Miami-Dade","425","7459","Florida","4/13/20","4481","2978","12086","66.46"
"Monroe","3","64","Florida","4/13/20","45","19","12087","42.22"
"Nassau","1","34","Florida","4/13/20","25","9","12089","36"
"Okaloosa","5","103","Florida","4/13/20","65","38","12091","58.46"
"Okeechobee","0","5","Florida","4/13/20","3","2","12093","66.67"
"Orange","40","1024","Florida","4/13/20","744","280","12095","37.63"
"Osceola","13","333","Florida","4/13/20","239","94","12097","39.33"
"Palm Beach","91","1704","Florida","4/13/20","1069","635","12099","59.4"
"Pasco","8","169","Florida","4/13/20","110","59","12101","53.64"
"Pinellas","17","479","Florida","4/13/20","362","117","12103","32.32"
"Polk","13","270","Florida","4/13/20","176","94","12105","53.41"
"Putnam","3","42","Florida","4/13/20","19","23","12107","121.05"
"Santa Rosa","8","113","Florida","4/13/20","58","55","12113","94.83"
"Sarasota","11","230","Florida","4/13/20","151","79","12115","52.32"
"Seminole","11","268","Florida","4/13/20","194","74","12117","38.14"
"St. Johns","4","176","Florida","4/13/20","146","30","12109","20.55"
"St. Lucie","9","161","Florida","4/13/20","100","61","12111","61"
"Sumter","5","112","Florida","4/13/20","80","32","12119","40"
"Suwannee","5","68","Florida","4/13/20","32","36","12121","112.5"
"Taylor","0","1","Florida","4/13/20","0","1","12123","1"
"Union","0","2","Florida","4/13/20","2","0","12125","0"
"Volusia","9","216","Florida","4/13/20","151","65","12127","43.05"
"Wakulla","1","12","Florida","4/13/20","6","6","12129","100"
"Walton","1","29","Florida","4/13/20","24","5","12131","20.83"
"Washington","0","4","Florida","4/13/20","1","3","12133","300"
"Appling","1","11","Georgia","4/13/20","6","5","13001","83.33"
"Atkinson","0","2","Georgia","4/13/20","0","2","13003","1"
"Bacon","1","14","Georgia","4/13/20","7","7","13005","100"
"Baker","2","16","Georgia","4/13/20","5","11","13007","220"
"Baldwin","5","53","Georgia","4/13/20","15","38","13009","253.33"
"Banks","1","7","Georgia","4/13/20","3","4","13011","133.33"
"Barrow","4","55","Georgia","4/13/20","27","28","13013","103.7"
"Bartow","5","216","Georgia","4/13/20","179","37","13015","20.67"
"Ben Hill","0","8","Georgia","4/13/20","5","3","13017","60"
"Berrien","0","6","Georgia","4/13/20","3","3","13019","100"
"Bibb","5","72","Georgia","4/13/20","40","32","13021","80"
"Bleckley","0","3","Georgia","4/13/20","1","2","13023","200"
"Brantley","1","11","Georgia","4/13/20","2","9","13025","450"
"Brooks","2","19","Georgia","4/13/20","6","13","13027","216.67"
"Bryan","1","31","Georgia","4/13/20","21","10","13029","47.62"
"Bulloch","2","19","Georgia","4/13/20","8","11","13031","137.5"
"Burke","3","28","Georgia","4/13/20","10","18","13033","180"
"Butts","2","30","Georgia","4/13/20","17","13","13035","76.47"
"Calhoun","4","48","Georgia","4/13/20","19","29","13037","152.63"
"Camden","2","22","Georgia","4/13/20","9","13","13039","144.44"
"Candler","0","4","Georgia","4/13/20","2","2","13043","100"
"Carroll","7","214","Georgia","4/13/20","163","51","13045","31.29"
"Catoosa","1","13","Georgia","4/13/20","6","7","13047","116.67"
"Charlton","0","3","Georgia","4/13/20","2","1","13049","50"
"Chatham","7","152","Georgia","4/13/20","104","48","13051","46.15"
"Chattahoochee","0","3","Georgia","4/13/20","2","1","13053","50"
"Chattooga","1","7","Georgia","4/13/20","3","4","13055","133.33"
"Cherokee","9","198","Georgia","4/13/20","133","65","13057","48.87"
"Clarke","2","85","Georgia","4/13/20","69","16","13059","23.19"
"Clay","1","16","Georgia","4/13/20","7","9","13061","128.57"
"Clayton","21","391","Georgia","4/13/20","244","147","13063","60.25"
"Clinch","1","6","Georgia","4/13/20","2","4","13065","200"
"Cobb","38","782","Georgia","4/13/20","515","267","13067","51.84"
"Coffee","6","60","Georgia","4/13/20","15","45","13069","300"
"Colquitt","5","88","Georgia","4/13/20","53","35","13071","66.04"
"Columbia","4","70","Georgia","4/13/20","40","30","13073","75"
"Cook","1","7","Georgia","4/13/20","1","6","13075","600"
"Coweta","6","119","Georgia","4/13/20","76","43","13077","56.58"
"Crawford","0","3","Georgia","4/13/20","1","2","13079","200"
"Crisp","4","71","Georgia","4/13/20","43","28","13081","65.12"
"Dade","0","2","Georgia","4/13/20","1","1","13083","100"
"Dawson","1","29","Georgia","4/13/20","19","10","13085","52.63"
"Decatur","2","36","Georgia","4/13/20","20","16","13087","80"
"DeKalb","57","980","Georgia","4/13/20","579","401","13089","69.26"
"Dodge","1","14","Georgia","4/13/20","8","6","13091","75"
"Dooly","4","50","Georgia","4/13/20","19","31","13093","163.16"
"Dougherty","72","1217","Georgia","4/13/20","716","501","13095","69.97"
"Douglas","9","167","Georgia","4/13/20","102","65","13097","63.73"
"Early","7","126","Georgia","4/13/20","76","50","13099","65.79"
"Echols","0","2","Georgia","4/13/20","0","2","13101","1"
"Effingham","1","22","Georgia","4/13/20","13","9","13103","69.23"
"Elbert","0","3","Georgia","4/13/20","2","1","13105","50"
"Emanuel","1","9","Georgia","4/13/20","1","8","13107","800"
"Evans","0","1","Georgia","4/13/20","0","1","13109","1"
"Fannin","0","9","Georgia","4/13/20","9","0","13111","0"
"Fayette","4","105","Georgia","4/13/20","74","31","13113","41.89"
"Floyd","4","111","Georgia","4/13/20","84","27","13115","32.14"
"Forsyth","8","138","Georgia","4/13/20","80","58","13117","72.5"
"Franklin","0","4","Georgia","4/13/20","5","-1","13119","-20"
"Fulton","82","1598","Georgia","4/13/20","1027","571","13121","55.6"
"Gilmer","1","7","Georgia","4/13/20","1","6","13123","600"
"Glynn","1","38","Georgia","4/13/20","29","9","13127","31.03"
"Gordon","2","39","Georgia","4/13/20","24","15","13129","62.5"
"Grady","2","15","Georgia","4/13/20","4","11","13131","275"
"Greene","2","29","Georgia","4/13/20","15","14","13133","93.33"
"Gwinnett","42","739","Georgia","4/13/20","443","296","13135","66.82"
"Habersham","2","15","Georgia","4/13/20","2","13","13137","650"
"Hall","23","292","Georgia","4/13/20","131","161","13139","122.9"
"Hancock","0","3","Georgia","4/13/20","0","3","13141","1"
"Haralson","1","16","Georgia","4/13/20","10","6","13143","60"
"Harris","2","22","Georgia","4/13/20","10","12","13145","120"
"Hart","0","4","Georgia","4/13/20","3","1","13147","33.33"
"Heard","0","4","Georgia","4/13/20","2","2","13149","100"
"Henry","15","280","Georgia","4/13/20","178","102","13151","57.3"
"Houston","9","129","Georgia","4/13/20","64","65","13153","101.56"
"Irwin","1","12","Georgia","4/13/20","6","6","13155","100"
"Jackson","1","27","Georgia","4/13/20","17","10","13157","58.82"
"Jasper","1","8","Georgia","4/13/20","3","5","13159","166.67"
"Jeff Davis","0","1","Georgia","4/13/20","1","0","13161","0"
"Jefferson","1","7","Georgia","4/13/20","3","4","13163","133.33"
"Jenkins","1","10","Georgia","4/13/20","4","6","13165","150"
"Johnson","2","19","Georgia","4/13/20","3","16","13167","533.33"
"Jones","1","12","Georgia","4/13/20","7","5","13169","71.43"
"Lamar","1","18","Georgia","4/13/20","14","4","13171","28.57"
"Lanier","0","5","Georgia","4/13/20","4","1","13173","25"
"Laurens","3","35","Georgia","4/13/20","16","19","13175","118.75"
"Lee","15","253","Georgia","4/13/20","147","106","13177","72.11"
"Liberty","1","18","Georgia","4/13/20","13","5","13179","38.46"
"Lincoln","1","9","Georgia","4/13/20","5","4","13181","80"
"Long","0","1","Georgia","4/13/20","1","0","13183","0"
"Lowndes","4","65","Georgia","4/13/20","40","25","13185","62.5"
"Lumpkin","0","9","Georgia","4/13/20","9","0","13187","0"
"Macon","3","25","Georgia","4/13/20","4","21","13193","525"
"Madison","0","10","Georgia","4/13/20","7","3","13195","42.86"
"Marion","1","10","Georgia","4/13/20","2","8","13197","400"
"McDuffie","2","25","Georgia","4/13/20","8","17","13189","212.5"
"McIntosh","0","3","Georgia","4/13/20","2","1","13191","50"
"Meriwether","1","23","Georgia","4/13/20","13","10","13199","76.92"
"Miller","0","12","Georgia","4/13/20","14","-2","13201","-14.29"
"Mitchell","13","147","Georgia","4/13/20","56","91","13205","162.5"
"Monroe","0","12","Georgia","4/13/20","10","2","13207","20"
"Montgomery","0","2","Georgia","4/13/20","0","2","13209","1"
"Morgan","1","14","Georgia","4/13/20","5","9","13211","180"
"Murray","1","15","Georgia","4/13/20","10","5","13213","50"
"Muscogee","17","161","Georgia","4/13/20","40","121","13215","302.5"
"Newton","4","91","Georgia","4/13/20","62","29","13217","46.77"
"Oconee","2","39","Georgia","4/13/20","24","15","13219","62.5"
"Oglethorpe","2","13","Georgia","4/13/20","1","12","13221","1200"
"Paulding","5","91","Georgia","4/13/20","54","37","13223","68.52"
"Peach","1","24","Georgia","4/13/20","15","9","13225","60"
"Pickens","0","11","Georgia","4/13/20","9","2","13227","22.22"
"Pierce","3","45","Georgia","4/13/20","21","24","13229","114.29"
"Pike","1","18","Georgia","4/13/20","9","9","13231","100"
"Polk","1","24","Georgia","4/13/20","20","4","13233","20"
"Pulaski","0","10","Georgia","4/13/20","7","3","13235","42.86"
"Putnam","1","7","Georgia","4/13/20","3","4","13237","133.33"
"Quitman","0","3","Georgia","4/13/20","1","2","13239","200"
"Rabun","0","6","Georgia","4/13/20","3","3","13241","100"
"Randolph","13","117","Georgia","4/13/20","24","93","13243","387.5"
"Richmond","13","147","Georgia","4/13/20","56","91","13245","162.5"
"Rockdale","3","100","Georgia","4/13/20","80","20","13247","25"
"Schley","1","12","Georgia","4/13/20","6","6","13249","100"
"Screven","1","7","Georgia","4/13/20","2","5","13251","250"
"Seminole","1","15","Georgia","4/13/20","9","6","13253","66.67"
"Spalding","5","75","Georgia","4/13/20","41","34","13255","82.93"
"Stephens","2","19","Georgia","4/13/20","8","11","13257","137.5"
"Stewart","1","8","Georgia","4/13/20","3","5","13259","166.67"
"Sumter","23","245","Georgia","4/13/20","87","158","13261","181.61"
"Talbot","1","9","Georgia","4/13/20","5","4","13263","80"
"Tattnall","0","5","Georgia","4/13/20","3","2","13267","66.67"
"Taylor","1","8","Georgia","4/13/20","3","5","13269","166.67"
"Telfair","1","9","Georgia","4/13/20","4","5","13271","125"
"Terrell","7","114","Georgia","4/13/20","65","49","13273","75.38"
"Thomas","7","78","Georgia","4/13/20","28","50","13275","178.57"
"Tift","3","62","Georgia","4/13/20","42","20","13277","47.62"
"Toombs","1","12","Georgia","4/13/20","7","5","13279","71.43"
"Towns","0","3","Georgia","4/13/20","1","2","13281","200"
"Treutlen","0","1","Georgia","4/13/20","1","0","13283","0"
"Troup","3","61","Georgia","4/13/20","37","24","13285","64.86"
"Turner","3","37","Georgia","4/13/20","14","23","13287","164.29"
"Twiggs","0","2","Georgia","4/13/20","2","0","13289","0"
"Union","1","7","Georgia","4/13/20","1","6","13291","600"
"Upson","6","61","Georgia","4/13/20","22","39","13293","177.27"
"Walker","0","6","Georgia","4/13/20","3","3","13295","100"
"Walton","3","44","Georgia","4/13/20","23","21","13297","91.3"
"Ware","5","56","Georgia","4/13/20","22","34","13299","154.55"
"Warren","0","7","Georgia","4/13/20","5","2","13301","40"
"Washington","2","23","Georgia","4/13/20","6","17","13303","283.33"
"Wayne","0","4","Georgia","4/13/20","2","2","13305","100"
"Webster","0","3","Georgia","4/13/20","4","-1","13307","-25"
"Wheeler","0","2","Georgia","4/13/20","1","1","13309","100"
"White","1","11","Georgia","4/13/20","4","7","13311","175"
"Whitfield","1","26","Georgia","4/13/20","17","9","13313","52.94"
"Wilcox","3","24","Georgia","4/13/20","2","22","13315","1100"
"Wilkes","0","6","Georgia","4/13/20","4","2","13317","50"
"Wilkinson","1","11","Georgia","4/13/20","3","8","13319","266.67"
"Worth","7","91","Georgia","4/13/20","39","52","13321","133.33"
"","0","103","Grand Princess","4/13/20","103","0",,"0"
"","3","133","Guam","4/13/20","113","20",,"17.7"
"Hawaii","2","40","Hawaii","4/13/20","23","17","15001","73.91"
"Honolulu","9","352","Hawaii","4/13/20","292","60","15003","20.55"
"Kauai","1","21","Hawaii","4/13/20","17","4","15007","23.53"
"Maui","6","86","Hawaii","4/13/20","44","42","15009","95.45"
"Out of HI","0","2","Hawaii","4/13/20","2","0","80015","0"
"Ada","16","517","Idaho","4/13/20","402","115","16001","28.61"
"Adams","0","1","Idaho","4/13/20","1","0","16003","0"
"Bannock","0","5","Idaho","4/13/20","5","0","16005","0"
"Bingham","0","2","Idaho","4/13/20","2","0","16011","0"
"Blaine","6","454","Idaho","4/13/20","410","44","16013","10.73"
"Bonner","0","4","Idaho","4/13/20","2","2","16017","100"
"Bonneville","1","13","Idaho","4/13/20","6","7","16019","116.67"
"Boundary","0","1","Idaho","4/13/20","0","1","16021","1"
"Camas","0","1","Idaho","4/13/20","1","0","16025","0"
"Canyon","8","155","Idaho","4/13/20","101","54","16027","53.47"
"Caribou","0","1","Idaho","4/13/20","1","0","16029","0"
"Cassia","1","8","Idaho","4/13/20","4","4","16031","100"
"Custer","0","2","Idaho","4/13/20","2","0","16037","0"
"Elmore","1","16","Idaho","4/13/20","11","5","16039","45.45"
"Fremont","0","2","Idaho","4/13/20","1","1","16043","100"
"Gem","0","9","Idaho","4/13/20","7","2","16045","28.57"
"Gooding","1","5","Idaho","4/13/20","1","4","16047","400"
"Idaho","0","3","Idaho","4/13/20","2","1","16049","50"
"Jefferson","0","4","Idaho","4/13/20","4","0","16051","0"
"Jerome","2","29","Idaho","4/13/20","13","16","16053","123.08"
"Kootenai","0","45","Idaho","4/13/20","42","3","16055","7.14"
"Latah","0","3","Idaho","4/13/20","1","2","16057","200"
"Lewis","0","0","Idaho","4/13/20","1","-1","16061","-100"
"Lincoln","1","15","Idaho","4/13/20","9","6","16063","66.67"
"Madison","0","5","Idaho","4/13/20","4","1","16065","25"
"Minidoka","0","5","Idaho","4/13/20","3","2","16067","66.67"
"Nez Perce","1","19","Idaho","4/13/20","13","6","16069","46.15"
"Owyhee","0","4","Idaho","4/13/20","2","2","16073","100"
"Payette","0","8","Idaho","4/13/20","6","2","16075","33.33"
"Power","0","2","Idaho","4/13/20","0","2","16077","1"
"Teton","0","6","Idaho","4/13/20","4","2","16081","50"
"Twin Falls","6","79","Idaho","4/13/20","37","42","16083","113.51"
"Valley","0","2","Idaho","4/13/20","2","0","16085","0"
"Washington","0","1","Idaho","4/13/20","1","0","16087","0"
"Adams","3","26","Illinois","4/13/20","8","18","17001","225"
"Bond","0","4","Illinois","4/13/20","3","1","17005","33.33"
"Boone","1","13","Illinois","4/13/20","4","9","17007","225"
"Bureau","0","6","Illinois","4/13/20","3","3","17011","100"
"Calhoun","0","1","Illinois","4/13/20","1","0","17013","0"
"Carroll","0","5","Illinois","4/13/20","4","1","17015","25"
"Champaign","4","87","Illinois","4/13/20","62","25","17019","40.32"
"Christian","0","24","Illinois","4/13/20","22","2","17021","9.09"
"Clark","0","4","Illinois","4/13/20","2","2","17023","100"
"Clinton","4","39","Illinois","4/13/20","11","28","17027","254.55"
"Coles","1","6","Illinois","4/13/20","0","6","17029","1"
"Cook","964","15474","Illinois","4/13/20","8728","6746","17031","77.29"
"Crawford","0","4","Illinois","4/13/20","5","-1","17033","-20"
"Cumberland","0","2","Illinois","4/13/20","1","1","17035","100"
"De Witt","0","1","Illinois","4/13/20","3","-2","17039","-66.67"
"DeKalb","2","34","Illinois","4/13/20","22","12","17037","54.55"
"Douglas","0","11","Illinois","4/13/20","10","1","17041","10"
"DuPage","73","1223","Illinois","4/13/20","715","508","17043","71.05"
"Effingham","0","3","Illinois","4/13/20","1","2","17049","200"
"Fayette","1","11","Illinois","4/13/20","3","8","17051","266.67"
"Ford","0","4","Illinois","4/13/20","1","3","17053","300"
"Franklin","0","4","Illinois","4/13/20","2","2","17055","100"
"Fulton","0","1","Illinois","4/13/20","0","1","17057","1"
"Gallatin","0","1","Illinois","4/13/20","1","0","17059","0"
"Greene","0","1","Illinois","4/13/20","0","1","17061","1"
"Grundy","2","21","Illinois","4/13/20","9","12","17063","133.33"
"Hancock","0","1","Illinois","4/13/20","0","1","17067","1"
"Henry","2","23","Illinois","4/13/20","10","13","17073","130"
"Iroquois","0","9","Illinois","4/13/20","6","3","17075","50"
"Jackson","3","36","Illinois","4/13/20","14","22","17077","157.14"
"Jasper","0","3","Illinois","4/13/20","4","-1","17079","-25"
"Jefferson","1","8","Illinois","4/13/20","1","7","17081","700"
"Jersey","0","6","Illinois","4/13/20","3","3","17083","100"
"Jo Daviess","1","11","Illinois","4/13/20","6","5","17085","83.33"
"Johnson","0","1","Illinois","4/13/20","0","1","17087","1"
"Kane","27","421","Illinois","4/13/20","234","187","17089","79.91"
"Kankakee","18","210","Illinois","4/13/20","85","125","17091","147.06"
"Kendall","8","114","Illinois","4/13/20","55","59","17093","107.27"
"Knox","0","2","Illinois","4/13/20","1","1","17095","100"
"Lake","100","1516","Illinois","4/13/20","815","701","17097","86.01"
"LaSalle","1","21","Illinois","4/13/20","11","10","17099","90.91"
"Lawrence","0","2","Illinois","4/13/20","0","2","17101","1"
"Lee","2","14","Illinois","4/13/20","2","12","17103","600"
"Livingston","1","17","Illinois","4/13/20","9","8","17105","88.89"
"Logan","0","4","Illinois","4/13/20","1","3","17107","300"
"Macon","5","42","Illinois","4/13/20","9","33","17115","366.67"
"Macoupin","1","16","Illinois","4/13/20","7","9","17117","128.57"
"Madison","9","115","Illinois","4/13/20","52","63","17119","121.15"
"Marion","1","13","Illinois","4/13/20","3","10","17121","333.33"
"Marshall","0","1","Illinois","4/13/20","1","0","17123","0"
"Mason","0","3","Illinois","4/13/20","1","2","17125","200"
"Massac","0","2","Illinois","4/13/20","2","0","17127","0"
"McDonough","0","2","Illinois","4/13/20","0","2","17109","1"
"McHenry","14","245","Illinois","4/13/20","144","101","17111","70.14"
"McLean","5","79","Illinois","4/13/20","46","33","17113","71.74"
"Menard","0","2","Illinois","4/13/20","2","0","17129","0"
"Mercer","0","2","Illinois","4/13/20","2","0","17131","0"
"Monroe","5","46","Illinois","4/13/20","11","35","17133","318.18"
"Montgomery","1","9","Illinois","4/13/20","3","6","17135","200"
"Morgan","0","10","Illinois","4/13/20","7","3","17137","42.86"
"Moultrie","0","2","Illinois","4/13/20","1","1","17139","100"
"Ogle","3","26","Illinois","4/13/20","7","19","17141","271.43"
"Peoria","3","31","Illinois","4/13/20","12","19","17143","158.33"
"Perry","0","1","Illinois","4/13/20","0","1","17145","1"
"Piatt","0","6","Illinois","4/13/20","3","3","17147","100"
"Pike","0","1","Illinois","4/13/20","1","0","17149","0"
"Pulaski","1","5","Illinois","4/13/20","0","5","17153","1"
"Randolph","2","41","Illinois","4/13/20","27","14","17157","51.85"
"Richland","0","1","Illinois","4/13/20","0","1","17159","1"
"Rock Island","8","105","Illinois","4/13/20","47","58","17161","123.4"
"Saline","0","3","Illinois","4/13/20","1","2","17165","200"
"Sangamon","2","44","Illinois","4/13/20","31","13","17167","41.94"
"Schuyler","0","1","Illinois","4/13/20","0","1","17169","1"
"Shelby","1","4","Illinois","4/13/20","0","4","17173","1"
"St. Clair","16","202","Illinois","4/13/20","92","110","17163","119.57"
"Stark","0","1","Illinois","4/13/20","0","1","17175","1"
"Stephenson","0","8","Illinois","4/13/20","5","3","17177","60"
"Tazewell","1","19","Illinois","4/13/20","14","5","17179","35.71"
"Vermilion","0","8","Illinois","4/13/20","5","3","17183","60"
"Wabash","0","2","Illinois","4/13/20","1","1","17185","100"
"Warren","0","2","Illinois","4/13/20","0","2","17187","1"
"Washington","0","2","Illinois","4/13/20","2","0","17189","0"
"Whiteside","1","28","Illinois","4/13/20","18","10","17195","55.56"
"Will","84","1283","Illinois","4/13/20","697","586","17197","84.07"
"Williamson","1","10","Illinois","4/13/20","3","7","17199","233.33"
"Winnebago","7","99","Illinois","4/13/20","49","50","17201","102.04"
"Woodford","0","9","Illinois","4/13/20","6","3","17203","50"
"Adams","0","5","Indiana","4/13/20","2","3","18001","150"
"Allen","10","156","Indiana","4/13/20","87","69","18003","79.31"
"Bartholomew","8","110","Indiana","4/13/20","54","56","18005","103.7"
"Benton","0","2","Indiana","4/13/20","0","2","18007","1"
"Blackford","0","5","Indiana","4/13/20","4","1","18009","25"
"Boone","6","109","Indiana","4/13/20","64","45","18011","70.31"
"Brown","1","12","Indiana","4/13/20","5","7","18013","140"
"Carroll","0","5","Indiana","4/13/20","3","2","18015","66.67"
"Cass","3","28","Indiana","4/13/20","4","24","18017","600"
"Clark","7","117","Indiana","4/13/20","71","46","18019","64.79"
"Clay","1","12","Indiana","4/13/20","4","8","18021","200"
"Clinton","1","11","Indiana","4/13/20","4","7","18023","175"
"Crawford","1","12","Indiana","4/13/20","5","7","18025","140"
"Daviess","1","10","Indiana","4/13/20","2","8","18027","400"
"Dearborn","13","129","Indiana","4/13/20","38","91","18029","239.47"
"Decatur","6","129","Indiana","4/13/20","90","39","18031","43.33"
"DeKalb","8","60","Indiana","4/13/20","4","56","18033","1400"
"Delaware","4","69","Indiana","4/13/20","40","29","18035","72.5"
"Dubois","1","13","Indiana","4/13/20","7","6","18037","85.71"
"Elkhart","8","89","Indiana","4/13/20","36","53","18039","147.22"
"Fayette","1","20","Indiana","4/13/20","16","4","18041","25"
"Floyd","8","108","Indiana","4/13/20","50","58","18043","116"
"Fountain","0","3","Indiana","4/13/20","2","1","18045","50"
"Franklin","2","69","Indiana","4/13/20","55","14","18047","25.45"
"Fulton","0","3","Indiana","4/13/20","3","0","18049","0"
"Gibson","0","4","Indiana","4/13/20","4","0","18051","0"
"Grant","2","37","Indiana","4/13/20","20","17","18053","85"
"Greene","2","25","Indiana","4/13/20","10","15","18055","150"
"Hamilton","22","490","Indiana","4/13/20","335","155","18057","46.27"
"Hancock","7","118","Indiana","4/13/20","72","46","18059","63.89"
"Harrison","4","58","Indiana","4/13/20","33","25","18061","75.76"
"Hendricks","19","330","Indiana","4/13/20","196","134","18063","68.37"
"Henry","1","23","Indiana","4/13/20","13","10","18065","76.92"
"Howard","3","50","Indiana","4/13/20","32","18","18067","56.25"
"Huntington","0","6","Indiana","4/13/20","4","2","18069","50"
"Jackson","5","70","Indiana","4/13/20","37","33","18071","89.19"
"Jasper","0","18","Indiana","4/13/20","15","3","18073","20"
"Jay","1","7","Indiana","4/13/20","3","4","18075","133.33"
"Jefferson","1","12","Indiana","4/13/20","6","6","18077","100"
"Jennings","3","56","Indiana","4/13/20","37","19","18079","51.35"
"Johnson","19","327","Indiana","4/13/20","195","132","18081","67.69"
"Knox","1","15","Indiana","4/13/20","8","7","18083","87.5"
"Kosciusko","1","18","Indiana","4/13/20","14","4","18085","28.57"
"LaGrange","1","13","Indiana","4/13/20","6","7","18087","116.67"
"Lake","61","796","Indiana","4/13/20","369","427","18089","115.72"
"LaPorte","2","34","Indiana","4/13/20","21","13","18091","61.9"
"Lawrence","5","71","Indiana","4/13/20","39","32","18093","82.05"
"Madison","23","261","Indiana","4/13/20","101","160","18095","158.42"
"Marion","151","3012","Indiana","4/13/20","1956","1056","18097","53.99"
"Marshall","1","17","Indiana","4/13/20","8","9","18099","112.5"
"Martin","0","5","Indiana","4/13/20","2","3","18101","150"
"Miami","1","16","Indiana","4/13/20","7","9","18103","128.57"
"Monroe","6","87","Indiana","4/13/20","48","39","18105","81.25"
"Montgomery","1","22","Indiana","4/13/20","15","7","18107","46.67"
"Morgan","4","103","Indiana","4/13/20","76","27","18109","35.53"
"Newton","3","27","Indiana","4/13/20","4","23","18111","575"
"Noble","1","15","Indiana","4/13/20","11","4","18113","36.36"
"Ohio","0","1","Indiana","4/13/20","1","0","18115","0"
"Orange","1","18","Indiana","4/13/20","9","9","18117","100"
"Owen","1","19","Indiana","4/13/20","15","4","18119","26.67"
"Parke","0","7","Indiana","4/13/20","5","2","18121","40"
"Perry","0","3","Indiana","4/13/20","0","3","18123","1"
"Pike","0","1","Indiana","4/13/20","0","1","18125","1"
"Porter","6","120","Indiana","4/13/20","79","41","18127","51.9"
"Posey","0","5","Indiana","4/13/20","5","0","18129","0"
"Pulaski","0","1","Indiana","4/13/20","0","1","18131","1"
"Putnam","2","33","Indiana","4/13/20","21","12","18133","57.14"
"Randolph","1","11","Indiana","4/13/20","5","6","18135","120"
"Ripley","2","86","Indiana","4/13/20","70","16","18137","22.86"
"Rush","1","17","Indiana","4/13/20","12","5","18139","41.67"
"Scott","1","17","Indiana","4/13/20","8","9","18143","112.5"
"Shelby","4","75","Indiana","4/13/20","45","30","18145","66.67"
"Spencer","0","3","Indiana","4/13/20","1","2","18147","200"
"St. Joseph","12","194","Indiana","4/13/20","112","82","18141","73.21"
"Starke","1","9","Indiana","4/13/20","4","5","18149","125"
"Steuben","1","12","Indiana","4/13/20","8","4","18151","50"
"Sullivan","0","6","Indiana","4/13/20","3","3","18153","100"
"Switzerland","0","12","Indiana","4/13/20","11","1","18155","9.09"
"Tippecanoe","2","45","Indiana","4/13/20","34","11","18157","32.35"
"Tipton","1","10","Indiana","4/13/20","6","4","18159","66.67"
"Union","1","9","Indiana","4/13/20","3","6","18161","200"
"Vanderburgh","2","57","Indiana","4/13/20","40","17","18163","42.5"
"Vermillion","0","3","Indiana","4/13/20","2","1","18165","50"
"Vigo","2","42","Indiana","4/13/20","25","17","18167","68"
"Wabash","1","7","Indiana","4/13/20","3","4","18169","133.33"
"Warren","0","3","Indiana","4/13/20","2","1","18171","50"
"Warrick","3","38","Indiana","4/13/20","19","19","18173","100"
"Washington","1","26","Indiana","4/13/20","18","8","18175","44.44"
"Wayne","1","19","Indiana","4/13/20","10","9","18177","90"
"Wells","0","4","Indiana","4/13/20","2","2","18179","100"
"White","0","4","Indiana","4/13/20","3","1","18181","33.33"
"Whitley","1","13","Indiana","4/13/20","8","5","18183","62.5"
"Adair","0","1","Iowa","4/13/20","1","0","19001","0"
"Allamakee","1","23","Iowa","4/13/20","18","5","19005","27.78"
"Appanoose","0","1","Iowa","4/13/20","1","0","19007","0"
"Audubon","0","1","Iowa","4/13/20","1","0","19009","0"
"Benton","1","20","Iowa","4/13/20","10","10","19011","100"
"Black Hawk","7","62","Iowa","4/13/20","12","50","19013","416.67"
"Boone","0","4","Iowa","4/13/20","3","1","19015","33.33"
"Bremer","0","4","Iowa","4/13/20","2","2","19017","100"
"Buchanan","0","8","Iowa","4/13/20","5","3","19019","60"
"Buena Vista","0","2","Iowa","4/13/20","0","2","19021","1"
"Butler","0","1","Iowa","4/13/20","1","0","19023","0"
"Carroll","0","1","Iowa","4/13/20","1","0","19027","0"
"Cass","0","1","Iowa","4/13/20","0","1","19029","1"
"Cedar","1","21","Iowa","4/13/20","13","8","19031","61.54"
"Cerro Gordo","0","13","Iowa","4/13/20","12","1","19033","8.33"
"Chickasaw","0","2","Iowa","4/13/20","1","1","19037","100"
"Clarke","0","2","Iowa","4/13/20","1","1","19039","100"
"Clay","0","2","Iowa","4/13/20","2","0","19041","0"
"Clayton","0","7","Iowa","4/13/20","4","3","19043","75"
"Clinton","2","33","Iowa","4/13/20","17","16","19045","94.12"
"Crawford","0","6","Iowa","4/13/20","5","1","19047","20"
"Dallas","0","36","Iowa","4/13/20","35","1","19049","2.86"
"Delaware","0","2","Iowa","4/13/20","0","2","19055","1"
"Des Moines","1","5","Iowa","4/13/20","1","4","19057","400"
"Dickinson","0","1","Iowa","4/13/20","1","0","19059","0"
"Dubuque","1","35","Iowa","4/13/20","25","10","19061","40"
"Fayette","0","5","Iowa","4/13/20","3","2","19065","66.67"
"Franklin","0","1","Iowa","4/13/20","1","0","19069","0"
"Greene","0","1","Iowa","4/13/20","0","1","19073","1"
"Grundy","0","1","Iowa","4/13/20","1","0","19075","0"
"Guthrie","0","1","Iowa","4/13/20","1","0","19077","0"
"Hamilton","0","2","Iowa","4/13/20","1","1","19079","100"
"Hancock","0","3","Iowa","4/13/20","3","0","19081","0"
"Hardin","0","2","Iowa","4/13/20","1","1","19083","100"
"Harrison","0","12","Iowa","4/13/20","10","2","19085","20"
"Henry","2","20","Iowa","4/13/20","9","11","19087","122.22"
"Howard","0","1","Iowa","4/13/20","1","0","19089","0"
"Iowa","0","7","Iowa","4/13/20","6","1","19095","16.67"
"Jackson","0","4","Iowa","4/13/20","4","0","19097","0"
"Jasper","1","12","Iowa","4/13/20","8","4","19099","50"
"Jefferson","0","4","Iowa","4/13/20","3","1","19101","33.33"
"Johnson","13","210","Iowa","4/13/20","118","92","19103","77.97"
"Jones","1","10","Iowa","4/13/20","6","4","19105","66.67"
"Keokuk","0","2","Iowa","4/13/20","2","0","19107","0"
"Kossuth","0","1","Iowa","4/13/20","1","0","19109","0"
"Lee","0","2","Iowa","4/13/20","1","1","19111","100"
"Linn","12","258","Iowa","4/13/20","176","82","19113","46.59"
"Louisa","10","79","Iowa","4/13/20","7","72","19115","1028.57"
"Lyon","0","4","Iowa","4/13/20","2","2","19119","100"
"Madison","0","2","Iowa","4/13/20","1","1","19121","100"
"Mahaska","0","5","Iowa","4/13/20","3","2","19123","66.67"
"Marion","0","3","Iowa","4/13/20","1","2","19125","200"
"Marshall","4","37","Iowa","4/13/20","12","25","19127","208.33"
"Mills","0","2","Iowa","4/13/20","1","1","19129","100"
"Mitchell","0","2","Iowa","4/13/20","2","0","19131","0"
"Monona","0","6","Iowa","4/13/20","6","0","19133","0"
"Montgomery","0","1","Iowa","4/13/20","1","0","19137","0"
"Muscatine","9","102","Iowa","4/13/20","41","61","19139","148.78"
"O'Brien","0","3","Iowa","4/13/20","3","0","19141","0"
"Osceola","0","2","Iowa","4/13/20","0","2","19143","1"
"Page","0","3","Iowa","4/13/20","3","0","19145","0"
"Plymouth","0","4","Iowa","4/13/20","4","0","19149","0"
"Polk","10","195","Iowa","4/13/20","125","70","19153","56"
"Pottawattamie","1","12","Iowa","4/13/20","8","4","19155","50"
"Poweshiek","0","6","Iowa","4/13/20","6","0","19157","0"
"Scott","9","118","Iowa","4/13/20","52","66","19163","126.92"
"Shelby","0","6","Iowa","4/13/20","6","0","19165","0"
"Sioux","0","7","Iowa","4/13/20","7","0","19167","0"
"Story","0","8","Iowa","4/13/20","5","3","19169","60"
"Tama","9","101","Iowa","4/13/20","35","66","19171","188.57"
"Taylor","0","1","Iowa","4/13/20","1","0","19173","0"
"Union","0","1","Iowa","4/13/20","0","1","19175","1"
"Van Buren","0","8","Iowa","4/13/20","6","2","19177","33.33"
"Wapello","1","6","Iowa","4/13/20","2","4","19179","200"
"Warren","0","14","Iowa","4/13/20","11","3","19181","27.27"
"Washington","5","89","Iowa","4/13/20","52","37","19183","71.15"
"Webster","0","2","Iowa","4/13/20","1","1","19187","100"
"Winnebago","0","2","Iowa","4/13/20","1","1","19189","100"
"Winneshiek","0","5","Iowa","4/13/20","4","1","19191","25"
"Woodbury","2","19","Iowa","4/13/20","8","11","19193","137.5"
"Worth","0","1","Iowa","4/13/20","0","1","19195","1"
"Wright","0","1","Iowa","4/13/20","1","0","19197","0"
"Anderson","0","1","Kansas","4/13/20","0","1","20003","1"
"Atchison","0","3","Kansas","4/13/20","2","1","20005","50"
"Barber","0","1","Kansas","4/13/20","0","1","20007","1"
"Barton","0","4","Kansas","4/13/20","3","1","20009","33.33"
"Bourbon","0","7","Kansas","4/13/20","6","1","20011","16.67"
"Butler","0","9","Kansas","4/13/20","8","1","20015","12.5"
"Chautauqua","0","3","Kansas","4/13/20","3","0","20019","0"
"Cherokee","0","6","Kansas","4/13/20","5","1","20021","20"
"Clay","0","1","Kansas","4/13/20","1","0","20027","0"
"Cloud","0","3","Kansas","4/13/20","1","2","20029","200"
"Coffey","2","40","Kansas","4/13/20","29","11","20031","37.93"
"Cowley","0","1","Kansas","4/13/20","1","0","20035","0"
"Crawford","0","6","Kansas","4/13/20","4","2","20037","50"
"Doniphan","0","1","Kansas","4/13/20","1","0","20043","0"
"Douglas","1","40","Kansas","4/13/20","36","4","20045","11.11"
"Ellis","0","2","Kansas","4/13/20","0","2","20051","1"
"Finney","1","17","Kansas","4/13/20","10","7","20055","70"
"Ford","2","16","Kansas","4/13/20","1","15","20057","1500"
"Franklin","0","12","Kansas","4/13/20","10","2","20059","20"
"Geary","1","8","Kansas","4/13/20","2","6","20061","300"
"Gove","0","1","Kansas","4/13/20","1","0","20063","0"
"Greenwood","0","1","Kansas","4/13/20","1","0","20073","0"
"Hamilton","0","1","Kansas","4/13/20","0","1","20075","1"
"Harvey","0","4","Kansas","4/13/20","3","1","20079","33.33"
"Jackson","0","1","Kansas","4/13/20","1","0","20085","0"
"Jefferson","0","5","Kansas","4/13/20","3","2","20087","66.67"
"Jewell","0","3","Kansas","4/13/20","1","2","20089","200"
"Johnson","14","309","Kansas","4/13/20","212","97","20091","45.75"
"Kearny","0","1","Kansas","4/13/20","0","1","20093","1"
"Labette","2","18","Kansas","4/13/20","5","13","20099","260"
"Leavenworth","7","90","Kansas","4/13/20","40","50","20103","125"
"Linn","0","5","Kansas","4/13/20","5","0","20107","0"
"Lyon","1","30","Kansas","4/13/20","23","7","20111","30.43"
"Marion","0","4","Kansas","4/13/20","3","1","20115","33.33"
"McPherson","1","13","Kansas","4/13/20","9","4","20113","44.44"
"Miami","0","3","Kansas","4/13/20","2","1","20121","50"
"Mitchell","0","2","Kansas","4/13/20","2","0","20123","0"
"Montgomery","1","14","Kansas","4/13/20","9","5","20125","55.56"
"Morris","0","2","Kansas","4/13/20","2","0","20127","0"
"Morton","0","1","Kansas","4/13/20","1","0","20129","0"
"Neosho","0","2","Kansas","4/13/20","1","1","20133","100"
"Osage","0","4","Kansas","4/13/20","3","1","20139","33.33"
"Osborne","0","2","Kansas","4/13/20","2","0","20141","0"
"Ottawa","0","3","Kansas","4/13/20","3","0","20143","0"
"Phillips","0","1","Kansas","4/13/20","0","1","20147","1"
"Pottawatomie","0","5","Kansas","4/13/20","3","2","20149","66.67"
"Pratt","0","1","Kansas","4/13/20","1","0","20151","0"
"Reno","0","13","Kansas","4/13/20","10","3","20155","30"
"Republic","0","4","Kansas","4/13/20","1","3","20157","300"
"Riley","1","21","Kansas","4/13/20","14","7","20161","50"
"Rooks","0","2","Kansas","4/13/20","0","2","20163","1"
"Saline","0","10","Kansas","4/13/20","7","3","20169","42.86"
"Scott","0","1","Kansas","4/13/20","0","1","20171","1"
"Sedgwick","11","200","Kansas","4/13/20","124","76","20173","61.29"
"Seward","1","6","Kansas","4/13/20","0","6","20175","1"
"Shawnee","5","78","Kansas","4/13/20","40","38","20177","95"
"Stafford","0","1","Kansas","4/13/20","1","0","20185","0"
"Stanton","0","2","Kansas","4/13/20","0","2","20187","1"
"Stevens","0","2","Kansas","4/13/20","1","1","20189","100"
"Sumner","0","2","Kansas","4/13/20","2","0","20191","0"
"Wabaunsee","0","1","Kansas","4/13/20","1","0","20197","0"
"Woodson","0","3","Kansas","4/13/20","3","0","20207","0"
"Wyandotte","22","337","Kansas","4/13/20","186","151","20209","81.18"
"Adair","1","11","Kentucky","4/13/20","3","8","21001","266.67"
"Allen","0","4","Kentucky","4/13/20","2","2","21003","100"
"Anderson","0","3","Kentucky","4/13/20","3","0","21005","0"
"Ballard","0","1","Kentucky","4/13/20","0","1","21007","1"
"Barren","1","5","Kentucky","4/13/20","0","5","21009","1"
"Bath","0","2","Kentucky","4/13/20","1","1","21011","100"
"Boone","5","48","Kentucky","4/13/20","12","36","21015","300"
"Bourbon","0","4","Kentucky","4/13/20","4","0","21017","0"
"Boyd","2","26","Kentucky","4/13/20","13","13","21019","100"
"Boyle","1","13","Kentucky","4/13/20","7","6","21021","85.71"
"Bracken","1","6","Kentucky","4/13/20","1","5","21023","500"
"Breathitt","0","2","Kentucky","4/13/20","1","1","21025","100"
"Breckinridge","0","3","Kentucky","4/13/20","2","1","21027","50"
"Bullitt","2","27","Kentucky","4/13/20","11","16","21029","145.45"
"Butler","1","11","Kentucky","4/13/20","1","10","21031","1000"
"Caldwell","1","10","Kentucky","4/13/20","2","8","21033","400"
"Calloway","1","14","Kentucky","4/13/20","5","9","21035","180"
"Campbell","5","47","Kentucky","4/13/20","12","35","21037","291.67"
"Carroll","0","2","Kentucky","4/13/20","2","0","21041","0"
"Carter","0","1","Kentucky","4/13/20","1","0","21043","0"
"Christian","5","62","Kentucky","4/13/20","30","32","21047","106.67"
"Clark","1","17","Kentucky","4/13/20","11","6","21049","54.55"
"Clinton","0","3","Kentucky","4/13/20","1","2","21053","200"
"Crittenden","0","3","Kentucky","4/13/20","1","2","21055","200"
"Cumberland","0","3","Kentucky","4/13/20","1","2","21057","200"
"Daviess","4","81","Kentucky","4/13/20","55","26","21059","47.27"
"Edmonson","0","6","Kentucky","4/13/20","5","1","21061","20"
"Fayette","8","179","Kentucky","4/13/20","122","57","21067","46.72"
"Fleming","0","1","Kentucky","4/13/20","0","1","21069","1"
"Floyd","0","1","Kentucky","4/13/20","0","1","21071","1"
"Franklin","0","10","Kentucky","4/13/20","7","3","21073","42.86"
"Gallatin","0","1","Kentucky","4/13/20","0","1","21077","1"
"Grant","2","13","Kentucky","4/13/20","2","11","21081","550"
"Graves","1","9","Kentucky","4/13/20","2","7","21083","350"
"Grayson","0","4","Kentucky","4/13/20","2","2","21085","100"
"Green","0","2","Kentucky","4/13/20","0","2","21087","1"
"Greenup","1","5","Kentucky","4/13/20","1","4","21089","400"
"Hancock","0","2","Kentucky","4/13/20","1","1","21091","100"
"Hardin","2","21","Kentucky","4/13/20","9","12","21093","133.33"
"Harrison","0","14","Kentucky","4/13/20","12","2","21097","16.67"
"Hart","0","1","Kentucky","4/13/20","0","1","21099","1"
"Henderson","3","29","Kentucky","4/13/20","6","23","21101","383.33"
"Henry","0","4","Kentucky","4/13/20","2","2","21103","100"
"Hopkins","8","87","Kentucky","4/13/20","34","53","21107","155.88"
"Jackson","1","5","Kentucky","4/13/20","0","5","21109","1"
"Jefferson","35","550","Kentucky","4/13/20","304","246","21111","80.92"
"Jessamine","1","26","Kentucky","4/13/20","16","10","21113","62.5"
"Johnson","0","1","Kentucky","4/13/20","1","0","21115","0"
"Kenton","8","91","Kentucky","4/13/20","33","58","21117","175.76"
"Knott","0","1","Kentucky","4/13/20","0","1","21119","1"
"Knox","0","1","Kentucky","4/13/20","0","1","21121","1"
"Larue","0","3","Kentucky","4/13/20","3","0","21123","0"
"Laurel","1","9","Kentucky","4/13/20","2","7","21125","350"
"Lawrence","0","1","Kentucky","4/13/20","1","0","21127","0"
"Leslie","0","1","Kentucky","4/13/20","0","1","21131","1"
"Letcher","0","1","Kentucky","4/13/20","0","1","21133","1"
"Lewis","0","2","Kentucky","4/13/20","2","0","21135","0"
"Lincoln","0","1","Kentucky","4/13/20","0","1","21137","1"
"Logan","0","5","Kentucky","4/13/20","4","1","21141","25"
"Lyon","1","12","Kentucky","4/13/20","4","8","21143","200"
"Madison","1","18","Kentucky","4/13/20","11","7","21151","63.64"
"Marion","1","11","Kentucky","4/13/20","3","8","21155","266.67"
"Marshall","1","11","Kentucky","4/13/20","3","8","21157","266.67"
"Martin","0","4","Kentucky","4/13/20","1","3","21159","300"
"Mason","0","5","Kentucky","4/13/20","2","3","21161","150"
"McCracken","1","21","Kentucky","4/13/20","13","8","21145","61.54"
"McCreary","1","8","Kentucky","4/13/20","1","7","21147","700"
"McLean","1","7","Kentucky","4/13/20","1","6","21149","600"
"Meade","0","2","Kentucky","4/13/20","2","0","21163","0"
"Menifee","0","3","Kentucky","4/13/20","3","0","21165","0"
"Mercer","1","9","Kentucky","4/13/20","4","5","21167","125"
"Monroe","0","2","Kentucky","4/13/20","0","2","21171","1"
"Montgomery","0","8","Kentucky","4/13/20","5","3","21173","60"
"Muhlenberg","4","28","Kentucky","4/13/20","0","28","21177","1"
"Nelson","1","10","Kentucky","4/13/20","4","6","21179","150"
"Nicholas","0","1","Kentucky","4/13/20","1","0","21181","0"
"Ohio","1","8","Kentucky","4/13/20","1","7","21183","700"
"Oldham","1","16","Kentucky","4/13/20","7","9","21185","128.57"
"Pendleton","0","3","Kentucky","4/13/20","2","1","21191","50"
"Perry","0","3","Kentucky","4/13/20","3","0","21193","0"
"Pike","0","4","Kentucky","4/13/20","1","3","21195","300"
"Powell","0","2","Kentucky","4/13/20","1","1","21197","100"
"Pulaski","3","33","Kentucky","4/13/20","13","20","21199","153.85"
"Rockcastle","1","8","Kentucky","4/13/20","2","6","21203","300"
"Rowan","0","1","Kentucky","4/13/20","0","1","21205","1"
"Russell","1","8","Kentucky","4/13/20","1","7","21207","700"
"Scott","1","22","Kentucky","4/13/20","14","8","21209","57.14"
"Shelby","2","18","Kentucky","4/13/20","7","11","21211","157.14"
"Simpson","1","17","Kentucky","4/13/20","13","4","21213","30.77"
"Spencer","1","6","Kentucky","4/13/20","2","4","21215","200"
"Taylor","0","3","Kentucky","4/13/20","2","1","21217","50"
"Todd","1","6","Kentucky","4/13/20","0","6","21219","1"
"Trimble","0","2","Kentucky","4/13/20","0","2","21223","1"
"Union","0","5","Kentucky","4/13/20","2","3","21225","150"
"Warren","4","49","Kentucky","4/13/20","21","28","21227","133.33"
"Washington","0","3","Kentucky","4/13/20","2","1","21229","50"
"Wayne","0","4","Kentucky","4/13/20","4","0","21231","0"
"Webster","1","8","Kentucky","4/13/20","3","5","21233","166.67"
"Whitley","1","4","Kentucky","4/13/20","0","4","21235","1"
"Woodford","1","17","Kentucky","4/13/20","9","8","21239","88.89"
"Acadia","3","101","Louisiana","4/13/20","79","22","22001","27.85"
"Allen","3","74","Louisiana","4/13/20","52","22","22003","42.31"
"Ascension","12","432","Louisiana","4/13/20","347","85","22005","24.5"
"Assumption","6","120","Louisiana","4/13/20","77","43","22007","55.84"
"Avoyelles","3","64","Louisiana","4/13/20","40","24","22009","60"
"Beauregard","1","28","Louisiana","4/13/20","23","5","22011","21.74"
"Bienville","3","37","Louisiana","4/13/20","14","23","22013","164.29"
"Bossier","7","188","Louisiana","4/13/20","139","49","22015","35.25"
"Caddo","46","1033","Louisiana","4/13/20","711","322","22017","45.29"
"Calcasieu","16","268","Louisiana","4/13/20","159","109","22019","68.55"
"Caldwell","1","18","Louisiana","4/13/20","11","7","22021","63.64"
"Cameron","0","2","Louisiana","4/13/20","0","2","22023","1"
"Catahoula","1","21","Louisiana","4/13/20","12","9","22025","75"
"Claiborne","2","41","Louisiana","4/13/20","30","11","22027","36.67"
"Concordia","1","19","Louisiana","4/13/20","9","10","22029","111.11"
"De Soto","6","125","Louisiana","4/13/20","82","43","22031","52.44"
"East Baton Rouge","65","1273","Louisiana","4/13/20","816","457","22033","56"
"East Carroll","0","1","Louisiana","4/13/20","1","0","22035","0"
"East Feliciana","5","73","Louisiana","4/13/20","39","34","22037","87.18"
"Evangeline","2","38","Louisiana","4/13/20","23","15","22039","65.22"
"Franklin","3","49","Louisiana","4/13/20","28","21","22041","75"
"Grant","0","12","Louisiana","4/13/20","10","2","22043","20"
"Iberia","8","142","Louisiana","4/13/20","83","59","22045","71.08"
"Iberville","15","241","Louisiana","4/13/20","136","105","22047","77.21"
"Jackson","1","8","Louisiana","4/13/20","4","4","22049","100"
"Jefferson","223","5088","Louisiana","4/13/20","3530","1558","22051","44.14"
"Jefferson Davis","4","47","Louisiana","4/13/20","21","26","22053","123.81"
"Lafayette","14","360","Louisiana","4/13/20","260","100","22055","38.46"
"Lafourche","25","481","Louisiana","4/13/20","305","176","22057","57.7"
"LaSalle","1","13","Louisiana","4/13/20","6","7","22059","116.67"
"Lincoln","3","39","Louisiana","4/13/20","19","20","22061","105.26"
"Livingston","6","122","Louisiana","4/13/20","79","43","22063","54.43"
"Madison","0","2","Louisiana","4/13/20","1","1","22065","100"
"Morehouse","2","32","Louisiana","4/13/20","15","17","22067","113.33"
"Natchitoches","3","41","Louisiana","4/13/20","22","19","22069","86.36"
"Orleans","155","5651","Louisiana","4/13/20","4565","1086","22071","23.79"
"Ouachita","22","384","Louisiana","4/13/20","230","154","22073","66.96"
"Plaquemines","6","140","Louisiana","4/13/20","100","40","22075","40"
"Pointe Coupee","3","47","Louisiana","4/13/20","24","23","22077","95.83"
"Rapides","8","168","Louisiana","4/13/20","110","58","22079","52.73"
"Red River","1","12","Louisiana","4/13/20","2","10","22081","500"
"Richland","1","20","Louisiana","4/13/20","11","9","22083","81.82"
"Sabine","0","9","Louisiana","4/13/20","7","2","22085","28.57"
"St. Bernard","15","369","Louisiana","4/13/20","267","102","22087","38.2"
"St. Charles","18","410","Louisiana","4/13/20","285","125","22089","43.86"
"St. Helena","1","14","Louisiana","4/13/20","8","6","22091","75"
"St. James","6","207","Louisiana","4/13/20","167","40","22093","23.95"
"St. John the Baptist","27","556","Louisiana","4/13/20","366","190","22095","51.91"
"St. Landry","9","114","Louisiana","4/13/20","52","62","22097","119.23"
"St. Martin","10","162","Louisiana","4/13/20","90","72","22099","80"
"St. Mary","8","127","Louisiana","4/13/20","73","54","22101","73.97"
"St. Tammany","35","881","Louisiana","4/13/20","637","244","22103","38.3"
"Tangipahoa","24","352","Louisiana","4/13/20","186","166","22105","89.25"
"Tensas","0","1","Louisiana","4/13/20","0","1","22107","1"
"Terrebonne","11","260","Louisiana","4/13/20","182","78","22109","42.86"
"Union","3","48","Louisiana","4/13/20","26","22","22111","84.62"
"Vermilion","1","26","Louisiana","4/13/20","17","9","22113","52.94"
"Vernon","1","14","Louisiana","4/13/20","10","4","22115","40"
"Washington","9","156","Louisiana","4/13/20","92","64","22117","69.57"
"Webster","2","65","Louisiana","4/13/20","51","14","22119","27.45"
"West Baton Rouge","4","72","Louisiana","4/13/20","45","27","22121","60"
"West Carroll","0","4","Louisiana","4/13/20","1","3","22123","300"
"West Feliciana","2","46","Louisiana","4/13/20","30","16","22125","53.33"
"Winn","1","12","Louisiana","4/13/20","2","10","22127","500"
"Androscoggin","1","28","Maine","4/13/20","23","5","23001","21.74"
"Aroostook","0","2","Maine","4/13/20","1","1","23003","100"
"Cumberland","7","299","Maine","4/13/20","249","50","23005","20.08"
"Franklin","0","8","Maine","4/13/20","5","3","23007","60"
"Hancock","0","5","Maine","4/13/20","2","3","23009","150"
"Kennebec","8","78","Maine","4/13/20","23","55","23011","239.13"
"Knox","0","12","Maine","4/13/20","9","3","23013","33.33"
"Lincoln","0","10","Maine","4/13/20","9","1","23015","11.11"
"Oxford","0","13","Maine","4/13/20","11","2","23017","18.18"
"Penobscot","1","34","Maine","4/13/20","25","9","23019","36"
"Sagadahoc","0","15","Maine","4/13/20","13","2","23023","15.38"
"Somerset","1","8","Maine","4/13/20","4","4","23025","100"
"Waldo","3","29","Maine","4/13/20","5","24","23027","480"
"Washington","0","1","Maine","4/13/20","1","0","23029","0"
"York","6","151","Maine","4/13/20","108","43","23031","39.81"
"Allegany","1","15","Maryland","4/13/20","6","9","24001","150"
"Anne Arundel","54","724","Maryland","4/13/20","343","381","24003","111.08"
"Baltimore","102","1361","Maryland","4/13/20","648","713","24005","110.03"
"Baltimore City","63","873","Maryland","4/13/20","435","438","24510","100.69"
"Calvert","8","94","Maryland","4/13/20","40","54","24009","135"
"Caroline","2","21","Maryland","4/13/20","6","15","24011","250"
"Carroll","14","250","Maryland","4/13/20","150","100","24013","66.67"
"Cecil","7","83","Maryland","4/13/20","37","46","24015","124.32"
"Charles","21","274","Maryland","4/13/20","129","145","24017","112.4"
"Dorchester","2","12","Maryland","4/13/20","1","11","24019","1100"
"Frederick","40","417","Maryland","4/13/20","138","279","24021","202.17"
"Garrett","0","4","Maryland","4/13/20","3","1","24023","33.33"
"Harford","12","142","Maryland","4/13/20","55","87","24025","158.18"
"Howard","25","386","Maryland","4/13/20","214","172","24027","80.37"
"Kent","1","11","Maryland","4/13/20","5","6","24029","120"
"Montgomery","138","1756","Maryland","4/13/20","793","963","24031","121.44"
"Prince George's","184","2205","Maryland","4/13/20","916","1289","24033","140.72"
"Queen Anne's","1","19","Maryland","4/13/20","15","4","24035","26.67"
"Somerset","0","6","Maryland","4/13/20","4","2","24039","50"
"St. Mary's","8","95","Maryland","4/13/20","41","54","24037","131.71"
"Talbot","1","16","Maryland","4/13/20","8","8","24041","100"
"Washington","8","93","Maryland","4/13/20","37","56","24043","151.35"
"Wicomico","7","58","Maryland","4/13/20","11","47","24045","427.27"
"Worcester","2","21","Maryland","4/13/20","10","11","24047","110"
"Barnstable","17","502","Massachusetts","4/13/20","383","119","25001","31.07"
"Berkshire","12","355","Massachusetts","4/13/20","268","87","25003","32.46"
"Bristol","96","1394","Massachusetts","4/13/20","722","672","25005","93.07"
"Dukes and Nantucket","1","21","Massachusetts","4/13/20","17","4","00000","23.53"
"Essex","251","3413","Massachusetts","4/13/20","1653","1760","25009","106.47"
"Franklin","6","148","Massachusetts","4/13/20","107","41","25011","38.32"
"Hampden","115","1694","Massachusetts","4/13/20","889","805","25013","90.55"
"Hampshire","11","224","Massachusetts","4/13/20","147","77","25015","52.38"
"Middlesex","433","5983","Massachusetts","4/13/20","2950","3033","25017","102.81"
"Norfolk","208","2838","Massachusetts","4/13/20","1382","1456","25021","105.35"
"Plymouth","153","2141","Massachusetts","4/13/20","1067","1074","25023","100.66"
"Suffolk","379","5579","Massachusetts","4/13/20","2929","2650","25025","90.47"
"Worcester","150","2128","Massachusetts","4/13/20","1077","1051","25027","97.59"
"Allegan","3","38","Michigan","4/13/20","16","22","26005","137.5"
"Alpena","0","1","Michigan","4/13/20","0","1","26007","1"
"Antrim","0","9","Michigan","4/13/20","6","3","26009","50"
"Arenac","0","5","Michigan","4/13/20","3","2","26011","66.67"
"Barry","1","14","Michigan","4/13/20","9","5","26015","55.56"
"Bay","5","67","Michigan","4/13/20","34","33","26017","97.06"
"Berrien","10","192","Michigan","4/13/20","121","71","26021","58.68"
"Branch","2","32","Michigan","4/13/20","15","17","26023","113.33"
"Calhoun","7","94","Michigan","4/13/20","44","50","26025","113.64"
"Cass","1","18","Michigan","4/13/20","11","7","26027","63.64"
"Charlevoix","0","11","Michigan","4/13/20","8","3","26029","37.5"
"Cheboygan","1","16","Michigan","4/13/20","9","7","26031","77.78"
"Chippewa","0","0","Michigan","4/13/20","1","-1","26033","-100"
"Clare","0","4","Michigan","4/13/20","3","1","26035","33.33"
"Clinton","5","98","Michigan","4/13/20","60","38","26037","63.33"
"Crawford","2","14","Michigan","4/13/20","2","12","26039","600"
"Delta","0","10","Michigan","4/13/20","8","2","26041","25"
"Dickinson","0","3","Michigan","4/13/20","2","1","26043","50"
"Eaton","3","79","Michigan","4/13/20","58","21","26045","36.21"
"Emmet","2","25","Michigan","4/13/20","14","11","26047","78.57"
"Federal Correctional Institution (FCI)","3","21","Michigan","4/13/20","0","21","00000","1"
"Genesee","62","1015","Michigan","4/13/20","582","433","26049","74.4"
"Gladwin","0","4","Michigan","4/13/20","4","0","26051","0"
"Gogebic","0","4","Michigan","4/13/20","3","1","26053","33.33"
"Grand Traverse","1","18","Michigan","4/13/20","14","4","26055","28.57"
"Gratiot","0","8","Michigan","4/13/20","5","3","26057","60"
"Hillsdale","4","78","Michigan","4/13/20","47","31","26059","65.96"
"Houghton","0","1","Michigan","4/13/20","1","0","26061","0"
"Huron","1","12","Michigan","4/13/20","5","7","26063","140"
"Ingham","11","263","Michigan","4/13/20","185","78","26065","42.16"
"Ionia","1","15","Michigan","4/13/20","8","7","26067","87.5"
"Iosco","0","6","Michigan","4/13/20","4","2","26069","50"
"Isabella","5","54","Michigan","4/13/20","21","33","26073","157.14"
"Jackson","10","185","Michigan","4/13/20","114","71","26075","62.28"
"Kalamazoo","6","104","Michigan","4/13/20","65","39","26077","60"
"Kalkaska","2","21","Michigan","4/13/20","9","12","26079","133.33"
"Kent","23","345","Michigan","4/13/20","183","162","26081","88.52"
"Lake","0","3","Michigan","4/13/20","0","3","26085","1"
"Lapeer","9","113","Michigan","4/13/20","53","60","26087","113.21"
"Leelanau","0","4","Michigan","4/13/20","2","2","26089","100"
"Lenawee","4","60","Michigan","4/13/20","35","25","26091","71.43"
"Livingston","14","265","Michigan","4/13/20","170","95","26093","55.88"
"Luce","0","1","Michigan","4/13/20","1","0","26095","0"
"Mackinac","0","4","Michigan","4/13/20","2","2","26097","100"
"Macomb","180","3423","Michigan","4/13/20","2162","1261","26099","58.33"
"Manistee","1","11","Michigan","4/13/20","7","4","26101","57.14"
"Marquette","1","24","Michigan","4/13/20","15","9","26103","60"
"Mason","0","3","Michigan","4/13/20","1","2","26105","200"
"Mecosta","1","12","Michigan","4/13/20","6","6","26107","100"
"Menominee","0","1","Michigan","4/13/20","0","1","26109","1"
"Michigan Department of Corrections (MDOC)","53","370","Michigan","4/13/20","0","370","00000","1"
"Midland","2","47","Michigan","4/13/20","30","17","26111","56.67"
"Missaukee","0","1","Michigan","4/13/20","1","0","26113","0"
"Monroe","11","191","Michigan","4/13/20","117","74","26115","63.25"
"Montcalm","1","23","Michigan","4/13/20","16","7","26117","43.75"
"Montmorency","0","1","Michigan","4/13/20","0","1","26119","1"
"Muskegon","5","68","Michigan","4/13/20","33","35","26121","106.06"
"Newaygo","1","8","Michigan","4/13/20","2","6","26123","300"
"Oakland","255","5421","Michigan","4/13/20","3638","1783","26125","49.01"
"Oceana","0","3","Michigan","4/13/20","3","0","26127","0"
"Ogemaw","0","5","Michigan","4/13/20","4","1","26129","25"
"Ontonagon","0","0","Michigan","4/13/20","1","-1","26131","-100"
"Osceola","0","7","Michigan","4/13/20","5","2","26133","40"
"Oscoda","0","4","Michigan","4/13/20","2","2","26135","100"
"Otsego","1","38","Michigan","4/13/20","28","10","26137","35.71"
"Ottawa","6","100","Michigan","4/13/20","56","44","26139","78.57"
"Out of MI","8","148","Michigan","4/13/20","91","57","80026","62.64"
"Presque Isle","0","2","Michigan","4/13/20","1","1","26141","100"
"Roscommon","1","10","Michigan","4/13/20","5","5","26143","100"
"Saginaw","22","293","Michigan","4/13/20","139","154","26145","110.79"
"Sanilac","1","24","Michigan","4/13/20","14","10","26151","71.43"
"Schoolcraft","0","3","Michigan","4/13/20","0","3","26153","1"
"Shiawassee","5","60","Michigan","4/13/20","26","34","26155","130.77"
"St. Clair","16","239","Michigan","4/13/20","125","114","26147","91.2"
"St. Joseph","1","21","Michigan","4/13/20","11","10","26149","90.91"
"Tuscola","4","47","Michigan","4/13/20","22","25","26157","113.64"
"Van Buren","1","30","Michigan","4/13/20","22","8","26159","36.36"
"Washtenaw","32","817","Michigan","4/13/20","591","226","26161","38.24"
"Wayne","488","11746","Michigan","4/13/20","8332","3414","26163","40.97"
"Wexford","0","9","Michigan","4/13/20","6","3","26165","50"
"Anoka","4","68","Minnesota","4/13/20","40","28","27003","70"
"Becker","0","2","Minnesota","4/13/20","0","2","27005","1"
"Beltrami","0","5","Minnesota","4/13/20","6","-1","27007","-16.67"
"Benton","0","1","Minnesota","4/13/20","1","0","27009","0"
"Big Stone","0","1","Minnesota","4/13/20","1","0","27011","0"
"Blue Earth","1","22","Minnesota","4/13/20","16","6","27013","37.5"
"Brown","0","7","Minnesota","4/13/20","5","2","27015","40"
"Carlton","2","25","Minnesota","4/13/20","10","15","27017","150"
"Carver","0","13","Minnesota","4/13/20","10","3","27019","30"
"Cass","0","4","Minnesota","4/13/20","1","3","27021","300"
"Chisago","0","7","Minnesota","4/13/20","5","2","27025","40"
"Clay","3","40","Minnesota","4/13/20","19","21","27027","110.53"
"Clearwater","0","2","Minnesota","4/13/20","2","0","27029","0"
"Cottonwood","0","6","Minnesota","4/13/20","5","1","27033","20"
"Crow Wing","1","16","Minnesota","4/13/20","6","10","27035","166.67"
"Dakota","4","95","Minnesota","4/13/20","67","28","27037","41.79"
"Dodge","1","16","Minnesota","4/13/20","10","6","27039","60"
"Douglas","0","1","Minnesota","4/13/20","1","0","27041","0"
"Faribault","0","4","Minnesota","4/13/20","3","1","27043","33.33"
"Fillmore","0","10","Minnesota","4/13/20","10","0","27045","0"
"Freeborn","2","24","Minnesota","4/13/20","11","13","27047","118.18"
"Goodhue","1","17","Minnesota","4/13/20","10","7","27049","70"
"Hennepin","40","557","Minnesota","4/13/20","280","277","27053","98.93"
"Houston","0","1","Minnesota","4/13/20","1","0","27055","0"
"Isanti","0","4","Minnesota","4/13/20","4","0","27059","0"
"Itasca","0","2","Minnesota","4/13/20","2","0","27061","0"
"Jackson","0","1","Minnesota","4/13/20","1","0","27063","0"
"Kandiyohi","0","2","Minnesota","4/13/20","2","0","27067","0"
"Koochiching","0","1","Minnesota","4/13/20","1","0","27071","0"
"Lac qui Parle","0","1","Minnesota","4/13/20","1","0","27073","0"
"Le Sueur","0","21","Minnesota","4/13/20","20","1","27079","5"
"Lincoln","0","2","Minnesota","4/13/20","2","0","27081","0"
"Lyon","0","5","Minnesota","4/13/20","4","1","27083","25"
"Mahnomen","0","1","Minnesota","4/13/20","1","0","27087","0"
"Martin","1","38","Minnesota","4/13/20","33","5","27091","15.15"
"McLeod","0","2","Minnesota","4/13/20","1","1","27085","100"
"Meeker","0","2","Minnesota","4/13/20","1","1","27093","100"
"Mower","1","25","Minnesota","4/13/20","17","8","27099","47.06"
"Murray","0","1","Minnesota","4/13/20","1","0","27101","0"
"Nicollet","0","6","Minnesota","4/13/20","4","2","27103","50"
"Nobles","0","1","Minnesota","4/13/20","0","1","27105","1"
"Olmsted","7","143","Minnesota","4/13/20","96","47","27109","48.96"
"Otter Tail","0","4","Minnesota","4/13/20","2","2","27111","100"
"Pine","1","5","Minnesota","4/13/20","0","5","27115","1"
"Pipestone","0","1","Minnesota","4/13/20","1","0","27117","0"
"Polk","0","1","Minnesota","4/13/20","1","0","27119","0"
"Ramsey","8","152","Minnesota","4/13/20","96","56","27123","58.33"
"Red Lake","0","1","Minnesota","4/13/20","0","1","27125","1"
"Redwood","0","1","Minnesota","4/13/20","1","0","27127","0"
"Renville","0","3","Minnesota","4/13/20","2","1","27129","50"
"Rice","0","4","Minnesota","4/13/20","4","0","27131","0"
"Rock","0","2","Minnesota","4/13/20","0","2","27133","1"
"Roseau","0","1","Minnesota","4/13/20","0","1","27135","1"
"Scott","1","20","Minnesota","4/13/20","15","5","27139","33.33"
"Sherburne","0","9","Minnesota","4/13/20","10","-1","27141","-10"
"Sibley","0","1","Minnesota","4/13/20","1","0","27143","0"
"St. Louis","3","38","Minnesota","4/13/20","16","22","27137","137.5"
"Stearns","0","7","Minnesota","4/13/20","6","1","27145","16.67"
"Steele","0","9","Minnesota","4/13/20","8","1","27147","12.5"
"Swift","0","1","Minnesota","4/13/20","0","1","27151","1"
"Todd","0","2","Minnesota","4/13/20","0","2","27153","1"
"Traverse","0","2","Minnesota","4/13/20","2","0","27155","0"
"Wabasha","0","6","Minnesota","4/13/20","6","0","27157","0"
"Waseca","0","3","Minnesota","4/13/20","3","0","27161","0"
"Washington","2","80","Minnesota","4/13/20","65","15","27163","23.08"
"Watonwan","0","4","Minnesota","4/13/20","4","0","27165","0"
"Wilkin","1","7","Minnesota","4/13/20","2","5","27167","250"
"Winona","2","30","Minnesota","4/13/20","14","16","27169","114.29"
"Wright","1","17","Minnesota","4/13/20","9","8","27171","88.89"
"Yellow Medicine","0","3","Minnesota","4/13/20","1","2","27173","200"
"Adams","5","57","Mississippi","4/13/20","19","38","28001","200"
"Alcorn","0","7","Mississippi","4/13/20","6","1","28003","16.67"
"Amite","1","14","Mississippi","4/13/20","6","8","28005","133.33"
"Attala","1","20","Mississippi","4/13/20","15","5","28007","33.33"
"Benton","0","5","Mississippi","4/13/20","5","0","28009","0"
"Bolivar","2","68","Mississippi","4/13/20","51","17","28011","33.33"
"Calhoun","2","24","Mississippi","4/13/20","9","15","28013","166.67"
"Carroll","0","8","Mississippi","4/13/20","6","2","28015","33.33"
"Chickasaw","2","30","Mississippi","4/13/20","15","15","28017","100"
"Choctaw","0","11","Mississippi","4/13/20","8","3","28019","37.5"
"Claiborne","1","7","Mississippi","4/13/20","1","6","28021","600"
"Clarke","1","15","Mississippi","4/13/20","8","7","28023","87.5"
"Clay","2","20","Mississippi","4/13/20","9","11","28025","122.22"
"Coahoma","1","38","Mississippi","4/13/20","29","9","28027","31.03"
"Copiah","2","31","Mississippi","4/13/20","16","15","28029","93.75"
"Covington","1","15","Mississippi","4/13/20","6","9","28031","150"
"DeSoto","6","178","Mississippi","4/13/20","136","42","28033","30.88"
"Forrest","8","105","Mississippi","4/13/20","46","59","28035","128.26"
"Franklin","1","10","Mississippi","4/13/20","5","5","28037","100"
"George","0","8","Mississippi","4/13/20","5","3","28039","60"
"Greene","0","2","Mississippi","4/13/20","1","1","28041","100"
"Grenada","1","11","Mississippi","4/13/20","7","4","28043","57.14"
"Hancock","1","40","Mississippi","4/13/20","30","10","28045","33.33"
"Harrison","5","112","Mississippi","4/13/20","79","33","28047","41.77"
"Hinds","14","259","Mississippi","4/13/20","158","101","28049","63.92"
"Holmes","3","46","Mississippi","4/13/20","23","23","28051","100"
"Humphreys","1","11","Mississippi","4/13/20","4","7","28053","175"
"Itawamba","1","9","Mississippi","4/13/20","4","5","28057","125"
"Jackson","7","147","Mississippi","4/13/20","98","49","28059","50"
"Jasper","2","14","Mississippi","4/13/20","3","11","28061","366.67"
"Jefferson","0","4","Mississippi","4/13/20","3","1","28063","33.33"
"Jefferson Davis","1","5","Mississippi","4/13/20","0","5","28065","1"
"Jones","3","37","Mississippi","4/13/20","13","24","28067","184.62"
"Kemper","1","14","Mississippi","4/13/20","6","8","28069","133.33"
"Lafayette","1","30","Mississippi","4/13/20","22","8","28071","36.36"
"Lamar","3","38","Mississippi","4/13/20","15","23","28073","153.33"
"Lauderdale","11","150","Mississippi","4/13/20","70","80","28075","114.29"
"Lawrence","0","6","Mississippi","4/13/20","5","1","28077","20"
"Leake","3","29","Mississippi","4/13/20","11","18","28079","163.64"
"Lee","2","46","Mississippi","4/13/20","30","16","28081","53.33"
"Leflore","4","48","Mississippi","4/13/20","23","25","28083","108.7"
"Lincoln","4","49","Mississippi","4/13/20","18","31","28085","172.22"
"Lowndes","1","25","Mississippi","4/13/20","15","10","28087","66.67"
"Madison","5","106","Mississippi","4/13/20","74","32","28089","43.24"
"Marion","2","21","Mississippi","4/13/20","8","13","28091","162.5"
"Marshall","2","34","Mississippi","4/13/20","23","11","28093","47.83"
"Monroe","3","37","Mississippi","4/13/20","16","21","28095","131.25"
"Montgomery","1","15","Mississippi","4/13/20","11","4","28097","36.36"
"Neshoba","3","34","Mississippi","4/13/20","11","23","28099","209.09"
"Newton","0","10","Mississippi","4/13/20","7","3","28101","42.86"
"Noxubee","0","6","Mississippi","4/13/20","5","1","28103","20"
"Oktibbeha","1","37","Mississippi","4/13/20","27","10","28105","37.04"
"Panola","1","23","Mississippi","4/13/20","17","6","28107","35.29"
"Pearl River","5","88","Mississippi","4/13/20","52","36","28109","69.23"
"Perry","1","19","Mississippi","4/13/20","14","5","28111","35.71"
"Pike","4","59","Mississippi","4/13/20","28","31","28113","110.71"
"Pontotoc","0","15","Mississippi","4/13/20","12","3","28115","25"
"Prentiss","1","14","Mississippi","4/13/20","10","4","28117","40"
"Quitman","1","12","Mississippi","4/13/20","7","5","28119","71.43"
"Rankin","4","100","Mississippi","4/13/20","74","26","28121","35.14"
"Scott","5","58","Mississippi","4/13/20","23","35","28123","152.17"
"Sharkey","0","3","Mississippi","4/13/20","3","0","28125","0"
"Simpson","0","7","Mississippi","4/13/20","6","1","28127","16.67"
"Smith","2","28","Mississippi","4/13/20","11","17","28129","154.55"
"Stone","1","11","Mississippi","4/13/20","1","10","28131","1000"
"Sunflower","3","38","Mississippi","4/13/20","19","19","28133","100"
"Tallahatchie","0","4","Mississippi","4/13/20","3","1","28135","33.33"
"Tate","1","24","Mississippi","4/13/20","16","8","28137","50"
"Tippah","1","44","Mississippi","4/13/20","36","8","28139","22.22"
"Tishomingo","0","2","Mississippi","4/13/20","1","1","28141","100"
"Tunica","0","21","Mississippi","4/13/20","18","3","28143","16.67"
"Union","0","7","Mississippi","4/13/20","6","1","28145","16.67"
"Walthall","1","21","Mississippi","4/13/20","12","9","28147","75"
"Warren","1","14","Mississippi","4/13/20","5","9","28149","180"
"Washington","3","57","Mississippi","4/13/20","38","19","28151","50"
"Wayne","1","9","Mississippi","4/13/20","5","4","28153","80"
"Webster","0","14","Mississippi","4/13/20","12","2","28155","16.67"
"Wilkinson","3","49","Mississippi","4/13/20","30","19","28157","63.33"
"Winston","1","20","Mississippi","4/13/20","15","5","28159","33.33"
"Yalobusha","0","14","Mississippi","4/13/20","11","3","28161","27.27"
"Yazoo","5","64","Mississippi","4/13/20","32","32","28163","100"
"Adair","0","11","Missouri","4/13/20","10","1","29001","10"
"Andrew","0","1","Missouri","4/13/20","0","1","29003","1"
"Atchison","0","1","Missouri","4/13/20","1","0","29005","0"
"Barry","0","2","Missouri","4/13/20","1","1","29009","100"
"Bates","0","6","Missouri","4/13/20","3","3","29013","100"
"Benton","0","3","Missouri","4/13/20","3","0","29015","0"
"Bollinger","0","3","Missouri","4/13/20","1","2","29017","200"
"Boone","1","82","Missouri","4/13/20","76","6","29019","7.89"
"Buchanan","2","22","Missouri","4/13/20","11","11","29021","100"
"Butler","2","16","Missouri","4/13/20","2","14","29023","700"
"Caldwell","0","1","Missouri","4/13/20","1","0","29025","0"
"Callaway","0","20","Missouri","4/13/20","19","1","29027","5.26"
"Camden","0","26","Missouri","4/13/20","24","2","29029","8.33"
"Cape Girardeau","1","30","Missouri","4/13/20","20","10","29031","50"
"Carter","0","3","Missouri","4/13/20","3","0","29035","0"
"Cass","2","42","Missouri","4/13/20","26","16","29037","61.54"
"Cedar","0","5","Missouri","4/13/20","4","1","29039","25"
"Chariton","0","4","Missouri","4/13/20","4","0","29041","0"
"Christian","0","17","Missouri","4/13/20","17","0","29043","0"
"Clark","0","1","Missouri","4/13/20","1","0","29045","0"
"Clay","2","51","Missouri","4/13/20","37","14","29047","37.84"
"Clinton","0","11","Missouri","4/13/20","8","3","29049","37.5"
"Cole","1","37","Missouri","4/13/20","31","6","29051","19.35"
"Cooper","0","4","Missouri","4/13/20","2","2","29053","100"
"Crawford","0","4","Missouri","4/13/20","3","1","29055","33.33"
"Dallas","0","2","Missouri","4/13/20","1","1","29059","100"
"DeKalb","0","3","Missouri","4/13/20","1","2","29063","200"
"Dunklin","1","16","Missouri","4/13/20","8","8","29069","100"
"Franklin","7","84","Missouri","4/13/20","33","51","29071","154.55"
"Gasconade","0","2","Missouri","4/13/20","2","0","29073","0"
"Gentry","0","1","Missouri","4/13/20","1","0","29075","0"
"Greene","1","79","Missouri","4/13/20","69","10","29077","14.49"
"Harrison","0","6","Missouri","4/13/20","3","3","29081","100"
"Henry","0","4","Missouri","4/13/20","2","2","29083","100"
"Howard","0","2","Missouri","4/13/20","0","2","29089","1"
"Howell","0","4","Missouri","4/13/20","1","3","29091","300"
"Iron","0","1","Missouri","4/13/20","0","1","29093","1"
"Jackson","10","225","Missouri","4/13/20","155","70","29095","45.16"
"Jasper","2","25","Missouri","4/13/20","13","12","29097","92.31"
"Jefferson","7","129","Missouri","4/13/20","81","48","29099","59.26"
"Johnson","2","45","Missouri","4/13/20","32","13","29101","40.62"
"Kansas City","17","329","Missouri","4/13/20","212","117","00000","55.19"
"Lafayette","0","28","Missouri","4/13/20","28","0","29107","0"
"Lincoln","1","26","Missouri","4/13/20","18","8","29113","44.44"
"Linn","0","4","Missouri","4/13/20","2","2","29115","100"
"Livingston","0","1","Missouri","4/13/20","1","0","29117","0"
"Macon","0","2","Missouri","4/13/20","2","0","29121","0"
"Madison","0","1","Missouri","4/13/20","1","0","29123","0"
"Maries","0","2","Missouri","4/13/20","2","0","29125","0"
"McDonald","0","4","Missouri","4/13/20","3","1","29119","33.33"
"Moniteau","0","4","Missouri","4/13/20","4","0","29135","0"
"Montgomery","0","6","Missouri","4/13/20","5","1","29139","20"
"Morgan","0","1","Missouri","4/13/20","1","0","29141","0"
"New Madrid","1","8","Missouri","4/13/20","2","6","29143","300"
"Newton","0","8","Missouri","4/13/20","6","2","29145","33.33"
"Nodaway","0","2","Missouri","4/13/20","2","0","29147","0"
"Oregon","0","1","Missouri","4/13/20","0","1","29149","1"
"Osage","0","4","Missouri","4/13/20","3","1","29151","33.33"
"Pemiscot","1","8","Missouri","4/13/20","3","5","29155","166.67"
"Perry","1","36","Missouri","4/13/20","28","8","29157","28.57"
"Pettis","0","3","Missouri","4/13/20","2","1","29159","50"
"Phelps","0","1","Missouri","4/13/20","1","0","29161","0"
"Pike","1","6","Missouri","4/13/20","2","4","29163","200"
"Platte","1","25","Missouri","4/13/20","17","8","29165","47.06"
"Polk","0","1","Missouri","4/13/20","0","1","29167","1"
"Pulaski","0","11","Missouri","4/13/20","11","0","29169","0"
"Ralls","0","1","Missouri","4/13/20","1","0","29173","0"
"Randolph","0","8","Missouri","4/13/20","7","1","29175","14.29"
"Ray","0","7","Missouri","4/13/20","4","3","29177","75"
"Reynolds","0","2","Missouri","4/13/20","2","0","29179","0"
"Ripley","0","3","Missouri","4/13/20","2","1","29181","50"
"Saline","3","23","Missouri","4/13/20","3","20","29195","666.67"
"Scotland","0","3","Missouri","4/13/20","0","3","29199","1"
"Scott","2","24","Missouri","4/13/20","10","14","29201","140"
"Shelby","0","1","Missouri","4/13/20","1","0","29205","0"
"St. Charles","27","380","Missouri","4/13/20","188","192","29183","102.13"
"St. Clair","0","2","Missouri","4/13/20","0","2","29185","1"
"St. Francois","1","23","Missouri","4/13/20","17","6","29187","35.29"
"St. Louis","96","1915","Missouri","4/13/20","1245","670","29189","53.82"
"St. Louis City","38","706","Missouri","4/13/20","440","266","29510","60.45"
"Ste. Genevieve","0","7","Missouri","4/13/20","6","1","29186","16.67"
"Stoddard","1","11","Missouri","4/13/20","7","4","29207","57.14"
"Stone","0","3","Missouri","4/13/20","3","0","29209","0"
"Taney","0","8","Missouri","4/13/20","7","1","29213","14.29"
"Vernon","0","3","Missouri","4/13/20","0","3","29217","1"
"Warren","1","17","Missouri","4/13/20","9","8","29219","88.89"
"Washington","0","1","Missouri","4/13/20","0","1","29221","1"
"Webster","0","4","Missouri","4/13/20","3","1","29225","33.33"
"Worth","0","1","Missouri","4/13/20","1","0","29227","0"
"Wright","0","8","Missouri","4/13/20","7","1","29229","14.29"
"Beaverhead","0","1","Montana","4/13/20","1","0","30001","0"
"Big Horn","0","1","Montana","4/13/20","0","1","30003","1"
"Broadwater","0","4","Montana","4/13/20","4","0","30007","0"
"Carbon","1","6","Montana","4/13/20","1","5","30009","500"
"Cascade","0","13","Montana","4/13/20","11","2","30013","18.18"
"Deer Lodge","0","3","Montana","4/13/20","3","0","30023","0"
"Flathead","2","36","Montana","4/13/20","25","11","30029","44"
"Gallatin","3","138","Montana","4/13/20","116","22","30031","18.97"
"Glacier","0","4","Montana","4/13/20","1","3","30035","300"
"Golden Valley","0","1","Montana","4/13/20","0","1","30037","1"
"Hill","0","1","Montana","4/13/20","1","0","30041","0"
"Jefferson","0","2","Montana","4/13/20","2","0","30043","0"
"Lake","0","5","Montana","4/13/20","4","1","30047","25"
"Lewis and Clark","0","16","Montana","4/13/20","14","2","30049","14.29"
"Liberty","0","1","Montana","4/13/20","1","0","30051","0"
"Lincoln","0","7","Montana","4/13/20","7","0","30053","0"
"Madison","0","8","Montana","4/13/20","9","-1","30057","-11.11"
"Meagher","0","1","Montana","4/13/20","1","0","30059","0"
"Missoula","1","30","Montana","4/13/20","21","9","30063","42.86"
"Musselshell","0","1","Montana","4/13/20","1","0","30065","0"
"Park","0","7","Montana","4/13/20","6","1","30067","16.67"
"Ravalli","0","5","Montana","4/13/20","2","3","30081","150"
"Richland","0","3","Montana","4/13/20","0","3","30083","1"
"Roosevelt","0","3","Montana","4/13/20","1","2","30085","200"
"Silver Bow","0","11","Montana","4/13/20","11","0","30093","0"
"Stillwater","0","1","Montana","4/13/20","0","1","30095","1"
"Toole","1","26","Montana","4/13/20","16","10","30101","62.5"
"Yellowstone","3","59","Montana","4/13/20","40","19","30111","47.5"
"Adams","6","54","Nebraska","4/13/20","13","41","31001","315.38"
"Antelope","0","1","Nebraska","4/13/20","1","0","31003","0"
"Box Butte","0","1","Nebraska","4/13/20","0","1","31013","1"
"Buffalo","3","36","Nebraska","4/13/20","18","18","31019","100"
"Burt","0","1","Nebraska","4/13/20","0","1","31021","1"
"Cass","0","3","Nebraska","4/13/20","2","1","31025","50"
"Cherry","0","1","Nebraska","4/13/20","1","0","31031","0"
"Cheyenne","0","3","Nebraska","4/13/20","1","2","31033","200"
"Clay","0","2","Nebraska","4/13/20","0","2","31035","1"
"Colfax","0","4","Nebraska","4/13/20","2","2","31037","100"
"Cuming","0","2","Nebraska","4/13/20","2","0","31039","0"
"Custer","3","19","Nebraska","4/13/20","1","18","31041","1800"
"Dakota","0","2","Nebraska","4/13/20","0","2","31043","1"
"Dawson","2","13","Nebraska","4/13/20","1","12","31047","1200"
"Dodge","0","10","Nebraska","4/13/20","7","3","31053","42.86"
"Douglas","12","242","Nebraska","4/13/20","159","83","31055","52.2"
"Franklin","0","3","Nebraska","4/13/20","0","3","31061","1"
"Gage","2","26","Nebraska","4/13/20","9","17","31067","188.89"
"Gosper","0","1","Nebraska","4/13/20","1","0","31073","0"
"Hall","15","161","Nebraska","4/13/20","55","106","31079","192.73"
"Hamilton","1","11","Nebraska","4/13/20","6","5","31081","83.33"
"Johnson","0","1","Nebraska","4/13/20","0","1","31097","1"
"Kearney","0","3","Nebraska","4/13/20","2","1","31099","50"
"Kimball","0","9","Nebraska","4/13/20","9","0","31105","0"
"Knox","0","2","Nebraska","4/13/20","2","0","31107","0"
"Lancaster","3","54","Nebraska","4/13/20","32","22","31109","68.75"
"Lincoln","0","17","Nebraska","4/13/20","16","1","31111","6.25"
"Logan","0","0","Nebraska","4/13/20","1","-1","31113","-100"
"Madison","0","6","Nebraska","4/13/20","5","1","31119","20"
"Merrick","0","2","Nebraska","4/13/20","2","0","31121","0"
"Nemaha","0","1","Nebraska","4/13/20","1","0","31127","0"
"Otoe","0","1","Nebraska","4/13/20","1","0","31131","0"
"Phelps","0","1","Nebraska","4/13/20","1","0","31137","0"
"Pierce","0","1","Nebraska","4/13/20","0","1","31139","1"
"Platte","0","6","Nebraska","4/13/20","5","1","31141","20"
"Polk","0","2","Nebraska","4/13/20","0","2","31143","1"
"Sarpy","2","41","Nebraska","4/13/20","28","13","31153","46.43"
"Saunders","0","6","Nebraska","4/13/20","4","2","31155","50"
"Scotts Bluff","1","14","Nebraska","4/13/20","6","8","31157","133.33"
"Seward","0","1","Nebraska","4/13/20","1","0","31159","0"
"Stanton","0","1","Nebraska","4/13/20","1","0","31167","0"
"Washington","0","20","Nebraska","4/13/20","19","1","31177","5.26"
"Wayne","0","1","Nebraska","4/13/20","0","1","31179","1"
"Webster","0","1","Nebraska","4/13/20","0","1","31181","1"
"York","0","4","Nebraska","4/13/20","1","3","31185","300"
"Carson City","2","22","Nevada","4/13/20","11","11","32510","100"
"Clark","119","2444","Nevada","4/13/20","1608","836","32003","51.99"
"Douglas","0","10","Nevada","4/13/20","7","3","32005","42.86"
"Elko","0","11","Nevada","4/13/20","8","3","32007","37.5"
"Humboldt","1","20","Nevada","4/13/20","11","9","32013","81.82"
"Lincoln","0","1","Nevada","4/13/20","0","1","32017","1"
"Lyon","1","10","Nevada","4/13/20","3","7","32019","233.33"
"Nye","0","10","Nevada","4/13/20","7","3","32023","42.86"
"Washoe","28","461","Nevada","4/13/20","264","197","32031","74.62"
"White Pine","0","1","Nevada","4/13/20","1","0","32033","0"
"Belknap","1","22","New Hampshire","4/13/20","18","4","33001","22.22"
"Carroll","1","28","New Hampshire","4/13/20","19","9","33003","47.37"
"Cheshire","1","19","New Hampshire","4/13/20","13","6","33005","46.15"
"Coos","0","2","New Hampshire","4/13/20","1","1","33007","100"
"Grafton","1","45","New Hampshire","4/13/20","41","4","33009","9.76"
"Hillsborough","16","385","New Hampshire","4/13/20","272","113","33011","41.54"
"Merrimack","3","73","New Hampshire","4/13/20","52","21","33013","40.38"
"Rockingham","14","345","New Hampshire","4/13/20","246","99","33015","40.24"
"Strafford","2","59","New Hampshire","4/13/20","46","13","33017","28.26"
"Sullivan","0","6","New Hampshire","4/13/20","6","0","33019","0"
"Atlantic","19","267","New Jersey","4/13/20","132","135","34001","102.27"
"Bergen","461","10092","New Jersey","4/13/20","6862","3230","34003","47.07"
"Burlington","73","1155","New Jersey","4/13/20","646","509","34005","78.79"
"Camden","108","1401","New Jersey","4/13/20","645","756","34007","117.21"
"Cape May","11","164","New Jersey","4/13/20","85","79","34009","92.94"
"Cumberland","18","187","New Jersey","4/13/20","64","123","34011","192.19"
"Essex","449","7634","New Jersey","4/13/20","4493","3141","34013","69.91"
"Gloucester","41","566","New Jersey","4/13/20","279","287","34015","102.87"
"Hudson","498","7879","New Jersey","4/13/20","4395","3484","34017","79.27"
"Hunterdon","16","325","New Jersey","4/13/20","211","114","34019","54.03"
"Mercer","129","1646","New Jersey","4/13/20","740","906","34021","122.43"
"Middlesex","389","5987","New Jersey","4/13/20","3263","2724","34023","83.48"
"Monmouth","190","3875","New Jersey","4/13/20","2545","1330","34025","52.26"
"Morris","181","3225","New Jersey","4/13/20","1956","1269","34027","64.88"
"Ocean","174","3593","New Jersey","4/13/20","2374","1219","34029","51.35"
"Passaic","313","5950","New Jersey","4/13/20","3756","2194","34031","58.41"
"Salem","5","66","New Jersey","4/13/20","29","37","34033","127.59"
"Somerset","130","1809","New Jersey","4/13/20","902","907","34035","100.55"
"Sussex","31","508","New Jersey","4/13/20","292","216","34037","73.97"
"Union","422","6636","New Jersey","4/13/20","3685","2951","34039","80.08"
"Warren","29","416","New Jersey","4/13/20","215","201","34041","93.49"
"Bernalillo","28","455","New Mexico","4/13/20","262","193","35001","73.66"
"Catron","0","1","New Mexico","4/13/20","1","0","35003","0"
"Chaves","1","19","New Mexico","4/13/20","14","5","35005","35.71"
"Cibola","2","25","New Mexico","4/13/20","14","11","35006","78.57"
"Colfax","0","2","New Mexico","4/13/20","0","2","35007","1"
"Curry","1","10","New Mexico","4/13/20","6","4","35009","66.67"
"Dona Ana","3","50","New Mexico","4/13/20","30","20","35013","66.67"
"Eddy","0","7","New Mexico","4/13/20","4","3","35015","75"
"Grant","1","9","New Mexico","4/13/20","3","6","35017","200"
"Lea","0","2","New Mexico","4/13/20","2","0","35025","0"
"Lincoln","0","1","New Mexico","4/13/20","1","0","35027","0"
"Los Alamos","0","5","New Mexico","4/13/20","2","3","35028","150"
"Luna","0","2","New Mexico","4/13/20","0","2","35029","1"
"McKinley","14","144","New Mexico","4/13/20","44","100","35031","227.27"
"Otero","0","4","New Mexico","4/13/20","3","1","35035","33.33"
"Quay","0","1","New Mexico","4/13/20","0","1","35037","1"
"Rio Arriba","0","7","New Mexico","4/13/20","6","1","35039","16.67"
"Roosevelt","0","1","New Mexico","4/13/20","1","0","35041","0"
"San Juan","10","151","New Mexico","4/13/20","83","68","35045","81.93"
"San Miguel","0","1","New Mexico","4/13/20","1","0","35047","0"
"Sandoval","17","235","New Mexico","4/13/20","114","121","35043","106.14"
"Santa Fe","2","75","New Mexico","4/13/20","64","11","35049","17.19"
"Socorro","1","12","New Mexico","4/13/20","5","7","35053","140"
"Taos","0","15","New Mexico","4/13/20","13","2","35055","15.38"
"Torrance","1","10","New Mexico","4/13/20","6","4","35057","66.67"
"Valencia","2","18","New Mexico","4/13/20","7","11","35061","157.14"
"Albany","26","499","New York","4/13/20","319","180","36001","56.43"
"Allegany","1","26","New York","4/13/20","17","9","36003","52.94"
"Broome","8","133","New York","4/13/20","76","57","36007","75"
"Cattaraugus","2","28","New York","4/13/20","12","16","36009","133.33"
"Cayuga","3","31","New York","4/13/20","11","20","36011","181.82"
"Chautauqua","1","23","New York","4/13/20","18","5","36013","27.78"
"Chemung","2","60","New York","4/13/20","47","13","36015","27.66"
"Chenango","3","65","New York","4/13/20","46","19","36017","41.3"
"Clinton","1","44","New York","4/13/20","36","8","36019","22.22"
"Columbia","3","93","New York","4/13/20","70","23","36021","32.86"
"Cortland","1","21","New York","4/13/20","14","7","36023","50"
"Delaware","2","42","New York","4/13/20","29","13","36025","44.83"
"Dutchess","99","1881","New York","4/13/20","1189","692","36027","58.2"
"Erie","73","1661","New York","4/13/20","1148","513","36029","44.69"
"Essex","0","12","New York","4/13/20","9","3","36031","33.33"
"Franklin","0","12","New York","4/13/20","10","2","36033","20"
"Fulton","1","21","New York","4/13/20","11","10","36035","90.91"
"Genesee","7","71","New York","4/13/20","23","48","36037","208.7"
"Greene","3","45","New York","4/13/20","24","21","36039","87.5"
"Hamilton","0","3","New York","4/13/20","2","1","36041","50"
"Herkimer","2","38","New York","4/13/20","25","13","36043","52"
"Jefferson","2","46","New York","4/13/20","33","13","36045","39.39"
"Lewis","0","6","New York","4/13/20","6","0","36049","0"
"Livingston","1","34","New York","4/13/20","24","10","36051","41.67"
"Madison","3","110","New York","4/13/20","92","18","36053","19.57"
"Monroe","36","823","New York","4/13/20","574","249","36055","43.38"
"Montgomery","2","29","New York","4/13/20","15","14","36057","93.33"
"Nassau","1249","24358","New York","4/13/20","15616","8742","36059","55.98"
"New York","4940","106763","New York","4/13/20","72181","34582","36061","47.91"
"Niagara","11","194","New York","4/13/20","120","74","36063","61.67"
"Oneida","15","206","New York","4/13/20","100","106","36065","106"
"Onondaga","20","520","New York","4/13/20","377","143","36067","37.93"
"Ontario","4","57","New York","4/13/20","32","25","36069","78.12"
"Orange","295","5598","New York","4/13/20","3533","2065","36071","58.45"
"Orleans","2","26","New York","4/13/20","13","13","36073","100"
"Oswego","1","42","New York","4/13/20","34","8","36075","23.53"
"Otsego","2","43","New York","4/13/20","29","14","36077","48.28"
"Putnam","23","507","New York","4/13/20","345","162","36079","46.96"
"Rensselaer","6","113","New York","4/13/20","74","39","36083","52.7"
"Rockland","323","7965","New York","4/13/20","5703","2262","36087","39.66"
"Saratoga","7","201","New York","4/13/20","153","48","36091","31.37"
"Schenectady","9","204","New York","4/13/20","138","66","36093","47.83"
"Schoharie","0","12","New York","4/13/20","11","1","36095","9.09"
"Schuyler","1","8","New York","4/13/20","4","4","36097","100"
"Seneca","1","16","New York","4/13/20","9","7","36099","77.78"
"St. Lawrence","4","89","New York","4/13/20","61","28","36089","45.9"
"Steuben","10","147","New York","4/13/20","75","72","36101","96"
"Suffolk","1065","21643","New York","4/13/20","14185","7458","36103","52.58"
"Sullivan","18","380","New York","4/13/20","253","127","36105","50.2"
"Tioga","2","23","New York","4/13/20","8","15","36107","187.5"
"Tompkins","2","113","New York","4/13/20","102","11","36109","10.78"
"Ulster","48","716","New York","4/13/20","382","334","36111","87.43"
"Warren","3","48","New York","4/13/20","26","22","36113","84.62"
"Washington","3","37","New York","4/13/20","19","18","36115","94.74"
"Wayne","1","42","New York","4/13/20","34","8","36117","23.53"
"Westchester","785","19786","New York","4/13/20","14294","5492","36119","38.42"
"Wyoming","1","31","New York","4/13/20","23","8","36121","34.78"
"Yates","0","4","New York","4/13/20","1","3","36123","300"
"Alamance","7","68","North Carolina","4/13/20","20","48","37001","240"
"Alexander","0","2","North Carolina","4/13/20","2","0","37003","0"
"Alleghany","0","2","North Carolina","4/13/20","2","0","37005","0"
"Anson","1","10","North Carolina","4/13/20","5","5","37007","100"
"Ashe","0","4","North Carolina","4/13/20","1","3","37009","300"
"Beaufort","1","14","North Carolina","4/13/20","9","5","37013","55.56"
"Bertie","1","12","North Carolina","4/13/20","7","5","37015","71.43"
"Bladen","0","2","North Carolina","4/13/20","1","1","37017","100"
"Brunswick","1","35","North Carolina","4/13/20","26","9","37019","34.62"
"Buncombe","1","37","North Carolina","4/13/20","33","4","37021","12.12"
"Burke","5","61","North Carolina","4/13/20","28","33","37023","117.86"
"Cabarrus","13","165","North Carolina","4/13/20","76","89","37025","117.11"
"Caldwell","1","19","North Carolina","4/13/20","11","8","37027","72.73"
"Carteret","0","22","North Carolina","4/13/20","25","-3","37031","-12"
"Caswell","0","3","North Carolina","4/13/20","2","1","37033","50"
"Catawba","1","35","North Carolina","4/13/20","25","10","37035","40"
"Chatham","7","69","North Carolina","4/13/20","21","48","37037","228.57"
"Cherokee","0","11","North Carolina","4/13/20","12","-1","37039","-8.33"
"Chowan","0","3","North Carolina","4/13/20","1","2","37041","200"
"Clay","0","4","North Carolina","4/13/20","3","1","37043","33.33"
"Cleveland","3","39","North Carolina","4/13/20","18","21","37045","116.67"
"Columbus","4","37","North Carolina","4/13/20","12","25","37047","208.33"
"Craven","1","27","North Carolina","4/13/20","18","9","37049","50"
"Cumberland","5","84","North Carolina","4/13/20","48","36","37051","75"
"Currituck","0","3","North Carolina","4/13/20","2","1","37053","50"
"Dare","1","13","North Carolina","4/13/20","6","7","37055","116.67"
"Davidson","3","85","North Carolina","4/13/20","63","22","37057","34.92"
"Davie","0","22","North Carolina","4/13/20","20","2","37059","10"
"Duplin","1","15","North Carolina","4/13/20","5","10","37061","200"
"Durham","14","290","North Carolina","4/13/20","191","99","37063","51.83"
"Edgecombe","3","26","North Carolina","4/13/20","5","21","37065","420"
"Forsyth","3","117","North Carolina","4/13/20","99","18","37067","18.18"
"Franklin","7","67","North Carolina","4/13/20","15","52","37069","346.67"
"Gaston","4","86","North Carolina","4/13/20","58","28","37071","48.28"
"Gates","0","4","North Carolina","4/13/20","1","3","37073","300"
"Granville","2","93","North Carolina","4/13/20","76","17","37077","22.37"
"Greene","0","12","North Carolina","4/13/20","10","2","37079","20"
"Guilford","5","138","North Carolina","4/13/20","104","34","37081","32.69"
"Halifax","2","22","North Carolina","4/13/20","10","12","37083","120"
"Harnett","2","45","North Carolina","4/13/20","31","14","37085","45.16"
"Haywood","0","3","North Carolina","4/13/20","3","0","37087","0"
"Henderson","7","97","North Carolina","4/13/20","51","46","37089","90.2"
"Hertford","0","4","North Carolina","4/13/20","4","0","37091","0"
"Hoke","1","18","North Carolina","4/13/20","11","7","37093","63.64"
"Iredell","3","71","North Carolina","4/13/20","52","19","37097","36.54"
"Jackson","0","2","North Carolina","4/13/20","2","0","37099","0"
"Johnston","9","101","North Carolina","4/13/20","37","64","37101","172.97"
"Jones","1","7","North Carolina","4/13/20","0","7","37103","1"
"Lee","2","15","North Carolina","4/13/20","3","12","37105","400"
"Lenoir","1","15","North Carolina","4/13/20","8","7","37107","87.5"
"Lincoln","1","15","North Carolina","4/13/20","9","6","37109","66.67"
"Macon","0","2","North Carolina","4/13/20","1","1","37113","100"
"Martin","0","6","North Carolina","4/13/20","3","3","37117","100"
"McDowell","1","16","North Carolina","4/13/20","10","6","37111","60"
"Mecklenburg","33","970","North Carolina","4/13/20","741","229","37119","30.9"
"Mitchell","0","4","North Carolina","4/13/20","2","2","37121","100"
"Montgomery","0","13","North Carolina","4/13/20","10","3","37123","30"
"Moore","10","84","North Carolina","4/13/20","14","70","37125","500"
"Nash","2","36","North Carolina","4/13/20","21","15","37127","71.43"
"New Hanover","2","61","North Carolina","4/13/20","47","14","37129","29.79"
"Northampton","2","62","North Carolina","4/13/20","46","16","37131","34.78"
"Onslow","2","34","North Carolina","4/13/20","21","13","37133","61.9"
"Orange","12","151","North Carolina","4/13/20","67","84","37135","125.37"
"Pamlico","0","6","North Carolina","4/13/20","3","3","37137","100"
"Pasquotank","1","15","North Carolina","4/13/20","8","7","37139","87.5"
"Pender","0","5","North Carolina","4/13/20","2","3","37141","150"
"Perquimans","0","4","North Carolina","4/13/20","2","2","37143","100"
"Person","0","8","North Carolina","4/13/20","6","2","37145","33.33"
"Pitt","4","65","North Carolina","4/13/20","36","29","37147","80.56"
"Polk","0","9","North Carolina","4/13/20","8","1","37149","12.5"
"Randolph","3","53","North Carolina","4/13/20","33","20","37151","60.61"
"Richmond","1","10","North Carolina","4/13/20","1","9","37153","900"
"Robeson","1","11","North Carolina","4/13/20","5","6","37155","120"
"Rockingham","1","14","North Carolina","4/13/20","6","8","37157","133.33"
"Rowan","22","204","North Carolina","4/13/20","51","153","37159","300"
"Rutherford","3","40","North Carolina","4/13/20","21","19","37161","90.48"
"Sampson","1","13","North Carolina","4/13/20","5","8","37163","160"
"Scotland","1","9","North Carolina","4/13/20","2","7","37165","350"
"Stanly","1","17","North Carolina","4/13/20","8","9","37167","112.5"
"Stokes","0","10","North Carolina","4/13/20","8","2","37169","25"
"Surry","1","10","North Carolina","4/13/20","3","7","37171","233.33"
"Swain","0","0","North Carolina","4/13/20","1","-1","37173","-100"
"Transylvania","0","6","North Carolina","4/13/20","5","1","37175","20"
"Union","4","104","North Carolina","4/13/20","75","29","37179","38.67"
"Vance","1","19","North Carolina","4/13/20","12","7","37181","58.33"
"Wake","23","476","North Carolina","4/13/20","314","162","37183","51.59"
"Warren","0","3","North Carolina","4/13/20","3","0","37185","0"
"Washington","2","17","North Carolina","4/13/20","6","11","37187","183.33"
"Watauga","0","8","North Carolina","4/13/20","8","0","37189","0"
"Wayne","7","72","North Carolina","4/13/20","23","49","37191","213.04"
"Wilkes","0","4","North Carolina","4/13/20","4","0","37193","0"
"Wilson","6","70","North Carolina","4/13/20","29","41","37195","141.38"
"Yadkin","1","14","North Carolina","4/13/20","9","5","37197","55.56"
"Barnes","0","2","North Dakota","4/13/20","2","0","38003","0"
"Bowman","0","1","North Dakota","4/13/20","0","1","38011","1"
"Burke","0","2","North Dakota","4/13/20","2","0","38013","0"
"Burleigh","2","51","North Dakota","4/13/20","38","13","38015","34.21"
"Cass","7","116","North Dakota","4/13/20","65","51","38017","78.46"
"Divide","0","1","North Dakota","4/13/20","1","0","38023","0"
"Dunn","0","3","North Dakota","4/13/20","1","2","38025","200"
"Eddy","0","1","North Dakota","4/13/20","1","0","38027","0"
"Emmons","0","1","North Dakota","4/13/20","1","0","38029","0"
"Foster","0","1","North Dakota","4/13/20","1","0","38031","0"
"Grand Forks","0","11","North Dakota","4/13/20","11","0","38035","0"
"Grant","0","1","North Dakota","4/13/20","1","0","38037","0"
"McHenry","0","1","North Dakota","4/13/20","1","0","38049","0"
"McIntosh","0","1","North Dakota","4/13/20","1","0","38051","0"
"McKenzie","1","8","North Dakota","4/13/20","3","5","38053","166.67"
"McLean","0","2","North Dakota","4/13/20","2","0","38055","0"
"Morton","0","20","North Dakota","4/13/20","17","3","38059","17.65"
"Mountrail","1","27","North Dakota","4/13/20","19","8","38061","42.11"
"Oliver","0","1","North Dakota","4/13/20","1","0","38065","0"
"Pierce","0","2","North Dakota","4/13/20","2","0","38069","0"
"Ramsey","0","3","North Dakota","4/13/20","3","0","38071","0"
"Richland","0","3","North Dakota","4/13/20","0","3","38077","1"
"Rolette","0","1","North Dakota","4/13/20","0","1","38079","1"
"Sargent","0","1","North Dakota","4/13/20","0","1","38081","1"
"Sioux","0","1","North Dakota","4/13/20","1","0","38085","0"
"Slope","0","3","North Dakota","4/13/20","2","1","38087","50"
"Stark","1","34","North Dakota","4/13/20","25","9","38089","36"
"Stutsman","0","1","North Dakota","4/13/20","0","1","38093","1"
"Walsh","0","3","North Dakota","4/13/20","3","0","38099","0"
"Ward","1","20","North Dakota","4/13/20","16","4","38101","25"
"Williams","0","8","North Dakota","4/13/20","5","3","38105","60"
"","0","11","Northern Mariana Islands","4/13/20","8","3",,"37.5"
"Adams","0","3","Ohio","4/13/20","2","1","39001","50"
"Allen","3","37","Ohio","4/13/20","19","18","39003","94.74"
"Ashland","0","5","Ohio","4/13/20","3","2","39005","66.67"
"Ashtabula","2","31","Ohio","4/13/20","15","16","39007","106.67"
"Athens","0","3","Ohio","4/13/20","3","0","39009","0"
"Auglaize","1","14","Ohio","4/13/20","8","6","39011","75"
"Belmont","4","53","Ohio","4/13/20","22","31","39013","140.91"
"Brown","0","5","Ohio","4/13/20","3","2","39015","66.67"
"Butler","7","121","Ohio","4/13/20","75","46","39017","61.33"
"Carroll","1","14","Ohio","4/13/20","9","5","39019","55.56"
"Champaign","0","6","Ohio","4/13/20","5","1","39021","20"
"Clark","1","20","Ohio","4/13/20","10","10","39023","100"
"Clermont","2","39","Ohio","4/13/20","27","12","39025","44.44"
"Clinton","1","16","Ohio","4/13/20","8","8","39027","100"
"Columbiana","9","114","Ohio","4/13/20","53","61","39029","115.09"
"Coshocton","1","16","Ohio","4/13/20","10","6","39031","60"
"Crawford","1","17","Ohio","4/13/20","9","8","39033","88.89"
"Cuyahoga","47","1197","Ohio","4/13/20","871","326","39035","37.43"
"Darke","2","49","Ohio","4/13/20","32","17","39037","53.12"
"Defiance","1","12","Ohio","4/13/20","8","4","39039","50"
"Delaware","3","96","Ohio","4/13/20","77","19","39041","24.68"
"Erie","0","12","Ohio","4/13/20","10","2","39043","20"
"Fairfield","4","84","Ohio","4/13/20","54","30","39045","55.56"
"Fayette","1","10","Ohio","4/13/20","2","8","39047","400"
"Franklin","53","1012","Ohio","4/13/20","644","368","39049","57.14"
"Fulton","0","7","Ohio","4/13/20","5","2","39051","40"
"Gallia","1","8","Ohio","4/13/20","4","4","39053","100"
"Geauga","4","68","Ohio","4/13/20","40","28","39055","70"
"Greene","2","30","Ohio","4/13/20","15","15","39057","100"
"Guernsey","1","6","Ohio","4/13/20","2","4","39059","200"
"Hamilton","23","558","Ohio","4/13/20","394","164","39061","41.62"
"Hancock","1","19","Ohio","4/13/20","14","5","39063","35.71"
"Hardin","1","8","Ohio","4/13/20","2","6","39065","300"
"Henry","0","1","Ohio","4/13/20","0","1","39069","1"
"Highland","0","7","Ohio","4/13/20","6","1","39071","16.67"
"Hocking","0","2","Ohio","4/13/20","0","2","39073","1"
"Holmes","0","3","Ohio","4/13/20","2","1","39075","50"
"Huron","1","14","Ohio","4/13/20","9","5","39077","55.56"
"Jackson","0","2","Ohio","4/13/20","0","2","39079","1"
"Jefferson","1","24","Ohio","4/13/20","15","9","39081","60"
"Knox","0","10","Ohio","4/13/20","7","3","39083","42.86"
"Lake","4","117","Ohio","4/13/20","87","30","39085","34.48"
"Lawrence","1","17","Ohio","4/13/20","10","7","39087","70"
"Licking","4","86","Ohio","4/13/20","57","29","39089","50.88"
"Logan","0","8","Ohio","4/13/20","5","3","39091","60"
"Lorain","10","184","Ohio","4/13/20","117","67","39093","57.26"
"Lucas","28","514","Ohio","4/13/20","321","193","39095","60.12"
"Madison","1","24","Ohio","4/13/20","17","7","39097","41.18"
"Mahoning","24","443","Ohio","4/13/20","272","171","39099","62.87"
"Marion","9","91","Ohio","4/13/20","25","66","39101","264"
"Medina","4","112","Ohio","4/13/20","83","29","39103","34.94"
"Meigs","0","1","Ohio","4/13/20","0","1","39105","1"
"Mercer","1","13","Ohio","4/13/20","8","5","39107","62.5"
"Miami","4","121","Ohio","4/13/20","90","31","39109","34.44"
"Monroe","0","2","Ohio","4/13/20","2","0","39111","0"
"Montgomery","13","201","Ohio","4/13/20","109","92","39113","84.4"
"Morgan","0","2","Ohio","4/13/20","1","1","39115","100"
"Morrow","1","9","Ohio","4/13/20","5","4","39117","80"
"Muskingum","0","8","Ohio","4/13/20","5","3","39119","60"
"Noble","0","2","Ohio","4/13/20","0","2","39121","1"
"Ottawa","1","11","Ohio","4/13/20","5","6","39123","120"
"Paulding","1","5","Ohio","4/13/20","1","4","39125","400"
"Perry","1","8","Ohio","4/13/20","4","4","39127","100"
"Pickaway","8","83","Ohio","4/13/20","29","54","39129","186.21"
"Pike","0","1","Ohio","4/13/20","1","0","39131","0"
"Portage","7","144","Ohio","4/13/20","94","50","39133","53.19"
"Preble","2","16","Ohio","4/13/20","5","11","39135","220"
"Putnam","0","1","Ohio","4/13/20","1","0","39137","0"
"Richland","3","43","Ohio","4/13/20","19","24","39139","126.32"
"Ross","2","19","Ohio","4/13/20","6","13","39141","216.67"
"Sandusky","1","12","Ohio","4/13/20","5","7","39143","140"
"Scioto","0","4","Ohio","4/13/20","1","3","39145","300"
"Seneca","0","9","Ohio","4/13/20","6","3","39147","50"
"Shelby","1","27","Ohio","4/13/20","17","10","39149","58.82"
"Stark","8","167","Ohio","4/13/20","109","58","39151","53.21"
"Summit","10","262","Ohio","4/13/20","189","73","39153","38.62"
"Trumbull","10","174","Ohio","4/13/20","102","72","39155","70.59"
"Tuscarawas","1","28","Ohio","4/13/20","23","5","39157","21.74"
"Union","0","11","Ohio","4/13/20","8","3","39159","37.5"
"Van Wert","0","2","Ohio","4/13/20","2","0","39161","0"
"Warren","6","76","Ohio","4/13/20","37","39","39165","105.41"
"Washington","4","41","Ohio","4/13/20","15","26","39167","173.33"
"Wayne","4","54","Ohio","4/13/20","26","28","39169","107.69"
"Williams","0","3","Ohio","4/13/20","1","2","39171","200"
"Wood","3","54","Ohio","4/13/20","34","20","39173","58.82"
"Wyandot","1","12","Ohio","4/13/20","5","7","39175","140"
"Adair","1","27","Oklahoma","4/13/20","20","7","40001","35"
"Alfalfa","0","1","Oklahoma","4/13/20","0","1","40003","1"
"Atoka","0","1","Oklahoma","4/13/20","1","0","40005","0"
"Beaver","0","1","Oklahoma","4/13/20","0","1","40007","1"
"Beckham","0","1","Oklahoma","4/13/20","1","0","40009","0"
"Bryan","0","4","Oklahoma","4/13/20","3","1","40013","33.33"
"Caddo","1","9","Oklahoma","4/13/20","5","4","40015","80"
"Canadian","3","57","Oklahoma","4/13/20","35","22","40017","62.86"
"Carter","0","1","Oklahoma","4/13/20","1","0","40019","0"
"Cherokee","1","20","Oklahoma","4/13/20","14","6","40021","42.86"
"Choctaw","0","2","Oklahoma","4/13/20","2","0","40023","0"
"Cleveland","12","267","Oklahoma","4/13/20","180","87","40027","48.33"
"Comanche","1","51","Oklahoma","4/13/20","41","10","40031","24.39"
"Cotton","0","5","Oklahoma","4/13/20","4","1","40033","25"
"Craig","0","7","Oklahoma","4/13/20","5","2","40035","40"
"Creek","2","56","Oklahoma","4/13/20","45","11","40037","24.44"
"Custer","0","6","Oklahoma","4/13/20","5","1","40039","20"
"Delaware","7","63","Oklahoma","4/13/20","13","50","40041","384.62"
"Dewey","0","1","Oklahoma","4/13/20","0","1","40043","1"
"Garfield","0","7","Oklahoma","4/13/20","5","2","40047","40"
"Garvin","0","11","Oklahoma","4/13/20","10","1","40049","10"
"Grady","0","11","Oklahoma","4/13/20","8","3","40051","37.5"
"Grant","0","2","Oklahoma","4/13/20","1","1","40053","100"
"Greer","3","50","Oklahoma","4/13/20","26","24","40055","92.31"
"Jackson","0","7","Oklahoma","4/13/20","4","3","40065","75"
"Jefferson","0","1","Oklahoma","4/13/20","1","0","40067","0"
"Kay","2","45","Oklahoma","4/13/20","30","15","40071","50"
"Kingfisher","0","6","Oklahoma","4/13/20","3","3","40073","100"
"Kiowa","0","2","Oklahoma","4/13/20","1","1","40075","100"
"Latimer","0","4","Oklahoma","4/13/20","4","0","40077","0"
"Le Flore","0","3","Oklahoma","4/13/20","1","2","40079","200"
"Lincoln","0","10","Oklahoma","4/13/20","9","1","40081","11.11"
"Logan","0","7","Oklahoma","4/13/20","6","1","40083","16.67"
"Love","0","2","Oklahoma","4/13/20","2","0","40085","0"
"Major","0","1","Oklahoma","4/13/20","1","0","40093","0"
"Marshall","0","1","Oklahoma","4/13/20","0","1","40095","1"
"Mayes","1","15","Oklahoma","4/13/20","10","5","40097","50"
"McClain","1","19","Oklahoma","4/13/20","12","7","40087","58.33"
"McCurtain","1","6","Oklahoma","4/13/20","1","5","40089","500"
"McIntosh","0","1","Oklahoma","4/13/20","1","0","40091","0"
"Muskogee","0","22","Oklahoma","4/13/20","20","2","40101","10"
"Noble","0","6","Oklahoma","4/13/20","6","0","40103","0"
"Nowata","0","10","Oklahoma","4/13/20","9","1","40105","11.11"
"Okfuskee","0","1","Oklahoma","4/13/20","0","1","40107","1"
"Oklahoma","25","455","Oklahoma","4/13/20","279","176","40109","63.08"
"Okmulgee","0","14","Oklahoma","4/13/20","11","3","40111","27.27"
"Osage","4","56","Oklahoma","4/13/20","31","25","40113","80.65"
"Ottawa","2","23","Oklahoma","4/13/20","12","11","40115","91.67"
"Out of OK","0","0","Oklahoma","4/13/20","2","-2","80040","-100"
"Pawnee","1","27","Oklahoma","4/13/20","22","5","40117","22.73"
"Payne","1","29","Oklahoma","4/13/20","21","8","40119","38.1"
"Pittsburg","1","10","Oklahoma","4/13/20","6","4","40121","66.67"
"Pontotoc","0","10","Oklahoma","4/13/20","8","2","40123","25"
"Pottawatomie","2","26","Oklahoma","4/13/20","13","13","40125","100"
"Rogers","1","25","Oklahoma","4/13/20","15","10","40131","66.67"
"Seminole","1","7","Oklahoma","4/13/20","3","4","40133","133.33"
"Sequoyah","1","11","Oklahoma","4/13/20","7","4","40135","57.14"
"Stephens","1","15","Oklahoma","4/13/20","11","4","40137","36.36"
"Texas","0","5","Oklahoma","4/13/20","3","2","40139","66.67"
"Tillman","0","1","Oklahoma","4/13/20","1","0","40141","0"
"Tulsa","13","337","Oklahoma","4/13/20","249","88","40143","35.34"
"Wagoner","3","73","Oklahoma","4/13/20","49","24","40145","48.98"
"Washington","11","114","Oklahoma","4/13/20","39","75","40147","192.31"
"Woodward","0","1","Oklahoma","4/13/20","1","0","40153","0"
"Benton","1","23","Oregon","4/13/20","19","4","41003","21.05"
"Clackamas","7","132","Oregon","4/13/20","84","48","41005","57.14"
"Clatsop","0","6","Oregon","4/13/20","4","2","41007","50"
"Columbia","1","12","Oregon","4/13/20","6","6","41009","100"
"Coos","0","1","Oregon","4/13/20","0","1","41011","1"
"Crook","0","1","Oregon","4/13/20","1","0","41013","0"
"Curry","0","3","Oregon","4/13/20","0","3","41015","1"
"Deschutes","2","54","Oregon","4/13/20","39","15","41017","38.46"
"Douglas","1","16","Oregon","4/13/20","11","5","41019","45.45"
"Grant","0","1","Oregon","4/13/20","1","0","41023","0"
"Hood River","0","4","Oregon","4/13/20","2","2","41027","100"
"Jackson","2","47","Oregon","4/13/20","33","14","41029","42.42"
"Josephine","1","19","Oregon","4/13/20","13","6","41033","46.15"
"Klamath","1","25","Oregon","4/13/20","15","10","41035","66.67"
"Lane","2","41","Oregon","4/13/20","27","14","41039","51.85"
"Lincoln","0","4","Oregon","4/13/20","4","0","41041","0"
"Linn","1","52","Oregon","4/13/20","43","9","41043","20.93"
"Malheur","0","4","Oregon","4/13/20","2","2","41045","100"
"Marion","12","280","Oregon","4/13/20","198","82","41047","41.41"
"Morrow","0","5","Oregon","4/13/20","2","3","41049","150"
"Multnomah","24","398","Oregon","4/13/20","233","165","41051","70.82"
"Polk","1","30","Oregon","4/13/20","24","6","41053","25"
"Sherman","0","1","Oregon","4/13/20","1","0","41055","0"
"Tillamook","0","4","Oregon","4/13/20","3","1","41057","33.33"
"Umatilla","1","16","Oregon","4/13/20","7","9","41059","128.57"
"Union","0","4","Oregon","4/13/20","3","1","41061","33.33"
"Wallowa","0","1","Oregon","4/13/20","1","0","41063","0"
"Wasco","0","10","Oregon","4/13/20","7","3","41065","42.86"
"Washington","14","360","Oregon","4/13/20","259","101","41067","39"
"Yamhill","1","30","Oregon","4/13/20","26","4","41071","15.38"
"Adams","4","56","Pennsylvania","4/13/20","25","31","42001","124"
"Allegheny","33","876","Pennsylvania","4/13/20","642","234","42003","36.45"
"Armstrong","2","28","Pennsylvania","4/13/20","13","15","42005","115.38"
"Beaver","8","153","Pennsylvania","4/13/20","96","57","42007","59.38"
"Bedford","0","5","Pennsylvania","4/13/20","4","1","42009","25"
"Berks","118","1150","Pennsylvania","4/13/20","326","824","42011","252.76"
"Blair","1","11","Pennsylvania","4/13/20","5","6","42013","120"
"Bradford","1","19","Pennsylvania","4/13/20","10","9","42015","90"
"Bucks","85","1229","Pennsylvania","4/13/20","634","595","42017","93.85"
"Butler","7","143","Pennsylvania","4/13/20","91","52","42019","57.14"
"Cambria","1","14","Pennsylvania","4/13/20","7","7","42021","100"
"Cameron","0","1","Pennsylvania","4/13/20","1","0","42023","0"
"Carbon","6","102","Pennsylvania","4/13/20","59","43","42025","72.88"
"Centre","4","70","Pennsylvania","4/13/20","44","26","42027","59.09"
"Chester","41","593","Pennsylvania","4/13/20","307","286","42029","93.16"
"Clarion","1","16","Pennsylvania","4/13/20","6","10","42031","166.67"
"Clearfield","0","9","Pennsylvania","4/13/20","7","2","42033","28.57"
"Clinton","1","8","Pennsylvania","4/13/20","3","5","42035","166.67"
"Columbia","12","113","Pennsylvania","4/13/20","26","87","42037","334.62"
"Crawford","1","16","Pennsylvania","4/13/20","9","7","42039","77.78"
"Cumberland","8","122","Pennsylvania","4/13/20","68","54","42041","79.41"
"Dauphin","15","240","Pennsylvania","4/13/20","132","108","42043","81.82"
"Delaware","133","1750","Pennsylvania","4/13/20","822","928","42045","112.9"
"Elk","0","2","Pennsylvania","4/13/20","0","2","42047","1"
"Erie","2","39","Pennsylvania","4/13/20","27","12","42049","44.44"
"Fayette","4","57","Pennsylvania","4/13/20","29","28","42051","96.55"
"Forest","0","5","Pennsylvania","4/13/20","4","1","42053","25"
"Franklin","5","66","Pennsylvania","4/13/20","32","34","42055","106.25"
"Fulton","0","1","Pennsylvania","4/13/20","1","0","42057","0"
"Greene","2","23","Pennsylvania","4/13/20","12","11","42059","91.67"
"Huntingdon","1","11","Pennsylvania","4/13/20","4","7","42061","175"
"Indiana","4","43","Pennsylvania","4/13/20","17","26","42063","152.94"
"Jefferson","0","2","Pennsylvania","4/13/20","0","2","42065","1"
"Juniata","4","39","Pennsylvania","4/13/20","11","28","42067","254.55"
"Lackawanna","38","459","Pennsylvania","4/13/20","190","269","42069","141.58"
"Lancaster","60","828","Pennsylvania","4/13/20","408","420","42071","102.94"
"Lawrence","4","51","Pennsylvania","4/13/20","24","27","42073","112.5"
"Lebanon","23","284","Pennsylvania","4/13/20","124","160","42075","129.03"
"Lehigh","106","1747","Pennsylvania","4/13/20","1006","741","42077","73.66"
"Luzerne","85","1446","Pennsylvania","4/13/20","849","597","42079","70.32"
"Lycoming","3","28","Pennsylvania","4/13/20","10","18","42081","180"
"McKean","0","3","Pennsylvania","4/13/20","1","2","42083","200"
"Mercer","4","43","Pennsylvania","4/13/20","18","25","42085","138.89"
"Mifflin","1","17","Pennsylvania","4/13/20","9","8","42087","88.89"
"Monroe","35","816","Pennsylvania","4/13/20","572","244","42089","42.66"
"Montgomery","151","2285","Pennsylvania","4/13/20","1230","1055","42091","85.77"
"Montour","0","39","Pennsylvania","4/13/20","37","2","42093","5.41"
"Northampton","59","1130","Pennsylvania","4/13/20","716","414","42095","57.82"
"Northumberland","4","40","Pennsylvania","4/13/20","15","25","42097","166.67"
"Perry","2","17","Pennsylvania","4/13/20","5","12","42099","240"
"Philadelphia","441","6813","Pennsylvania","4/13/20","3728","3085","42101","82.75"
"Pike","14","221","Pennsylvania","4/13/20","125","96","42103","76.8"
"Potter","0","4","Pennsylvania","4/13/20","3","1","42105","33.33"
"Schuylkill","13","192","Pennsylvania","4/13/20","103","89","42107","86.41"
"Snyder","2","23","Pennsylvania","4/13/20","8","15","42109","187.5"
"Somerset","1","13","Pennsylvania","4/13/20","6","7","42111","116.67"
"Sullivan","0","1","Pennsylvania","4/13/20","1","0","42113","0"
"Susquehanna","4","31","Pennsylvania","4/13/20","6","25","42115","416.67"
"Tioga","1","14","Pennsylvania","4/13/20","8","6","42117","75"
"Union","2","21","Pennsylvania","4/13/20","6","15","42119","250"
"Venango","0","6","Pennsylvania","4/13/20","5","1","42121","20"
"Warren","0","1","Pennsylvania","4/13/20","1","0","42123","0"
"Washington","2","69","Pennsylvania","4/13/20","53","16","42125","30.19"
"Wayne","5","67","Pennsylvania","4/13/20","35","32","42127","91.43"
"Westmoreland","10","228","Pennsylvania","4/13/20","157","71","42129","45.22"
"Wyoming","1","12","Pennsylvania","4/13/20","5","7","42131","140"
"York","20","331","Pennsylvania","4/13/20","189","142","42133","75.13"
"","56","903","Puerto Rico","4/13/20","513","390",,"76.02"
"Bristol","2","39","Rhode Island","4/13/20","25","14","44001","56"
"Kent","11","169","Rhode Island","4/13/20","92","77","44003","83.7"
"Newport","5","74","Rhode Island","4/13/20","42","32","44005","76.19"
"Providence","106","1278","Rhode Island","4/13/20","538","740","44007","137.55"
"Washington","12","140","Rhode Island","4/13/20","53","87","44009","164.15"
"Abbeville","0","9","South Carolina","4/13/20","6","3","45001","50"
"Aiken","3","51","South Carolina","4/13/20","27","24","45003","88.89"
"Allendale","0","5","South Carolina","4/13/20","2","3","45005","150"
"Anderson","5","109","South Carolina","4/13/20","72","37","45007","51.39"
"Bamberg","0","7","South Carolina","4/13/20","5","2","45009","40"
"Barnwell","0","5","South Carolina","4/13/20","3","2","45011","66.67"
"Beaufort","4","194","South Carolina","4/13/20","163","31","45013","19.02"
"Berkeley","5","90","South Carolina","4/13/20","52","38","45015","73.08"
"Calhoun","0","6","South Carolina","4/13/20","5","1","45017","20"
"Charleston","7","351","South Carolina","4/13/20","300","51","45019","17"
"Cherokee","1","8","South Carolina","4/13/20","4","4","45021","100"
"Chester","1","20","South Carolina","4/13/20","14","6","45023","42.86"
"Chesterfield","1","23","South Carolina","4/13/20","15","8","45025","53.33"
"Clarendon","4","86","South Carolina","4/13/20","58","28","45027","48.28"
"Colleton","1","17","South Carolina","4/13/20","10","7","45029","70"
"Darlington","2","43","South Carolina","4/13/20","27","16","45031","59.26"
"Dillon","1","5","South Carolina","4/13/20","1","4","45033","400"
"Dorchester","3","73","South Carolina","4/13/20","52","21","45035","40.38"
"Edgefield","1","10","South Carolina","4/13/20","6","4","45037","66.67"
"Fairfield","1","23","South Carolina","4/13/20","16","7","45039","43.75"
"Florence","6","79","South Carolina","4/13/20","39","40","45041","102.56"
"Georgetown","1","31","South Carolina","4/13/20","21","10","45043","47.62"
"Greenville","20","346","South Carolina","4/13/20","204","142","45045","69.61"
"Greenwood","1","18","South Carolina","4/13/20","11","7","45047","63.64"
"Hampton","1","9","South Carolina","4/13/20","3","6","45049","200"
"Horry","10","147","South Carolina","4/13/20","76","71","45051","93.42"
"Jasper","0","12","South Carolina","4/13/20","11","1","45053","9.09"
"Kershaw","4","181","South Carolina","4/13/20","152","29","45055","19.08"
"Lancaster","3","66","South Carolina","4/13/20","43","23","45057","53.49"
"Laurens","1","14","South Carolina","4/13/20","6","8","45059","133.33"
"Lee","2","31","South Carolina","4/13/20","18","13","45061","72.22"
"Lexington","13","212","South Carolina","4/13/20","124","88","45063","70.97"
"Marion","0","7","South Carolina","4/13/20","4","3","45067","75"
"Marlboro","1","15","South Carolina","4/13/20","6","9","45069","150"
"McCormick","0","3","South Carolina","4/13/20","2","1","45065","50"
"Newberry","1","13","South Carolina","4/13/20","7","6","45071","85.71"
"Oconee","1","14","South Carolina","4/13/20","8","6","45073","75"
"Orangeburg","1","37","South Carolina","4/13/20","28","9","45075","32.14"
"Pickens","1","28","South Carolina","4/13/20","20","8","45077","40"
"Richland","26","494","South Carolina","4/13/20","311","183","45079","58.84"
"Saluda","0","6","South Carolina","4/13/20","4","2","45081","50"
"Spartanburg","12","174","South Carolina","4/13/20","88","86","45083","97.73"
"Sumter","8","148","South Carolina","4/13/20","90","58","45085","64.44"
"Union","1","22","South Carolina","4/13/20","12","10","45087","83.33"
"Williamsburg","1","15","South Carolina","4/13/20","11","4","45089","36.36"
"York","6","134","South Carolina","4/13/20","95","39","45091","41.05"
"Aurora","0","1","South Dakota","4/13/20","1","0","46003","0"
"Beadle","0","21","South Dakota","4/13/20","21","0","46005","0"
"Bon Homme","0","4","South Dakota","4/13/20","2","2","46009","100"
"Brookings","1","9","South Dakota","4/13/20","4","5","46011","125"
"Brown","0","14","South Dakota","4/13/20","13","1","46013","7.69"
"Brule","0","1","South Dakota","4/13/20","0","1","46015","1"
"Charles Mix","0","4","South Dakota","4/13/20","2","2","46023","100"
"Clark","0","1","South Dakota","4/13/20","1","0","46025","0"
"Clay","0","5","South Dakota","4/13/20","3","2","46027","66.67"
"Codington","0","12","South Dakota","4/13/20","11","1","46029","9.09"
"Corson","0","1","South Dakota","4/13/20","0","1","46031","1"
"Davison","0","3","South Dakota","4/13/20","3","0","46035","0"
"Deuel","0","1","South Dakota","4/13/20","1","0","46039","0"
"Fall River","0","1","South Dakota","4/13/20","1","0","46047","0"
"Faulk","0","1","South Dakota","4/13/20","1","0","46049","0"
"Hamlin","0","1","South Dakota","4/13/20","1","0","46057","0"
"Hughes","0","5","South Dakota","4/13/20","3","2","46065","66.67"
"Hutchinson","0","2","South Dakota","4/13/20","2","0","46067","0"
"Hyde","0","1","South Dakota","4/13/20","0","1","46069","1"
"Jerauld","0","3","South Dakota","4/13/20","0","3","46073","1"
"Lake","0","2","South Dakota","4/13/20","1","1","46079","100"
"Lawrence","0","9","South Dakota","4/13/20","9","0","46081","0"
"Lincoln","4","50","South Dakota","4/13/20","24","26","46083","108.33"
"Lyman","0","2","South Dakota","4/13/20","1","1","46085","100"
"Marshall","0","1","South Dakota","4/13/20","1","0","46091","0"
"McCook","0","2","South Dakota","4/13/20","2","0","46087","0"
"Meade","0","1","South Dakota","4/13/20","1","0","46093","0"
"Miner","0","1","South Dakota","4/13/20","0","1","46097","1"
"Minnehaha","73","654","South Dakota","4/13/20","140","514","46099","367.14"
"Oglala Lakota","0","1","South Dakota","4/13/20","0","1","46102","1"
"Pennington","0","9","South Dakota","4/13/20","6","3","46103","50"
"Roberts","0","4","South Dakota","4/13/20","4","0","46109","0"
"Sanborn","0","2","South Dakota","4/13/20","0","2","46111","1"
"Spink","0","3","South Dakota","4/13/20","3","0","46115","0"
"Sully","0","1","South Dakota","4/13/20","0","1","46119","1"
"Todd","0","1","South Dakota","4/13/20","1","0","46121","0"
"Turner","0","5","South Dakota","4/13/20","4","1","46125","25"
"Union","0","5","South Dakota","4/13/20","3","2","46127","66.67"
"Walworth","0","2","South Dakota","4/13/20","0","2","46129","1"
"Yankton","1","22","South Dakota","4/13/20","18","4","46135","22.22"
"Anderson","1","15","Tennessee","4/13/20","10","5","47001","50"
"Bedford","2","23","Tennessee","4/13/20","8","15","47003","187.5"
"Benton","0","4","Tennessee","4/13/20","4","0","47005","0"
"Bledsoe","1","8","Tennessee","4/13/20","3","5","47007","166.67"
"Blount","1","46","Tennessee","4/13/20","38","8","47009","21.05"
"Bradley","1","32","Tennessee","4/13/20","23","9","47011","39.13"
"Campbell","1","11","Tennessee","4/13/20","5","6","47013","120"
"Cannon","0","7","Tennessee","4/13/20","7","0","47015","0"
"Carroll","1","12","Tennessee","4/13/20","8","4","47017","50"
"Carter","0","3","Tennessee","4/13/20","3","0","47019","0"
"Cheatham","1","18","Tennessee","4/13/20","13","5","47021","38.46"
"Chester","0","5","Tennessee","4/13/20","6","-1","47023","-16.67"
"Claiborne","0","4","Tennessee","4/13/20","2","2","47025","100"
"Clay","0","4","Tennessee","4/13/20","1","3","47027","300"
"Cocke","1","5","Tennessee","4/13/20","1","4","47029","400"
"Coffee","1","11","Tennessee","4/13/20","7","4","47031","57.14"
"Cumberland","2","43","Tennessee","4/13/20","26","17","47035","65.38"
"Davidson","55","1207","Tennessee","4/13/20","819","388","47037","47.37"
"Decatur","0","3","Tennessee","4/13/20","0","3","47039","1"
"DeKalb","0","10","Tennessee","4/13/20","7","3","47041","42.86"
"Dickson","1","30","Tennessee","4/13/20","24","6","47043","25"
"Dyer","2","22","Tennessee","4/13/20","9","13","47045","144.44"
"Fayette","2","36","Tennessee","4/13/20","21","15","47047","71.43"
"Fentress","0","2","Tennessee","4/13/20","2","0","47049","0"
"Franklin","1","21","Tennessee","4/13/20","14","7","47051","50"
"Gibson","1","20","Tennessee","4/13/20","12","8","47053","66.67"
"Giles","0","3","Tennessee","4/13/20","3","0","47055","0"
"Grainger","0","4","Tennessee","4/13/20","3","1","47057","33.33"
"Greene","1","27","Tennessee","4/13/20","17","10","47059","58.82"
"Grundy","1","23","Tennessee","4/13/20","15","8","47061","53.33"
"Hamblen","0","6","Tennessee","4/13/20","4","2","47063","50"
"Hamilton","4","109","Tennessee","4/13/20","83","26","47065","31.33"
"Hardeman","0","7","Tennessee","4/13/20","6","1","47069","16.67"
"Hardin","0","2","Tennessee","4/13/20","2","0","47071","0"
"Hawkins","1","24","Tennessee","4/13/20","14","10","47073","71.43"
"Haywood","1","12","Tennessee","4/13/20","5","7","47075","140"
"Henderson","0","2","Tennessee","4/13/20","1","1","47077","100"
"Henry","0","8","Tennessee","4/13/20","5","3","47079","60"
"Hickman","0","2","Tennessee","4/13/20","2","0","47081","0"
"Houston","0","3","Tennessee","4/13/20","2","1","47083","50"
"Humphreys","0","4","Tennessee","4/13/20","3","1","47085","33.33"
"Jackson","1","7","Tennessee","4/13/20","3","4","47087","133.33"
"Jefferson","1","16","Tennessee","4/13/20","7","9","47089","128.57"
"Johnson","0","2","Tennessee","4/13/20","2","0","47091","0"
"Knox","8","173","Tennessee","4/13/20","119","54","47093","45.38"
"Lake","1","4","Tennessee","4/13/20","0","4","47095","1"
"Lauderdale","1","9","Tennessee","4/13/20","5","4","47097","80"
"Lawrence","1","13","Tennessee","4/13/20","4","9","47099","225"
"Lewis","0","2","Tennessee","4/13/20","2","0","47101","0"
"Lincoln","1","9","Tennessee","4/13/20","5","4","47103","80"
"Loudon","0","16","Tennessee","4/13/20","13","3","47105","23.08"
"Macon","2","26","Tennessee","4/13/20","11","15","47111","136.36"
"Madison","7","68","Tennessee","4/13/20","22","46","47113","209.09"
"Marion","1","26","Tennessee","4/13/20","20","6","47115","30"
"Marshall","0","9","Tennessee","4/13/20","9","0","47117","0"
"Maury","1","33","Tennessee","4/13/20","24","9","47119","37.5"
"McMinn","0","5","Tennessee","4/13/20","3","2","47107","66.67"
"McNairy","1","9","Tennessee","4/13/20","4","5","47109","125"
"Meigs","0","3","Tennessee","4/13/20","2","1","47121","50"
"Monroe","0","8","Tennessee","4/13/20","6","2","47123","33.33"
"Montgomery","7","102","Tennessee","4/13/20","54","48","47125","88.89"
"Morgan","0","5","Tennessee","4/13/20","5","0","47129","0"
"Obion","1","8","Tennessee","4/13/20","2","6","47131","300"
"Out of TN","-4","260","Tennessee","4/13/20","290","-30","80047","-10.34"
"Overton","0","5","Tennessee","4/13/20","4","1","47133","25"
"Perry","0","4","Tennessee","4/13/20","3","1","47135","33.33"
"Polk","0","5","Tennessee","4/13/20","3","2","47139","66.67"
"Putnam","5","87","Tennessee","4/13/20","55","32","47141","58.18"
"Roane","0","5","Tennessee","4/13/20","5","0","47145","0"
"Robertson","4","88","Tennessee","4/13/20","60","28","47147","46.67"
"Rutherford","13","250","Tennessee","4/13/20","161","89","47149","55.28"
"Scott","1","9","Tennessee","4/13/20","3","6","47151","200"
"Sequatchie","0","3","Tennessee","4/13/20","2","1","47153","50"
"Sevier","1","22","Tennessee","4/13/20","16","6","47155","37.5"
"Shelby","81","1331","Tennessee","4/13/20","766","565","47157","73.76"
"Smith","1","10","Tennessee","4/13/20","3","7","47159","233.33"
"Stewart","0","4","Tennessee","4/13/20","2","2","47161","100"
"Sullivan","2","42","Tennessee","4/13/20","25","17","47163","68"
"Sumner","17","454","Tennessee","4/13/20","335","119","47165","35.52"
"Tipton","2","50","Tennessee","4/13/20","36","14","47167","38.89"
"Trousdale","1","20","Tennessee","4/13/20","11","9","47169","81.82"
"Unicoi","0","1","Tennessee","4/13/20","1","0","47171","0"
"Union","0","3","Tennessee","4/13/20","1","2","47173","200"
"Van Buren","0","1","Tennessee","4/13/20","0","1","47175","1"
"Warren","0","4","Tennessee","4/13/20","1","3","47177","300"
"Washington","3","42","Tennessee","4/13/20","24","18","47179","75"
"Wayne","0","2","Tennessee","4/13/20","2","0","47181","0"
"Weakley","0","6","Tennessee","4/13/20","5","1","47183","20"
"White","0","4","Tennessee","4/13/20","2","2","47185","100"
"Williamson","8","318","Tennessee","4/13/20","260","58","47187","22.31"
"Wilson","7","143","Tennessee","4/13/20","97","46","47189","47.42"
"Anderson","0","3","Texas","4/13/20","1","2","48001","200"
"Andrews","1","12","Texas","4/13/20","6","6","48003","100"
"Angelina","0","16","Texas","4/13/20","14","2","48005","14.29"
"Aransas","0","2","Texas","4/13/20","1","1","48007","100"
"Atascosa","1","9","Texas","4/13/20","3","6","48013","200"
"Austin","1","11","Texas","4/13/20","5","6","48015","120"
"Bandera","0","2","Texas","4/13/20","0","2","48019","1"
"Bastrop","2","27","Texas","4/13/20","11","16","48021","145.45"
"Bee","0","2","Texas","4/13/20","0","2","48025","1"
"Bell","5","101","Texas","4/13/20","68","33","48027","48.53"
"Bexar","52","772","Texas","4/13/20","410","362","48029","88.29"
"Blanco","0","4","Texas","4/13/20","2","2","48031","100"
"Bowie","3","32","Texas","4/13/20","14","18","48037","128.57"
"Brazoria","10","237","Texas","4/13/20","167","70","48039","41.92"
"Brazos","7","143","Texas","4/13/20","94","49","48041","52.13"
"Brown","1","11","Texas","4/13/20","6","5","48049","83.33"
"Burleson","1","6","Texas","4/13/20","2","4","48051","200"
"Burnet","0","6","Texas","4/13/20","4","2","48053","50"
"Caldwell","0","6","Texas","4/13/20","4","2","48055","50"
"Calhoun","0","15","Texas","4/13/20","12","3","48057","25"
"Callahan","0","1","Texas","4/13/20","0","1","48059","1"
"Cameron","15","195","Texas","4/13/20","87","108","48061","124.14"
"Camp","0","3","Texas","4/13/20","1","2","48063","200"
"Cass","0","5","Texas","4/13/20","3","2","48067","66.67"
"Castro","0","11","Texas","4/13/20","11","0","48069","0"
"Chambers","3","29","Texas","4/13/20","11","18","48071","163.64"
"Cherokee","0","6","Texas","4/13/20","6","0","48073","0"
"Clay","0","2","Texas","4/13/20","1","1","48077","100"
"Collin","24","472","Texas","4/13/20","306","166","48085","54.25"
"Colorado","1","7","Texas","4/13/20","2","5","48089","250"
"Comal","2","38","Texas","4/13/20","22","16","48091","72.73"
"Comanche","0","3","Texas","4/13/20","2","1","48093","50"
"Concho","0","1","Texas","4/13/20","0","1","48095","1"
"Cooke","0","1","Texas","4/13/20","0","1","48097","1"
"Coryell","4","34","Texas","4/13/20","5","29","48099","580"
"Crane","0","2","Texas","4/13/20","2","0","48103","0"
"Crosby","0","1","Texas","4/13/20","1","0","48107","0"
"Dallam","0","1","Texas","4/13/20","1","0","48111","0"
"Dallas","90","1788","Texas","4/13/20","1155","633","48113","54.81"
"Dawson","0","8","Texas","4/13/20","7","1","48115","14.29"
"Deaf Smith","0","8","Texas","4/13/20","7","1","48117","14.29"
"Delta","0","1","Texas","4/13/20","0","1","48119","1"
"Denton","24","507","Texas","4/13/20","337","170","48121","50.45"
"DeWitt","0","9","Texas","4/13/20","7","2","48123","28.57"
"Dickens","0","2","Texas","4/13/20","0","2","48125","1"
"Dimmit","0","1","Texas","4/13/20","0","1","48127","1"
"Donley","2","22","Texas","4/13/20","7","15","48129","214.29"
"Eastland","0","3","Texas","4/13/20","3","0","48133","0"
"Ector","2","43","Texas","4/13/20","26","17","48135","65.38"
"El Paso","23","292","Texas","4/13/20","132","160","48141","121.21"
"Ellis","5","66","Texas","4/13/20","29","37","48139","127.59"
"Erath","0","13","Texas","4/13/20","10","3","48143","30"
"Falls","0","1","Texas","4/13/20","1","0","48145","0"
"Fannin","0","5","Texas","4/13/20","2","3","48147","150"
"Fayette","0","10","Texas","4/13/20","9","1","48149","11.11"
"Floyd","0","1","Texas","4/13/20","0","1","48153","1"
"Fort Bend","32","543","Texas","4/13/20","318","225","48157","70.75"
"Franklin","0","1","Texas","4/13/20","1","0","48159","0"
"Frio","0","1","Texas","4/13/20","0","1","48163","1"
"Gaines","0","2","Texas","4/13/20","1","1","48165","100"
"Galveston","14","355","Texas","4/13/20","256","99","48167","38.67"
"Gillespie","0","1","Texas","4/13/20","3","-2","48171","-66.67"
"Goliad","0","4","Texas","4/13/20","3","1","48175","33.33"
"Gonzales","0","2","Texas","4/13/20","1","1","48177","100"
"Gray","1","13","Texas","4/13/20","9","4","48179","44.44"
"Grayson","1","17","Texas","4/13/20","13","4","48181","30.77"
"Gregg","3","40","Texas","4/13/20","16","24","48183","150"
"Grimes","1","7","Texas","4/13/20","3","4","48185","133.33"
"Guadalupe","3","49","Texas","4/13/20","28","21","48187","75"
"Hale","1","11","Texas","4/13/20","7","4","48189","57.14"
"Hamilton","0","3","Texas","4/13/20","0","3","48193","1"
"Hansford","0","1","Texas","4/13/20","1","0","48195","0"
"Hardin","5","61","Texas","4/13/20","26","35","48199","134.62"
"Harris","276","3744","Texas","4/13/20","1809","1935","48201","106.97"
"Harrison","1","16","Texas","4/13/20","8","8","48203","100"
"Hays","3","82","Texas","4/13/20","59","23","48209","38.98"
"Hemphill","0","1","Texas","4/13/20","1","0","48211","0"
"Henderson","1","10","Texas","4/13/20","2","8","48213","400"
"Hidalgo","13","190","Texas","4/13/20","99","91","48215","91.92"
"Hill","0","8","Texas","4/13/20","5","3","48217","60"
"Hockley","1","14","Texas","4/13/20","10","4","48219","40"
"Hood","1","13","Texas","4/13/20","9","4","48221","44.44"
"Hopkins","0","4","Texas","4/13/20","4","0","48223","0"
"Howard","0","1","Texas","4/13/20","0","1","48227","1"
"Hunt","2","18","Texas","4/13/20","1","17","48231","1700"
"Hutchinson","0","3","Texas","4/13/20","2","1","48233","50"
"Jack","0","1","Texas","4/13/20","0","1","48237","1"
"Jackson","0","4","Texas","4/13/20","3","1","48239","33.33"
"Jasper","1","7","Texas","4/13/20","3","4","48241","133.33"
"Jefferson","10","127","Texas","4/13/20","59","68","48245","115.25"
"Jim Wells","0","2","Texas","4/13/20","2","0","48249","0"
"Johnson","1","28","Texas","4/13/20","21","7","48251","33.33"
"Jones","0","2","Texas","4/13/20","0","2","48253","1"
"Karnes","0","2","Texas","4/13/20","2","0","48255","0"
"Kaufman","3","28","Texas","4/13/20","9","19","48257","211.11"
"Kendall","0","11","Texas","4/13/20","9","2","48259","22.22"
"Kerr","0","2","Texas","4/13/20","2","0","48265","0"
"Kleberg","0","2","Texas","4/13/20","2","0","48273","0"
"Knox","0","1","Texas","4/13/20","0","1","48275","1"
"Lamar","0","8","Texas","4/13/20","6","2","48277","33.33"
"Lamb","0","2","Texas","4/13/20","1","1","48279","100"
"Lampasas","0","2","Texas","4/13/20","2","0","48281","0"
"Lavaca","0","4","Texas","4/13/20","2","2","48285","100"
"Lee","0","2","Texas","4/13/20","2","0","48287","0"
"Leon","0","3","Texas","4/13/20","2","1","48289","50"
"Liberty","2","19","Texas","4/13/20","6","13","48291","216.67"
"Limestone","1","11","Texas","4/13/20","3","8","48293","266.67"
"Live Oak","0","3","Texas","4/13/20","3","0","48297","0"
"Llano","0","3","Texas","4/13/20","2","1","48299","50"
"Lubbock","18","307","Texas","4/13/20","180","127","48303","70.56"
"Lynn","0","5","Texas","4/13/20","3","2","48305","66.67"
"Madison","0","1","Texas","4/13/20","0","1","48313","1"
"Martin","0","2","Texas","4/13/20","2","0","48317","0"
"Mason","0","1","Texas","4/13/20","1","0","48319","0"
"Matagorda","1","49","Texas","4/13/20","41","8","48321","19.51"
"Maverick","1","9","Texas","4/13/20","5","4","48323","80"
"McCulloch","0","3","Texas","4/13/20","0","3","48307","1"
"McLennan","3","71","Texas","4/13/20","53","18","48309","33.96"
"Medina","1","13","Texas","4/13/20","4","9","48325","225"
"Midland","1","32","Texas","4/13/20","24","8","48329","33.33"
"Milam","1","8","Texas","4/13/20","3","5","48331","166.67"
"Mitchell","0","1","Texas","4/13/20","0","1","48335","1"
"Montague","0","2","Texas","4/13/20","1","1","48337","100"
"Montgomery","15","266","Texas","4/13/20","161","105","48339","65.22"
"Moore","2","22","Texas","4/13/20","6","16","48341","266.67"
"Morris","0","3","Texas","4/13/20","1","2","48343","200"
"Motley","0","1","Texas","4/13/20","0","1","48345","1"
"Nacogdoches","4","48","Texas","4/13/20","18","30","48347","166.67"
"Navarro","1","12","Texas","4/13/20","4","8","48349","200"
"Newton","0","2","Texas","4/13/20","1","1","48351","100"
"Nueces","2","76","Texas","4/13/20","59","17","48355","28.81"
"Oldham","0","3","Texas","4/13/20","2","1","48359","50"
"Orange","3","44","Texas","4/13/20","22","22","48361","100"
"Palo Pinto","1","7","Texas","4/13/20","1","6","48363","600"
"Panola","1","13","Texas","4/13/20","4","9","48365","225"
"Parker","1","14","Texas","4/13/20","6","8","48367","133.33"
"Pecos","0","3","Texas","4/13/20","1","2","48371","200"
"Polk","0","9","Texas","4/13/20","8","1","48373","12.5"
"Potter","4","70","Texas","4/13/20","40","30","48375","75"
"Rains","0","1","Texas","4/13/20","0","1","48379","1"
"Randall","4","64","Texas","4/13/20","36","28","48381","77.78"
"Reeves","0","2","Texas","4/13/20","1","1","48389","100"
"Robertson","0","2","Texas","4/13/20","2","0","48395","0"
"Rockwall","2","26","Texas","4/13/20","10","16","48397","160"
"Rusk","1","16","Texas","4/13/20","12","4","48401","33.33"
"San Augustine","1","9","Texas","4/13/20","4","5","48405","125"
"San Jacinto","1","7","Texas","4/13/20","1","6","48407","600"
"San Patricio","1","7","Texas","4/13/20","2","5","48409","250"
"Scurry","0","2","Texas","4/13/20","0","2","48415","1"
"Shelby","3","36","Texas","4/13/20","12","24","48419","200"
"Smith","5","96","Texas","4/13/20","62","34","48423","54.84"
"Starr","0","7","Texas","4/13/20","7","0","48427","0"
"Stephens","0","1","Texas","4/13/20","0","1","48429","1"
"Swisher","0","4","Texas","4/13/20","1","3","48437","300"
"Tarrant","61","876","Texas","4/13/20","452","424","48439","93.81"
"Taylor","5","68","Texas","4/13/20","31","37","48441","119.35"
"Terry","1","10","Texas","4/13/20","4","6","48445","150"
"Titus","1","6","Texas","4/13/20","1","5","48449","500"
"Tom Green","2","39","Texas","4/13/20","24","15","48451","62.5"
"Travis","39","774","Texas","4/13/20","502","272","48453","54.18"
"Trinity","0","3","Texas","4/13/20","2","1","48455","50"
"Tyler","0","4","Texas","4/13/20","2","2","48457","100"
"Upshur","1","8","Texas","4/13/20","3","5","48459","166.67"
"Uvalde","0","6","Texas","4/13/20","5","1","48463","20"
"Val Verde","1","12","Texas","4/13/20","5","7","48465","140"
"Van Zandt","1","10","Texas","4/13/20","5","5","48467","100"
"Victoria","7","81","Texas","4/13/20","35","46","48469","131.43"
"Walker","2","21","Texas","4/13/20","10","11","48471","110"
"Waller","1","16","Texas","4/13/20","9","7","48473","77.78"
"Washington","3","37","Texas","4/13/20","19","18","48477","94.74"
"Webb","11","196","Texas","4/13/20","122","74","48479","60.66"
"Wharton","2","27","Texas","4/13/20","13","14","48481","107.69"
"Wichita","1","56","Texas","4/13/20","47","9","48485","19.15"
"Willacy","0","5","Texas","4/13/20","5","0","48489","0"
"Williamson","6","117","Texas","4/13/20","77","40","48491","51.95"
"Wilson","1","11","Texas","4/13/20","6","5","48493","83.33"
"Winkler","0","1","Texas","4/13/20","0","1","48495","1"
"Wise","0","5","Texas","4/13/20","3","2","48497","66.67"
"Wood","0","5","Texas","4/13/20","3","2","48499","66.67"
"Young","0","3","Texas","4/13/20","3","0","48503","0"
"Zapata","0","3","Texas","4/13/20","1","2","48505","200"
"Bear River","0","13","Utah","4/13/20","11","2","00000","18.18"
"Cache","2","36","Utah","4/13/20","22","14","49005","63.64"
"Carbon","0","2","Utah","4/13/20","1","1","49007","100"
"Davis","7","204","Utah","4/13/20","154","50","49011","32.47"
"Duchesne","0","3","Utah","4/13/20","1","2","49013","200"
"Emery","0","2","Utah","4/13/20","2","0","49015","0"
"Garfield","0","1","Utah","4/13/20","1","0","49017","0"
"Grand","0","1","Utah","4/13/20","1","0","49019","0"
"Iron","0","15","Utah","4/13/20","13","2","49021","15.38"
"Kane","0","3","Utah","4/13/20","2","1","49025","50"
"Salt Lake","54","1157","Utah","4/13/20","777","380","49035","48.91"
"San Juan","1","9","Utah","4/13/20","5","4","49037","80"
"Summit","7","306","Utah","4/13/20","260","46","49043","17.69"
"Tooele","2","34","Utah","4/13/20","22","12","49045","54.55"
"Uintah","1","6","Utah","4/13/20","2","4","49047","200"
"Utah","14","322","Utah","4/13/20","223","99","49049","44.39"
"Wasatch","3","103","Utah","4/13/20","79","24","49051","30.38"
"Washington","2","43","Utah","4/13/20","31","12","49053","38.71"
"Weber-Morgan","5","103","Utah","4/13/20","71","32","00000","45.07"
"Addison","2","56","Vermont","4/13/20","40","16","50001","40"
"Bennington","1","32","Vermont","4/13/20","25","7","50003","28"
"Caledonia","0","9","Vermont","4/13/20","6","3","50005","50"
"Chittenden","12","372","Vermont","4/13/20","285","87","50007","30.53"
"Essex","0","1","Vermont","4/13/20","0","1","50009","1"
"Franklin","8","83","Vermont","4/13/20","29","54","50011","186.21"
"Grand Isle","0","3","Vermont","4/13/20","0","3","50013","1"
"Lamoille","1","22","Vermont","4/13/20","18","4","50015","22.22"
"Orange","0","5","Vermont","4/13/20","4","1","50017","25"
"Orleans","0","8","Vermont","4/13/20","8","0","50019","0"
"Rutland","2","39","Vermont","4/13/20","28","11","50021","39.29"
"Washington","1","28","Vermont","4/13/20","22","6","50023","27.27"
"Windham","3","55","Vermont","4/13/20","35","20","50025","57.14"
"Windsor","1","27","Vermont","4/13/20","22","5","50027","22.73"
"","1","51","Virgin Islands","4/13/20","43","8",,"18.6"
"Accomack","1","15","Virginia","4/13/20","11","4","51001","36.36"
"Albemarle","2","49","Virginia","4/13/20","34","15","51003","44.12"
"Alexandria","20","235","Virginia","4/13/20","93","142","51510","152.69"
"Alleghany","0","4","Virginia","4/13/20","2","2","51005","100"
"Amelia","0","9","Virginia","4/13/20","6","3","51007","50"
"Amherst","1","10","Virginia","4/13/20","6","4","51009","66.67"
"Appomattox","1","7","Virginia","4/13/20","1","6","51011","600"
"Arlington","27","390","Virginia","4/13/20","203","187","51013","92.12"
"Augusta","1","17","Virginia","4/13/20","9","8","51015","88.89"
"Bedford","2","16","Virginia","4/13/20","5","11","51019","220"
"Botetourt","1","24","Virginia","4/13/20","15","9","51023","60"
"Bristol","0","1","Virginia","4/13/20","1","0","51520","0"
"Brunswick","0","3","Virginia","4/13/20","1","2","51025","200"
"Buchanan","0","2","Virginia","4/13/20","0","2","51027","1"
"Buckingham","2","16","Virginia","4/13/20","4","12","51029","300"
"Buena Vista","0","4","Virginia","4/13/20","4","0","51530","0"
"Campbell","1","10","Virginia","4/13/20","2","8","51031","400"
"Caroline","1","6","Virginia","4/13/20","1","5","51033","500"
"Carroll","0","3","Virginia","4/13/20","1","2","51035","200"
"Charles City","1","9","Virginia","4/13/20","4","5","51036","125"
"Charlotte","0","4","Virginia","4/13/20","1","3","51037","300"
"Charlottesville","2","33","Virginia","4/13/20","22","11","51540","50"
"Chesapeake","7","126","Virginia","4/13/20","77","49","51550","63.64"
"Chesterfield","15","211","Virginia","4/13/20","108","103","51041","95.37"
"Clarke","0","3","Virginia","4/13/20","2","1","51043","50"
"Colonial Heights","1","10","Virginia","4/13/20","0","10","51570","1"
"Covington","0","1","Virginia","4/13/20","1","0","51580","0"
"Craig","0","2","Virginia","4/13/20","0","2","51045","1"
"Culpeper","2","20","Virginia","4/13/20","8","12","51047","150"
"Cumberland","1","8","Virginia","4/13/20","2","6","51049","300"
"Danville","1","21","Virginia","4/13/20","13","8","51590","61.54"
"Dinwiddie","1","6","Virginia","4/13/20","0","6","51053","1"
"Emporia","1","7","Virginia","4/13/20","2","5","51595","250"
"Fairfax","97","1164","Virginia","4/13/20","488","676","51059","138.52"
"Fairfax City","0","1","Virginia","4/13/20","0","1","51600","1"
"Falls Church","0","2","Virginia","4/13/20","0","2","51610","1"
"Fauquier","2","28","Virginia","4/13/20","11","17","51061","154.55"
"Floyd","0","1","Virginia","4/13/20","0","1","51063","1"
"Fluvanna","2","23","Virginia","4/13/20","9","14","51065","155.56"
"Franklin","1","14","Virginia","4/13/20","10","4","51067","40"
"Franklin City","0","7","Virginia","4/13/20","4","3","51620","75"
"Frederick","5","66","Virginia","4/13/20","31","35","51069","112.9"
"Fredericksburg","1","13","Virginia","4/13/20","7","6","51630","85.71"
"Galax","0","1","Virginia","4/13/20","1","0","51640","0"
"Giles","0","4","Virginia","4/13/20","1","3","51071","300"
"Gloucester","1","20","Virginia","4/13/20","12","8","51073","66.67"
"Goochland","3","38","Virginia","4/13/20","17","21","51075","123.53"
"Greene","0","5","Virginia","4/13/20","4","1","51079","25"
"Greensville","1","10","Virginia","4/13/20","4","6","51081","150"
"Halifax","1","7","Virginia","4/13/20","2","5","51083","250"
"Hampton","4","72","Virginia","4/13/20","41","31","51650","75.61"
"Hanover","4","39","Virginia","4/13/20","13","26","51085","200"
"Harrisonburg","9","87","Virginia","4/13/20","27","60","51660","222.22"
"Henrico","27","397","Virginia","4/13/20","207","190","51087","91.79"
"Henry","1","8","Virginia","4/13/20","3","5","51089","166.67"
"Hopewell","1","14","Virginia","4/13/20","10","4","51670","40"
"Isle of Wight","2","33","Virginia","4/13/20","22","11","51093","50"
"James City","1","126","Virginia","4/13/20","118","8","51095","6.78"
"King and Queen","0","2","Virginia","4/13/20","1","1","51097","100"
"King George","1","14","Virginia","4/13/20","10","4","51099","40"
"King William","0","2","Virginia","4/13/20","2","0","51101","0"
"Lancaster","0","1","Virginia","4/13/20","1","0","51103","0"
"Lee","1","7","Virginia","4/13/20","2","5","51105","250"
"Lexington","0","3","Virginia","4/13/20","3","0","51678","0"
"Loudoun","19","324","Virginia","4/13/20","188","136","51107","72.34"
"Louisa","2","27","Virginia","4/13/20","14","13","51109","92.86"
"Lunenburg","1","4","Virginia","4/13/20","0","4","51111","1"
"Lynchburg","3","33","Virginia","4/13/20","11","22","51680","200"
"Madison","0","6","Virginia","4/13/20","4","2","51113","50"
"Manassas","3","41","Virginia","4/13/20","17","24","51683","141.18"
"Manassas Park","1","10","Virginia","4/13/20","4","6","51685","150"
"Mathews","0","3","Virginia","4/13/20","2","1","51115","50"
"Mecklenburg","6","57","Virginia","4/13/20","12","45","51117","375"
"Middlesex","0","3","Virginia","4/13/20","0","3","51119","1"
"Montgomery","4","32","Virginia","4/13/20","7","25","51121","357.14"
"Nelson","0","5","Virginia","4/13/20","2","3","51125","150"
"New Kent","0","13","Virginia","4/13/20","12","1","51127","8.33"
"Newport News","5","88","Virginia","4/13/20","54","34","51700","62.96"
"Norfolk","6","99","Virginia","4/13/20","60","39","51710","65"
"Northampton","0","4","Virginia","4/13/20","2","2","51131","100"
"Northumberland","0","4","Virginia","4/13/20","3","1","51133","33.33"
"Nottoway","1","5","Virginia","4/13/20","1","4","51135","400"
"Orange","1","14","Virginia","4/13/20","5","9","51137","180"
"Page","1","6","Virginia","4/13/20","2","4","51139","200"
"Petersburg","1","19","Virginia","4/13/20","10","9","51730","90"
"Pittsylvania","0","4","Virginia","4/13/20","3","1","51143","33.33"
"Poquoson","0","6","Virginia","4/13/20","3","3","51735","100"
"Portsmouth","4","54","Virginia","4/13/20","27","27","51740","100"
"Powhatan","0","5","Virginia","4/13/20","4","1","51145","25"
"Prince Edward","1","13","Virginia","4/13/20","3","10","51147","333.33"
"Prince George","1","27","Virginia","4/13/20","18","9","51149","50"
"Prince William","34","434","Virginia","4/13/20","193","241","51153","124.87"
"Pulaski","0","4","Virginia","4/13/20","1","3","51155","300"
"Radford","0","1","Virginia","4/13/20","1","0","51750","0"
"Rappahannock","0","1","Virginia","4/13/20","0","1","51157","1"
"Richmond","1","5","Virginia","4/13/20","1","4","51159","400"
"Richmond City","9","167","Virginia","4/13/20","105","62","51760","59.05"
"Roanoke","2","18","Virginia","4/13/20","5","13","51161","260"
"Roanoke City","1","21","Virginia","4/13/20","11","10","51770","90.91"
"Rockbridge","0","3","Virginia","4/13/20","3","0","51163","0"
"Rockingham","5","49","Virginia","4/13/20","15","34","51165","226.67"
"Russell","0","1","Virginia","4/13/20","1","0","51167","0"
"Salem","0","1","Virginia","4/13/20","1","0","51775","0"
"Scott","0","3","Virginia","4/13/20","0","3","51169","1"
"Shenandoah","1","17","Virginia","4/13/20","13","4","51171","30.77"
"Smyth","1","11","Virginia","4/13/20","2","9","51173","450"
"Southampton","0","5","Virginia","4/13/20","5","0","51175","0"
"Spotsylvania","4","51","Virginia","4/13/20","26","25","51177","96.15"
"Stafford","6","87","Virginia","4/13/20","43","44","51179","102.33"
"Staunton","0","2","Virginia","4/13/20","1","1","51790","100"
"Suffolk","3","51","Virginia","4/13/20","28","23","51800","82.14"
"Surry","0","3","Virginia","4/13/20","3","0","51181","0"
"Sussex","1","8","Virginia","4/13/20","4","4","51183","100"
"Tazewell","0","4","Virginia","4/13/20","3","1","51185","33.33"
"Virginia Beach","10","251","Virginia","4/13/20","178","73","51810","41.01"
"Warren","2","17","Virginia","4/13/20","5","12","51187","240"
"Washington","3","28","Virginia","4/13/20","5","23","51191","460"
"Waynesboro","0","6","Virginia","4/13/20","3","3","51820","100"
"Westmoreland","1","8","Virginia","4/13/20","3","5","51193","166.67"
"Williamsburg","1","20","Virginia","4/13/20","13","7","51830","53.85"
"Winchester","1","20","Virginia","4/13/20","13","7","51840","53.85"
"Wise","2","13","Virginia","4/13/20","1","12","51195","1200"
"Wythe","1","7","Virginia","4/13/20","3","4","51197","133.33"
"York","2","33","Virginia","4/13/20","21","12","51199","57.14"
"Adams","2","37","Washington","4/13/20","26","11","53001","42.31"
"Asotin","0","5","Washington","4/13/20","3","2","53003","66.67"
"Benton","12","259","Washington","4/13/20","175","84","53005","48"
"Chelan","4","55","Washington","4/13/20","29","26","53007","89.66"
"Clallam","1","12","Washington","4/13/20","8","4","53009","50"
"Clark","10","239","Washington","4/13/20","168","71","53011","42.26"
"Columbia","0","1","Washington","4/13/20","1","0","53013","0"
"Cowlitz","1","25","Washington","4/13/20","18","7","53015","38.89"
"Douglas","1","18","Washington","4/13/20","10","8","53017","80"
"Ferry","0","1","Washington","4/13/20","1","0","53019","0"
"Franklin","8","122","Washington","4/13/20","64","58","53021","90.62"
"Grant","5","120","Washington","4/13/20","88","32","53025","36.36"
"Grays Harbor","1","11","Washington","4/13/20","6","5","53027","83.33"
"Island","2","158","Washington","4/13/20","141","17","53029","12.06"
"Jefferson","1","28","Washington","4/13/20","22","6","53031","27.27"
"King","156","4426","Washington","4/13/20","3331","1095","53033","32.87"
"Kitsap","4","132","Washington","4/13/20","104","28","53035","26.92"
"Kittitas","0","14","Washington","4/13/20","12","2","53037","16.67"
"Klickitat","0","14","Washington","4/13/20","11","3","53039","27.27"
"Lewis","0","17","Washington","4/13/20","16","1","53041","6.25"
"Lincoln","0","2","Washington","4/13/20","1","1","53043","100"
"Mason","1","19","Washington","4/13/20","15","4","53045","26.67"
"Okanogan","1","15","Washington","4/13/20","9","6","53047","66.67"
"Pacific","0","1","Washington","4/13/20","0","1","53049","1"
"Pend Oreille","0","1","Washington","4/13/20","1","0","53051","0"
"Pierce","36","969","Washington","4/13/20","717","252","53053","35.15"
"San Juan","1","13","Washington","4/13/20","9","4","53055","44.44"
"Skagit","4","191","Washington","4/13/20","161","30","53057","18.63"
"Skamania","0","3","Washington","4/13/20","2","1","53059","50"
"Snohomish","43","1907","Washington","4/13/20","1603","304","53061","18.96"
"Spokane","8","276","Washington","4/13/20","222","54","53063","24.32"
"Stevens","0","7","Washington","4/13/20","5","2","53065","40"
"Thurston","2","81","Washington","4/13/20","67","14","53067","20.9"
"Wahkiakum","0","2","Washington","4/13/20","2","0","53069","0"
"Walla Walla","1","21","Washington","4/13/20","12","9","53071","75"
"Whatcom","5","264","Washington","4/13/20","228","36","53073","15.79"
"Whitman","0","12","Washington","4/13/20","12","0","53075","0"
"Yakima","25","538","Washington","4/13/20","363","175","53077","48.21"
"Barbour","0","4","West Virginia","4/13/20","2","2","54001","100"
"Berkeley","5","92","West Virginia","4/13/20","54","38","54003","70.37"
"Boone","0","1","West Virginia","4/13/20","0","1","54005","1"
"Braxton","0","1","West Virginia","4/13/20","0","1","54007","1"
"Brooke","0","3","West Virginia","4/13/20","0","3","54009","1"
"Cabell","2","23","West Virginia","4/13/20","7","16","54011","228.57"
"Fayette","0","2","West Virginia","4/13/20","0","2","54019","1"
"Grant","0","1","West Virginia","4/13/20","0","1","54023","1"
"Greenbrier","0","3","West Virginia","4/13/20","3","0","54025","0"
"Hampshire","1","4","West Virginia","4/13/20","0","4","54027","1"
"Hancock","0","7","West Virginia","4/13/20","6","1","54029","16.67"
"Hardy","0","2","West Virginia","4/13/20","2","0","54031","0"
"Harrison","0","28","West Virginia","4/13/20","25","3","54033","12"
"Jackson","2","27","West Virginia","4/13/20","16","11","54035","68.75"
"Jefferson","4","49","West Virginia","4/13/20","22","27","54037","122.73"
"Kanawha","4","86","West Virginia","4/13/20","56","30","54039","53.57"
"Lewis","0","2","West Virginia","4/13/20","1","1","54041","100"
"Logan","0","8","West Virginia","4/13/20","6","2","54045","33.33"
"Marion","2","34","West Virginia","4/13/20","17","17","54049","100"
"Marshall","0","6","West Virginia","4/13/20","5","1","54051","20"
"Mason","1","8","West Virginia","4/13/20","4","4","54053","100"
"McDowell","1","5","West Virginia","4/13/20","0","5","54047","1"
"Mercer","1","8","West Virginia","4/13/20","4","4","54055","100"
"Mineral","0","4","West Virginia","4/13/20","2","2","54057","100"
"Mingo","0","1","West Virginia","4/13/20","0","1","54059","1"
"Monongalia","4","83","West Virginia","4/13/20","53","30","54061","56.6"
"Monroe","0","1","West Virginia","4/13/20","0","1","54063","1"
"Morgan","0","6","West Virginia","4/13/20","3","3","54065","100"
"Nicholas","0","2","West Virginia","4/13/20","0","2","54067","1"
"Ohio","1","25","West Virginia","4/13/20","15","10","54069","66.67"
"Pendleton","0","1","West Virginia","4/13/20","1","0","54071","0"
"Pleasants","0","1","West Virginia","4/13/20","1","0","54073","0"
"Preston","0","6","West Virginia","4/13/20","4","2","54077","50"
"Putnam","0","11","West Virginia","4/13/20","8","3","54079","37.5"
"Raleigh","0","5","West Virginia","4/13/20","4","1","54081","25"
"Randolph","0","4","West Virginia","4/13/20","3","1","54083","33.33"
"Roane","0","2","West Virginia","4/13/20","2","0","54087","0"
"Summers","0","1","West Virginia","4/13/20","0","1","54089","1"
"Taylor","0","3","West Virginia","4/13/20","1","2","54091","200"
"Tucker","0","4","West Virginia","4/13/20","3","1","54093","33.33"
"Tyler","0","3","West Virginia","4/13/20","0","3","54095","1"
"Upshur","0","3","West Virginia","4/13/20","1","2","54097","200"
"Wayne","2","17","West Virginia","4/13/20","0","17","54099","1"
"Wetzel","0","3","West Virginia","4/13/20","2","1","54103","50"
"Wirt","0","2","West Virginia","4/13/20","1","1","54105","100"
"Wood","1","18","West Virginia","4/13/20","11","7","54107","63.64"
"Wyoming","0","1","West Virginia","4/13/20","0","1","54109","1"
"Adams","0","3","Wisconsin","4/13/20","2","1","55001","50"
"Ashland","0","2","Wisconsin","4/13/20","1","1","55003","100"
"Barron","0","6","Wisconsin","4/13/20","4","2","55005","50"
"Bayfield","0","3","Wisconsin","4/13/20","3","0","55007","0"
"Brown","5","77","Wisconsin","4/13/20","39","38","55009","97.44"
"Buffalo","0","3","Wisconsin","4/13/20","2","1","55011","50"
"Calumet","0","5","Wisconsin","4/13/20","4","1","55015","25"
"Chippewa","1","20","Wisconsin","4/13/20","16","4","55017","25"
"Clark","0","8","Wisconsin","4/13/20","7","1","55019","14.29"
"Columbia","1","25","Wisconsin","4/13/20","21","4","55021","19.05"
"Crawford","0","3","Wisconsin","4/13/20","2","1","55023","50"
"Dane","8","340","Wisconsin","4/13/20","287","53","55025","18.47"
"Dodge","1","19","Wisconsin","4/13/20","15","4","55027","26.67"
"Door","1","9","Wisconsin","4/13/20","4","5","55029","125"
"Douglas","0","7","Wisconsin","4/13/20","7","0","55031","0"
"Dunn","1","9","Wisconsin","4/13/20","5","4","55033","80"
"Eau Claire","0","21","Wisconsin","4/13/20","21","0","55035","0"
"Florence","0","2","Wisconsin","4/13/20","2","0","55037","0"
"Fond du Lac","2","57","Wisconsin","4/13/20","43","14","55039","32.56"
"Grant","0","6","Wisconsin","4/13/20","3","3","55043","100"
"Green","0","9","Wisconsin","4/13/20","9","0","55045","0"
"Green Lake","0","1","Wisconsin","4/13/20","0","1","55047","1"
"Iowa","0","5","Wisconsin","4/13/20","3","2","55049","66.67"
"Iron","0","2","Wisconsin","4/13/20","1","1","55051","100"
"Jackson","1","10","Wisconsin","4/13/20","4","6","55053","150"
"Jefferson","1","24","Wisconsin","4/13/20","14","10","55055","71.43"
"Juneau","0","7","Wisconsin","4/13/20","5","2","55057","40"
"Kenosha","11","182","Wisconsin","4/13/20","104","78","55059","75"
"Kewaunee","0","4","Wisconsin","4/13/20","1","3","55061","300"
"La Crosse","0","25","Wisconsin","4/13/20","22","3","55063","13.64"
"Lafayette","0","3","Wisconsin","4/13/20","0","3","55065","1"
"Manitowoc","0","3","Wisconsin","4/13/20","3","0","55071","0"
"Marathon","0","14","Wisconsin","4/13/20","12","2","55073","16.67"
"Marinette","0","3","Wisconsin","4/13/20","3","0","55075","0"
"Marquette","0","2","Wisconsin","4/13/20","2","0","55077","0"
"Menominee","0","1","Wisconsin","4/13/20","1","0","55078","0"
"Milwaukee","70","1743","Wisconsin","4/13/20","1256","487","55079","38.77"
"Monroe","0","8","Wisconsin","4/13/20","7","1","55081","14.29"
"Oconto","0","3","Wisconsin","4/13/20","1","2","55083","200"
"Oneida","0","6","Wisconsin","4/13/20","3","3","55085","100"
"Outagamie","1","29","Wisconsin","4/13/20","22","7","55087","31.82"
"Ozaukee","1","72","Wisconsin","4/13/20","62","10","55089","16.13"
"Pierce","0","7","Wisconsin","4/13/20","7","0","55093","0"
"Polk","0","3","Wisconsin","4/13/20","0","3","55095","1"
"Portage","0","4","Wisconsin","4/13/20","3","1","55097","33.33"
"Price","0","1","Wisconsin","4/13/20","0","1","55099","1"
"Racine","9","117","Wisconsin","4/13/20","57","60","55101","105.26"
"Richland","0","5","Wisconsin","4/13/20","3","2","55103","66.67"
"Rock","4","60","Wisconsin","4/13/20","34","26","55105","76.47"
"Rusk","0","3","Wisconsin","4/13/20","3","0","55107","0"
"Sauk","1","26","Wisconsin","4/13/20","18","8","55111","44.44"
"Sawyer","0","1","Wisconsin","4/13/20","0","1","55113","1"
"Shawano","0","5","Wisconsin","4/13/20","2","3","55115","150"
"Sheboygan","2","36","Wisconsin","4/13/20","21","15","55117","71.43"
"St. Croix","0","10","Wisconsin","4/13/20","7","3","55109","42.86"
"Trempealeau","0","1","Wisconsin","4/13/20","1","0","55121","0"
"Vilas","0","4","Wisconsin","4/13/20","4","0","55125","0"
"Walworth","3","38","Wisconsin","4/13/20","20","18","55127","90"
"Washington","2","73","Wisconsin","4/13/20","57","16","55131","28.07"
"Waukesha","8","218","Wisconsin","4/13/20","160","58","55133","36.25"
"Waupaca","0","4","Wisconsin","4/13/20","2","2","55135","100"
"Waushara","0","2","Wisconsin","4/13/20","1","1","55137","100"
"Winnebago","0","27","Wisconsin","4/13/20","24","3","55139","12.5"
"Wood","0","2","Wisconsin","4/13/20","2","0","55141","0"
"Albany","0","5","Wyoming","4/13/20","4","1","56001","25"
"Big Horn","0","1","Wyoming","4/13/20","0","1","56003","1"
"Campbell","0","11","Wyoming","4/13/20","9","2","56005","22.22"
"Carbon","0","4","Wyoming","4/13/20","4","0","56007","0"
"Converse","1","8","Wyoming","4/13/20","4","4","56009","100"
"Crook","0","3","Wyoming","4/13/20","1","2","56011","200"
"Fremont","0","41","Wyoming","4/13/20","38","3","56013","7.89"
"Goshen","0","3","Wyoming","4/13/20","3","0","56015","0"
"Hot Springs","0","1","Wyoming","4/13/20","0","1","56017","1"
"Johnson","0","11","Wyoming","4/13/20","8","3","56019","37.5"
"Laramie","2","60","Wyoming","4/13/20","44","16","56021","36.36"
"Lincoln","0","5","Wyoming","4/13/20","4","1","56023","25"
"Natrona","1","33","Wyoming","4/13/20","25","8","56025","32"
"Niobrara","0","1","Wyoming","4/13/20","0","1","56027","1"
"Park","0","1","Wyoming","4/13/20","1","0","56029","0"
"Sheridan","0","12","Wyoming","4/13/20","12","0","56033","0"
"Sublette","0","1","Wyoming","4/13/20","1","0","56035","0"
"Sweetwater","1","9","Wyoming","4/13/20","5","4","56037","80"
"Teton","2","56","Wyoming","4/13/20","40","16","56039","40"
"Uinta","0","4","Wyoming","4/13/20","3","1","56041","33.33"
"Washakie","0","5","Wyoming","4/13/20","4","1","56043","25"
