"Locality","DailyAvgNewCasesPast7Days","TotalCases","State","Date","TotalCases7DaysAgo","NewCasesPast7Days","FIPS-Code","PercentIncreaseTotalCasesPast7Days"
"Autauga","2","61","Alabama","5/7/20","44","17","01001","38.64"
"Baldwin","4","205","Alabama","5/7/20","174","31","01003","17.82"
"Barbour","2","51","Alabama","5/7/20","39","12","01005","30.77"
"Bibb","0","44","Alabama","5/7/20","42","2","01007","4.76"
"Blount","1","44","Alabama","5/7/20","37","7","01009","18.92"
"Bullock","1","18","Alabama","5/7/20","13","5","01011","38.46"
"Butler","15","155","Alabama","5/7/20","53","102","01013","192.45"
"Calhoun","4","120","Alabama","5/7/20","94","26","01015","27.66"
"Chambers","2","308","Alabama","5/7/20","295","13","01017","4.41"
"Cherokee","0","18","Alabama","5/7/20","15","3","01019","20"
"Chilton","1","63","Alabama","5/7/20","53","10","01021","18.87"
"Choctaw","2","56","Alabama","5/7/20","43","13","01023","30.23"
"Clarke","3","50","Alabama","5/7/20","32","18","01025","56.25"
"Clay","1","25","Alabama","5/7/20","21","4","01027","19.05"
"Cleburne","0","13","Alabama","5/7/20","12","1","01029","8.33"
"Coffee","4","141","Alabama","5/7/20","111","30","01031","27.03"
"Colbert","3","51","Alabama","5/7/20","29","22","01033","75.86"
"Conecuh","0","12","Alabama","5/7/20","9","3","01035","33.33"
"Coosa","0","31","Alabama","5/7/20","31","0","01037","0"
"Covington","2","48","Alabama","5/7/20","36","12","01039","33.33"
"Crenshaw","2","31","Alabama","5/7/20","19","12","01041","63.16"
"Cullman","1","61","Alabama","5/7/20","55","6","01043","10.91"
"Dale","1","36","Alabama","5/7/20","27","9","01045","33.33"
"Dallas","6","83","Alabama","5/7/20","41","42","01047","102.44"
"DeKalb","7","124","Alabama","5/7/20","77","47","01049","61.04"
"Elmore","6","127","Alabama","5/7/20","86","41","01051","47.67"
"Escambia","1","33","Alabama","5/7/20","28","5","01053","17.86"
"Etowah","3","161","Alabama","5/7/20","139","22","01055","15.83"
"Fayette","0","7","Alabama","5/7/20","6","1","01057","16.67"
"Franklin","18","184","Alabama","5/7/20","58","126","01059","217.24"
"Geneva","0","11","Alabama","5/7/20","9","2","01061","22.22"
"Greene","2","67","Alabama","5/7/20","55","12","01063","21.82"
"Hale","2","62","Alabama","5/7/20","47","15","01065","31.91"
"Henry","0","27","Alabama","5/7/20","24","3","01067","12.5"
"Houston","1","100","Alabama","5/7/20","90","10","01069","11.11"
"Jackson","1","56","Alabama","5/7/20","49","7","01071","14.29"
"Jefferson","26","1065","Alabama","5/7/20","886","179","01073","20.2"
"Lamar","0","13","Alabama","5/7/20","11","2","01075","18.18"
"Lauderdale","6","79","Alabama","5/7/20","38","41","01077","107.89"
"Lawrence","1","19","Alabama","5/7/20","12","7","01079","58.33"
"Lee","3","417","Alabama","5/7/20","394","23","01081","5.84"
"Limestone","1","54","Alabama","5/7/20","44","10","01083","22.73"
"Lowndes","3","85","Alabama","5/7/20","65","20","01085","30.77"
"Macon","1","43","Alabama","5/7/20","37","6","01087","16.22"
"Madison","2","241","Alabama","5/7/20","227","14","01089","6.17"
"Marengo","3","73","Alabama","5/7/20","49","24","01091","48.98"
"Marion","3","93","Alabama","5/7/20","75","18","01093","24"
"Marshall","24","487","Alabama","5/7/20","317","170","01095","53.63"
"Mobile","42","1355","Alabama","5/7/20","1058","297","01097","28.07"
"Monroe","0","15","Alabama","5/7/20","13","2","01099","15.38"
"Montgomery","25","515","Alabama","5/7/20","337","178","01101","52.82"
"Morgan","2","84","Alabama","5/7/20","68","16","01103","23.53"
"Perry","1","18","Alabama","5/7/20","9","9","01105","100"
"Pickens","2","59","Alabama","5/7/20","48","11","01107","22.92"
"Pike","3","85","Alabama","5/7/20","67","18","01109","26.87"
"Randolph","5","96","Alabama","5/7/20","62","34","01111","54.84"
"Russell","2","69","Alabama","5/7/20","57","12","01113","21.05"
"Shelby","4","348","Alabama","5/7/20","320","28","01117","8.75"
"St. Clair","1","78","Alabama","5/7/20","72","6","01115","8.33"
"Sumter","4","92","Alabama","5/7/20","64","28","01119","43.75"
"Talladega","1","70","Alabama","5/7/20","61","9","01121","14.75"
"Tallapoosa","4","314","Alabama","5/7/20","285","29","01123","10.18"
"Tuscaloosa","7","259","Alabama","5/7/20","208","51","01125","24.52"
"Walker","1","103","Alabama","5/7/20","96","7","01127","7.29"
"Washington","1","43","Alabama","5/7/20","34","9","01129","26.47"
"Wilcox","1","73","Alabama","5/7/20","66","7","01131","10.61"
"Winston","0","17","Alabama","5/7/20","15","2","01133","13.33"
"Anchorage","2","191","Alaska","5/7/20","179","12","02020","6.7"
"Bethel","0","1","Alaska","5/7/20","1","0","02050","0"
"Fairbanks North Star","0","83","Alaska","5/7/20","81","2","02090","2.47"
"Juneau","0","27","Alaska","5/7/20","27","0","02110","0"
"Kenai Peninsula","1","23","Alaska","5/7/20","19","4","02122","21.05"
"Ketchikan Gateway","0","16","Alaska","5/7/20","16","0","02130","0"
"Kodiak Island","0","1","Alaska","5/7/20","1","0","02150","0"
"Matanuska-Susitna","0","21","Alaska","5/7/20","21","0","02170","0"
"Nome","0","1","Alaska","5/7/20","1","0","02180","0"
"Petersburg","0","4","Alaska","5/7/20","4","0","02195","0"
"Prince of Wales-Hyder","0","2","Alaska","5/7/20","2","0","02198","0"
"Sitka","0","1","Alaska","5/7/20","1","0","02220","0"
"Southeast Fairbanks","0","2","Alaska","5/7/20","1","1","02240","100"
"Yukon-Koyukuk","0","1","Alaska","5/7/20","1","0","02290","0"
"Apache","26","630","Arizona","5/7/20","449","181","04001","40.31"
"Cochise","0","40","Arizona","5/7/20","39","1","04003","2.56"
"Coconino","19","618","Arizona","5/7/20","486","132","04005","27.16"
"Gila","1","17","Arizona","5/7/20","13","4","04007","30.77"
"Graham","0","19","Arizona","5/7/20","16","3","04009","18.75"
"Greenlee","0","2","Arizona","5/7/20","2","0","04011","0"
"La Paz","1","20","Arizona","5/7/20","14","6","04012","42.86"
"Maricopa","175","5196","Arizona","5/7/20","3972","1224","04013","30.82"
"Mohave","6","158","Arizona","5/7/20","117","41","04015","35.04"
"Navajo","29","912","Arizona","5/7/20","712","200","04017","28.09"
"Pima","32","1465","Arizona","5/7/20","1241","224","04019","18.05"
"Pinal","19","530","Arizona","5/7/20","397","133","04021","33.5"
"Santa Cruz","1","38","Arizona","5/7/20","33","5","04023","15.15"
"Yavapai","10","152","Arizona","5/7/20","79","73","04025","92.41"
"Yuma","9","148","Arizona","5/7/20","85","63","04027","74.12"
"Arkansas","0","2","Arkansas","5/7/20","2","0","05001","0"
"Ashley","0","17","Arkansas","5/7/20","15","2","05003","13.33"
"Baxter","0","5","Arkansas","5/7/20","5","0","05005","0"
"Benton","2","113","Arkansas","5/7/20","102","11","05007","10.78"
"Boone","0","4","Arkansas","5/7/20","5","-1","05009","-20"
"Bradley","0","11","Arkansas","5/7/20","12","-1","05011","-8.33"
"Carroll","0","6","Arkansas","5/7/20","5","1","05015","20"
"Chicot","0","10","Arkansas","5/7/20","9","1","05017","11.11"
"Clark","0","32","Arkansas","5/7/20","30","2","05019","6.67"
"Clay","0","3","Arkansas","5/7/20","3","0","05021","0"
"Cleburne","0","72","Arkansas","5/7/20","73","-1","05023","-1.37"
"Cleveland","0","12","Arkansas","5/7/20","11","1","05025","9.09"
"Columbia","0","15","Arkansas","5/7/20","13","2","05027","15.38"
"Conway","0","13","Arkansas","5/7/20","13","0","05029","0"
"Craighead","3","92","Arkansas","5/7/20","74","18","05031","24.32"
"Crawford","0","5","Arkansas","5/7/20","4","1","05033","25"
"Crittenden","2","203","Arkansas","5/7/20","187","16","05035","8.56"
"Cross","1","27","Arkansas","5/7/20","17","10","05037","58.82"
"Dallas","0","1","Arkansas","5/7/20","1","0","05039","0"
"Desha","0","17","Arkansas","5/7/20","16","1","05041","6.25"
"Drew","0","19","Arkansas","5/7/20","16","3","05043","18.75"
"Faulkner","1","81","Arkansas","5/7/20","76","5","05045","6.58"
"Franklin","0","2","Arkansas","5/7/20","2","0","05047","0"
"Fulton","0","3","Arkansas","5/7/20","1","2","05049","200"
"Garland","0","118","Arkansas","5/7/20","116","2","05051","1.72"
"Grant","0","14","Arkansas","5/7/20","14","0","05053","0"
"Greene","1","22","Arkansas","5/7/20","16","6","05055","37.5"
"Hempstead","0","7","Arkansas","5/7/20","6","1","05057","16.67"
"Hot Spring","0","22","Arkansas","5/7/20","19","3","05059","15.79"
"Howard","0","14","Arkansas","5/7/20","13","1","05061","7.69"
"Independence","0","12","Arkansas","5/7/20","9","3","05063","33.33"
"Izard","1","11","Arkansas","5/7/20","5","6","05065","120"
"Jackson","0","1","Arkansas","5/7/20","1","0","05067","0"
"Jefferson","8","223","Arkansas","5/7/20","169","54","05069","31.95"
"Johnson","0","33","Arkansas","5/7/20","31","2","05071","6.45"
"Lafayette","0","9","Arkansas","5/7/20","7","2","05073","28.57"
"Lawrence","1","69","Arkansas","5/7/20","59","10","05075","16.95"
"Lee","0","4","Arkansas","5/7/20","3","1","05077","33.33"
"Lincoln","12","899","Arkansas","5/7/20","814","85","05079","10.44"
"Logan","0","3","Arkansas","5/7/20","3","0","05083","0"
"Lonoke","0","44","Arkansas","5/7/20","41","3","05085","7.32"
"Madison","0","1","Arkansas","5/7/20","1","0","05087","0"
"Marion","0","1","Arkansas","5/7/20","1","0","05089","0"
"Miller","0","35","Arkansas","5/7/20","34","1","05091","2.94"
"Mississippi","3","42","Arkansas","5/7/20","19","23","05093","121.05"
"Monroe","0","4","Arkansas","5/7/20","4","0","05095","0"
"Montgomery","0","1","Arkansas","5/7/20","1","0","05097","0"
"Nevada","0","3","Arkansas","5/7/20","1","2","05099","200"
"Newton","0","3","Arkansas","5/7/20","3","0","05101","0"
"Ouachita","0","8","Arkansas","5/7/20","6","2","05103","33.33"
"Perry","0","7","Arkansas","5/7/20","7","0","05105","0"
"Phillips","0","5","Arkansas","5/7/20","5","0","05107","0"
"Pike","0","3","Arkansas","5/7/20","3","0","05109","0"
"Poinsett","0","25","Arkansas","5/7/20","22","3","05111","13.64"
"Polk","0","7","Arkansas","5/7/20","8","-1","05113","-12.5"
"Pope","1","47","Arkansas","5/7/20","43","4","05115","9.3"
"Prairie","0","2","Arkansas","5/7/20","2","0","05117","0"
"Pulaski","10","588","Arkansas","5/7/20","518","70","05119","13.51"
"Randolph","1","21","Arkansas","5/7/20","17","4","05121","23.53"
"Saline","0","70","Arkansas","5/7/20","67","3","05125","4.48"
"Scott","0","1","Arkansas","5/7/20","1","0","05127","0"
"Searcy","0","6","Arkansas","5/7/20","6","0","05129","0"
"Sebastian","0","14","Arkansas","5/7/20","13","1","05131","7.69"
"Sevier","0","14","Arkansas","5/7/20","11","3","05133","27.27"
"Sharp","0","8","Arkansas","5/7/20","10","-2","05135","-20"
"St. Francis","3","104","Arkansas","5/7/20","83","21","05123","25.3"
"Stone","0","8","Arkansas","5/7/20","7","1","05137","14.29"
"Union","3","73","Arkansas","5/7/20","50","23","05139","46"
"Van Buren","0","28","Arkansas","5/7/20","28","0","05141","0"
"Washington","2","102","Arkansas","5/7/20","86","16","05143","18.6"
"White","0","35","Arkansas","5/7/20","34","1","05145","2.94"
"Woodruff","0","1","Arkansas","5/7/20","1","0","05147","0"
"Yell","1","7","Arkansas","5/7/20","3","4","05149","133.33"
"Alameda","45","1917","California","5/7/20","1603","314","06001","19.59"
"Alpine","0","2","California","5/7/20","2","0","06003","0"
"Amador","0","8","California","5/7/20","8","0","06005","0"
"Butte","0","18","California","5/7/20","16","2","06007","12.5"
"Calaveras","0","13","California","5/7/20","13","0","06009","0"
"Colusa","0","3","California","5/7/20","3","0","06011","0"
"Contra Costa","15","999","California","5/7/20","891","108","06013","12.12"
"Del Norte","0","3","California","5/7/20","3","0","06015","0"
"El Dorado","1","54","California","5/7/20","44","10","06017","22.73"
"Fresno","34","777","California","5/7/20","538","239","06019","44.42"
"Glenn","0","5","California","5/7/20","5","0","06021","0"
"Humboldt","0","55","California","5/7/20","54","1","06023","1.85"
"Imperial","19","455","California","5/7/20","319","136","06025","42.63"
"Inyo","0","19","California","5/7/20","19","0","06027","0"
"Kern","34","1133","California","5/7/20","893","240","06029","26.88"
"Kings","20","233","California","5/7/20","96","137","06031","142.71"
"Lake","0","8","California","5/7/20","6","2","06033","33.33"
"Los Angeles","899","29511","California","5/7/20","23220","6291","06037","27.09"
"Madera","1","55","California","5/7/20","46","9","06039","19.57"
"Marin","2","247","California","5/7/20","235","12","06041","5.11"
"Mariposa","2","15","California","5/7/20","3","12","06043","400"
"Mendocino","0","12","California","5/7/20","12","0","06045","0"
"Merced","4","155","California","5/7/20","125","30","06047","24"
"Mono","0","28","California","5/7/20","26","2","06051","7.69"
"Monterey","6","247","California","5/7/20","206","41","06053","19.9"
"Napa","2","78","California","5/7/20","67","11","06055","16.42"
"Nevada","0","41","California","5/7/20","41","0","06057","0"
"Orange","100","3092","California","5/7/20","2393","699","06059","29.21"
"Placer","3","165","California","5/7/20","147","18","06061","12.24"
"Plumas","0","4","California","5/7/20","4","0","06063","0"
"Riverside","104","4756","California","5/7/20","4031","725","06065","17.99"
"Sacramento","11","1153","California","5/7/20","1077","76","06067","7.06"
"San Benito","0","53","California","5/7/20","50","3","06069","6"
"San Bernardino","72","2562","California","5/7/20","2058","504","06071","24.49"
"San Diego","127","4319","California","5/7/20","3432","887","06073","25.84"
"San Francisco","44","1806","California","5/7/20","1499","307","06075","20.48"
"San Joaquin","5","581","California","5/7/20","543","38","06077","7"
"San Luis Obispo","4","211","California","5/7/20","184","27","06079","14.67"
"San Mateo","29","1377","California","5/7/20","1177","200","06081","16.99"
"Santa Barbara","18","613","California","5/7/20","485","128","06083","26.39"
"Santa Clara","17","2281","California","5/7/20","2163","118","06085","5.46"
"Santa Cruz","1","139","California","5/7/20","131","8","06087","6.11"
"Shasta","0","31","California","5/7/20","31","0","06089","0"
"Siskiyou","0","5","California","5/7/20","5","0","06093","0"
"Solano","11","337","California","5/7/20","263","74","06095","28.14"
"Sonoma","8","286","California","5/7/20","232","54","06097","23.28"
"Stanislaus","17","461","California","5/7/20","339","122","06099","35.99"
"Sutter","0","31","California","5/7/20","30","1","06101","3.33"
"Tehama","0","1","California","5/7/20","1","0","06103","0"
"Tulare","47","969","California","5/7/20","640","329","06107","51.41"
"Tuolumne","0","2","California","5/7/20","4","-2","06109","-50"
"Ventura","14","631","California","5/7/20","535","96","06111","17.94"
"Yolo","1","172","California","5/7/20","164","8","06113","4.88"
"Yuba","0","19","California","5/7/20","18","1","06115","5.56"
"Adams","66","2046","Colorado","5/7/20","1585","461","08001","29.09"
"Alamosa","2","25","Colorado","5/7/20","10","15","08003","150"
"Arapahoe","88","3089","Colorado","5/7/20","2472","617","08005","24.96"
"Archuleta","0","8","Colorado","5/7/20","8","0","08007","0"
"Baca","0","12","Colorado","5/7/20","10","2","08009","20"
"Boulder","20","720","Colorado","5/7/20","580","140","08013","24.14"
"Broomfield","5","186","Colorado","5/7/20","150","36","08014","24"
"Chaffee","0","68","Colorado","5/7/20","66","2","08015","3.03"
"Clear Creek","0","13","Colorado","5/7/20","13","0","08019","0"
"Costilla","0","3","Colorado","5/7/20","3","0","08023","0"
"Crowley","0","4","Colorado","5/7/20","2","2","08025","100"
"Custer","0","2","Colorado","5/7/20","2","0","08027","0"
"Delta","1","53","Colorado","5/7/20","44","9","08029","20.45"
"Denver","114","3799","Colorado","5/7/20","3001","798","08031","26.59"
"Douglas","14","573","Colorado","5/7/20","478","95","08035","19.87"
"Eagle","1","554","Colorado","5/7/20","550","4","08037","0.73"
"El Paso","21","1079","Colorado","5/7/20","932","147","08041","15.77"
"Elbert","1","37","Colorado","5/7/20","29","8","08039","27.59"
"Fremont","0","23","Colorado","5/7/20","22","1","08043","4.55"
"Garfield","1","100","Colorado","5/7/20","93","7","08045","7.53"
"Gilpin","0","1","Colorado","5/7/20","1","0","08047","0"
"Grand","0","5","Colorado","5/7/20","5","0","08049","0"
"Gunnison","1","173","Colorado","5/7/20","166","7","08051","4.22"
"Hinsdale","0","3","Colorado","5/7/20","3","0","08053","0"
"Huerfano","0","2","Colorado","5/7/20","2","0","08055","0"
"Jefferson","29","1542","Colorado","5/7/20","1338","204","08059","15.25"
"Kit Carson","0","24","Colorado","5/7/20","21","3","08063","14.29"
"La Plata","0","63","Colorado","5/7/20","62","1","08067","1.61"
"Lake","1","23","Colorado","5/7/20","18","5","08065","27.78"
"Larimer","9","423","Colorado","5/7/20","363","60","08069","16.53"
"Las Animas","0","4","Colorado","5/7/20","3","1","08071","33.33"
"Lincoln","0","3","Colorado","5/7/20","3","0","08073","0"
"Logan","5","318","Colorado","5/7/20","282","36","08075","12.77"
"Mesa","1","50","Colorado","5/7/20","46","4","08077","8.7"
"Mineral","0","2","Colorado","5/7/20","2","0","08079","0"
"Moffat","0","6","Colorado","5/7/20","6","0","08081","0"
"Montezuma","1","21","Colorado","5/7/20","16","5","08083","31.25"
"Montrose","3","114","Colorado","5/7/20","96","18","08085","18.75"
"Morgan","11","448","Colorado","5/7/20","372","76","08087","20.43"
"Otero","0","10","Colorado","5/7/20","10","0","08089","0"
"Ouray","0","5","Colorado","5/7/20","5","0","08091","0"
"Park","1","15","Colorado","5/7/20","11","4","08093","36.36"
"Phillips","0","7","Colorado","5/7/20","6","1","08095","16.67"
"Pitkin","-2","54","Colorado","5/7/20","65","-11","08097","-16.92"
"Prowers","1","8","Colorado","5/7/20","1","7","08099","700"
"Pueblo","3","163","Colorado","5/7/20","139","24","08101","17.27"
"Rio Blanco","0","1","Colorado","5/7/20","1","0","08103","0"
"Rio Grande","0","7","Colorado","5/7/20","7","0","08105","0"
"Routt","0","58","Colorado","5/7/20","56","2","08107","3.57"
"Saguache","0","3","Colorado","5/7/20","4","-1","08109","-25"
"San Juan","0","1","Colorado","5/7/20","0","1","08111","1"
"San Miguel","0","20","Colorado","5/7/20","19","1","08113","5.26"
"Summit","4","155","Colorado","5/7/20","128","27","08117","21.09"
"Teller","0","30","Colorado","5/7/20","28","2","08119","7.14"
"Washington","0","9","Colorado","5/7/20","7","2","08121","28.57"
"Weld","38","2042","Colorado","5/7/20","1776","266","08123","14.98"
"Yuma","0","10","Colorado","5/7/20","8","2","08125","25"
"Fairfield","198","12679","Connecticut","5/7/20","11294","1385","09001","12.26"
"Hartford","164","6750","Connecticut","5/7/20","5601","1149","09003","20.51"
"Litchfield","22","1114","Connecticut","5/7/20","963","151","09005","15.68"
"Middlesex","15","764","Connecticut","5/7/20","657","107","09007","16.29"
"New Haven","163","8678","Connecticut","5/7/20","7536","1142","09009","15.15"
"New London","25","742","Connecticut","5/7/20","564","178","09011","31.56"
"Tolland","12","522","Connecticut","5/7/20","437","85","09013","19.45"
"Windham","9","250","Connecticut","5/7/20","186","64","09015","34.41"
"Kent","27","945","Delaware","5/7/20","759","186","10001","24.51"
"New Castle","57","2130","Delaware","5/7/20","1734","396","10003","22.84"
"Sussex","88","2834","Delaware","5/7/20","2216","618","10005","27.89"
"","0","49","Diamond Princess","5/7/20","49","0",,"0"
"District of Columbia","190","5654","District of Columbia","5/7/20","4323","1331","11001","30.79"
"Alachua","5","300","Florida","5/7/20","267","33","12001","12.36"
"Baker","0","22","Florida","5/7/20","20","2","12003","10"
"Bay","1","76","Florida","5/7/20","72","4","12005","5.56"
"Bradford","0","48","Florida","5/7/20","46","2","12007","4.35"
"Brevard","6","325","Florida","5/7/20","285","40","12009","14.04"
"Broward","103","5677","Florida","5/7/20","4953","724","12011","14.62"
"Calhoun","2","24","Florida","5/7/20","8","16","12013","200"
"Charlotte","10","304","Florida","5/7/20","236","68","12015","28.81"
"Citrus","0","102","Florida","5/7/20","99","3","12017","3.03"
"Clay","3","292","Florida","5/7/20","273","19","12019","6.96"
"Collier","16","705","Florida","5/7/20","596","109","12021","18.29"
"Columbia","6","101","Florida","5/7/20","58","43","12023","74.14"
"DeSoto","2","42","Florida","5/7/20","29","13","12027","44.83"
"Dixie","1","11","Florida","5/7/20","7","4","12029","57.14"
"Duval","10","1083","Florida","5/7/20","1012","71","12031","7.02"
"Escambia","16","616","Florida","5/7/20","506","110","12033","21.74"
"Flagler","2","145","Florida","5/7/20","133","12","12035","9.02"
"Franklin","0","2","Florida","5/7/20","2","0","12037","0"
"Gadsden","4","121","Florida","5/7/20","95","26","12039","27.37"
"Gilchrist","0","6","Florida","5/7/20","5","1","12041","20"
"Glades","0","6","Florida","5/7/20","6","0","12043","0"
"Gulf","0","1","Florida","5/7/20","1","0","12045","0"
"Hamilton","0","7","Florida","5/7/20","6","1","12047","16.67"
"Hardee","2","35","Florida","5/7/20","18","17","12049","94.44"
"Hendry","7","129","Florida","5/7/20","83","46","12051","55.42"
"Hernando","1","97","Florida","5/7/20","90","7","12053","7.78"
"Highlands","1","90","Florida","5/7/20","81","9","12055","11.11"
"Hillsborough","34","1364","Florida","5/7/20","1124","240","12057","21.35"
"Holmes","0","10","Florida","5/7/20","10","0","12059","0"
"Indian River","1","99","Florida","5/7/20","90","9","12061","10"
"Jackson","2","31","Florida","5/7/20","14","17","12063","121.43"
"Jefferson","0","28","Florida","5/7/20","28","0","12065","0"
"Lafayette","0","3","Florida","5/7/20","1","2","12067","200"
"Lake","1","237","Florida","5/7/20","227","10","12069","4.41"
"Lee","27","1212","Florida","5/7/20","1021","191","12071","18.71"
"Leon","4","249","Florida","5/7/20","219","30","12073","13.7"
"Levy","0","20","Florida","5/7/20","19","1","12075","5.26"
"Liberty","16","114","Florida","5/7/20","3","111","12077","3700"
"Madison","1","61","Florida","5/7/20","55","6","12079","10.91"
"Manatee","22","737","Florida","5/7/20","580","157","12081","27.07"
"Marion","4","202","Florida","5/7/20","175","27","12083","15.43"
"Martin","6","233","Florida","5/7/20","191","42","12085","21.99"
"Miami-Dade","217","13585","Florida","5/7/20","12063","1522","12086","12.62"
"Monroe","0","80","Florida","5/7/20","79","1","12087","1.27"
"Nassau","1","60","Florida","5/7/20","56","4","12089","7.14"
"Okaloosa","1","163","Florida","5/7/20","154","9","12091","5.84"
"Okeechobee","2","22","Florida","5/7/20","11","11","12093","100"
"Orange","13","1474","Florida","5/7/20","1385","89","12095","6.43"
"Osceola","9","544","Florida","5/7/20","478","66","12097","13.81"
"Palm Beach","89","3587","Florida","5/7/20","2963","624","12099","21.06"
"Pasco","6","289","Florida","5/7/20","249","40","12101","16.06"
"Pinellas","13","820","Florida","5/7/20","729","91","12103","12.48"
"Polk","16","594","Florida","5/7/20","483","111","12105","22.98"
"Putnam","2","120","Florida","5/7/20","106","14","12107","13.21"
"Santa Rosa","1","160","Florida","5/7/20","154","6","12113","3.9"
"Sarasota","9","412","Florida","5/7/20","352","60","12115","17.05"
"Seminole","4","410","Florida","5/7/20","379","31","12117","8.18"
"St. Johns","2","222","Florida","5/7/20","208","14","12109","6.73"
"St. Lucie","3","271","Florida","5/7/20","247","24","12111","9.72"
"Sumter","8","238","Florida","5/7/20","181","57","12119","31.49"
"Suwannee","2","144","Florida","5/7/20","130","14","12121","10.77"
"Taylor","0","3","Florida","5/7/20","3","0","12123","0"
"Union","0","5","Florida","5/7/20","4","1","12125","25"
"Volusia","12","534","Florida","5/7/20","452","82","12127","18.14"
"Wakulla","1","29","Florida","5/7/20","23","6","12129","26.09"
"Walton","2","50","Florida","5/7/20","38","12","12131","31.58"
"Washington","0","12","Florida","5/7/20","12","0","12133","0"
"Appling","3","88","Georgia","5/7/20","70","18","13001","25.71"
"Atkinson","2","20","Georgia","5/7/20","8","12","13003","150"
"Bacon","1","32","Georgia","5/7/20","24","8","13005","33.33"
"Baker","1","29","Georgia","5/7/20","23","6","13007","26.09"
"Baldwin","8","270","Georgia","5/7/20","215","55","13009","25.58"
"Banks","2","35","Georgia","5/7/20","24","11","13011","45.83"
"Barrow","8","191","Georgia","5/7/20","133","58","13013","43.61"
"Bartow","7","360","Georgia","5/7/20","313","47","13015","15.02"
"Ben Hill","2","38","Georgia","5/7/20","25","13","13017","52"
"Berrien","0","19","Georgia","5/7/20","17","2","13019","11.76"
"Bibb","11","379","Georgia","5/7/20","305","74","13021","24.26"
"Bleckley","1","22","Georgia","5/7/20","16","6","13023","37.5"
"Brantley","0","23","Georgia","5/7/20","23","0","13025","0"
"Brooks","1","64","Georgia","5/7/20","58","6","13027","10.34"
"Bryan","1","57","Georgia","5/7/20","52","5","13029","9.62"
"Bulloch","1","41","Georgia","5/7/20","37","4","13031","10.81"
"Burke","1","90","Georgia","5/7/20","85","5","13033","5.88"
"Butts","4","167","Georgia","5/7/20","141","26","13035","18.44"
"Calhoun","2","110","Georgia","5/7/20","99","11","13037","11.11"
"Camden","0","35","Georgia","5/7/20","33","2","13039","6.06"
"Candler","0","7","Georgia","5/7/20","7","0","13043","0"
"Carroll","4","389","Georgia","5/7/20","358","31","13045","8.66"
"Catoosa","1","52","Georgia","5/7/20","47","5","13047","10.64"
"Charlton","1","14","Georgia","5/7/20","8","6","13049","75"
"Chatham","8","285","Georgia","5/7/20","226","59","13051","26.11"
"Chattahoochee","0","13","Georgia","5/7/20","12","1","13053","8.33"
"Chattooga","0","16","Georgia","5/7/20","16","0","13055","0"
"Cherokee","15","569","Georgia","5/7/20","467","102","13057","21.84"
"Clarke","4","176","Georgia","5/7/20","150","26","13059","17.33"
"Clay","1","27","Georgia","5/7/20","22","5","13061","22.73"
"Clayton","24","878","Georgia","5/7/20","713","165","13063","23.14"
"Clinch","1","16","Georgia","5/7/20","8","8","13065","100"
"Cobb","59","2024","Georgia","5/7/20","1614","410","13067","25.4"
"Coffee","4","165","Georgia","5/7/20","138","27","13069","19.57"
"Colquitt","2","201","Georgia","5/7/20","185","16","13071","8.65"
"Columbia","1","170","Georgia","5/7/20","160","10","13073","6.25"
"Cook","1","31","Georgia","5/7/20","23","8","13075","34.78"
"Coweta","9","257","Georgia","5/7/20","195","62","13077","31.79"
"Crawford","1","19","Georgia","5/7/20","15","4","13079","26.67"
"Crisp","2","181","Georgia","5/7/20","165","16","13081","9.7"
"Dade","0","16","Georgia","5/7/20","14","2","13083","14.29"
"Dawson","2","73","Georgia","5/7/20","61","12","13085","19.67"
"Decatur","3","105","Georgia","5/7/20","82","23","13087","28.05"
"DeKalb","53","2396","Georgia","5/7/20","2026","370","13089","18.26"
"Dodge","1","31","Georgia","5/7/20","26","5","13091","19.23"
"Dooly","1","135","Georgia","5/7/20","129","6","13093","4.65"
"Dougherty","9","1566","Georgia","5/7/20","1505","61","13095","4.05"
"Douglas","7","366","Georgia","5/7/20","319","47","13097","14.73"
"Early","2","224","Georgia","5/7/20","213","11","13099","5.16"
"Echols","0","6","Georgia","5/7/20","5","1","13101","20"
"Effingham","0","38","Georgia","5/7/20","35","3","13103","8.57"
"Elbert","2","34","Georgia","5/7/20","23","11","13105","47.83"
"Emanuel","0","23","Georgia","5/7/20","21","2","13107","9.52"
"Evans","0","5","Georgia","5/7/20","4","1","13109","25"
"Fannin","1","34","Georgia","5/7/20","29","5","13111","17.24"
"Fayette","2","191","Georgia","5/7/20","176","15","13113","8.52"
"Floyd","2","155","Georgia","5/7/20","144","11","13115","7.64"
"Forsyth","9","361","Georgia","5/7/20","298","63","13117","21.14"
"Franklin","1","25","Georgia","5/7/20","18","7","13119","38.89"
"Fulton","64","3258","Georgia","5/7/20","2811","447","13121","15.9"
"Gilmer","3","89","Georgia","5/7/20","68","21","13123","30.88"
"Glascock","0","1","Georgia","5/7/20","0","1","13125","1"
"Glynn","2","71","Georgia","5/7/20","55","16","13127","29.09"
"Gordon","4","120","Georgia","5/7/20","92","28","13129","30.43"
"Grady","2","80","Georgia","5/7/20","63","17","13131","26.98"
"Greene","0","56","Georgia","5/7/20","54","2","13133","3.7"
"Gwinnett","67","2253","Georgia","5/7/20","1787","466","13135","26.08"
"Habersham","18","383","Georgia","5/7/20","257","126","13137","49.03"
"Hall","89","1958","Georgia","5/7/20","1332","626","13139","47"
"Hancock","10","117","Georgia","5/7/20","45","72","13141","160"
"Haralson","1","32","Georgia","5/7/20","27","5","13143","18.52"
"Harris","0","61","Georgia","5/7/20","60","1","13145","1.67"
"Hart","1","15","Georgia","5/7/20","10","5","13147","50"
"Heard","1","14","Georgia","5/7/20","10","4","13149","40"
"Henry","10","559","Georgia","5/7/20","492","67","13151","13.62"
"Houston","8","281","Georgia","5/7/20","223","58","13153","26.01"
"Irwin","1","21","Georgia","5/7/20","15","6","13155","40"
"Jackson","4","119","Georgia","5/7/20","93","26","13157","27.96"
"Jasper","1","26","Georgia","5/7/20","21","5","13159","23.81"
"Jeff Davis","1","22","Georgia","5/7/20","17","5","13161","29.41"
"Jefferson","0","17","Georgia","5/7/20","14","3","13163","21.43"
"Jenkins","0","17","Georgia","5/7/20","16","1","13165","6.25"
"Johnson","2","64","Georgia","5/7/20","49","15","13167","30.61"
"Jones","0","31","Georgia","5/7/20","28","3","13169","10.71"
"Lamar","0","38","Georgia","5/7/20","38","0","13171","0"
"Lanier","0","10","Georgia","5/7/20","8","2","13173","25"
"Laurens","2","72","Georgia","5/7/20","60","12","13175","20"
"Lee","3","339","Georgia","5/7/20","318","21","13177","6.6"
"Liberty","1","41","Georgia","5/7/20","37","4","13179","10.81"
"Lincoln","0","12","Georgia","5/7/20","12","0","13181","0"
"Long","0","5","Georgia","5/7/20","5","0","13183","0"
"Lowndes","3","173","Georgia","5/7/20","155","18","13185","11.61"
"Lumpkin","5","76","Georgia","5/7/20","44","32","13187","72.73"
"Macon","0","81","Georgia","5/7/20","79","2","13193","2.53"
"Madison","1","28","Georgia","5/7/20","24","4","13195","16.67"
"Marion","-1","37","Georgia","5/7/20","42","-5","13197","-11.9"
"McDuffie","1","50","Georgia","5/7/20","45","5","13189","11.11"
"McIntosh","0","6","Georgia","5/7/20","4","2","13191","50"
"Meriwether","1","61","Georgia","5/7/20","54","7","13199","12.96"
"Miller","0","30","Georgia","5/7/20","33","-3","13201","-9.09"
"Mitchell","4","340","Georgia","5/7/20","310","30","13205","9.68"
"Monroe","2","34","Georgia","5/7/20","23","11","13207","47.83"
"Montgomery","0","2","Georgia","5/7/20","2","0","13209","0"
"Morgan","0","30","Georgia","5/7/20","28","2","13211","7.14"
"Murray","1","41","Georgia","5/7/20","31","10","13213","32.26"
"Muscogee","7","354","Georgia","5/7/20","303","51","13215","16.83"
"Newton","6","236","Georgia","5/7/20","196","40","13217","20.41"
"Oconee","0","67","Georgia","5/7/20","64","3","13219","4.69"
"Oglethorpe","1","53","Georgia","5/7/20","48","5","13221","10.42"
"Out of GA","18","1089","Georgia","5/7/20","962","127","80013","13.2"
"Paulding","4","218","Georgia","5/7/20","188","30","13223","15.96"
"Peach","2","61","Georgia","5/7/20","46","15","13225","32.61"
"Pickens","1","31","Georgia","5/7/20","26","5","13227","19.23"
"Pierce","1","59","Georgia","5/7/20","55","4","13229","7.27"
"Pike","0","41","Georgia","5/7/20","40","1","13231","2.5"
"Polk","1","64","Georgia","5/7/20","57","7","13233","12.28"
"Pulaski","1","34","Georgia","5/7/20","30","4","13235","13.33"
"Putnam","2","52","Georgia","5/7/20","40","12","13237","30"
"Quitman","0","6","Georgia","5/7/20","4","2","13239","50"
"Rabun","0","13","Georgia","5/7/20","13","0","13241","0"
"Randolph","1","167","Georgia","5/7/20","159","8","13243","5.03"
"Richmond","4","436","Georgia","5/7/20","406","30","13245","7.39"
"Rockdale","6","226","Georgia","5/7/20","186","40","13247","21.51"
"Schley","0","15","Georgia","5/7/20","16","-1","13249","-6.25"
"Screven","0","17","Georgia","5/7/20","15","2","13251","13.33"
"Seminole","1","33","Georgia","5/7/20","29","4","13253","13.79"
"Spalding","2","224","Georgia","5/7/20","208","16","13255","7.69"
"Stephens","2","91","Georgia","5/7/20","78","13","13257","16.67"
"Stewart","0","27","Georgia","5/7/20","24","3","13259","12.5"
"Sumter","1","387","Georgia","5/7/20","380","7","13261","1.84"
"Talbot","0","26","Georgia","5/7/20","26","0","13263","0"
"Taliaferro","0","1","Georgia","5/7/20","0","1","13265","1"
"Tattnall","0","9","Georgia","5/7/20","10","-1","13267","-10"
"Taylor","0","18","Georgia","5/7/20","17","1","13269","5.88"
"Telfair","0","28","Georgia","5/7/20","27","1","13271","3.7"
"Terrell","2","195","Georgia","5/7/20","183","12","13273","6.56"
"Thomas","6","227","Georgia","5/7/20","186","41","13275","22.04"
"Tift","3","139","Georgia","5/7/20","117","22","13277","18.8"
"Toombs","1","39","Georgia","5/7/20","31","8","13279","25.81"
"Towns","0","20","Georgia","5/7/20","21","-1","13281","-4.76"
"Treutlen","0","5","Georgia","5/7/20","3","2","13283","66.67"
"Troup","3","171","Georgia","5/7/20","148","23","13285","15.54"
"Turner","1","73","Georgia","5/7/20","68","5","13287","7.35"
"Twiggs","0","8","Georgia","5/7/20","8","0","13289","0"
"Union","0","33","Georgia","5/7/20","33","0","13291","0"
"Upson","4","246","Georgia","5/7/20","216","30","13293","13.89"
"Walker","0","61","Georgia","5/7/20","61","0","13295","0"
"Walton","3","148","Georgia","5/7/20","126","22","13297","17.46"
"Ware","4","148","Georgia","5/7/20","121","27","13299","22.31"
"Warren","0","13","Georgia","5/7/20","12","1","13301","8.33"
"Washington","1","51","Georgia","5/7/20","42","9","13303","21.43"
"Wayne","0","13","Georgia","5/7/20","13","0","13305","0"
"Webster","0","10","Georgia","5/7/20","10","0","13307","0"
"Wheeler","0","5","Georgia","5/7/20","4","1","13309","25"
"White","4","87","Georgia","5/7/20","59","28","13311","47.46"
"Whitfield","5","141","Georgia","5/7/20","103","38","13313","36.89"
"Wilcox","0","92","Georgia","5/7/20","90","2","13315","2.22"
"Wilkes","0","26","Georgia","5/7/20","25","1","13317","4"
"Wilkinson","1","40","Georgia","5/7/20","35","5","13319","14.29"
"Worth","4","179","Georgia","5/7/20","153","26","13321","16.99"
"","0","103","Grand Princess","5/7/20","103","0",,"0"
"","1","149","Guam","5/7/20","145","4",,"2.76"
"Hawaii","0","74","Hawaii","5/7/20","73","1","15001","1.37"
"Honolulu","1","408","Hawaii","5/7/20","399","9","15003","2.26"
"Kauai","0","21","Hawaii","5/7/20","21","0","15007","0"
"Maui","0","116","Hawaii","5/7/20","116","0","15009","0"
"Out of HI","0","10","Hawaii","5/7/20","9","1","80015","11.11"
"Ada","7","721","Idaho","5/7/20","671","50","16001","7.45"
"Adams","0","3","Idaho","5/7/20","3","0","16003","0"
"Bannock","0","12","Idaho","5/7/20","11","1","16005","9.09"
"Bingham","0","4","Idaho","5/7/20","4","0","16011","0"
"Blaine","0","499","Idaho","5/7/20","498","1","16013","0.2"
"Bonner","0","4","Idaho","5/7/20","4","0","16017","0"
"Bonneville","0","28","Idaho","5/7/20","28","0","16019","0"
"Camas","0","1","Idaho","5/7/20","1","0","16025","0"
"Canyon","3","272","Idaho","5/7/20","252","20","16027","7.94"
"Caribou","0","1","Idaho","5/7/20","1","0","16029","0"
"Cassia","0","13","Idaho","5/7/20","12","1","16031","8.33"
"Custer","0","2","Idaho","5/7/20","2","0","16037","0"
"Elmore","0","31","Idaho","5/7/20","30","1","16039","3.33"
"Fremont","0","3","Idaho","5/7/20","2","1","16043","50"
"Gem","0","14","Idaho","5/7/20","12","2","16045","16.67"
"Gooding","1","16","Idaho","5/7/20","11","5","16047","45.45"
"Idaho","0","3","Idaho","5/7/20","3","0","16049","0"
"Jefferson","0","5","Idaho","5/7/20","5","0","16051","0"
"Jerome","2","65","Idaho","5/7/20","51","14","16053","27.45"
"Kootenai","0","62","Idaho","5/7/20","61","1","16055","1.64"
"Latah","0","5","Idaho","5/7/20","5","0","16057","0"
"Lemhi","0","1","Idaho","5/7/20","1","0","16059","0"
"Lincoln","0","29","Idaho","5/7/20","27","2","16063","7.41"
"Madison","1","16","Idaho","5/7/20","10","6","16065","60"
"Minidoka","0","11","Idaho","5/7/20","11","0","16067","0"
"Nez Perce","3","78","Idaho","5/7/20","60","18","16069","30"
"Owyhee","0","8","Idaho","5/7/20","8","0","16073","0"
"Payette","0","17","Idaho","5/7/20","16","1","16075","6.25"
"Power","0","2","Idaho","5/7/20","2","0","16077","0"
"Teton","0","10","Idaho","5/7/20","9","1","16081","11.11"
"Twin Falls","10","239","Idaho","5/7/20","170","69","16083","40.59"
"Valley","0","2","Idaho","5/7/20","2","0","16085","0"
"Washington","0","1","Idaho","5/7/20","1","0","16087","0"
"Adams","0","40","Illinois","5/7/20","40","0","17001","0"
"Alexander","0","6","Illinois","5/7/20","3","3","17003","100"
"Bond","0","8","Illinois","5/7/20","6","2","17005","33.33"
"Boone","10","168","Illinois","5/7/20","98","70","17007","71.43"
"Brown","1","6","Illinois","5/7/20","0","6","17009","1"
"Bureau","0","12","Illinois","5/7/20","10","2","17011","20"
"Calhoun","0","1","Illinois","5/7/20","1","0","17013","0"
"Carroll","0","10","Illinois","5/7/20","9","1","17015","11.11"
"Cass","2","50","Illinois","5/7/20","33","17","17017","51.52"
"Champaign","14","229","Illinois","5/7/20","130","99","17019","76.15"
"Christian","0","27","Illinois","5/7/20","30","-3","17021","-10"
"Clark","0","5","Illinois","5/7/20","5","0","17023","0"
"Clay","0","2","Illinois","5/7/20","2","0","17025","0"
"Clinton","2","122","Illinois","5/7/20","106","16","17027","15.09"
"Coles","0","22","Illinois","5/7/20","22","0","17029","0"
"Cook","1690","48341","Illinois","5/7/20","36513","11828","17031","32.39"
"Crawford","0","10","Illinois","5/7/20","10","0","17033","0"
"Cumberland","0","4","Illinois","5/7/20","3","1","17035","33.33"
"De Witt","0","3","Illinois","5/7/20","3","0","17039","0"
"DeKalb","8","149","Illinois","5/7/20","95","54","17037","56.84"
"Douglas","1","20","Illinois","5/7/20","14","6","17041","42.86"
"DuPage","162","4213","Illinois","5/7/20","3081","1132","17043","36.74"
"Effingham","0","5","Illinois","5/7/20","5","0","17049","0"
"Fayette","0","17","Illinois","5/7/20","16","1","17051","6.25"
"Ford","0","12","Illinois","5/7/20","9","3","17053","33.33"
"Franklin","0","10","Illinois","5/7/20","8","2","17055","25"
"Fulton","0","3","Illinois","5/7/20","3","0","17057","0"
"Gallatin","0","2","Illinois","5/7/20","2","0","17059","0"
"Greene","0","3","Illinois","5/7/20","3","0","17061","0"
"Grundy","2","50","Illinois","5/7/20","35","15","17063","42.86"
"Hamilton","0","2","Illinois","5/7/20","2","0","17065","0"
"Hancock","1","10","Illinois","5/7/20","6","4","17067","66.67"
"Hardin","0","1","Illinois","5/7/20","1","0","17069","0"
"Henderson","0","5","Illinois","5/7/20","4","1","17071","25"
"Henry","1","55","Illinois","5/7/20","45","10","17073","22.22"
"Iroquois","7","77","Illinois","5/7/20","27","50","17075","185.19"
"Jackson","7","157","Illinois","5/7/20","107","50","17077","46.73"
"Jasper","0","46","Illinois","5/7/20","44","2","17079","4.55"
"Jefferson","1","88","Illinois","5/7/20","83","5","17081","6.02"
"Jersey","1","16","Illinois","5/7/20","12","4","17083","33.33"
"Jo Daviess","0","14","Illinois","5/7/20","13","1","17085","7.69"
"Johnson","0","4","Illinois","5/7/20","4","0","17087","0"
"Kane","139","2498","Illinois","5/7/20","1526","972","17089","63.7"
"Kankakee","13","428","Illinois","5/7/20","338","90","17091","26.63"
"Kendall","14","363","Illinois","5/7/20","266","97","17093","36.47"
"Knox","2","63","Illinois","5/7/20","46","17","17095","36.96"
"Lake","179","4762","Illinois","5/7/20","3509","1253","17097","35.71"
"LaSalle","5","91","Illinois","5/7/20","53","38","17099","71.7"
"Lawrence","0","3","Illinois","5/7/20","3","0","17101","0"
"Lee","4","51","Illinois","5/7/20","24","27","17103","112.5"
"Livingston","1","24","Illinois","5/7/20","20","4","17105","20"
"Logan","0","7","Illinois","5/7/20","7","0","17107","0"
"Macon","4","133","Illinois","5/7/20","106","27","17115","25.47"
"Macoupin","1","39","Illinois","5/7/20","30","9","17117","30"
"Madison","9","396","Illinois","5/7/20","333","63","17119","18.92"
"Marion","1","40","Illinois","5/7/20","33","7","17121","21.21"
"Marshall","0","4","Illinois","5/7/20","4","0","17123","0"
"Mason","0","15","Illinois","5/7/20","12","3","17125","25"
"Massac","0","5","Illinois","5/7/20","4","1","17127","25"
"McDonough","4","46","Illinois","5/7/20","18","28","17109","155.56"
"McHenry","34","857","Illinois","5/7/20","621","236","17111","38"
"McLean","2","110","Illinois","5/7/20","95","15","17113","15.79"
"Menard","1","17","Illinois","5/7/20","8","9","17129","112.5"
"Mercer","0","11","Illinois","5/7/20","8","3","17131","37.5"
"Monroe","1","77","Illinois","5/7/20","70","7","17133","10"
"Montgomery","1","33","Illinois","5/7/20","26","7","17135","26.92"
"Morgan","1","27","Illinois","5/7/20","22","5","17137","22.73"
"Moultrie","0","6","Illinois","5/7/20","5","1","17139","20"
"Ogle","3","139","Illinois","5/7/20","119","20","17141","16.81"
"Out of IL","10","71","Illinois","5/7/20","0","71","80017","1"
"Peoria","6","130","Illinois","5/7/20","86","44","17143","51.16"
"Perry","2","36","Illinois","5/7/20","21","15","17145","71.43"
"Piatt","0","7","Illinois","5/7/20","7","0","17147","0"
"Pike","0","1","Illinois","5/7/20","1","0","17149","0"
"Pulaski","1","24","Illinois","5/7/20","18","6","17153","33.33"
"Randolph","7","206","Illinois","5/7/20","156","50","17157","32.05"
"Richland","0","3","Illinois","5/7/20","3","0","17159","0"
"Rock Island","14","477","Illinois","5/7/20","377","100","17161","26.53"
"Saline","0","5","Illinois","5/7/20","3","2","17165","66.67"
"Sangamon","8","237","Illinois","5/7/20","178","59","17167","33.15"
"Schuyler","0","3","Illinois","5/7/20","2","1","17169","50"
"Shelby","0","10","Illinois","5/7/20","10","0","17173","0"
"St. Clair","21","623","Illinois","5/7/20","475","148","17163","31.16"
"Stark","0","1","Illinois","5/7/20","1","0","17175","0"
"Stephenson","6","78","Illinois","5/7/20","35","43","17177","122.86"
"Tazewell","1","54","Illinois","5/7/20","45","9","17179","20"
"Union","5","52","Illinois","5/7/20","17","35","17181","205.88"
"Vermilion","1","23","Illinois","5/7/20","17","6","17183","35.29"
"Wabash","0","1","Illinois","5/7/20","1","0","17185","0"
"Warren","4","92","Illinois","5/7/20","62","30","17187","48.39"
"Washington","1","14","Illinois","5/7/20","10","4","17189","40"
"Wayne","0","2","Illinois","5/7/20","2","0","17191","0"
"White","0","2","Illinois","5/7/20","2","0","17193","0"
"Whiteside","2","99","Illinois","5/7/20","84","15","17195","17.86"
"Will","135","3434","Illinois","5/7/20","2492","942","17197","37.8"
"Williamson","2","42","Illinois","5/7/20","31","11","17199","35.48"
"Winnebago","45","759","Illinois","5/7/20","442","317","17201","71.72"
"Woodford","0","15","Illinois","5/7/20","13","2","17203","15.38"
"Adams","0","8","Indiana","5/7/20","7","1","18001","14.29"
"Allen","26","743","Indiana","5/7/20","560","183","18003","32.68"
"Bartholomew","9","316","Indiana","5/7/20","250","66","18005","26.4"
"Benton","1","12","Indiana","5/7/20","8","4","18007","50"
"Blackford","1","12","Indiana","5/7/20","8","4","18009","50"
"Boone","3","211","Indiana","5/7/20","190","21","18011","11.05"
"Brown","1","25","Indiana","5/7/20","15","10","18013","66.67"
"Carroll","6","66","Indiana","5/7/20","22","44","18015","200"
"Cass","44","1469","Indiana","5/7/20","1164","305","18017","26.2"
"Clark","9","355","Indiana","5/7/20","293","62","18019","21.16"
"Clay","0","23","Indiana","5/7/20","20","3","18021","15"
"Clinton","5","75","Indiana","5/7/20","38","37","18023","97.37"
"Crawford","0","20","Indiana","5/7/20","18","2","18025","11.11"
"Daviess","1","54","Indiana","5/7/20","47","7","18027","14.89"
"Dearborn","6","145","Indiana","5/7/20","104","41","18029","39.42"
"Decatur","1","208","Indiana","5/7/20","200","8","18031","4"
"DeKalb","0","23","Indiana","5/7/20","20","3","18033","15"
"Delaware","5","213","Indiana","5/7/20","176","37","18035","21.02"
"Dubois","2","35","Indiana","5/7/20","23","12","18037","52.17"
"Elkhart","14","387","Indiana","5/7/20","287","100","18039","34.84"
"Fayette","1","34","Indiana","5/7/20","28","6","18041","21.43"
"Floyd","7","224","Indiana","5/7/20","178","46","18043","25.84"
"Fountain","0","14","Indiana","5/7/20","11","3","18045","27.27"
"Franklin","1","101","Indiana","5/7/20","97","4","18047","4.12"
"Fulton","1","34","Indiana","5/7/20","27","7","18049","25.93"
"Gibson","0","7","Indiana","5/7/20","7","0","18051","0"
"Grant","3","151","Indiana","5/7/20","129","22","18053","17.05"
"Greene","11","132","Indiana","5/7/20","56","76","18055","135.71"
"Hamilton","20","894","Indiana","5/7/20","755","139","18057","18.41"
"Hancock","3","241","Indiana","5/7/20","218","23","18059","10.55"
"Harrison","3","150","Indiana","5/7/20","129","21","18061","16.28"
"Hendricks","32","893","Indiana","5/7/20","667","226","18063","33.88"
"Henry","3","59","Indiana","5/7/20","39","20","18065","51.28"
"Howard","8","225","Indiana","5/7/20","172","53","18067","30.81"
"Huntington","0","12","Indiana","5/7/20","9","3","18069","33.33"
"Jackson","12","219","Indiana","5/7/20","138","81","18071","58.7"
"Jasper","-1","37","Indiana","5/7/20","46","-9","18073","-19.57"
"Jay","0","18","Indiana","5/7/20","15","3","18075","20"
"Jefferson","1","32","Indiana","5/7/20","26","6","18077","23.08"
"Jennings","2","89","Indiana","5/7/20","75","14","18079","18.67"
"Johnson","25","754","Indiana","5/7/20","579","175","18081","30.22"
"Knox","0","20","Indiana","5/7/20","20","0","18083","0"
"Kosciusko","1","39","Indiana","5/7/20","34","5","18085","14.71"
"LaGrange","2","36","Indiana","5/7/20","25","11","18087","44"
"Lake","63","2288","Indiana","5/7/20","1846","442","18089","23.94"
"LaPorte","12","303","Indiana","5/7/20","218","85","18091","38.99"
"Lawrence","2","112","Indiana","5/7/20","99","13","18093","13.13"
"Madison","8","474","Indiana","5/7/20","420","54","18095","12.86"
"Marion","198","6914","Indiana","5/7/20","5530","1384","18097","25.03"
"Marshall","0","31","Indiana","5/7/20","29","2","18099","6.9"
"Martin","0","7","Indiana","5/7/20","7","0","18101","0"
"Miami","2","121","Indiana","5/7/20","104","17","18103","16.35"
"Monroe","2","137","Indiana","5/7/20","123","14","18105","11.38"
"Montgomery","6","111","Indiana","5/7/20","67","44","18107","65.67"
"Morgan","4","183","Indiana","5/7/20","152","31","18109","20.39"
"Newton","2","61","Indiana","5/7/20","46","15","18111","32.61"
"Noble","8","124","Indiana","5/7/20","69","55","18113","79.71"
"Ohio","0","7","Indiana","5/7/20","4","3","18115","75"
"Orange","4","106","Indiana","5/7/20","76","30","18117","39.47"
"Owen","0","24","Indiana","5/7/20","23","1","18119","4.35"
"Parke","0","13","Indiana","5/7/20","12","1","18121","8.33"
"Perry","0","13","Indiana","5/7/20","10","3","18123","30"
"Pike","0","2","Indiana","5/7/20","1","1","18125","100"
"Porter","8","294","Indiana","5/7/20","238","56","18127","23.53"
"Posey","1","15","Indiana","5/7/20","11","4","18129","36.36"
"Pulaski","1","33","Indiana","5/7/20","23","10","18131","43.48"
"Putnam","2","79","Indiana","5/7/20","66","13","18133","19.7"
"Randolph","0","18","Indiana","5/7/20","15","3","18135","20"
"Ripley","1","98","Indiana","5/7/20","92","6","18137","6.52"
"Rush","1","37","Indiana","5/7/20","31","6","18139","19.35"
"Scott","2","63","Indiana","5/7/20","46","17","18143","36.96"
"Shelby","6","243","Indiana","5/7/20","201","42","18145","20.9"
"Spencer","0","6","Indiana","5/7/20","5","1","18147","20"
"St. Joseph","14","730","Indiana","5/7/20","633","97","18141","15.32"
"Starke","0","19","Indiana","5/7/20","16","3","18149","18.75"
"Steuben","5","61","Indiana","5/7/20","23","38","18151","165.22"
"Sullivan","0","18","Indiana","5/7/20","16","2","18153","12.5"
"Switzerland","0","15","Indiana","5/7/20","15","0","18155","0"
"Tippecanoe","13","202","Indiana","5/7/20","110","92","18157","83.64"
"Tipton","0","20","Indiana","5/7/20","18","2","18159","11.11"
"Union","0","8","Indiana","5/7/20","7","1","18161","14.29"
"Vanderburgh","5","169","Indiana","5/7/20","135","34","18163","25.19"
"Vermillion","0","7","Indiana","5/7/20","7","0","18165","0"
"Vigo","2","75","Indiana","5/7/20","64","11","18167","17.19"
"Wabash","3","64","Indiana","5/7/20","42","22","18169","52.38"
"Warren","0","12","Indiana","5/7/20","11","1","18171","9.09"
"Warrick","3","116","Indiana","5/7/20","96","20","18173","20.83"
"Washington","0","45","Indiana","5/7/20","43","2","18175","4.65"
"Wayne","2","49","Indiana","5/7/20","34","15","18177","44.12"
"Wells","1","9","Indiana","5/7/20","5","4","18179","80"
"White","12","130","Indiana","5/7/20","47","83","18181","176.6"
"Whitley","0","22","Indiana","5/7/20","19","3","18183","15.79"
"Adair","0","3","Iowa","5/7/20","1","2","19001","200"
"Allamakee","1","99","Iowa","5/7/20","89","10","19005","11.24"
"Appanoose","1","6","Iowa","5/7/20","2","4","19007","200"
"Audubon","1","8","Iowa","5/7/20","1","7","19009","700"
"Benton","1","35","Iowa","5/7/20","31","4","19011","12.9"
"Black Hawk","44","1450","Iowa","5/7/20","1140","310","19013","27.19"
"Boone","3","33","Iowa","5/7/20","12","21","19015","175"
"Bremer","1","56","Iowa","5/7/20","51","5","19017","9.8"
"Buchanan","1","22","Iowa","5/7/20","17","5","19019","29.41"
"Buena Vista","2","18","Iowa","5/7/20","4","14","19021","350"
"Butler","0","11","Iowa","5/7/20","9","2","19023","22.22"
"Calhoun","0","1","Iowa","5/7/20","0","1","19025","1"
"Carroll","0","5","Iowa","5/7/20","2","3","19027","150"
"Cass","0","1","Iowa","5/7/20","1","0","19029","0"
"Cedar","1","39","Iowa","5/7/20","29","10","19031","34.48"
"Cerro Gordo","0","14","Iowa","5/7/20","14","0","19033","0"
"Cherokee","0","4","Iowa","5/7/20","2","2","19035","100"
"Chickasaw","0","6","Iowa","5/7/20","5","1","19037","20"
"Clarke","0","4","Iowa","5/7/20","2","2","19039","100"
"Clay","1","8","Iowa","5/7/20","4","4","19041","100"
"Clayton","1","19","Iowa","5/7/20","14","5","19043","35.71"
"Clinton","1","53","Iowa","5/7/20","48","5","19045","10.42"
"Crawford","15","124","Iowa","5/7/20","21","103","19047","490.48"
"Dallas","47","644","Iowa","5/7/20","318","326","19049","102.52"
"Davis","1","7","Iowa","5/7/20","1","6","19051","600"
"Delaware","0","8","Iowa","5/7/20","8","0","19055","0"
"Des Moines","2","29","Iowa","5/7/20","16","13","19057","81.25"
"Dickinson","0","6","Iowa","5/7/20","6","0","19059","0"
"Dubuque","10","175","Iowa","5/7/20","102","73","19061","71.57"
"Fayette","1","24","Iowa","5/7/20","20","4","19065","20"
"Floyd","0","2","Iowa","5/7/20","0","2","19067","1"
"Franklin","1","7","Iowa","5/7/20","2","5","19069","250"
"Greene","1","13","Iowa","5/7/20","5","8","19073","160"
"Grundy","1","16","Iowa","5/7/20","11","5","19075","45.45"
"Guthrie","3","32","Iowa","5/7/20","12","20","19077","166.67"
"Hamilton","0","9","Iowa","5/7/20","7","2","19079","28.57"
"Hancock","0","3","Iowa","5/7/20","3","0","19081","0"
"Hardin","0","11","Iowa","5/7/20","8","3","19083","37.5"
"Harrison","0","17","Iowa","5/7/20","16","1","19085","6.25"
"Henry","1","42","Iowa","5/7/20","32","10","19087","31.25"
"Howard","0","13","Iowa","5/7/20","10","3","19089","30"
"Humboldt","0","6","Iowa","5/7/20","4","2","19091","50"
"Iowa","1","26","Iowa","5/7/20","19","7","19095","36.84"
"Jackson","0","7","Iowa","5/7/20","5","2","19097","40"
"Jasper","14","229","Iowa","5/7/20","130","99","19099","76.15"
"Jefferson","0","6","Iowa","5/7/20","6","0","19101","0"
"Johnson","12","543","Iowa","5/7/20","461","82","19103","17.79"
"Jones","1","30","Iowa","5/7/20","21","9","19105","42.86"
"Keokuk","1","6","Iowa","5/7/20","2","4","19107","200"
"Kossuth","0","2","Iowa","5/7/20","2","0","19109","0"
"Lee","1","17","Iowa","5/7/20","8","9","19111","112.5"
"Linn","19","805","Iowa","5/7/20","669","136","19113","20.33"
"Louisa","2","280","Iowa","5/7/20","269","11","19115","4.09"
"Lyon","0","15","Iowa","5/7/20","13","2","19119","15.38"
"Madison","1","10","Iowa","5/7/20","5","5","19121","100"
"Mahaska","1","20","Iowa","5/7/20","10","10","19123","100"
"Marion","1","12","Iowa","5/7/20","8","4","19125","50"
"Marshall","31","686","Iowa","5/7/20","467","219","19127","46.9"
"Mills","0","5","Iowa","5/7/20","2","3","19129","150"
"Mitchell","0","3","Iowa","5/7/20","2","1","19131","50"
"Monona","1","11","Iowa","5/7/20","7","4","19133","57.14"
"Monroe","0","2","Iowa","5/7/20","0","2","19135","1"
"Montgomery","0","2","Iowa","5/7/20","1","1","19137","100"
"Muscatine","15","441","Iowa","5/7/20","336","105","19139","31.25"
"O'Brien","1","13","Iowa","5/7/20","8","5","19141","62.5"
"Osceola","1","17","Iowa","5/7/20","9","8","19143","88.89"
"Page","0","9","Iowa","5/7/20","6","3","19145","50"
"Plymouth","5","44","Iowa","5/7/20","12","32","19149","266.67"
"Pocahontas","0","3","Iowa","5/7/20","1","2","19151","200"
"Polk","153","2053","Iowa","5/7/20","985","1068","19153","108.43"
"Pottawattamie","5","71","Iowa","5/7/20","33","38","19155","115.15"
"Poweshiek","3","78","Iowa","5/7/20","56","22","19157","39.29"
"Sac","0","2","Iowa","5/7/20","0","2","19161","1"
"Scott","7","274","Iowa","5/7/20","226","48","19163","21.24"
"Shelby","1","13","Iowa","5/7/20","9","4","19165","44.44"
"Sioux","3","31","Iowa","5/7/20","9","22","19167","244.44"
"Story","4","52","Iowa","5/7/20","27","25","19169","92.59"
"Tama","8","321","Iowa","5/7/20","266","55","19171","20.68"
"Taylor","0","1","Iowa","5/7/20","1","0","19173","0"
"Union","0","1","Iowa","5/7/20","1","0","19175","0"
"Van Buren","0","8","Iowa","5/7/20","8","0","19177","0"
"Wapello","22","165","Iowa","5/7/20","10","155","19179","1550"
"Warren","2","35","Iowa","5/7/20","22","13","19181","59.09"
"Washington","2","154","Iowa","5/7/20","141","13","19183","9.22"
"Wayne","0","1","Iowa","5/7/20","0","1","19185","1"
"Webster","0","8","Iowa","5/7/20","5","3","19187","60"
"Winnebago","0","3","Iowa","5/7/20","2","1","19189","50"
"Winneshiek","0","18","Iowa","5/7/20","15","3","19191","20"
"Woodbury","98","1429","Iowa","5/7/20","742","687","19193","92.59"
"Worth","0","1","Iowa","5/7/20","1","0","19195","0"
"Wright","0","5","Iowa","5/7/20","3","2","19197","66.67"
"Atchison","0","12","Kansas","5/7/20","9","3","20005","33.33"
"Barber","0","1","Kansas","5/7/20","1","0","20007","0"
"Barton","0","12","Kansas","5/7/20","9","3","20009","33.33"
"Bourbon","0","6","Kansas","5/7/20","6","0","20011","0"
"Brown","0","1","Kansas","5/7/20","0","1","20013","1"
"Butler","0","14","Kansas","5/7/20","16","-2","20015","-12.5"
"Chase","0","3","Kansas","5/7/20","3","0","20017","0"
"Chautauqua","0","4","Kansas","5/7/20","4","0","20019","0"
"Cherokee","0","8","Kansas","5/7/20","8","0","20021","0"
"Cheyenne","0","2","Kansas","5/7/20","2","0","20023","0"
"Clark","2","17","Kansas","5/7/20","1","16","20025","1600"
"Clay","0","4","Kansas","5/7/20","4","0","20027","0"
"Cloud","0","4","Kansas","5/7/20","4","0","20029","0"
"Coffey","0","50","Kansas","5/7/20","48","2","20031","4.17"
"Cowley","0","3","Kansas","5/7/20","3","0","20035","0"
"Crawford","0","8","Kansas","5/7/20","8","0","20037","0"
"Dickinson","0","2","Kansas","5/7/20","2","0","20041","0"
"Doniphan","1","7","Kansas","5/7/20","3","4","20043","133.33"
"Douglas","1","56","Kansas","5/7/20","50","6","20045","12"
"Edwards","0","4","Kansas","5/7/20","3","1","20047","33.33"
"Elk","0","0","Kansas","5/7/20","1","-1","20049","-100"
"Ellis","0","8","Kansas","5/7/20","8","0","20051","0"
"Ellsworth","0","1","Kansas","5/7/20","0","1","20053","1"
"Finney","55","791","Kansas","5/7/20","404","387","20055","95.79"
"Ford","36","930","Kansas","5/7/20","675","255","20057","37.78"
"Franklin","1","20","Kansas","5/7/20","14","6","20059","42.86"
"Geary","0","13","Kansas","5/7/20","11","2","20061","18.18"
"Gove","0","1","Kansas","5/7/20","1","0","20063","0"
"Grant","1","8","Kansas","5/7/20","4","4","20067","100"
"Gray","0","6","Kansas","5/7/20","4","2","20069","50"
"Greenwood","0","3","Kansas","5/7/20","3","0","20073","0"
"Hamilton","0","5","Kansas","5/7/20","2","3","20075","150"
"Harper","0","1","Kansas","5/7/20","1","0","20077","0"
"Harvey","0","9","Kansas","5/7/20","7","2","20079","28.57"
"Haskell","0","9","Kansas","5/7/20","7","2","20081","28.57"
"Jackson","0","2","Kansas","5/7/20","2","0","20085","0"
"Jefferson","0","12","Kansas","5/7/20","9","3","20087","33.33"
"Jewell","0","4","Kansas","5/7/20","4","0","20089","0"
"Johnson","13","553","Kansas","5/7/20","464","89","20091","19.18"
"Kearny","1","26","Kansas","5/7/20","16","10","20093","62.5"
"Kiowa","0","2","Kansas","5/7/20","1","1","20097","100"
"Labette","0","22","Kansas","5/7/20","22","0","20099","0"
"Leavenworth","76","885","Kansas","5/7/20","356","529","20103","148.6"
"Linn","0","6","Kansas","5/7/20","6","0","20107","0"
"Lyon","9","282","Kansas","5/7/20","218","64","20111","29.36"
"Marion","0","5","Kansas","5/7/20","5","0","20115","0"
"McPherson","0","25","Kansas","5/7/20","22","3","20113","13.64"
"Meade","2","16","Kansas","5/7/20","5","11","20119","220"
"Miami","0","5","Kansas","5/7/20","5","0","20121","0"
"Mitchell","0","3","Kansas","5/7/20","3","0","20123","0"
"Montgomery","0","20","Kansas","5/7/20","17","3","20125","17.65"
"Morris","0","3","Kansas","5/7/20","3","0","20127","0"
"Morton","0","3","Kansas","5/7/20","3","0","20129","0"
"Nemaha","0","1","Kansas","5/7/20","1","0","20131","0"
"Neosho","0","2","Kansas","5/7/20","2","0","20133","0"
"Norton","0","2","Kansas","5/7/20","0","2","20137","1"
"Osage","0","5","Kansas","5/7/20","5","0","20139","0"
"Osborne","0","2","Kansas","5/7/20","2","0","20141","0"
"Ottawa","0","4","Kansas","5/7/20","4","0","20143","0"
"Phillips","0","1","Kansas","5/7/20","1","0","20147","0"
"Pottawatomie","0","15","Kansas","5/7/20","13","2","20149","15.38"
"Pratt","0","1","Kansas","5/7/20","1","0","20151","0"
"Reno","1","41","Kansas","5/7/20","36","5","20155","13.89"
"Republic","0","4","Kansas","5/7/20","4","0","20157","0"
"Rice","0","3","Kansas","5/7/20","3","0","20159","0"
"Riley","1","56","Kansas","5/7/20","49","7","20161","14.29"
"Rooks","0","6","Kansas","5/7/20","6","0","20163","0"
"Saline","0","21","Kansas","5/7/20","21","0","20169","0"
"Scott","0","2","Kansas","5/7/20","0","2","20171","1"
"Sedgwick","7","454","Kansas","5/7/20","402","52","20173","12.94"
"Seward","20","664","Kansas","5/7/20","527","137","20175","26"
"Shawnee","3","140","Kansas","5/7/20","117","23","20177","19.66"
"Sheridan","0","2","Kansas","5/7/20","2","0","20179","0"
"Sherman","0","5","Kansas","5/7/20","4","1","20181","25"
"Smith","0","2","Kansas","5/7/20","2","0","20183","0"
"Stafford","0","1","Kansas","5/7/20","1","0","20185","0"
"Stanton","0","7","Kansas","5/7/20","6","1","20187","16.67"
"Stevens","1","14","Kansas","5/7/20","9","5","20189","55.56"
"Sumner","0","4","Kansas","5/7/20","3","1","20191","33.33"
"Wabaunsee","1","27","Kansas","5/7/20","21","6","20197","28.57"
"Washington","0","0","Kansas","5/7/20","1","-1","20201","-100"
"Wilson","0","1","Kansas","5/7/20","1","0","20205","0"
"Woodson","0","6","Kansas","5/7/20","5","1","20207","20"
"Wyandotte","38","942","Kansas","5/7/20","677","265","20209","39.14"
"Adair","0","84","Kentucky","5/7/20","81","3","21001","3.7"
"Allen","2","25","Kentucky","5/7/20","13","12","21003","92.31"
"Anderson","0","9","Kentucky","5/7/20","8","1","21005","12.5"
"Ballard","0","8","Kentucky","5/7/20","9","-1","21007","-11.11"
"Barren","1","24","Kentucky","5/7/20","17","7","21009","41.18"
"Bath","0","4","Kentucky","5/7/20","4","0","21011","0"
"Boone","8","197","Kentucky","5/7/20","138","59","21015","42.75"
"Bourbon","0","8","Kentucky","5/7/20","8","0","21017","0"
"Boyd","0","32","Kentucky","5/7/20","31","1","21019","3.23"
"Boyle","0","16","Kentucky","5/7/20","17","-1","21021","-5.88"
"Bracken","0","10","Kentucky","5/7/20","7","3","21023","42.86"
"Breathitt","0","2","Kentucky","5/7/20","2","0","21025","0"
"Breckinridge","0","11","Kentucky","5/7/20","9","2","21027","22.22"
"Bullitt","3","74","Kentucky","5/7/20","53","21","21029","39.62"
"Butler","10","188","Kentucky","5/7/20","116","72","21031","62.07"
"Caldwell","0","12","Kentucky","5/7/20","13","-1","21033","-7.69"
"Calloway","0","35","Kentucky","5/7/20","34","1","21035","2.94"
"Campbell","3","110","Kentucky","5/7/20","89","21","21037","23.6"
"Carlisle","0","2","Kentucky","5/7/20","2","0","21039","0"
"Carroll","0","2","Kentucky","5/7/20","2","0","21041","0"
"Carter","0","6","Kentucky","5/7/20","5","1","21043","20"
"Casey","0","1","Kentucky","5/7/20","1","0","21045","0"
"Christian","1","92","Kentucky","5/7/20","86","6","21047","6.98"
"Clark","0","20","Kentucky","5/7/20","21","-1","21049","-4.76"
"Clay","0","1","Kentucky","5/7/20","1","0","21051","0"
"Clinton","0","3","Kentucky","5/7/20","3","0","21053","0"
"Crittenden","0","4","Kentucky","5/7/20","4","0","21055","0"
"Cumberland","0","5","Kentucky","5/7/20","5","0","21057","0"
"Daviess","10","258","Kentucky","5/7/20","188","70","21059","37.23"
"Edmonson","2","41","Kentucky","5/7/20","26","15","21061","57.69"
"Fayette","11","328","Kentucky","5/7/20","248","80","21067","32.26"
"Fleming","0","2","Kentucky","5/7/20","2","0","21069","0"
"Floyd","0","13","Kentucky","5/7/20","13","0","21071","0"
"Franklin","0","16","Kentucky","5/7/20","16","0","21073","0"
"Fulton","0","1","Kentucky","5/7/20","2","-1","21075","-50"
"Gallatin","0","1","Kentucky","5/7/20","1","0","21077","0"
"Garrard","0","2","Kentucky","5/7/20","2","0","21079","0"
"Grant","1","27","Kentucky","5/7/20","21","6","21081","28.57"
"Graves","2","145","Kentucky","5/7/20","131","14","21083","10.69"
"Grayson","4","93","Kentucky","5/7/20","65","28","21085","43.08"
"Green","0","1","Kentucky","5/7/20","1","0","21087","0"
"Greenup","0","12","Kentucky","5/7/20","11","1","21089","9.09"
"Hancock","0","6","Kentucky","5/7/20","6","0","21091","0"
"Hardin","2","56","Kentucky","5/7/20","40","16","21093","40"
"Harlan","0","1","Kentucky","5/7/20","0","1","21095","1"
"Harrison","0","18","Kentucky","5/7/20","17","1","21097","5.88"
"Hart","1","8","Kentucky","5/7/20","3","5","21099","166.67"
"Henderson","2","75","Kentucky","5/7/20","58","17","21101","29.31"
"Henry","0","8","Kentucky","5/7/20","6","2","21103","33.33"
"Hickman","1","5","Kentucky","5/7/20","1","4","21105","400"
"Hopkins","2","212","Kentucky","5/7/20","196","16","21107","8.16"
"Jackson","0","60","Kentucky","5/7/20","59","1","21109","1.69"
"Jefferson","39","1578","Kentucky","5/7/20","1307","271","21111","20.73"
"Jessamine","0","40","Kentucky","5/7/20","41","-1","21113","-2.44"
"Johnson","0","4","Kentucky","5/7/20","3","1","21115","33.33"
"Kenton","12","360","Kentucky","5/7/20","276","84","21117","30.43"
"Knott","0","4","Kentucky","5/7/20","4","0","21119","0"
"Knox","0","6","Kentucky","5/7/20","6","0","21121","0"
"Larue","0","6","Kentucky","5/7/20","5","1","21123","20"
"Laurel","0","20","Kentucky","5/7/20","17","3","21125","17.65"
"Lawrence","0","1","Kentucky","5/7/20","1","0","21127","0"
"Leslie","0","4","Kentucky","5/7/20","4","0","21131","0"
"Letcher","0","3","Kentucky","5/7/20","2","1","21133","50"
"Lewis","0","3","Kentucky","5/7/20","3","0","21135","0"
"Lincoln","0","6","Kentucky","5/7/20","5","1","21137","20"
"Livingston","0","6","Kentucky","5/7/20","4","2","21139","50"
"Logan","2","24","Kentucky","5/7/20","10","14","21141","140"
"Lyon","0","13","Kentucky","5/7/20","13","0","21143","0"
"Madison","1","33","Kentucky","5/7/20","28","5","21151","17.86"
"Marion","0","17","Kentucky","5/7/20","16","1","21155","6.25"
"Marshall","0","33","Kentucky","5/7/20","34","-1","21157","-2.94"
"Martin","0","3","Kentucky","5/7/20","3","0","21159","0"
"Mason","0","6","Kentucky","5/7/20","6","0","21161","0"
"McCracken","2","68","Kentucky","5/7/20","55","13","21145","23.64"
"McCreary","0","11","Kentucky","5/7/20","11","0","21147","0"
"McLean","0","16","Kentucky","5/7/20","15","1","21149","6.67"
"Meade","1","17","Kentucky","5/7/20","12","5","21163","41.67"
"Menifee","0","3","Kentucky","5/7/20","3","0","21165","0"
"Mercer","0","10","Kentucky","5/7/20","11","-1","21167","-9.09"
"Metcalfe","0","2","Kentucky","5/7/20","1","1","21169","100"
"Monroe","0","6","Kentucky","5/7/20","5","1","21171","20"
"Montgomery","0","11","Kentucky","5/7/20","11","0","21173","0"
"Morgan","0","1","Kentucky","5/7/20","1","0","21175","0"
"Muhlenberg","46","446","Kentucky","5/7/20","123","323","21177","262.6"
"Nelson","1","28","Kentucky","5/7/20","22","6","21179","27.27"
"Nicholas","0","1","Kentucky","5/7/20","1","0","21181","0"
"Ohio","4","65","Kentucky","5/7/20","39","26","21183","66.67"
"Oldham","1","36","Kentucky","5/7/20","29","7","21185","24.14"
"Owen","0","1","Kentucky","5/7/20","1","0","21187","0"
"Owsley","0","2","Kentucky","5/7/20","2","0","21189","0"
"Pendleton","0","5","Kentucky","5/7/20","6","-1","21191","-16.67"
"Perry","0","14","Kentucky","5/7/20","12","2","21193","16.67"
"Pike","1","15","Kentucky","5/7/20","11","4","21195","36.36"
"Powell","0","1","Kentucky","5/7/20","1","0","21197","0"
"Pulaski","0","43","Kentucky","5/7/20","43","0","21199","0"
"Rockcastle","0","13","Kentucky","5/7/20","11","2","21203","18.18"
"Rowan","0","2","Kentucky","5/7/20","2","0","21205","0"
"Russell","0","17","Kentucky","5/7/20","16","1","21207","6.25"
"Scott","1","32","Kentucky","5/7/20","24","8","21209","33.33"
"Shelby","1","35","Kentucky","5/7/20","30","5","21211","16.67"
"Simpson","1","32","Kentucky","5/7/20","27","5","21213","18.52"
"Spencer","0","16","Kentucky","5/7/20","13","3","21215","23.08"
"Taylor","0","9","Kentucky","5/7/20","8","1","21217","12.5"
"Todd","0","13","Kentucky","5/7/20","12","1","21219","8.33"
"Trigg","0","9","Kentucky","5/7/20","9","0","21221","0"
"Trimble","0","3","Kentucky","5/7/20","3","0","21223","0"
"Union","0","10","Kentucky","5/7/20","8","2","21225","25"
"Warren","22","486","Kentucky","5/7/20","332","154","21227","46.39"
"Washington","0","5","Kentucky","5/7/20","5","0","21229","0"
"Wayne","0","8","Kentucky","5/7/20","9","-1","21231","-11.11"
"Webster","1","27","Kentucky","5/7/20","22","5","21233","22.73"
"Whitley","0","11","Kentucky","5/7/20","11","0","21235","0"
"Woodford","0","17","Kentucky","5/7/20","18","-1","21239","-5.56"
"Acadia","2","142","Louisiana","5/7/20","130","12","22001","9.23"
"Allen","0","90","Louisiana","5/7/20","90","0","22003","0"
"Ascension","11","672","Louisiana","5/7/20","593","79","22005","13.32"
"Assumption","3","206","Louisiana","5/7/20","182","24","22007","13.19"
"Avoyelles","0","74","Louisiana","5/7/20","71","3","22009","4.23"
"Beauregard","1","44","Louisiana","5/7/20","39","5","22011","12.82"
"Bienville","0","78","Louisiana","5/7/20","77","1","22013","1.3"
"Bossier","3","307","Louisiana","5/7/20","286","21","22015","7.34"
"Caddo","21","1690","Louisiana","5/7/20","1540","150","22017","9.74"
"Calcasieu","13","478","Louisiana","5/7/20","389","89","22019","22.88"
"Caldwell","3","41","Louisiana","5/7/20","18","23","22021","127.78"
"Cameron","0","3","Louisiana","5/7/20","3","0","22023","0"
"Catahoula","1","46","Louisiana","5/7/20","36","10","22025","27.78"
"Claiborne","0","58","Louisiana","5/7/20","59","-1","22027","-1.69"
"Concordia","1","42","Louisiana","5/7/20","38","4","22029","10.53"
"De Soto","2","207","Louisiana","5/7/20","190","17","22031","8.95"
"East Baton Rouge","55","2256","Louisiana","5/7/20","1874","382","22033","20.38"
"East Carroll","1","14","Louisiana","5/7/20","9","5","22035","55.56"
"East Feliciana","1","132","Louisiana","5/7/20","122","10","22037","8.2"
"Evangeline","2","64","Louisiana","5/7/20","49","15","22039","30.61"
"Franklin","3","145","Louisiana","5/7/20","125","20","22041","16"
"Grant","1","17","Louisiana","5/7/20","13","4","22043","30.77"
"Iberia","3","281","Louisiana","5/7/20","257","24","22045","9.34"
"Iberville","6","492","Louisiana","5/7/20","450","42","22047","9.33"
"Jackson","3","57","Louisiana","5/7/20","34","23","22049","67.65"
"Jefferson","56","6588","Louisiana","5/7/20","6197","391","22051","6.31"
"Jefferson Davis","1","66","Louisiana","5/7/20","62","4","22053","6.45"
"Lafayette","3","479","Louisiana","5/7/20","455","24","22055","5.27"
"Lafourche","6","693","Louisiana","5/7/20","651","42","22057","6.45"
"LaSalle","1","30","Louisiana","5/7/20","23","7","22059","30.43"
"Lincoln","2","101","Louisiana","5/7/20","85","16","22061","18.82"
"Livingston","10","268","Louisiana","5/7/20","197","71","22063","36.04"
"Madison","0","8","Louisiana","5/7/20","7","1","22065","14.29"
"Morehouse","1","57","Louisiana","5/7/20","52","5","22067","9.62"
"Natchitoches","1","91","Louisiana","5/7/20","84","7","22069","8.33"
"Orleans","25","6626","Louisiana","5/7/20","6452","174","22071","2.7"
"Ouachita","15","814","Louisiana","5/7/20","706","108","22073","15.3"
"Plaquemines","1","185","Louisiana","5/7/20","177","8","22075","4.52"
"Pointe Coupee","3","120","Louisiana","5/7/20","99","21","22077","21.21"
"Rapides","7","316","Louisiana","5/7/20","265","51","22079","19.25"
"Red River","1","34","Louisiana","5/7/20","25","9","22081","36"
"Richland","5","91","Louisiana","5/7/20","58","33","22083","56.9"
"Sabine","0","17","Louisiana","5/7/20","17","0","22085","0"
"St. Bernard","6","508","Louisiana","5/7/20","464","44","22087","9.48"
"St. Charles","3","594","Louisiana","5/7/20","570","24","22089","4.21"
"St. Helena","1","32","Louisiana","5/7/20","28","4","22091","14.29"
"St. James","1","256","Louisiana","5/7/20","246","10","22093","4.07"
"St. John the Baptist","3","791","Louisiana","5/7/20","768","23","22095","2.99"
"St. Landry","3","203","Louisiana","5/7/20","180","23","22097","12.78"
"St. Martin","3","254","Louisiana","5/7/20","232","22","22099","9.48"
"St. Mary","4","222","Louisiana","5/7/20","191","31","22101","16.23"
"St. Tammany","28","1415","Louisiana","5/7/20","1220","195","22103","15.98"
"Tangipahoa","12","635","Louisiana","5/7/20","553","82","22105","14.83"
"Tensas","0","3","Louisiana","5/7/20","1","2","22107","200"
"Terrebonne","9","499","Louisiana","5/7/20","437","62","22109","14.19"
"Union","5","151","Louisiana","5/7/20","117","34","22111","29.06"
"Vermilion","1","40","Louisiana","5/7/20","35","5","22113","14.29"
"Vernon","0","17","Louisiana","5/7/20","16","1","22115","6.25"
"Washington","7","308","Louisiana","5/7/20","262","46","22117","17.56"
"Webster","2","97","Louisiana","5/7/20","85","12","22119","14.12"
"West Baton Rouge","3","118","Louisiana","5/7/20","98","20","22121","20.41"
"West Carroll","0","4","Louisiana","5/7/20","4","0","22123","0"
"West Feliciana","8","174","Louisiana","5/7/20","115","59","22125","51.3"
"Winn","2","48","Louisiana","5/7/20","32","16","22127","50"
"Androscoggin","4","74","Maine","5/7/20","48","26","23001","54.17"
"Aroostook","0","6","Maine","5/7/20","5","1","23003","20"
"Cumberland","21","631","Maine","5/7/20","486","145","23005","29.84"
"Franklin","1","31","Maine","5/7/20","27","4","23007","14.81"
"Hancock","0","10","Maine","5/7/20","10","0","23009","0"
"Kennebec","0","107","Maine","5/7/20","104","3","23011","2.88"
"Knox","0","17","Maine","5/7/20","16","1","23013","6.25"
"Lincoln","0","14","Maine","5/7/20","13","1","23015","7.69"
"Oxford","0","17","Maine","5/7/20","15","2","23017","13.33"
"Penobscot","2","89","Maine","5/7/20","78","11","23019","14.1"
"Piscataquis","0","1","Maine","5/7/20","1","0","23021","0"
"Sagadahoc","0","20","Maine","5/7/20","19","1","23023","5.26"
"Somerset","0","17","Maine","5/7/20","17","0","23025","0"
"Waldo","0","49","Maine","5/7/20","48","1","23027","2.08"
"Washington","0","2","Maine","5/7/20","2","0","23029","0"
"York","5","243","Maine","5/7/20","205","38","23031","18.54"
"Allegany","4","143","Maryland","5/7/20","118","25","24001","21.19"
"Anne Arundel","67","2194","Maryland","5/7/20","1725","469","24003","27.19"
"Baltimore","119","3662","Maryland","5/7/20","2831","831","24005","29.35"
"Baltimore City","113","2856","Maryland","5/7/20","2068","788","24510","38.1"
"Calvert","5","188","Maryland","5/7/20","150","38","24009","25.33"
"Caroline","5","105","Maryland","5/7/20","71","34","24011","47.89"
"Carroll","14","534","Maryland","5/7/20","436","98","24013","22.48"
"Cecil","6","208","Maryland","5/7/20","167","41","24015","24.55"
"Charles","19","698","Maryland","5/7/20","564","134","24017","23.76"
"Dorchester","5","85","Maryland","5/7/20","51","34","24019","66.67"
"Frederick","33","1151","Maryland","5/7/20","918","233","24021","25.38"
"Garrett","0","4","Maryland","5/7/20","4","0","24023","0"
"Harford","20","552","Maryland","5/7/20","414","138","24025","33.33"
"Howard","33","1098","Maryland","5/7/20","867","231","24027","26.64"
"Kent","3","98","Maryland","5/7/20","79","19","24029","24.05"
"Montgomery","247","6032","Maryland","5/7/20","4300","1732","24031","40.28"
"Prince George's","353","8516","Maryland","5/7/20","6043","2473","24033","40.92"
"Queen Anne's","2","68","Maryland","5/7/20","52","16","24035","30.77"
"Somerset","2","40","Maryland","5/7/20","26","14","24039","53.85"
"St. Mary's","6","193","Maryland","5/7/20","150","43","24037","28.67"
"Talbot","2","52","Maryland","5/7/20","35","17","24041","48.57"
"Washington","8","260","Maryland","5/7/20","206","54","24043","26.21"
"Wicomico","19","541","Maryland","5/7/20","406","135","24045","33.25"
"Worcester","5","96","Maryland","5/7/20","61","35","24047","57.38"
"Barnstable","26","1065","Massachusetts","5/7/20","886","179","25001","20.2"
"Berkshire","4","474","Massachusetts","5/7/20","449","25","25003","5.57"
"Bristol","140","4610","Massachusetts","5/7/20","3631","979","25005","26.96"
"Dukes and Nantucket","1","37","Massachusetts","5/7/20","30","7","00000","23.33"
"Essex","286","10812","Massachusetts","5/7/20","8813","1999","25009","22.68"
"Franklin","4","291","Massachusetts","5/7/20","262","29","25011","11.07"
"Hampden","99","4512","Massachusetts","5/7/20","3819","693","25013","18.15"
"Hampshire","8","614","Massachusetts","5/7/20","560","54","25015","9.64"
"Middlesex","371","17016","Massachusetts","5/7/20","14420","2596","25017","18"
"Norfolk","132","6979","Massachusetts","5/7/20","6054","925","25021","15.28"
"Plymouth","153","6254","Massachusetts","5/7/20","5180","1074","25023","20.73"
"Suffolk","278","14996","Massachusetts","5/7/20","13051","1945","25025","14.9"
"Worcester","241","7315","Massachusetts","5/7/20","5630","1685","25027","29.93"
"Alcona","0","7","Michigan","5/7/20","7","0","26001","0"
"Allegan","5","153","Michigan","5/7/20","120","33","26005","27.5"
"Alpena","1","93","Michigan","5/7/20","89","4","26007","4.49"
"Antrim","0","11","Michigan","5/7/20","11","0","26009","0"
"Arenac","0","31","Michigan","5/7/20","28","3","26011","10.71"
"Baraga","0","1","Michigan","5/7/20","0","1","26013","1"
"Barry","1","54","Michigan","5/7/20","45","9","26015","20"
"Bay","6","210","Michigan","5/7/20","168","42","26017","25"
"Benzie","0","4","Michigan","5/7/20","6","-2","26019","-33.33"
"Berrien","16","464","Michigan","5/7/20","352","112","26021","31.82"
"Branch","1","78","Michigan","5/7/20","68","10","26023","14.71"
"Calhoun","4","283","Michigan","5/7/20","254","29","26025","11.42"
"Cass","1","47","Michigan","5/7/20","40","7","26027","17.5"
"Charlevoix","0","15","Michigan","5/7/20","14","1","26029","7.14"
"Cheboygan","0","24","Michigan","5/7/20","24","0","26031","0"
"Chippewa","0","3","Michigan","5/7/20","3","0","26033","0"
"Clare","0","12","Michigan","5/7/20","11","1","26035","9.09"
"Clinton","2","141","Michigan","5/7/20","128","13","26037","10.16"
"Crawford","0","60","Michigan","5/7/20","58","2","26039","3.45"
"Delta","0","16","Michigan","5/7/20","14","2","26041","14.29"
"Dickinson","0","4","Michigan","5/7/20","3","1","26043","33.33"
"Eaton","3","169","Michigan","5/7/20","148","21","26045","14.19"
"Emmet","0","25","Michigan","5/7/20","25","0","26047","0"
"Federal Correctional Institution (FCI)","3","106","Michigan","5/7/20","88","18","00000","20.45"
"Genesee","29","1909","Michigan","5/7/20","1704","205","26049","12.03"
"Gladwin","0","15","Michigan","5/7/20","15","0","26051","0"
"Gogebic","0","4","Michigan","5/7/20","4","0","26053","0"
"Grand Traverse","0","21","Michigan","5/7/20","20","1","26055","5"
"Gratiot","2","30","Michigan","5/7/20","15","15","26057","100"
"Hillsdale","3","148","Michigan","5/7/20","127","21","26059","16.54"
"Houghton","0","2","Michigan","5/7/20","2","0","26061","0"
"Huron","2","38","Michigan","5/7/20","24","14","26063","58.33"
"Ingham","13","579","Michigan","5/7/20","490","89","26065","18.16"
"Ionia","4","109","Michigan","5/7/20","82","27","26067","32.93"
"Iosco","0","66","Michigan","5/7/20","63","3","26069","4.76"
"Isabella","0","76","Michigan","5/7/20","76","0","26073","0"
"Jackson","2","401","Michigan","5/7/20","384","17","26075","4.43"
"Kalamazoo","29","600","Michigan","5/7/20","400","200","26077","50"
"Kalkaska","0","28","Michigan","5/7/20","27","1","26079","3.7"
"Kent","88","2230","Michigan","5/7/20","1615","615","26081","38.08"
"Lake","0","3","Michigan","5/7/20","3","0","26085","0"
"Lapeer","1","184","Michigan","5/7/20","180","4","26087","2.22"
"Leelanau","0","9","Michigan","5/7/20","9","0","26089","0"
"Lenawee","4","150","Michigan","5/7/20","119","31","26091","26.05"
"Livingston","6","433","Michigan","5/7/20","393","40","26093","10.18"
"Luce","0","1","Michigan","5/7/20","1","0","26095","0"
"Mackinac","0","6","Michigan","5/7/20","6","0","26097","0"
"Macomb","55","5939","Michigan","5/7/20","5556","383","26099","6.89"
"Manistee","0","12","Michigan","5/7/20","12","0","26101","0"
"Marquette","1","53","Michigan","5/7/20","46","7","26103","15.22"
"Mason","1","18","Michigan","5/7/20","14","4","26105","28.57"
"Mecosta","0","18","Michigan","5/7/20","17","1","26107","5.88"
"Menominee","0","6","Michigan","5/7/20","5","1","26109","20"
"Michigan Department of Corrections (MDOC)","83","2036","Michigan","5/7/20","1453","583","00000","40.12"
"Midland","0","93","Michigan","5/7/20","90","3","26111","3.33"
"Missaukee","0","22","Michigan","5/7/20","21","1","26113","4.76"
"Monroe","13","396","Michigan","5/7/20","306","90","26115","29.41"
"Montcalm","1","48","Michigan","5/7/20","42","6","26117","14.29"
"Montmorency","0","5","Michigan","5/7/20","5","0","26119","0"
"Muskegon","10","344","Michigan","5/7/20","276","68","26121","24.64"
"Newaygo","2","37","Michigan","5/7/20","24","13","26123","54.17"
"Oakland","83","8579","Michigan","5/7/20","7998","581","26125","7.26"
"Oceana","2","28","Michigan","5/7/20","13","15","26127","115.38"
"Ogemaw","0","20","Michigan","5/7/20","17","3","26129","17.65"
"Osceola","0","10","Michigan","5/7/20","10","0","26133","0"
"Oscoda","0","7","Michigan","5/7/20","5","2","26135","40"
"Otsego","1","113","Michigan","5/7/20","109","4","26137","3.67"
"Ottawa","20","409","Michigan","5/7/20","271","138","26139","50.92"
"Out of MI","5","64","Michigan","5/7/20","32","32","80026","100"
"Presque Isle","0","12","Michigan","5/7/20","11","1","26141","9.09"
"Roscommon","0","20","Michigan","5/7/20","18","2","26143","11.11"
"Saginaw","16","784","Michigan","5/7/20","672","112","26145","16.67"
"Sanilac","0","39","Michigan","5/7/20","36","3","26151","8.33"
"Schoolcraft","0","4","Michigan","5/7/20","3","1","26153","33.33"
"Shiawassee","3","214","Michigan","5/7/20","193","21","26155","10.88"
"St. Clair","3","391","Michigan","5/7/20","371","20","26147","5.39"
"St. Joseph","2","48","Michigan","5/7/20","33","15","26149","45.45"
"Tuscola","3","128","Michigan","5/7/20","107","21","26157","19.63"
"Van Buren","4","90","Michigan","5/7/20","63","27","26159","42.86"
"Washtenaw","10","1260","Michigan","5/7/20","1188","72","26161","6.06"
"Wayne","155","18071","Michigan","5/7/20","16986","1085","26163","6.39"
"Wexford","0","11","Michigan","5/7/20","11","0","26165","0"
"Aitkin","0","1","Minnesota","5/7/20","1","0","27001","0"
"Anoka","31","426","Minnesota","5/7/20","212","214","27003","100.94"
"Becker","2","18","Minnesota","5/7/20","2","16","27005","800"
"Beltrami","0","6","Minnesota","5/7/20","6","0","27007","0"
"Benton","7","64","Minnesota","5/7/20","15","49","27009","326.67"
"Big Stone","0","2","Minnesota","5/7/20","2","0","27011","0"
"Blue Earth","2","55","Minnesota","5/7/20","38","17","27013","44.74"
"Brown","0","9","Minnesota","5/7/20","8","1","27015","12.5"
"Carlton","0","62","Minnesota","5/7/20","59","3","27017","5.08"
"Carver","5","58","Minnesota","5/7/20","21","37","27019","176.19"
"Cass","0","7","Minnesota","5/7/20","5","2","27021","40"
"Chippewa","0","5","Minnesota","5/7/20","2","3","27023","150"
"Chisago","0","14","Minnesota","5/7/20","11","3","27025","27.27"
"Clay","9","222","Minnesota","5/7/20","157","65","27027","41.4"
"Clearwater","0","2","Minnesota","5/7/20","2","0","27029","0"
"Cottonwood","3","43","Minnesota","5/7/20","20","23","27033","115"
"Crow Wing","0","23","Minnesota","5/7/20","20","3","27035","15"
"Dakota","23","322","Minnesota","5/7/20","162","160","27037","98.77"
"Dodge","0","21","Minnesota","5/7/20","21","0","27039","0"
"Douglas","2","14","Minnesota","5/7/20","2","12","27041","600"
"Faribault","0","7","Minnesota","5/7/20","5","2","27043","40"
"Fillmore","0","12","Minnesota","5/7/20","12","0","27045","0"
"Freeborn","1","39","Minnesota","5/7/20","34","5","27047","14.71"
"Goodhue","1","25","Minnesota","5/7/20","19","6","27049","31.58"
"Grant","0","1","Minnesota","5/7/20","0","1","27051","1"
"Hennepin","175","2962","Minnesota","5/7/20","1738","1224","27053","70.43"
"Houston","0","2","Minnesota","5/7/20","1","1","27055","100"
"Isanti","0","7","Minnesota","5/7/20","6","1","27059","16.67"
"Itasca","3","24","Minnesota","5/7/20","5","19","27061","380"
"Jackson","2","29","Minnesota","5/7/20","14","15","27063","107.14"
"Kanabec","1","4","Minnesota","5/7/20","0","4","27065","1"
"Kandiyohi","21","238","Minnesota","5/7/20","91","147","27067","161.54"
"Kittson","0","1","Minnesota","5/7/20","1","0","27069","0"
"Koochiching","0","1","Minnesota","5/7/20","1","0","27071","0"
"Lac qui Parle","0","2","Minnesota","5/7/20","1","1","27073","100"
"Lake","0","1","Minnesota","5/7/20","0","1","27075","1"
"Le Sueur","1","28","Minnesota","5/7/20","24","4","27079","16.67"
"Lincoln","0","3","Minnesota","5/7/20","3","0","27081","0"
"Lyon","1","15","Minnesota","5/7/20","7","8","27083","114.29"
"Mahnomen","0","2","Minnesota","5/7/20","2","0","27087","0"
"Marshall","1","8","Minnesota","5/7/20","1","7","27089","700"
"Martin","3","111","Minnesota","5/7/20","88","23","27091","26.14"
"McLeod","0","6","Minnesota","5/7/20","4","2","27085","50"
"Meeker","1","18","Minnesota","5/7/20","11","7","27093","63.64"
"Mille Lacs","1","6","Minnesota","5/7/20","2","4","27095","200"
"Morrison","1","11","Minnesota","5/7/20","5","6","27097","120"
"Mower","1","36","Minnesota","5/7/20","28","8","27099","28.57"
"Murray","2","25","Minnesota","5/7/20","13","12","27101","92.31"
"Nicollet","1","18","Minnesota","5/7/20","11","7","27103","63.64"
"Nobles","59","1153","Minnesota","5/7/20","742","411","27105","55.39"
"Norman","0","9","Minnesota","5/7/20","8","1","27107","12.5"
"Olmsted","10","336","Minnesota","5/7/20","265","71","27109","26.79"
"Otter Tail","2","21","Minnesota","5/7/20","9","12","27111","133.33"
"Pennington","0","1","Minnesota","5/7/20","1","0","27113","0"
"Pine","1","61","Minnesota","5/7/20","56","5","27115","8.93"
"Pipestone","0","5","Minnesota","5/7/20","2","3","27117","150"
"Polk","2","43","Minnesota","5/7/20","27","16","27119","59.26"
"Pope","0","3","Minnesota","5/7/20","0","3","27121","1"
"Ramsey","49","717","Minnesota","5/7/20","374","343","27123","91.71"
"Red Lake","0","1","Minnesota","5/7/20","1","0","27125","0"
"Redwood","0","3","Minnesota","5/7/20","2","1","27127","50"
"Renville","0","6","Minnesota","5/7/20","4","2","27129","50"
"Rice","5","48","Minnesota","5/7/20","14","34","27131","242.86"
"Rock","1","19","Minnesota","5/7/20","11","8","27133","72.73"
"Roseau","0","1","Minnesota","5/7/20","1","0","27135","0"
"Scott","8","100","Minnesota","5/7/20","44","56","27139","127.27"
"Sherburne","9","88","Minnesota","5/7/20","28","60","27141","214.29"
"Sibley","0","2","Minnesota","5/7/20","2","0","27143","0"
"St. Louis","3","89","Minnesota","5/7/20","71","18","27137","25.35"
"Stearns","128","1161","Minnesota","5/7/20","267","894","27145","334.83"
"Steele","3","37","Minnesota","5/7/20","16","21","27147","131.25"
"Stevens","0","1","Minnesota","5/7/20","0","1","27149","1"
"Swift","0","2","Minnesota","5/7/20","2","0","27151","0"
"Todd","3","26","Minnesota","5/7/20","7","19","27153","271.43"
"Traverse","0","2","Minnesota","5/7/20","2","0","27155","0"
"Wabasha","1","12","Minnesota","5/7/20","8","4","27157","50"
"Wadena","0","4","Minnesota","5/7/20","1","3","27159","300"
"Waseca","1","12","Minnesota","5/7/20","4","8","27161","200"
"Washington","9","193","Minnesota","5/7/20","131","62","27163","47.33"
"Watonwan","1","18","Minnesota","5/7/20","11","7","27165","63.64"
"Wilkin","0","11","Minnesota","5/7/20","12","-1","27167","-8.33"
"Winona","0","68","Minnesota","5/7/20","66","2","27169","3.03"
"Wright","4","73","Minnesota","5/7/20","42","31","27171","73.81"
"Yellow Medicine","0","3","Minnesota","5/7/20","3","0","27173","0"
"Adams","3","157","Mississippi","5/7/20","133","24","28001","18.05"
"Alcorn","0","10","Mississippi","5/7/20","10","0","28003","0"
"Amite","1","33","Mississippi","5/7/20","29","4","28005","13.79"
"Attala","10","170","Mississippi","5/7/20","99","71","28007","71.72"
"Benton","0","13","Mississippi","5/7/20","11","2","28009","18.18"
"Bolivar","2","115","Mississippi","5/7/20","102","13","28011","12.75"
"Calhoun","1","57","Mississippi","5/7/20","50","7","28013","14"
"Carroll","9","99","Mississippi","5/7/20","38","61","28015","160.53"
"Chickasaw","2","84","Mississippi","5/7/20","68","16","28017","23.53"
"Choctaw","0","14","Mississippi","5/7/20","13","1","28019","7.69"
"Claiborne","2","33","Mississippi","5/7/20","22","11","28021","50"
"Clarke","2","71","Mississippi","5/7/20","54","17","28023","31.48"
"Clay","3","63","Mississippi","5/7/20","40","23","28025","57.5"
"Coahoma","1","70","Mississippi","5/7/20","61","9","28027","14.75"
"Copiah","6","141","Mississippi","5/7/20","96","45","28029","46.88"
"Covington","3","84","Mississippi","5/7/20","62","22","28031","35.48"
"DeSoto","5","320","Mississippi","5/7/20","282","38","28033","13.48"
"Forrest","11","283","Mississippi","5/7/20","207","76","28035","36.71"
"Franklin","0","18","Mississippi","5/7/20","16","2","28037","12.5"
"George","0","15","Mississippi","5/7/20","13","2","28039","15.38"
"Greene","0","6","Mississippi","5/7/20","5","1","28041","20"
"Grenada","2","45","Mississippi","5/7/20","28","17","28043","60.71"
"Hancock","1","72","Mississippi","5/7/20","62","10","28045","16.13"
"Harrison","2","188","Mississippi","5/7/20","174","14","28047","8.05"
"Hinds","19","600","Mississippi","5/7/20","470","130","28049","27.66"
"Holmes","8","190","Mississippi","5/7/20","133","57","28051","42.86"
"Humphreys","1","28","Mississippi","5/7/20","23","5","28053","21.74"
"Itawamba","1","66","Mississippi","5/7/20","57","9","28057","15.79"
"Jackson","2","272","Mississippi","5/7/20","259","13","28059","5.02"
"Jasper","5","76","Mississippi","5/7/20","42","34","28061","80.95"
"Jefferson","2","30","Mississippi","5/7/20","18","12","28063","66.67"
"Jefferson Davis","2","47","Mississippi","5/7/20","32","15","28065","46.88"
"Jones","9","209","Mississippi","5/7/20","143","66","28067","46.15"
"Kemper","4","84","Mississippi","5/7/20","57","27","28069","47.37"
"Lafayette","1","96","Mississippi","5/7/20","89","7","28071","7.87"
"Lamar","5","136","Mississippi","5/7/20","103","33","28073","32.04"
"Lauderdale","14","450","Mississippi","5/7/20","349","101","28075","28.94"
"Lawrence","2","61","Mississippi","5/7/20","45","16","28077","35.56"
"Leake","9","267","Mississippi","5/7/20","204","63","28079","30.88"
"Lee","1","73","Mississippi","5/7/20","69","4","28081","5.8"
"Leflore","5","180","Mississippi","5/7/20","148","32","28083","21.62"
"Lincoln","5","179","Mississippi","5/7/20","141","38","28085","26.95"
"Lowndes","2","71","Mississippi","5/7/20","54","17","28087","31.48"
"Madison","15","333","Mississippi","5/7/20","229","104","28089","45.41"
"Marion","1","80","Mississippi","5/7/20","72","8","28091","11.11"
"Marshall","1","50","Mississippi","5/7/20","43","7","28093","16.28"
"Monroe","4","188","Mississippi","5/7/20","157","31","28095","19.75"
"Montgomery","4","56","Mississippi","5/7/20","28","28","28097","100"
"Neshoba","11","261","Mississippi","5/7/20","187","74","28099","39.57"
"Newton","6","121","Mississippi","5/7/20","81","40","28101","49.38"
"Noxubee","4","97","Mississippi","5/7/20","66","31","28103","46.97"
"Oktibbeha","2","62","Mississippi","5/7/20","51","11","28105","21.57"
"Panola","1","43","Mississippi","5/7/20","39","4","28107","10.26"
"Pearl River","4","188","Mississippi","5/7/20","163","25","28109","15.34"
"Perry","1","33","Mississippi","5/7/20","27","6","28111","22.22"
"Pike","2","162","Mississippi","5/7/20","148","14","28113","9.46"
"Pontotoc","1","22","Mississippi","5/7/20","18","4","28115","22.22"
"Prentiss","0","33","Mississippi","5/7/20","32","1","28117","3.12"
"Quitman","0","16","Mississippi","5/7/20","14","2","28119","14.29"
"Rankin","6","231","Mississippi","5/7/20","186","45","28121","24.19"
"Scott","15","423","Mississippi","5/7/20","316","107","28123","33.86"
"Sharkey","0","5","Mississippi","5/7/20","5","0","28125","0"
"Simpson","1","56","Mississippi","5/7/20","46","10","28127","21.74"
"Smith","3","95","Mississippi","5/7/20","74","21","28129","28.38"
"Stone","0","23","Mississippi","5/7/20","22","1","28131","4.55"
"Sunflower","1","61","Mississippi","5/7/20","53","8","28133","15.09"
"Tallahatchie","0","12","Mississippi","5/7/20","11","1","28135","9.09"
"Tate","1","48","Mississippi","5/7/20","41","7","28137","17.07"
"Tippah","1","61","Mississippi","5/7/20","54","7","28139","12.96"
"Tishomingo","0","8","Mississippi","5/7/20","7","1","28141","14.29"
"Tunica","1","39","Mississippi","5/7/20","35","4","28143","11.43"
"Union","3","41","Mississippi","5/7/20","17","24","28145","141.18"
"Walthall","1","36","Mississippi","5/7/20","31","5","28147","16.13"
"Warren","3","90","Mississippi","5/7/20","68","22","28149","32.35"
"Washington","0","78","Mississippi","5/7/20","77","1","28151","1.3"
"Wayne","1","27","Mississippi","5/7/20","23","4","28153","17.39"
"Webster","0","21","Mississippi","5/7/20","18","3","28155","16.67"
"Wilkinson","1","74","Mississippi","5/7/20","69","5","28157","7.25"
"Winston","2","57","Mississippi","5/7/20","42","15","28159","35.71"
"Yalobusha","1","25","Mississippi","5/7/20","19","6","28161","31.58"
"Yazoo","3","154","Mississippi","5/7/20","135","19","28163","14.07"
"Adair","0","12","Missouri","5/7/20","12","0","29001","0"
"Andrew","1","6","Missouri","5/7/20","2","4","29003","200"
"Atchison","0","2","Missouri","5/7/20","2","0","29005","0"
"Audrain","0","1","Missouri","5/7/20","1","0","29007","0"
"Barry","0","6","Missouri","5/7/20","6","0","29009","0"
"Bates","0","6","Missouri","5/7/20","6","0","29013","0"
"Benton","0","8","Missouri","5/7/20","8","0","29015","0"
"Bollinger","0","4","Missouri","5/7/20","4","0","29017","0"
"Boone","0","98","Missouri","5/7/20","100","-2","29019","-2"
"Buchanan","45","404","Missouri","5/7/20","87","317","29021","364.37"
"Butler","0","26","Missouri","5/7/20","26","0","29023","0"
"Caldwell","0","3","Missouri","5/7/20","3","0","29025","0"
"Callaway","0","23","Missouri","5/7/20","22","1","29027","4.55"
"Camden","0","35","Missouri","5/7/20","35","0","29029","0"
"Cape Girardeau","0","49","Missouri","5/7/20","49","0","29031","0"
"Carroll","0","3","Missouri","5/7/20","3","0","29033","0"
"Carter","0","3","Missouri","5/7/20","3","0","29035","0"
"Cass","0","65","Missouri","5/7/20","62","3","29037","4.84"
"Cedar","1","9","Missouri","5/7/20","5","4","29039","80"
"Chariton","0","6","Missouri","5/7/20","5","1","29041","20"
"Christian","0","20","Missouri","5/7/20","19","1","29043","5.26"
"Clark","0","1","Missouri","5/7/20","1","0","29045","0"
"Clay","3","91","Missouri","5/7/20","70","21","29047","30"
"Clinton","0","13","Missouri","5/7/20","11","2","29049","18.18"
"Cole","1","55","Missouri","5/7/20","51","4","29051","7.84"
"Cooper","0","9","Missouri","5/7/20","7","2","29053","28.57"
"Crawford","0","8","Missouri","5/7/20","8","0","29055","0"
"Dallas","0","2","Missouri","5/7/20","2","0","29059","0"
"Daviess","0","3","Missouri","5/7/20","2","1","29061","50"
"DeKalb","0","3","Missouri","5/7/20","3","0","29063","0"
"Dunklin","0","23","Missouri","5/7/20","21","2","29069","9.52"
"Franklin","3","137","Missouri","5/7/20","114","23","29071","20.18"
"Gasconade","0","2","Missouri","5/7/20","2","0","29073","0"
"Gentry","0","1","Missouri","5/7/20","1","0","29075","0"
"Greene","0","99","Missouri","5/7/20","96","3","29077","3.12"
"Harrison","0","6","Missouri","5/7/20","6","0","29081","0"
"Henry","0","8","Missouri","5/7/20","8","0","29083","0"
"Holt","0","1","Missouri","5/7/20","1","0","29087","0"
"Howard","0","3","Missouri","5/7/20","2","1","29089","50"
"Howell","0","5","Missouri","5/7/20","5","0","29091","0"
"Iron","0","2","Missouri","5/7/20","2","0","29093","0"
"Jackson","8","373","Missouri","5/7/20","315","58","29095","18.41"
"Jasper","0","24","Missouri","5/7/20","24","0","29097","0"
"Jefferson","4","304","Missouri","5/7/20","274","30","29099","10.95"
"Johnson","1","62","Missouri","5/7/20","54","8","29101","14.81"
"Kansas City","25","723","Missouri","5/7/20","545","178","00000","32.66"
"Lafayette","3","58","Missouri","5/7/20","37","21","29107","56.76"
"Lawrence","0","2","Missouri","5/7/20","0","2","29109","1"
"Lewis","0","6","Missouri","5/7/20","6","0","29111","0"
"Lincoln","1","77","Missouri","5/7/20","70","7","29113","10"
"Linn","0","5","Missouri","5/7/20","5","0","29115","0"
"Livingston","0","4","Missouri","5/7/20","2","2","29117","100"
"Macon","0","3","Missouri","5/7/20","2","1","29121","50"
"Madison","0","2","Missouri","5/7/20","1","1","29123","100"
"Maries","0","2","Missouri","5/7/20","2","0","29125","0"
"Marion","0","5","Missouri","5/7/20","5","0","29127","0"
"McDonald","0","4","Missouri","5/7/20","4","0","29119","0"
"Miller","0","3","Missouri","5/7/20","1","2","29131","200"
"Mississippi","1","33","Missouri","5/7/20","29","4","29133","13.79"
"Moniteau","0","51","Missouri","5/7/20","52","-1","29135","-1.92"
"Montgomery","0","7","Missouri","5/7/20","7","0","29139","0"
"Morgan","0","6","Missouri","5/7/20","3","3","29141","100"
"New Madrid","0","11","Missouri","5/7/20","9","2","29143","22.22"
"Newton","0","11","Missouri","5/7/20","10","1","29145","10"
"Nodaway","0","5","Missouri","5/7/20","3","2","29147","66.67"
"Oregon","0","2","Missouri","5/7/20","1","1","29149","100"
"Osage","0","5","Missouri","5/7/20","5","0","29151","0"
"Pemiscot","4","55","Missouri","5/7/20","28","27","29155","96.43"
"Perry","0","44","Missouri","5/7/20","43","1","29157","2.33"
"Pettis","3","56","Missouri","5/7/20","35","21","29159","60"
"Phelps","0","3","Missouri","5/7/20","2","1","29161","50"
"Pike","0","12","Missouri","5/7/20","11","1","29163","9.09"
"Platte","1","38","Missouri","5/7/20","32","6","29165","18.75"
"Polk","0","1","Missouri","5/7/20","1","0","29167","0"
"Pulaski","0","36","Missouri","5/7/20","34","2","29169","5.88"
"Ralls","0","1","Missouri","5/7/20","1","0","29173","0"
"Randolph","0","8","Missouri","5/7/20","8","0","29175","0"
"Ray","0","12","Missouri","5/7/20","12","0","29177","0"
"Reynolds","0","2","Missouri","5/7/20","2","0","29179","0"
"Ripley","0","5","Missouri","5/7/20","5","0","29181","0"
"Saline","3","211","Missouri","5/7/20","188","23","29195","12.23"
"Scotland","0","4","Missouri","5/7/20","4","0","29199","0"
"Scott","2","77","Missouri","5/7/20","64","13","29201","20.31"
"Shelby","0","1","Missouri","5/7/20","1","0","29205","0"
"St. Charles","7","646","Missouri","5/7/20","596","50","29183","8.39"
"St. Clair","0","2","Missouri","5/7/20","2","0","29185","0"
"St. Francois","0","29","Missouri","5/7/20","28","1","29187","3.57"
"St. Louis","79","3826","Missouri","5/7/20","3274","552","29189","16.86"
"St. Louis City","44","1450","Missouri","5/7/20","1145","305","29510","26.64"
"Ste. Genevieve","0","9","Missouri","5/7/20","7","2","29186","28.57"
"Stoddard","1","24","Missouri","5/7/20","19","5","29207","26.32"
"Stone","0","3","Missouri","5/7/20","3","0","29209","0"
"Sullivan","0","1","Missouri","5/7/20","0","1","29211","1"
"Taney","0","12","Missouri","5/7/20","11","1","29213","9.09"
"Vernon","0","5","Missouri","5/7/20","4","1","29217","25"
"Warren","1","26","Missouri","5/7/20","22","4","29219","18.18"
"Washington","0","9","Missouri","5/7/20","8","1","29221","12.5"
"Webster","0","15","Missouri","5/7/20","15","0","29225","0"
"Worth","0","1","Missouri","5/7/20","1","0","29227","0"
"Wright","0","10","Missouri","5/7/20","10","0","29229","0"
"Beaverhead","0","1","Montana","5/7/20","1","0","30001","0"
"Big Horn","0","3","Montana","5/7/20","3","0","30003","0"
"Broadwater","0","4","Montana","5/7/20","4","0","30007","0"
"Carbon","0","6","Montana","5/7/20","6","0","30009","0"
"Cascade","0","16","Montana","5/7/20","15","1","30013","6.67"
"Deer Lodge","0","3","Montana","5/7/20","3","0","30023","0"
"Fergus","0","0","Montana","5/7/20","1","-1","30027","-100"
"Flathead","0","37","Montana","5/7/20","37","0","30029","0"
"Gallatin","0","146","Montana","5/7/20","146","0","30031","0"
"Glacier","0","6","Montana","5/7/20","6","0","30035","0"
"Golden Valley","0","3","Montana","5/7/20","3","0","30037","0"
"Hill","0","1","Montana","5/7/20","1","0","30041","0"
"Jefferson","0","2","Montana","5/7/20","2","0","30043","0"
"Lake","0","5","Montana","5/7/20","5","0","30047","0"
"Lewis and Clark","0","16","Montana","5/7/20","16","0","30049","0"
"Liberty","0","1","Montana","5/7/20","1","0","30051","0"
"Lincoln","0","7","Montana","5/7/20","7","0","30053","0"
"Madison","0","8","Montana","5/7/20","8","0","30057","0"
"Meagher","0","1","Montana","5/7/20","1","0","30059","0"
"Missoula","0","39","Montana","5/7/20","39","0","30063","0"
"Musselshell","0","1","Montana","5/7/20","1","0","30065","0"
"Park","0","8","Montana","5/7/20","8","0","30067","0"
"Pondera","0","2","Montana","5/7/20","2","0","30073","0"
"Ravalli","0","5","Montana","5/7/20","5","0","30081","0"
"Richland","0","3","Montana","5/7/20","3","0","30083","0"
"Roosevelt","0","7","Montana","5/7/20","7","0","30085","0"
"Silver Bow","0","11","Montana","5/7/20","11","0","30093","0"
"Stillwater","0","1","Montana","5/7/20","1","0","30095","0"
"Toole","0","29","Montana","5/7/20","29","0","30101","0"
"Wheatland","0","1","Montana","5/7/20","1","0","30107","0"
"Yellowstone","0","83","Montana","5/7/20","80","3","30111","3.75"
"Adams","7","216","Nebraska","5/7/20","164","52","31001","31.71"
"Antelope","0","4","Nebraska","5/7/20","2","2","31003","100"
"Boone","0","2","Nebraska","5/7/20","0","2","31011","1"
"Box Butte","0","1","Nebraska","5/7/20","1","0","31013","0"
"Buffalo","3","119","Nebraska","5/7/20","101","18","31019","17.82"
"Burt","0","5","Nebraska","5/7/20","3","2","31021","66.67"
"Butler","1","13","Nebraska","5/7/20","4","9","31023","225"
"Cass","1","9","Nebraska","5/7/20","5","4","31025","80"
"Cedar","0","5","Nebraska","5/7/20","4","1","31027","25"
"Cherry","0","1","Nebraska","5/7/20","1","0","31031","0"
"Cheyenne","0","7","Nebraska","5/7/20","6","1","31033","16.67"
"Clay","0","10","Nebraska","5/7/20","9","1","31035","11.11"
"Colfax","38","338","Nebraska","5/7/20","69","269","31037","389.86"
"Cuming","1","10","Nebraska","5/7/20","6","4","31039","66.67"
"Custer","1","27","Nebraska","5/7/20","23","4","31041","17.39"
"Dakota","52","1017","Nebraska","5/7/20","656","361","31043","55.03"
"Dawes","0","0","Nebraska","5/7/20","2","-2","31045","-100"
"Dawson","32","679","Nebraska","5/7/20","456","223","31047","48.9"
"Dixon","1","15","Nebraska","5/7/20","7","8","31051","114.29"
"Dodge","12","138","Nebraska","5/7/20","55","83","31053","150.91"
"Douglas","81","1221","Nebraska","5/7/20","656","565","31055","86.13"
"Fillmore","0","3","Nebraska","5/7/20","1","2","31059","200"
"Franklin","0","5","Nebraska","5/7/20","5","0","31061","0"
"Frontier","0","1","Nebraska","5/7/20","1","0","31063","0"
"Furnas","0","4","Nebraska","5/7/20","3","1","31065","33.33"
"Gage","1","40","Nebraska","5/7/20","36","4","31067","11.11"
"Gosper","0","12","Nebraska","5/7/20","9","3","31073","33.33"
"Greeley","0","2","Nebraska","5/7/20","2","0","31077","0"
"Hall","40","1306","Nebraska","5/7/20","1025","281","31079","27.41"
"Hamilton","0","45","Nebraska","5/7/20","42","3","31081","7.14"
"Hitchcock","0","1","Nebraska","5/7/20","1","0","31087","0"
"Holt","0","1","Nebraska","5/7/20","0","1","31089","1"
"Howard","1","19","Nebraska","5/7/20","12","7","31093","58.33"
"Jefferson","0","4","Nebraska","5/7/20","4","0","31095","0"
"Johnson","0","4","Nebraska","5/7/20","4","0","31097","0"
"Kearney","0","6","Nebraska","5/7/20","4","2","31099","50"
"Keith","0","1","Nebraska","5/7/20","0","1","31101","1"
"Kimball","0","9","Nebraska","5/7/20","9","0","31105","0"
"Knox","0","5","Nebraska","5/7/20","2","3","31107","150"
"Lancaster","38","503","Nebraska","5/7/20","240","263","31109","109.58"
"Lincoln","2","37","Nebraska","5/7/20","25","12","31111","48"
"Madison","17","237","Nebraska","5/7/20","115","122","31119","106.09"
"Merrick","1","20","Nebraska","5/7/20","12","8","31121","66.67"
"Morrill","1","7","Nebraska","5/7/20","1","6","31123","600"
"Nance","0","4","Nebraska","5/7/20","2","2","31125","100"
"Nemaha","0","1","Nebraska","5/7/20","1","0","31127","0"
"Otoe","0","3","Nebraska","5/7/20","1","2","31131","200"
"Phelps","0","8","Nebraska","5/7/20","5","3","31137","60"
"Pierce","0","1","Nebraska","5/7/20","1","0","31139","0"
"Platte","29","286","Nebraska","5/7/20","83","203","31141","244.58"
"Polk","0","9","Nebraska","5/7/20","7","2","31143","28.57"
"Red Willow","0","5","Nebraska","5/7/20","3","2","31145","66.67"
"Saline","27","320","Nebraska","5/7/20","129","191","31151","148.06"
"Sarpy","11","198","Nebraska","5/7/20","122","76","31153","62.3"
"Saunders","0","10","Nebraska","5/7/20","9","1","31155","11.11"
"Scotts Bluff","1","35","Nebraska","5/7/20","29","6","31157","20.69"
"Seward","1","15","Nebraska","5/7/20","8","7","31159","87.5"
"Sherman","0","2","Nebraska","5/7/20","1","1","31163","100"
"Stanton","0","8","Nebraska","5/7/20","5","3","31167","60"
"Thomas","0","1","Nebraska","5/7/20","0","1","31171","1"
"Thurston","1","9","Nebraska","5/7/20","4","5","31173","125"
"Valley","0","1","Nebraska","5/7/20","1","0","31175","0"
"Washington","0","22","Nebraska","5/7/20","22","0","31177","0"
"Wayne","0","1","Nebraska","5/7/20","1","0","31179","0"
"Webster","0","5","Nebraska","5/7/20","4","1","31181","25"
"York","0","15","Nebraska","5/7/20","12","3","31185","25"
"Carson City","1","51","Nevada","5/7/20","45","6","32510","13.33"
"Churchill","0","3","Nevada","5/7/20","3","0","32001","0"
"Clark","85","4573","Nevada","5/7/20","3979","594","32003","14.93"
"Douglas","0","22","Nevada","5/7/20","19","3","32005","15.79"
"Elko","0","15","Nevada","5/7/20","15","0","32007","0"
"Humboldt","2","58","Nevada","5/7/20","41","17","32013","41.46"
"Lander","1","14","Nevada","5/7/20","7","7","32015","100"
"Lincoln","0","1","Nevada","5/7/20","0","1","32017","1"
"Lyon","1","37","Nevada","5/7/20","28","9","32019","32.14"
"Mineral","0","4","Nevada","5/7/20","4","0","32021","0"
"Nye","1","44","Nevada","5/7/20","36","8","32023","22.22"
"Washoe","22","1030","Nevada","5/7/20","873","157","32031","17.98"
"White Pine","0","3","Nevada","5/7/20","3","0","32033","0"
"Belknap","1","42","New Hampshire","5/7/20","34","8","33001","23.53"
"Carroll","1","35","New Hampshire","5/7/20","31","4","33003","12.9"
"Cheshire","0","41","New Hampshire","5/7/20","40","1","33005","2.5"
"Coos","0","2","New Hampshire","5/7/20","2","0","33007","0"
"Grafton","1","55","New Hampshire","5/7/20","50","5","33009","10"
"Hillsborough","49","1308","New Hampshire","5/7/20","964","344","33011","35.68"
"Merrimack","6","220","New Hampshire","5/7/20","177","43","33013","24.29"
"Rockingham","34","933","New Hampshire","5/7/20","692","241","33015","34.83"
"Strafford","4","172","New Hampshire","5/7/20","141","31","33017","21.99"
"Sullivan","0","14","New Hampshire","5/7/20","12","2","33019","16.67"
"Atlantic","48","1302","New Jersey","5/7/20","964","338","34001","35.06"
"Bergen","143","16609","New Jersey","5/7/20","15610","999","34003","6.4"
"Burlington","97","3367","New Jersey","5/7/20","2690","677","34005","25.17"
"Camden","137","4479","New Jersey","5/7/20","3519","960","34007","27.28"
"Cape May","11","401","New Jersey","5/7/20","323","78","34009","24.15"
"Cumberland","52","1090","New Jersey","5/7/20","723","367","34011","50.76"
"Essex","219","15215","New Jersey","5/7/20","13682","1533","34013","11.2"
"Gloucester","42","1548","New Jersey","5/7/20","1251","297","34015","23.74"
"Hudson","318","17142","New Jersey","5/7/20","14916","2226","34017","14.92"
"Hunterdon","12","685","New Jersey","5/7/20","603","82","34019","13.6"
"Mercer","150","4986","New Jersey","5/7/20","3937","1049","34021","26.64"
"Middlesex","242","13411","New Jersey","5/7/20","11715","1696","34023","14.48"
"Monmouth","88","6649","New Jersey","5/7/20","6033","616","34025","10.21"
"Morris","59","5702","New Jersey","5/7/20","5287","415","34027","7.85"
"Ocean","119","7209","New Jersey","5/7/20","6375","834","34029","13.08"
"Passaic","241","14133","New Jersey","5/7/20","12449","1684","34031","13.53"
"Salem","18","358","New Jersey","5/7/20","231","127","34033","54.98"
"Somerset","64","3914","New Jersey","5/7/20","3464","450","34035","12.99"
"Sussex","12","1006","New Jersey","5/7/20","921","85","34037","9.23"
"Union","172","13781","New Jersey","5/7/20","12578","1203","34039","9.56"
"Warren","14","1004","New Jersey","5/7/20","903","101","34041","11.18"
"Bernalillo","29","1012","New Mexico","5/7/20","811","201","35001","24.78"
"Catron","0","2","New Mexico","5/7/20","1","1","35003","100"
"Chaves","1","26","New Mexico","5/7/20","22","4","35005","18.18"
"Cibola","4","82","New Mexico","5/7/20","52","30","35006","57.69"
"Colfax","0","5","New Mexico","5/7/20","5","0","35007","0"
"Curry","1","26","New Mexico","5/7/20","17","9","35009","52.94"
"De Baca","0","1","New Mexico","5/7/20","0","1","35011","1"
"Dona Ana","8","197","New Mexico","5/7/20","144","53","35013","36.81"
"Eddy","0","13","New Mexico","5/7/20","12","1","35015","8.33"
"Grant","0","15","New Mexico","5/7/20","14","1","35017","7.14"
"Guadalupe","0","15","New Mexico","5/7/20","14","1","35019","7.14"
"Harding","0","1","New Mexico","5/7/20","1","0","35021","0"
"Lea","1","14","New Mexico","5/7/20","10","4","35025","40"
"Lincoln","0","2","New Mexico","5/7/20","2","0","35027","0"
"Los Alamos","0","6","New Mexico","5/7/20","6","0","35028","0"
"Luna","0","7","New Mexico","5/7/20","5","2","35029","40"
"McKinley","54","1402","New Mexico","5/7/20","1027","375","35031","36.51"
"Otero","1","9","New Mexico","5/7/20","5","4","35035","80"
"Quay","0","4","New Mexico","5/7/20","4","0","35037","0"
"Rio Arriba","2","26","New Mexico","5/7/20","14","12","35039","85.71"
"Roosevelt","0","11","New Mexico","5/7/20","9","2","35041","22.22"
"San Juan","43","921","New Mexico","5/7/20","621","300","35045","48.31"
"San Miguel","0","4","New Mexico","5/7/20","2","2","35047","100"
"Sandoval","7","439","New Mexico","5/7/20","389","50","35043","12.85"
"Santa Fe","1","110","New Mexico","5/7/20","100","10","35049","10"
"Sierra","0","1","New Mexico","5/7/20","1","0","35051","0"
"Socorro","1","48","New Mexico","5/7/20","42","6","35053","14.29"
"Taos","0","20","New Mexico","5/7/20","18","2","35055","11.11"
"Torrance","0","17","New Mexico","5/7/20","15","2","35057","13.33"
"Union","0","3","New Mexico","5/7/20","3","0","35059","0"
"Valencia","1","54","New Mexico","5/7/20","45","9","35061","20"
"Albany","26","1348","New York","5/7/20","1165","183","36001","15.71"
"Allegany","0","35","New York","5/7/20","35","0","36003","0"
"Broome","11","360","New York","5/7/20","284","76","36007","26.76"
"Cattaraugus","2","59","New York","5/7/20","47","12","36009","25.53"
"Cayuga","1","52","New York","5/7/20","48","4","36011","8.33"
"Chautauqua","1","40","New York","5/7/20","33","7","36013","21.21"
"Chemung","1","129","New York","5/7/20","122","7","36015","5.74"
"Chenango","1","105","New York","5/7/20","98","7","36017","7.14"
"Clinton","1","69","New York","5/7/20","59","10","36019","16.95"
"Columbia","19","302","New York","5/7/20","170","132","36021","77.65"
"Cortland","0","29","New York","5/7/20","28","1","36023","3.57"
"Delaware","0","63","New York","5/7/20","61","2","36025","3.28"
"Dutchess","40","3233","New York","5/7/20","2954","279","36027","9.44"
"Erie","117","4136","New York","5/7/20","3319","817","36029","24.62"
"Essex","0","30","New York","5/7/20","28","2","36031","7.14"
"Franklin","0","16","New York","5/7/20","15","1","36033","6.67"
"Fulton","4","101","New York","5/7/20","71","30","36035","42.25"
"Genesee","2","168","New York","5/7/20","153","15","36037","9.8"
"Greene","10","198","New York","5/7/20","131","67","36039","51.15"
"Hamilton","0","5","New York","5/7/20","3","2","36041","66.67"
"Herkimer","2","74","New York","5/7/20","58","16","36043","27.59"
"Jefferson","0","64","New York","5/7/20","61","3","36045","4.92"
"Lewis","0","10","New York","5/7/20","9","1","36049","11.11"
"Livingston","4","95","New York","5/7/20","69","26","36051","37.68"
"Madison","16","246","New York","5/7/20","131","115","36053","87.79"
"Monroe","35","1688","New York","5/7/20","1441","247","36055","17.14"
"Montgomery","1","63","New York","5/7/20","53","10","36057","18.87"
"Nassau","248","37593","New York","5/7/20","35854","1739","36059","4.85"
"New York","1820","180216","New York","5/7/20","167478","12738","36061","7.61"
"Niagara","24","588","New York","5/7/20","420","168","36063","40"
"Oneida","24","609","New York","5/7/20","439","170","36065","38.72"
"Onondaga","40","1115","New York","5/7/20","832","283","36067","34.01"
"Ontario","2","101","New York","5/7/20","90","11","36069","12.22"
"Orange","97","9328","New York","5/7/20","8650","678","36071","7.84"
"Orleans","3","108","New York","5/7/20","89","19","36073","21.35"
"Oswego","1","70","New York","5/7/20","63","7","36075","11.11"
"Otsego","0","67","New York","5/7/20","67","0","36077","0"
"Putnam","14","1066","New York","5/7/20","970","96","36079","9.9"
"Rensselaer","11","367","New York","5/7/20","287","80","36083","27.87"
"Rockland","82","12280","New York","5/7/20","11708","572","36087","4.89"
"Saratoga","3","374","New York","5/7/20","354","20","36091","5.65"
"Schenectady","7","551","New York","5/7/20","501","50","36093","9.98"
"Schoharie","0","45","New York","5/7/20","42","3","36095","7.14"
"Schuyler","0","7","New York","5/7/20","7","0","36097","0"
"Seneca","1","46","New York","5/7/20","39","7","36099","17.95"
"St. Lawrence","1","181","New York","5/7/20","173","8","36089","4.62"
"Steuben","1","224","New York","5/7/20","216","8","36101","3.7"
"Suffolk","318","35892","New York","5/7/20","33664","2228","36103","6.62"
"Sullivan","26","1021","New York","5/7/20","838","183","36105","21.84"
"Tioga","1","97","New York","5/7/20","88","9","36107","10.23"
"Tompkins","0","130","New York","5/7/20","128","2","36109","1.56"
"Ulster","20","1416","New York","5/7/20","1279","137","36111","10.71"
"Warren","2","193","New York","5/7/20","176","17","36113","9.66"
"Washington","6","190","New York","5/7/20","148","42","36115","28.38"
"Wayne","1","78","New York","5/7/20","71","7","36117","9.86"
"Westchester","248","30708","New York","5/7/20","28970","1738","36119","6"
"Wyoming","1","71","New York","5/7/20","67","4","36121","5.97"
"Yates","0","19","New York","5/7/20","18","1","36123","5.56"
"Alamance","5","143","North Carolina","5/7/20","109","34","37001","31.19"
"Alexander","1","8","North Carolina","5/7/20","4","4","37003","100"
"Alleghany","1","7","North Carolina","5/7/20","3","4","37005","133.33"
"Anson","1","33","North Carolina","5/7/20","25","8","37007","32"
"Ashe","0","6","North Carolina","5/7/20","5","1","37009","20"
"Beaufort","0","22","North Carolina","5/7/20","22","0","37013","0"
"Bertie","2","57","North Carolina","5/7/20","44","13","37015","29.55"
"Bladen","3","45","North Carolina","5/7/20","21","24","37017","114.29"
"Brunswick","1","50","North Carolina","5/7/20","43","7","37019","16.28"
"Buncombe","3","88","North Carolina","5/7/20","68","20","37021","29.41"
"Burke","3","126","North Carolina","5/7/20","102","24","37023","23.53"
"Cabarrus","4","333","North Carolina","5/7/20","303","30","37025","9.9"
"Caldwell","2","50","North Carolina","5/7/20","34","16","37027","47.06"
"Camden","0","2","North Carolina","5/7/20","1","1","37029","100"
"Carteret","0","29","North Carolina","5/7/20","28","1","37031","3.57"
"Caswell","2","38","North Carolina","5/7/20","22","16","37033","72.73"
"Catawba","1","65","North Carolina","5/7/20","56","9","37035","16.07"
"Chatham","15","421","North Carolina","5/7/20","316","105","37037","33.23"
"Cherokee","0","19","North Carolina","5/7/20","16","3","37039","18.75"
"Chowan","0","7","North Carolina","5/7/20","7","0","37041","0"
"Clay","0","6","North Carolina","5/7/20","6","0","37043","0"
"Cleveland","0","50","North Carolina","5/7/20","47","3","37045","6.38"
"Columbus","4","184","North Carolina","5/7/20","153","31","37047","20.26"
"Craven","1","46","North Carolina","5/7/20","40","6","37049","15"
"Cumberland","17","356","North Carolina","5/7/20","238","118","37051","49.58"
"Currituck","0","7","North Carolina","5/7/20","5","2","37053","40"
"Dare","0","18","North Carolina","5/7/20","15","3","37055","20"
"Davidson","4","191","North Carolina","5/7/20","166","25","37057","15.06"
"Davie","0","31","North Carolina","5/7/20","30","1","37059","3.33"
"Duplin","10","161","North Carolina","5/7/20","92","69","37061","75"
"Durham","15","841","North Carolina","5/7/20","733","108","37063","14.73"
"Edgecombe","6","137","North Carolina","5/7/20","94","43","37065","45.74"
"Forsyth","13","332","North Carolina","5/7/20","242","90","37067","37.19"
"Franklin","1","111","North Carolina","5/7/20","104","7","37069","6.73"
"Gaston","2","157","North Carolina","5/7/20","140","17","37071","12.14"
"Gates","0","10","North Carolina","5/7/20","7","3","37073","42.86"
"Graham","0","2","North Carolina","5/7/20","2","0","37075","0"
"Granville","4","164","North Carolina","5/7/20","136","28","37077","20.59"
"Greene","2","33","North Carolina","5/7/20","16","17","37079","106.25"
"Guilford","22","536","North Carolina","5/7/20","381","155","37081","40.68"
"Halifax","3","77","North Carolina","5/7/20","58","19","37083","32.76"
"Harnett","6","199","North Carolina","5/7/20","156","43","37085","27.56"
"Haywood","1","18","North Carolina","5/7/20","10","8","37087","80"
"Henderson","3","216","North Carolina","5/7/20","192","24","37089","12.5"
"Hertford","1","46","North Carolina","5/7/20","37","9","37091","24.32"
"Hoke","5","113","North Carolina","5/7/20","80","33","37093","41.25"
"Hyde","0","1","North Carolina","5/7/20","1","0","37095","0"
"Iredell","4","138","North Carolina","5/7/20","112","26","37097","23.21"
"Jackson","1","20","North Carolina","5/7/20","15","5","37099","33.33"
"Johnston","4","189","North Carolina","5/7/20","158","31","37101","19.62"
"Jones","1","19","North Carolina","5/7/20","14","5","37103","35.71"
"Lee","9","229","North Carolina","5/7/20","169","60","37105","35.5"
"Lenoir","4","97","North Carolina","5/7/20","67","30","37107","44.78"
"Lincoln","1","37","North Carolina","5/7/20","27","10","37109","37.04"
"Macon","0","3","North Carolina","5/7/20","3","0","37113","0"
"Madison","0","1","North Carolina","5/7/20","1","0","37115","0"
"Martin","2","27","North Carolina","5/7/20","16","11","37117","68.75"
"McDowell","0","28","North Carolina","5/7/20","25","3","37111","12"
"Mecklenburg","42","1922","North Carolina","5/7/20","1627","295","37119","18.13"
"Mitchell","0","5","North Carolina","5/7/20","5","0","37121","0"
"Montgomery","1","43","North Carolina","5/7/20","38","5","37123","13.16"
"Moore","3","148","North Carolina","5/7/20","125","23","37125","18.4"
"Nash","2","107","North Carolina","5/7/20","92","15","37127","16.3"
"New Hanover","3","97","North Carolina","5/7/20","79","18","37129","22.78"
"Northampton","2","102","North Carolina","5/7/20","86","16","37131","18.6"
"Onslow","1","53","North Carolina","5/7/20","45","8","37133","17.78"
"Orange","3","239","North Carolina","5/7/20","217","22","37135","10.14"
"Pamlico","0","8","North Carolina","5/7/20","7","1","37137","14.29"
"Pasquotank","0","39","North Carolina","5/7/20","36","3","37139","8.33"
"Pender","1","20","North Carolina","5/7/20","13","7","37141","53.85"
"Perquimans","0","14","North Carolina","5/7/20","13","1","37143","7.69"
"Person","1","27","North Carolina","5/7/20","20","7","37145","35"
"Pitt","4","152","North Carolina","5/7/20","123","29","37147","23.58"
"Polk","1","30","North Carolina","5/7/20","20","10","37149","50"
"Randolph","12","290","North Carolina","5/7/20","205","85","37151","41.46"
"Richmond","5","80","North Carolina","5/7/20","47","33","37153","70.21"
"Robeson","23","323","North Carolina","5/7/20","162","161","37155","99.38"
"Rockingham","1","36","North Carolina","5/7/20","26","10","37157","38.46"
"Rowan","10","452","North Carolina","5/7/20","381","71","37159","18.64"
"Rutherford","1","148","North Carolina","5/7/20","139","9","37161","6.47"
"Sampson","9","126","North Carolina","5/7/20","63","63","37163","100"
"Scotland","1","34","North Carolina","5/7/20","24","10","37165","41.67"
"Stanly","0","30","North Carolina","5/7/20","29","1","37167","3.45"
"Stokes","0","11","North Carolina","5/7/20","11","0","37169","0"
"Surry","2","26","North Carolina","5/7/20","13","13","37171","100"
"Swain","0","5","North Carolina","5/7/20","3","2","37173","66.67"
"Transylvania","0","8","North Carolina","5/7/20","7","1","37175","14.29"
"Tyrrell","0","4","North Carolina","5/7/20","4","0","37177","0"
"Union","6","283","North Carolina","5/7/20","243","40","37179","16.46"
"Vance","8","147","North Carolina","5/7/20","88","59","37181","67.05"
"Wake","21","981","North Carolina","5/7/20","833","148","37183","17.77"
"Warren","1","19","North Carolina","5/7/20","10","9","37185","90"
"Washington","0","25","North Carolina","5/7/20","24","1","37187","4.17"
"Watauga","0","9","North Carolina","5/7/20","9","0","37189","0"
"Wayne","6","699","North Carolina","5/7/20","655","44","37191","6.72"
"Wilkes","22","186","North Carolina","5/7/20","33","153","37193","463.64"
"Wilson","4","192","North Carolina","5/7/20","165","27","37195","16.36"
"Yadkin","2","33","North Carolina","5/7/20","17","16","37197","94.12"
"Yancey","1","7","North Carolina","5/7/20","0","7","37199","1"
"Barnes","0","4","North Dakota","5/7/20","4","0","38003","0"
"Benson","0","2","North Dakota","5/7/20","0","2","38005","1"
"Bowman","0","1","North Dakota","5/7/20","1","0","38011","0"
"Burke","0","5","North Dakota","5/7/20","3","2","38013","66.67"
"Burleigh","4","102","North Dakota","5/7/20","77","25","38015","32.47"
"Cass","28","709","North Dakota","5/7/20","513","196","38017","38.21"
"Divide","0","1","North Dakota","5/7/20","1","0","38023","0"
"Dunn","0","11","North Dakota","5/7/20","10","1","38025","10"
"Eddy","0","1","North Dakota","5/7/20","1","0","38027","0"
"Emmons","0","1","North Dakota","5/7/20","1","0","38029","0"
"Foster","0","1","North Dakota","5/7/20","1","0","38031","0"
"Grand Forks","2","275","North Dakota","5/7/20","258","17","38035","6.59"
"Grant","0","1","North Dakota","5/7/20","1","0","38037","0"
"McHenry","0","1","North Dakota","5/7/20","1","0","38049","0"
"McIntosh","0","1","North Dakota","5/7/20","1","0","38051","0"
"McKenzie","0","15","North Dakota","5/7/20","13","2","38053","15.38"
"McLean","0","5","North Dakota","5/7/20","3","2","38055","66.67"
"Mercer","0","3","North Dakota","5/7/20","0","3","38057","1"
"Morton","2","35","North Dakota","5/7/20","24","11","38059","45.83"
"Mountrail","0","35","North Dakota","5/7/20","35","0","38061","0"
"Nelson","0","1","North Dakota","5/7/20","1","0","38063","0"
"Oliver","0","1","North Dakota","5/7/20","1","0","38065","0"
"Pembina","0","5","North Dakota","5/7/20","3","2","38067","66.67"
"Pierce","0","3","North Dakota","5/7/20","2","1","38069","50"
"Ramsey","0","5","North Dakota","5/7/20","3","2","38071","66.67"
"Ransom","0","2","North Dakota","5/7/20","1","1","38073","100"
"Renville","0","1","North Dakota","5/7/20","0","1","38075","1"
"Richland","0","8","North Dakota","5/7/20","7","1","38077","14.29"
"Rolette","0","2","North Dakota","5/7/20","1","1","38079","100"
"Sargent","0","3","North Dakota","5/7/20","1","2","38081","200"
"Sioux","0","1","North Dakota","5/7/20","1","0","38085","0"
"Slope","0","3","North Dakota","5/7/20","3","0","38087","0"
"Stark","2","60","North Dakota","5/7/20","49","11","38089","22.45"
"Stutsman","1","12","North Dakota","5/7/20","6","6","38093","100"
"Traill","0","1","North Dakota","5/7/20","0","1","38097","1"
"Walsh","0","8","North Dakota","5/7/20","7","1","38099","14.29"
"Ward","1","26","North Dakota","5/7/20","21","5","38101","23.81"
"Wells","0","2","North Dakota","5/7/20","2","0","38103","0"
"Williams","1","18","North Dakota","5/7/20","10","8","38105","80"
"","0","15","Northern Mariana Islands","5/7/20","14","1",,"7.14"
"Adams","0","5","Ohio","5/7/20","4","1","39001","25"
"Allen","2","138","Ohio","5/7/20","121","17","39003","14.05"
"Ashland","1","12","Ohio","5/7/20","7","5","39005","71.43"
"Ashtabula","6","169","Ohio","5/7/20","126","43","39007","34.13"
"Athens","0","4","Ohio","5/7/20","3","1","39009","33.33"
"Auglaize","1","36","Ohio","5/7/20","32","4","39011","12.5"
"Belmont","9","205","Ohio","5/7/20","144","61","39013","42.36"
"Brown","1","16","Ohio","5/7/20","11","5","39015","45.45"
"Butler","13","372","Ohio","5/7/20","281","91","39017","32.38"
"Carroll","0","21","Ohio","5/7/20","21","0","39019","0"
"Champaign","0","16","Ohio","5/7/20","14","2","39021","14.29"
"Clark","2","74","Ohio","5/7/20","57","17","39023","29.82"
"Clermont","3","110","Ohio","5/7/20","88","22","39025","25"
"Clinton","0","32","Ohio","5/7/20","29","3","39027","10.34"
"Columbiana","8","311","Ohio","5/7/20","253","58","39029","22.92"
"Coshocton","0","18","Ohio","5/7/20","17","1","39031","5.88"
"Crawford","3","65","Ohio","5/7/20","45","20","39033","44.44"
"Cuyahoga","66","2591","Ohio","5/7/20","2126","465","39035","21.87"
"Darke","0","79","Ohio","5/7/20","76","3","39037","3.95"
"Defiance","0","21","Ohio","5/7/20","20","1","39039","5"
"Delaware","5","196","Ohio","5/7/20","160","36","39041","22.5"
"Erie","3","75","Ohio","5/7/20","56","19","39043","33.93"
"Fairfield","4","162","Ohio","5/7/20","137","25","39045","18.25"
"Fayette","1","23","Ohio","5/7/20","15","8","39047","53.33"
"Franklin","134","3377","Ohio","5/7/20","2441","936","39049","38.34"
"Fulton","1","30","Ohio","5/7/20","22","8","39051","36.36"
"Gallia","0","6","Ohio","5/7/20","6","0","39053","0"
"Geauga","4","184","Ohio","5/7/20","154","30","39055","19.48"
"Greene","1","52","Ohio","5/7/20","46","6","39057","13.04"
"Guernsey","1","20","Ohio","5/7/20","15","5","39059","33.33"
"Hamilton","51","1572","Ohio","5/7/20","1218","354","39061","29.06"
"Hancock","0","39","Ohio","5/7/20","37","2","39063","5.41"
"Hardin","0","26","Ohio","5/7/20","25","1","39065","4"
"Harrison","0","6","Ohio","5/7/20","4","2","39067","50"
"Henry","0","6","Ohio","5/7/20","5","1","39069","20"
"Highland","0","11","Ohio","5/7/20","11","0","39071","0"
"Hocking","0","20","Ohio","5/7/20","18","2","39073","11.11"
"Holmes","0","7","Ohio","5/7/20","6","1","39075","16.67"
"Huron","1","34","Ohio","5/7/20","29","5","39077","17.24"
"Jackson","0","7","Ohio","5/7/20","4","3","39079","75"
"Jefferson","1","49","Ohio","5/7/20","43","6","39081","13.95"
"Knox","1","20","Ohio","5/7/20","16","4","39083","25"
"Lake","3","187","Ohio","5/7/20","168","19","39085","11.31"
"Lawrence","0","24","Ohio","5/7/20","24","0","39087","0"
"Licking","4","146","Ohio","5/7/20","118","28","39089","23.73"
"Logan","1","23","Ohio","5/7/20","18","5","39091","27.78"
"Lorain","11","528","Ohio","5/7/20","452","76","39093","16.81"
"Lucas","47","1583","Ohio","5/7/20","1251","332","39095","26.54"
"Madison","1","73","Ohio","5/7/20","63","10","39097","15.87"
"Mahoning","31","1044","Ohio","5/7/20","828","216","39099","26.09"
"Marion","22","2350","Ohio","5/7/20","2196","154","39101","7.01"
"Medina","3","185","Ohio","5/7/20","167","18","39103","10.78"
"Meigs","0","3","Ohio","5/7/20","2","1","39105","50"
"Mercer","3","42","Ohio","5/7/20","21","21","39107","100"
"Miami","1","145","Ohio","5/7/20","139","6","39109","4.32"
"Monroe","0","5","Ohio","5/7/20","3","2","39111","66.67"
"Montgomery","9","345","Ohio","5/7/20","285","60","39113","21.05"
"Morgan","0","5","Ohio","5/7/20","4","1","39115","25"
"Morrow","6","83","Ohio","5/7/20","42","41","39117","97.62"
"Muskingum","2","23","Ohio","5/7/20","12","11","39119","91.67"
"Noble","0","5","Ohio","5/7/20","5","0","39121","0"
"Ottawa","1","44","Ohio","5/7/20","38","6","39123","15.79"
"Paulding","0","8","Ohio","5/7/20","8","0","39125","0"
"Perry","0","13","Ohio","5/7/20","12","1","39127","8.33"
"Pickaway","16","1841","Ohio","5/7/20","1732","109","39129","6.29"
"Pike","0","4","Ohio","5/7/20","3","1","39131","33.33"
"Portage","4","265","Ohio","5/7/20","236","29","39133","12.29"
"Preble","0","27","Ohio","5/7/20","27","0","39135","0"
"Putnam","1","73","Ohio","5/7/20","67","6","39137","8.96"
"Richland","2","94","Ohio","5/7/20","81","13","39139","16.05"
"Ross","1","44","Ohio","5/7/20","39","5","39141","12.82"
"Sandusky","2","41","Ohio","5/7/20","27","14","39143","51.85"
"Scioto","1","15","Ohio","5/7/20","10","5","39145","50"
"Seneca","0","14","Ohio","5/7/20","14","0","39147","0"
"Shelby","0","31","Ohio","5/7/20","30","1","39149","3.33"
"Stark","15","450","Ohio","5/7/20","347","103","39151","29.68"
"Summit","32","831","Ohio","5/7/20","608","223","39153","36.68"
"Trumbull","9","371","Ohio","5/7/20","308","63","39155","20.45"
"Tuscarawas","11","153","Ohio","5/7/20","74","79","39157","106.76"
"Union","1","28","Ohio","5/7/20","22","6","39159","27.27"
"Van Wert","0","3","Ohio","5/7/20","3","0","39161","0"
"Vinton","0","9","Ohio","5/7/20","6","3","39163","50"
"Warren","6","188","Ohio","5/7/20","146","42","39165","28.77"
"Washington","2","111","Ohio","5/7/20","98","13","39167","13.27"
"Wayne","7","177","Ohio","5/7/20","128","49","39169","38.28"
"Williams","1","43","Ohio","5/7/20","34","9","39171","26.47"
"Wood","7","212","Ohio","5/7/20","164","48","39173","29.27"
"Wyandot","0","25","Ohio","5/7/20","24","1","39175","4.17"
"Adair","1","69","Oklahoma","5/7/20","64","5","40001","7.81"
"Alfalfa","0","1","Oklahoma","5/7/20","1","0","40003","0"
"Atoka","0","1","Oklahoma","5/7/20","1","0","40005","0"
"Beaver","1","17","Oklahoma","5/7/20","8","9","40007","112.5"
"Beckham","0","6","Oklahoma","5/7/20","5","1","40009","20"
"Blaine","0","2","Oklahoma","5/7/20","0","2","40011","1"
"Bryan","1","12","Oklahoma","5/7/20","8","4","40013","50"
"Caddo","4","89","Oklahoma","5/7/20","62","27","40015","43.55"
"Canadian","1","107","Oklahoma","5/7/20","98","9","40017","9.18"
"Carter","0","6","Oklahoma","5/7/20","3","3","40019","100"
"Cherokee","0","29","Oklahoma","5/7/20","27","2","40021","7.41"
"Choctaw","0","3","Oklahoma","5/7/20","3","0","40023","0"
"Cimarron","0","1","Oklahoma","5/7/20","1","0","40025","0"
"Cleveland","4","448","Oklahoma","5/7/20","419","29","40027","6.92"
"Comanche","5","115","Oklahoma","5/7/20","80","35","40031","43.75"
"Cotton","0","5","Oklahoma","5/7/20","5","0","40033","0"
"Craig","0","13","Oklahoma","5/7/20","10","3","40035","30"
"Creek","1","82","Oklahoma","5/7/20","77","5","40037","6.49"
"Custer","0","11","Oklahoma","5/7/20","10","1","40039","10"
"Delaware","0","92","Oklahoma","5/7/20","90","2","40041","2.22"
"Dewey","0","2","Oklahoma","5/7/20","2","0","40043","0"
"Garfield","1","21","Oklahoma","5/7/20","17","4","40047","23.53"
"Garvin","0","14","Oklahoma","5/7/20","13","1","40049","7.69"
"Grady","1","41","Oklahoma","5/7/20","36","5","40051","13.89"
"Grant","0","2","Oklahoma","5/7/20","2","0","40053","0"
"Greer","0","65","Oklahoma","5/7/20","65","0","40055","0"
"Harper","0","1","Oklahoma","5/7/20","1","0","40059","0"
"Haskell","0","5","Oklahoma","5/7/20","4","1","40061","25"
"Jackson","1","19","Oklahoma","5/7/20","15","4","40065","26.67"
"Jefferson","0","2","Oklahoma","5/7/20","2","0","40067","0"
"Johnston","0","3","Oklahoma","5/7/20","3","0","40069","0"
"Kay","0","48","Oklahoma","5/7/20","47","1","40071","2.13"
"Kingfisher","0","8","Oklahoma","5/7/20","8","0","40073","0"
"Kiowa","0","5","Oklahoma","5/7/20","5","0","40075","0"
"Latimer","0","5","Oklahoma","5/7/20","5","0","40077","0"
"Le Flore","0","13","Oklahoma","5/7/20","11","2","40079","18.18"
"Lincoln","0","16","Oklahoma","5/7/20","13","3","40081","23.08"
"Logan","0","18","Oklahoma","5/7/20","15","3","40083","20"
"Love","0","3","Oklahoma","5/7/20","2","1","40085","50"
"Major","0","4","Oklahoma","5/7/20","3","1","40093","33.33"
"Marshall","0","2","Oklahoma","5/7/20","2","0","40095","0"
"Mayes","0","24","Oklahoma","5/7/20","22","2","40097","9.09"
"McClain","4","84","Oklahoma","5/7/20","53","31","40087","58.49"
"McCurtain","0","8","Oklahoma","5/7/20","8","0","40089","0"
"McIntosh","0","4","Oklahoma","5/7/20","2","2","40091","100"
"Murray","0","2","Oklahoma","5/7/20","1","1","40099","100"
"Muskogee","0","28","Oklahoma","5/7/20","27","1","40101","3.7"
"Noble","0","7","Oklahoma","5/7/20","6","1","40103","16.67"
"Nowata","0","21","Oklahoma","5/7/20","21","0","40105","0"
"Okfuskee","0","1","Oklahoma","5/7/20","1","0","40107","0"
"Oklahoma","17","895","Oklahoma","5/7/20","773","122","40109","15.78"
"Okmulgee","0","17","Oklahoma","5/7/20","16","1","40111","6.25"
"Osage","1","82","Oklahoma","5/7/20","75","7","40113","9.33"
"Ottawa","0","34","Oklahoma","5/7/20","31","3","40115","9.68"
"Pawnee","0","29","Oklahoma","5/7/20","29","0","40117","0"
"Payne","0","44","Oklahoma","5/7/20","44","0","40119","0"
"Pittsburg","1","39","Oklahoma","5/7/20","29","10","40121","34.48"
"Pontotoc","0","10","Oklahoma","5/7/20","10","0","40123","0"
"Pottawatomie","1","53","Oklahoma","5/7/20","45","8","40125","17.78"
"Pushmataha","0","1","Oklahoma","5/7/20","1","0","40127","0"
"Rogers","1","69","Oklahoma","5/7/20","59","10","40131","16.95"
"Seminole","1","19","Oklahoma","5/7/20","10","9","40133","90"
"Sequoyah","0","13","Oklahoma","5/7/20","12","1","40135","8.33"
"Stephens","0","22","Oklahoma","5/7/20","22","0","40137","0"
"Texas","25","308","Oklahoma","5/7/20","131","177","40139","135.11"
"Tillman","2","16","Oklahoma","5/7/20","1","15","40141","1500"
"Tulsa","16","676","Oklahoma","5/7/20","567","109","40143","19.22"
"Wagoner","1","125","Oklahoma","5/7/20","119","6","40145","5.04"
"Washington","5","289","Oklahoma","5/7/20","256","33","40147","12.89"
"Woods","0","3","Oklahoma","5/7/20","3","0","40151","0"
"Woodward","0","1","Oklahoma","5/7/20","1","0","40153","0"
"Baker","0","1","Oregon","5/7/20","0","1","41001","1"
"Benton","2","44","Oregon","5/7/20","30","14","41003","46.67"
"Clackamas","4","241","Oregon","5/7/20","214","27","41005","12.62"
"Clatsop","2","18","Oregon","5/7/20","6","12","41007","200"
"Columbia","0","15","Oregon","5/7/20","14","1","41009","7.14"
"Coos","1","29","Oregon","5/7/20","20","9","41011","45"
"Crook","0","1","Oregon","5/7/20","1","0","41013","0"
"Curry","0","4","Oregon","5/7/20","4","0","41015","0"
"Deschutes","1","83","Oregon","5/7/20","76","7","41017","9.21"
"Douglas","0","24","Oregon","5/7/20","23","1","41019","4.35"
"Grant","0","1","Oregon","5/7/20","1","0","41023","0"
"Harney","0","1","Oregon","5/7/20","1","0","41025","0"
"Hood River","1","11","Oregon","5/7/20","6","5","41027","83.33"
"Jackson","0","49","Oregon","5/7/20","49","0","41029","0"
"Jefferson","2","22","Oregon","5/7/20","10","12","41031","120"
"Josephine","1","24","Oregon","5/7/20","20","4","41033","20"
"Klamath","0","39","Oregon","5/7/20","38","1","41035","2.63"
"Lane","1","57","Oregon","5/7/20","50","7","41039","14"
"Lincoln","0","6","Oregon","5/7/20","5","1","41041","20"
"Linn","2","99","Oregon","5/7/20","86","13","41043","15.12"
"Malheur","1","13","Oregon","5/7/20","8","5","41045","62.5"
"Marion","17","613","Oregon","5/7/20","491","122","41047","24.85"
"Morrow","1","11","Oregon","5/7/20","6","5","41049","83.33"
"Multnomah","15","809","Oregon","5/7/20","707","102","41051","14.43"
"Polk","6","78","Oregon","5/7/20","39","39","41053","100"
"Sherman","0","1","Oregon","5/7/20","1","0","41055","0"
"Tillamook","0","6","Oregon","5/7/20","6","0","41057","0"
"Umatilla","4","77","Oregon","5/7/20","50","27","41059","54"
"Union","0","4","Oregon","5/7/20","4","0","41061","0"
"Wallowa","0","1","Oregon","5/7/20","1","0","41063","0"
"Wasco","0","14","Oregon","5/7/20","13","1","41065","7.69"
"Washington","8","548","Oregon","5/7/20","491","57","41067","11.61"
"Yamhill","1","45","Oregon","5/7/20","39","6","41071","15.38"
"Adams","2","151","Pennsylvania","5/7/20","137","14","42001","10.22"
"Allegheny","21","1439","Pennsylvania","5/7/20","1289","150","42003","11.64"
"Armstrong","1","55","Pennsylvania","5/7/20","51","4","42005","7.84"
"Beaver","10","472","Pennsylvania","5/7/20","405","67","42007","16.54"
"Bedford","0","27","Pennsylvania","5/7/20","24","3","42009","12.5"
"Berks","57","3095","Pennsylvania","5/7/20","2698","397","42011","14.71"
"Blair","1","28","Pennsylvania","5/7/20","23","5","42013","21.74"
"Bradford","1","36","Pennsylvania","5/7/20","31","5","42015","16.13"
"Bucks","101","3613","Pennsylvania","5/7/20","2907","706","42017","24.29"
"Butler","2","190","Pennsylvania","5/7/20","178","12","42019","6.74"
"Cambria","1","37","Pennsylvania","5/7/20","28","9","42021","32.14"
"Cameron","0","2","Pennsylvania","5/7/20","1","1","42023","100"
"Carbon","2","189","Pennsylvania","5/7/20","175","14","42025","8"
"Centre","3","116","Pennsylvania","5/7/20","96","20","42027","20.83"
"Chester","43","1673","Pennsylvania","5/7/20","1375","298","42029","21.67"
"Clarion","0","23","Pennsylvania","5/7/20","23","0","42031","0"
"Clearfield","1","22","Pennsylvania","5/7/20","16","6","42033","37.5"
"Clinton","1","35","Pennsylvania","5/7/20","31","4","42035","12.9"
"Columbia","3","306","Pennsylvania","5/7/20","283","23","42037","8.13"
"Crawford","0","20","Pennsylvania","5/7/20","19","1","42039","5.26"
"Cumberland","9","403","Pennsylvania","5/7/20","343","60","42041","17.49"
"Dauphin","22","735","Pennsylvania","5/7/20","584","151","42043","25.86"
"Delaware","114","4497","Pennsylvania","5/7/20","3696","801","42045","21.67"
"Elk","0","5","Pennsylvania","5/7/20","3","2","42047","66.67"
"Erie","2","101","Pennsylvania","5/7/20","87","14","42049","16.09"
"Fayette","1","84","Pennsylvania","5/7/20","80","4","42051","5"
"Forest","0","7","Pennsylvania","5/7/20","7","0","42053","0"
"Franklin","20","425","Pennsylvania","5/7/20","284","141","42055","49.65"
"Fulton","0","7","Pennsylvania","5/7/20","5","2","42057","40"
"Greene","0","27","Pennsylvania","5/7/20","26","1","42059","3.85"
"Huntingdon","10","109","Pennsylvania","5/7/20","38","71","42061","186.84"
"Indiana","2","75","Pennsylvania","5/7/20","63","12","42063","19.05"
"Jefferson","0","7","Pennsylvania","5/7/20","4","3","42065","75"
"Juniata","1","92","Pennsylvania","5/7/20","83","9","42067","10.84"
"Lackawanna","26","1093","Pennsylvania","5/7/20","913","180","42069","19.72"
"Lancaster","44","2070","Pennsylvania","5/7/20","1765","305","42071","17.28"
"Lawrence","1","69","Pennsylvania","5/7/20","65","4","42073","6.15"
"Lebanon","16","785","Pennsylvania","5/7/20","676","109","42075","16.12"
"Lehigh","44","3102","Pennsylvania","5/7/20","2796","306","42077","10.94"
"Luzerne","27","2332","Pennsylvania","5/7/20","2143","189","42079","8.82"
"Lycoming","4","99","Pennsylvania","5/7/20","68","31","42081","45.59"
"McKean","0","6","Pennsylvania","5/7/20","6","0","42083","0"
"Mercer","1","70","Pennsylvania","5/7/20","65","5","42085","7.69"
"Mifflin","1","48","Pennsylvania","5/7/20","38","10","42087","26.32"
"Monroe","10","1194","Pennsylvania","5/7/20","1127","67","42089","5.94"
"Montgomery","87","4915","Pennsylvania","5/7/20","4307","608","42091","14.12"
"Montour","0","50","Pennsylvania","5/7/20","47","3","42093","6.38"
"Northampton","44","2355","Pennsylvania","5/7/20","2050","305","42095","14.88"
"Northumberland","3","112","Pennsylvania","5/7/20","93","19","42097","20.43"
"Perry","1","34","Pennsylvania","5/7/20","30","4","42099","13.33"
"Philadelphia","368","17047","Pennsylvania","5/7/20","14468","2579","42101","17.83"
"Pike","6","419","Pennsylvania","5/7/20","378","41","42103","10.85"
"Potter","0","4","Pennsylvania","5/7/20","4","0","42105","0"
"Schuylkill","8","422","Pennsylvania","5/7/20","368","54","42107","14.67"
"Snyder","0","33","Pennsylvania","5/7/20","33","0","42109","0"
"Somerset","1","32","Pennsylvania","5/7/20","26","6","42111","23.08"
"Sullivan","0","1","Pennsylvania","5/7/20","1","0","42113","0"
"Susquehanna","0","86","Pennsylvania","5/7/20","84","2","42115","2.38"
"Tioga","0","16","Pennsylvania","5/7/20","16","0","42117","0"
"Union","1","40","Pennsylvania","5/7/20","36","4","42119","11.11"
"Venango","0","7","Pennsylvania","5/7/20","7","0","42121","0"
"Warren","0","1","Pennsylvania","5/7/20","1","0","42123","0"
"Washington","1","120","Pennsylvania","5/7/20","115","5","42125","4.35"
"Wayne","2","113","Pennsylvania","5/7/20","100","13","42127","13"
"Westmoreland","3","411","Pennsylvania","5/7/20","391","20","42129","5.12"
"Wyoming","1","27","Pennsylvania","5/7/20","20","7","42131","35"
"York","14","740","Pennsylvania","5/7/20","641","99","42133","15.44"
"","70","2031","Puerto Rico","5/7/20","1539","492",,"31.97"
"Bristol","2","154","Rhode Island","5/7/20","143","11","44001","7.69"
"Kent","12","703","Rhode Island","5/7/20","622","81","44003","13.02"
"Newport","2","161","Rhode Island","5/7/20","149","12","44005","8.05"
"Providence","121","7138","Rhode Island","5/7/20","6290","848","44007","13.48"
"Washington","5","363","Rhode Island","5/7/20","330","33","44009","10"
"Abbeville","0","34","South Carolina","5/7/20","31","3","45001","9.68"
"Aiken","1","109","South Carolina","5/7/20","99","10","45003","10.1"
"Allendale","1","19","South Carolina","5/7/20","10","9","45005","90"
"Anderson","3","182","South Carolina","5/7/20","160","22","45007","13.75"
"Bamberg","1","14","South Carolina","5/7/20","10","4","45009","40"
"Barnwell","1","29","South Carolina","5/7/20","20","9","45011","45"
"Beaufort","1","269","South Carolina","5/7/20","263","6","45013","2.28"
"Berkeley","1","189","South Carolina","5/7/20","180","9","45015","5"
"Calhoun","0","7","South Carolina","5/7/20","7","0","45017","0"
"Charleston","3","467","South Carolina","5/7/20","444","23","45019","5.18"
"Cherokee","1","21","South Carolina","5/7/20","17","4","45021","23.53"
"Chester","1","35","South Carolina","5/7/20","30","5","45023","16.67"
"Chesterfield","3","69","South Carolina","5/7/20","51","18","45025","35.29"
"Clarendon","6","253","South Carolina","5/7/20","210","43","45027","20.48"
"Colleton","1","32","South Carolina","5/7/20","27","5","45029","18.52"
"Darlington","4","157","South Carolina","5/7/20","126","31","45031","24.6"
"Dillon","4","78","South Carolina","5/7/20","52","26","45033","50"
"Dorchester","1","104","South Carolina","5/7/20","97","7","45035","7.22"
"Edgefield","1","36","South Carolina","5/7/20","29","7","45037","24.14"
"Fairfield","6","75","South Carolina","5/7/20","36","39","45039","108.33"
"Florence","9","370","South Carolina","5/7/20","304","66","45041","21.71"
"Georgetown","1","50","South Carolina","5/7/20","43","7","45043","16.28"
"Greenville","16","835","South Carolina","5/7/20","722","113","45045","15.65"
"Greenwood","2","61","South Carolina","5/7/20","49","12","45047","24.49"
"Hampton","1","27","South Carolina","5/7/20","23","4","45049","17.39"
"Horry","4","242","South Carolina","5/7/20","215","27","45051","12.56"
"Jasper","0","21","South Carolina","5/7/20","19","2","45053","10.53"
"Kershaw","2","250","South Carolina","5/7/20","237","13","45055","5.49"
"Lancaster","1","101","South Carolina","5/7/20","96","5","45057","5.21"
"Laurens","1","44","South Carolina","5/7/20","39","5","45059","12.82"
"Lee","2","80","South Carolina","5/7/20","63","17","45061","26.98"
"Lexington","14","458","South Carolina","5/7/20","361","97","45063","26.87"
"Marion","1","43","South Carolina","5/7/20","34","9","45067","26.47"
"Marlboro","2","56","South Carolina","5/7/20","45","11","45069","24.44"
"McCormick","0","7","South Carolina","5/7/20","6","1","45065","16.67"
"Newberry","1","31","South Carolina","5/7/20","26","5","45071","19.23"
"Oconee","1","32","South Carolina","5/7/20","24","8","45073","33.33"
"Orangeburg","3","95","South Carolina","5/7/20","72","23","45075","31.94"
"Pickens","1","62","South Carolina","5/7/20","54","8","45077","14.81"
"Richland","21","1043","South Carolina","5/7/20","899","144","45079","16.02"
"Saluda","5","82","South Carolina","5/7/20","47","35","45081","74.47"
"Spartanburg","5","325","South Carolina","5/7/20","287","38","45083","13.24"
"Sumter","7","277","South Carolina","5/7/20","228","49","45085","21.49"
"Union","0","27","South Carolina","5/7/20","26","1","45087","3.85"
"Williamsburg","7","119","South Carolina","5/7/20","67","52","45089","77.61"
"York","2","225","South Carolina","5/7/20","210","15","45091","7.14"
"Aurora","0","1","South Dakota","5/7/20","1","0","46003","0"
"Beadle","0","21","South Dakota","5/7/20","21","0","46005","0"
"Bon Homme","0","4","South Dakota","5/7/20","4","0","46009","0"
"Brookings","0","14","South Dakota","5/7/20","13","1","46011","7.69"
"Brown","8","93","South Dakota","5/7/20","39","54","46013","138.46"
"Buffalo","0","1","South Dakota","5/7/20","1","0","46017","0"
"Charles Mix","0","5","South Dakota","5/7/20","5","0","46023","0"
"Clark","0","1","South Dakota","5/7/20","1","0","46025","0"
"Clay","0","7","South Dakota","5/7/20","6","1","46027","16.67"
"Codington","0","15","South Dakota","5/7/20","14","1","46029","7.14"
"Corson","0","1","South Dakota","5/7/20","1","0","46031","0"
"Davison","0","7","South Dakota","5/7/20","5","2","46035","40"
"Day","1","10","South Dakota","5/7/20","1","9","46037","900"
"Deuel","0","1","South Dakota","5/7/20","1","0","46039","0"
"Dewey","0","1","South Dakota","5/7/20","0","1","46041","1"
"Douglas","0","1","South Dakota","5/7/20","1","0","46043","0"
"Fall River","0","2","South Dakota","5/7/20","1","1","46047","100"
"Faulk","0","1","South Dakota","5/7/20","1","0","46049","0"
"Grant","0","2","South Dakota","5/7/20","0","2","46051","1"
"Hamlin","0","2","South Dakota","5/7/20","2","0","46057","0"
"Hand","0","1","South Dakota","5/7/20","1","0","46059","0"
"Hughes","1","14","South Dakota","5/7/20","8","6","46065","75"
"Hutchinson","0","3","South Dakota","5/7/20","3","0","46067","0"
"Hyde","0","1","South Dakota","5/7/20","1","0","46069","0"
"Jerauld","0","6","South Dakota","5/7/20","6","0","46073","0"
"Lake","0","4","South Dakota","5/7/20","4","0","46079","0"
"Lawrence","0","9","South Dakota","5/7/20","9","0","46081","0"
"Lincoln","3","171","South Dakota","5/7/20","147","24","46083","16.33"
"Lyman","0","3","South Dakota","5/7/20","3","0","46085","0"
"Marshall","0","1","South Dakota","5/7/20","1","0","46091","0"
"McCook","0","4","South Dakota","5/7/20","4","0","46087","0"
"McPherson","0","1","South Dakota","5/7/20","1","0","46089","0"
"Meade","0","2","South Dakota","5/7/20","1","1","46093","100"
"Miner","0","1","South Dakota","5/7/20","1","0","46097","0"
"Minnehaha","42","2332","South Dakota","5/7/20","2038","294","46099","14.43"
"Moody","1","11","South Dakota","5/7/20","5","6","46101","120"
"Oglala Lakota","0","1","South Dakota","5/7/20","1","0","46102","0"
"Pennington","1","17","South Dakota","5/7/20","12","5","46103","41.67"
"Roberts","1","11","South Dakota","5/7/20","4","7","46109","175"
"Sanborn","0","3","South Dakota","5/7/20","3","0","46111","0"
"Spink","0","3","South Dakota","5/7/20","3","0","46115","0"
"Stanley","0","8","South Dakota","5/7/20","7","1","46117","14.29"
"Sully","0","1","South Dakota","5/7/20","1","0","46119","0"
"Todd","1","7","South Dakota","5/7/20","1","6","46121","600"
"Turner","0","18","South Dakota","5/7/20","17","1","46125","5.88"
"Union","4","48","South Dakota","5/7/20","18","30","46127","166.67"
"Walworth","0","5","South Dakota","5/7/20","5","0","46129","0"
"Yankton","0","29","South Dakota","5/7/20","26","3","46135","11.54"
"Ziebach","0","1","South Dakota","5/7/20","0","1","46137","1"
"Anderson","0","31","Tennessee","5/7/20","28","3","47001","10.71"
"Bedford","6","217","Tennessee","5/7/20","173","44","47003","25.43"
"Benton","0","7","Tennessee","5/7/20","6","1","47005","16.67"
"Bledsoe","1","602","Tennessee","5/7/20","594","8","47007","1.35"
"Blount","2","69","Tennessee","5/7/20","56","13","47009","23.21"
"Bradley","2","64","Tennessee","5/7/20","49","15","47011","30.61"
"Campbell","0","16","Tennessee","5/7/20","15","1","47013","6.67"
"Cannon","0","13","Tennessee","5/7/20","12","1","47015","8.33"
"Carroll","0","19","Tennessee","5/7/20","18","1","47017","5.56"
"Carter","1","18","Tennessee","5/7/20","12","6","47019","50"
"Cheatham","2","58","Tennessee","5/7/20","46","12","47021","26.09"
"Chester","0","10","Tennessee","5/7/20","10","0","47023","0"
"Claiborne","0","7","Tennessee","5/7/20","5","2","47025","40"
"Clay","0","6","Tennessee","5/7/20","5","1","47027","20"
"Cocke","0","17","Tennessee","5/7/20","16","1","47029","6.25"
"Coffee","2","47","Tennessee","5/7/20","36","11","47031","30.56"
"Crockett","0","7","Tennessee","5/7/20","7","0","47033","0"
"Cumberland","1","84","Tennessee","5/7/20","74","10","47035","13.51"
"Davidson","78","3157","Tennessee","5/7/20","2612","545","47037","20.87"
"Decatur","0","4","Tennessee","5/7/20","4","0","47039","0"
"DeKalb","1","25","Tennessee","5/7/20","15","10","47041","66.67"
"Dickson","2","85","Tennessee","5/7/20","72","13","47043","18.06"
"Dyer","1","39","Tennessee","5/7/20","34","5","47045","14.71"
"Fayette","2","73","Tennessee","5/7/20","56","17","47047","30.36"
"Fentress","0","5","Tennessee","5/7/20","4","1","47049","25"
"Franklin","0","37","Tennessee","5/7/20","36","1","47051","2.78"
"Gibson","1","52","Tennessee","5/7/20","43","9","47053","20.93"
"Giles","0","9","Tennessee","5/7/20","8","1","47055","12.5"
"Grainger","0","6","Tennessee","5/7/20","5","1","47057","20"
"Greene","0","43","Tennessee","5/7/20","44","-1","47059","-2.27"
"Grundy","0","30","Tennessee","5/7/20","28","2","47061","7.14"
"Hamblen","0","20","Tennessee","5/7/20","18","2","47063","11.11"
"Hamilton","8","211","Tennessee","5/7/20","156","55","47065","35.26"
"Hardeman","1","23","Tennessee","5/7/20","14","9","47069","64.29"
"Hardin","0","7","Tennessee","5/7/20","5","2","47071","40"
"Hawkins","0","31","Tennessee","5/7/20","30","1","47073","3.33"
"Haywood","1","26","Tennessee","5/7/20","20","6","47075","30"
"Henderson","0","10","Tennessee","5/7/20","7","3","47077","42.86"
"Henry","0","14","Tennessee","5/7/20","13","1","47079","7.69"
"Hickman","1","48","Tennessee","5/7/20","44","4","47081","9.09"
"Houston","0","6","Tennessee","5/7/20","5","1","47083","20"
"Humphreys","0","11","Tennessee","5/7/20","10","1","47085","10"
"Jackson","0","8","Tennessee","5/7/20","7","1","47087","14.29"
"Jefferson","1","26","Tennessee","5/7/20","19","7","47089","36.84"
"Johnson","0","5","Tennessee","5/7/20","3","2","47091","66.67"
"Knox","4","253","Tennessee","5/7/20","228","25","47093","10.96"
"Lake","1","59","Tennessee","5/7/20","55","4","47095","7.27"
"Lauderdale","1","25","Tennessee","5/7/20","21","4","47097","19.05"
"Lawrence","0","19","Tennessee","5/7/20","17","2","47099","11.76"
"Lewis","0","2","Tennessee","5/7/20","2","0","47101","0"
"Lincoln","0","16","Tennessee","5/7/20","13","3","47103","23.08"
"Loudon","1","38","Tennessee","5/7/20","33","5","47105","15.15"
"Macon","2","55","Tennessee","5/7/20","40","15","47111","37.5"
"Madison","1","145","Tennessee","5/7/20","135","10","47113","7.41"
"Marion","0","29","Tennessee","5/7/20","29","0","47115","0"
"Marshall","0","24","Tennessee","5/7/20","22","2","47117","9.09"
"Maury","1","52","Tennessee","5/7/20","42","10","47119","23.81"
"McMinn","2","108","Tennessee","5/7/20","92","16","47107","17.39"
"McNairy","0","11","Tennessee","5/7/20","11","0","47109","0"
"Meigs","1","17","Tennessee","5/7/20","8","9","47121","112.5"
"Monroe","1","26","Tennessee","5/7/20","20","6","47123","30"
"Montgomery","1","155","Tennessee","5/7/20","146","9","47125","6.16"
"Moore","0","3","Tennessee","5/7/20","3","0","47127","0"
"Morgan","0","6","Tennessee","5/7/20","6","0","47129","0"
"Obion","0","15","Tennessee","5/7/20","13","2","47131","15.38"
"Out of TN","14","354","Tennessee","5/7/20","254","100","80047","39.37"
"Overton","0","11","Tennessee","5/7/20","8","3","47133","37.5"
"Perry","1","13","Tennessee","5/7/20","9","4","47135","44.44"
"Polk","1","12","Tennessee","5/7/20","8","4","47139","50"
"Putnam","6","162","Tennessee","5/7/20","121","41","47141","33.88"
"Rhea","0","6","Tennessee","5/7/20","5","1","47143","20"
"Roane","0","8","Tennessee","5/7/20","7","1","47145","14.29"
"Robertson","7","195","Tennessee","5/7/20","148","47","47147","31.76"
"Rutherford","27","661","Tennessee","5/7/20","474","187","47149","39.45"
"Scott","0","11","Tennessee","5/7/20","11","0","47151","0"
"Sequatchie","0","7","Tennessee","5/7/20","5","2","47153","40"
"Sevier","2","63","Tennessee","5/7/20","49","14","47155","28.57"
"Shelby","80","3066","Tennessee","5/7/20","2507","559","47157","22.3"
"Smith","0","23","Tennessee","5/7/20","21","2","47159","9.52"
"Stewart","0","7","Tennessee","5/7/20","7","0","47161","0"
"Sullivan","0","52","Tennessee","5/7/20","49","3","47163","6.12"
"Sumner","7","672","Tennessee","5/7/20","623","49","47165","7.87"
"Tipton","9","158","Tennessee","5/7/20","98","60","47167","61.22"
"Trousdale","176","1356","Tennessee","5/7/20","123","1233","47169","1002.44"
"Unicoi","0","2","Tennessee","5/7/20","1","1","47171","100"
"Union","0","3","Tennessee","5/7/20","3","0","47173","0"
"Van Buren","0","2","Tennessee","5/7/20","2","0","47175","0"
"Warren","0","10","Tennessee","5/7/20","7","3","47177","42.86"
"Washington","1","59","Tennessee","5/7/20","54","5","47179","9.26"
"Wayne","0","4","Tennessee","5/7/20","4","0","47181","0"
"Weakley","0","24","Tennessee","5/7/20","23","1","47183","4.35"
"White","1","16","Tennessee","5/7/20","7","9","47185","128.57"
"Williamson","3","434","Tennessee","5/7/20","411","23","47187","5.6"
"Wilson","5","288","Tennessee","5/7/20","253","35","47189","13.83"
"Anderson","2","40","Texas","5/7/20","29","11","48001","37.93"
"Andrews","0","21","Texas","5/7/20","19","2","48003","10.53"
"Angelina","6","93","Texas","5/7/20","53","40","48005","75.47"
"Aransas","0","2","Texas","5/7/20","2","0","48007","0"
"Armstrong","0","2","Texas","5/7/20","2","0","48011","0"
"Atascosa","0","22","Texas","5/7/20","19","3","48013","15.79"
"Austin","0","14","Texas","5/7/20","13","1","48015","7.69"
"Bailey","0","2","Texas","5/7/20","0","2","48017","1"
"Bandera","0","6","Texas","5/7/20","6","0","48019","0"
"Bastrop","5","107","Texas","5/7/20","73","34","48021","46.58"
"Bee","0","6","Texas","5/7/20","6","0","48025","0"
"Bell","3","213","Texas","5/7/20","189","24","48027","12.7"
"Bexar","55","1761","Texas","5/7/20","1374","387","48029","28.17"
"Blanco","0","6","Texas","5/7/20","6","0","48031","0"
"Bosque","0","5","Texas","5/7/20","4","1","48035","25"
"Bowie","1","76","Texas","5/7/20","70","6","48037","8.57"
"Brazoria","15","588","Texas","5/7/20","485","103","48039","21.24"
"Brazos","6","232","Texas","5/7/20","193","39","48041","20.21"
"Brewster","0","1","Texas","5/7/20","0","1","48043","1"
"Briscoe","0","1","Texas","5/7/20","0","1","48045","1"
"Brooks","0","1","Texas","5/7/20","1","0","48047","0"
"Brown","0","38","Texas","5/7/20","36","2","48049","5.56"
"Burleson","0","14","Texas","5/7/20","12","2","48051","16.67"
"Burnet","1","24","Texas","5/7/20","19","5","48053","26.32"
"Caldwell","2","25","Texas","5/7/20","14","11","48055","78.57"
"Calhoun","1","34","Texas","5/7/20","30","4","48057","13.33"
"Callahan","0","5","Texas","5/7/20","2","3","48059","150"
"Cameron","10","469","Texas","5/7/20","401","68","48061","16.96"
"Camp","0","7","Texas","5/7/20","6","1","48063","16.67"
"Carson","0","3","Texas","5/7/20","2","1","48065","50"
"Cass","1","17","Texas","5/7/20","13","4","48067","30.77"
"Castro","1","22","Texas","5/7/20","13","9","48069","69.23"
"Chambers","1","47","Texas","5/7/20","41","6","48071","14.63"
"Cherokee","1","20","Texas","5/7/20","14","6","48073","42.86"
"Childress","0","1","Texas","5/7/20","1","0","48075","0"
"Clay","0","3","Texas","5/7/20","3","0","48077","0"
"Cochran","0","1","Texas","5/7/20","1","0","48079","0"
"Coke","0","1","Texas","5/7/20","0","1","48081","1"
"Coleman","0","2","Texas","5/7/20","1","1","48083","100"
"Collin","18","839","Texas","5/7/20","710","129","48085","18.17"
"Collingsworth","0","1","Texas","5/7/20","0","1","48087","1"
"Colorado","0","12","Texas","5/7/20","10","2","48089","20"
"Comal","1","61","Texas","5/7/20","54","7","48091","12.96"
"Comanche","0","3","Texas","5/7/20","4","-1","48093","-25"
"Concho","0","1","Texas","5/7/20","1","0","48095","0"
"Cooke","0","11","Texas","5/7/20","8","3","48097","37.5"
"Coryell","7","201","Texas","5/7/20","155","46","48099","29.68"
"Cottle","0","3","Texas","5/7/20","2","1","48101","50"
"Crane","0","2","Texas","5/7/20","2","0","48103","0"
"Crosby","0","2","Texas","5/7/20","2","0","48107","0"
"Dallam","0","11","Texas","5/7/20","10","1","48111","10"
"Dallas","227","5120","Texas","5/7/20","3531","1589","48113","45"
"Dawson","1","30","Texas","5/7/20","24","6","48115","25"
"Deaf Smith","1","41","Texas","5/7/20","31","10","48117","32.26"
"Delta","0","1","Texas","5/7/20","1","0","48119","0"
"Denton","14","846","Texas","5/7/20","748","98","48121","13.1"
"DeWitt","0","15","Texas","5/7/20","15","0","48123","0"
"Dickens","0","1","Texas","5/7/20","1","0","48125","0"
"Dimmit","0","1","Texas","5/7/20","1","0","48127","0"
"Donley","0","25","Texas","5/7/20","24","1","48129","4.17"
"Duval","0","3","Texas","5/7/20","2","1","48131","50"
"Eastland","0","3","Texas","5/7/20","3","0","48133","0"
"Ector","1","90","Texas","5/7/20","81","9","48135","11.11"
"El Paso","33","1119","Texas","5/7/20","887","232","48141","26.16"
"Ellis","6","188","Texas","5/7/20","148","40","48139","27.03"
"Erath","0","15","Texas","5/7/20","12","3","48143","25"
"Falls","0","6","Texas","5/7/20","4","2","48145","50"
"Fannin","1","23","Texas","5/7/20","18","5","48147","27.78"
"Fayette","1","19","Texas","5/7/20","15","4","48149","26.67"
"Floyd","0","4","Texas","5/7/20","3","1","48153","33.33"
"Fort Bend","38","1287","Texas","5/7/20","1018","269","48157","26.42"
"Franklin","0","3","Texas","5/7/20","1","2","48159","200"
"Freestone","1","7","Texas","5/7/20","3","4","48161","133.33"
"Frio","3","25","Texas","5/7/20","7","18","48163","257.14"
"Gaines","0","3","Texas","5/7/20","2","1","48165","50"
"Galveston","14","669","Texas","5/7/20","572","97","48167","16.96"
"Garza","0","3","Texas","5/7/20","1","2","48169","200"
"Gillespie","0","4","Texas","5/7/20","1","3","48171","300"
"Glasscock","0","1","Texas","5/7/20","1","0","48173","0"
"Goliad","0","7","Texas","5/7/20","7","0","48175","0"
"Gonzales","2","31","Texas","5/7/20","20","11","48177","55"
"Gray","4","73","Texas","5/7/20","47","26","48179","55.32"
"Grayson","4","60","Texas","5/7/20","31","29","48181","93.55"
"Gregg","5","109","Texas","5/7/20","73","36","48183","49.32"
"Grimes","1","25","Texas","5/7/20","19","6","48185","31.58"
"Guadalupe","1","90","Texas","5/7/20","80","10","48187","12.5"
"Hale","2","37","Texas","5/7/20","25","12","48189","48"
"Hamilton","0","5","Texas","5/7/20","5","0","48193","0"
"Hansford","1","11","Texas","5/7/20","6","5","48195","83.33"
"Hardin","2","113","Texas","5/7/20","99","14","48199","14.14"
"Harris","146","7377","Texas","5/7/20","6356","1021","48201","16.06"
"Harrison","9","167","Texas","5/7/20","102","65","48203","63.73"
"Hartley","0","7","Texas","5/7/20","4","3","48205","75"
"Hays","2","176","Texas","5/7/20","165","11","48209","6.67"
"Hemphill","0","1","Texas","5/7/20","1","0","48211","0"
"Henderson","1","34","Texas","5/7/20","25","9","48213","36"
"Hidalgo","5","359","Texas","5/7/20","324","35","48215","10.8"
"Hill","0","18","Texas","5/7/20","16","2","48217","12.5"
"Hockley","0","19","Texas","5/7/20","20","-1","48219","-5"
"Hood","0","20","Texas","5/7/20","19","1","48221","5.26"
"Hopkins","0","7","Texas","5/7/20","4","3","48223","75"
"Houston","1","10","Texas","5/7/20","5","5","48225","100"
"Howard","0","6","Texas","5/7/20","4","2","48227","50"
"Hunt","1","54","Texas","5/7/20","44","10","48231","22.73"
"Hutchinson","1","19","Texas","5/7/20","14","5","48233","35.71"
"Jack","0","4","Texas","5/7/20","4","0","48237","0"
"Jackson","1","14","Texas","5/7/20","6","8","48239","133.33"
"Jasper","-1","18","Texas","5/7/20","22","-4","48241","-18.18"
"Jefferson","4","336","Texas","5/7/20","305","31","48245","10.16"
"Jim Hogg","0","3","Texas","5/7/20","3","0","48247","0"
"Jim Wells","0","5","Texas","5/7/20","3","2","48249","66.67"
"Johnson","4","97","Texas","5/7/20","69","28","48251","40.58"
"Jones","7","84","Texas","5/7/20","37","47","48253","127.03"
"Karnes","0","3","Texas","5/7/20","3","0","48255","0"
"Kaufman","3","106","Texas","5/7/20","86","20","48257","23.26"
"Kendall","0","18","Texas","5/7/20","16","2","48259","12.5"
"Kerr","0","6","Texas","5/7/20","5","1","48265","20"
"Kleberg","0","10","Texas","5/7/20","9","1","48273","11.11"
"Knox","0","1","Texas","5/7/20","1","0","48275","0"
"La Salle","0","1","Texas","5/7/20","1","0","48283","0"
"Lamar","4","76","Texas","5/7/20","51","25","48277","49.02"
"Lamb","0","5","Texas","5/7/20","3","2","48279","66.67"
"Lampasas","0","6","Texas","5/7/20","3","3","48281","100"
"Lavaca","0","6","Texas","5/7/20","6","0","48285","0"
"Lee","0","2","Texas","5/7/20","2","0","48287","0"
"Leon","0","7","Texas","5/7/20","5","2","48289","40"
"Liberty","1","48","Texas","5/7/20","42","6","48291","14.29"
"Limestone","0","13","Texas","5/7/20","13","0","48293","0"
"Lipscomb","0","2","Texas","5/7/20","2","0","48295","0"
"Live Oak","0","5","Texas","5/7/20","5","0","48297","0"
"Llano","0","3","Texas","5/7/20","3","0","48299","0"
"Lubbock","8","575","Texas","5/7/20","516","59","48303","11.43"
"Lynn","0","5","Texas","5/7/20","5","0","48305","0"
"Madison","0","2","Texas","5/7/20","2","0","48313","0"
"Marion","0","15","Texas","5/7/20","13","2","48315","15.38"
"Martin","0","3","Texas","5/7/20","2","1","48317","50"
"Mason","2","28","Texas","5/7/20","15","13","48319","86.67"
"Matagorda","1","64","Texas","5/7/20","60","4","48321","6.67"
"Maverick","0","26","Texas","5/7/20","24","2","48323","8.33"
"McCulloch","0","3","Texas","5/7/20","3","0","48307","0"
"McLennan","1","92","Texas","5/7/20","88","4","48309","4.55"
"Medina","0","21","Texas","5/7/20","20","1","48325","5"
"Midland","3","94","Texas","5/7/20","76","18","48329","23.68"
"Milam","0","18","Texas","5/7/20","16","2","48331","12.5"
"Mitchell","0","1","Texas","5/7/20","1","0","48335","0"
"Montague","0","9","Texas","5/7/20","6","3","48337","50"
"Montgomery","12","689","Texas","5/7/20","602","87","48339","14.45"
"Moore","18","454","Texas","5/7/20","327","127","48341","38.84"
"Morris","1","9","Texas","5/7/20","5","4","48343","80"
"Motley","0","1","Texas","5/7/20","1","0","48345","0"
"Nacogdoches","6","202","Texas","5/7/20","157","45","48347","28.66"
"Navarro","1","34","Texas","5/7/20","30","4","48349","13.33"
"Newton","0","4","Texas","5/7/20","2","2","48351","100"
"Nolan","0","2","Texas","5/7/20","1","1","48353","100"
"Nueces","3","117","Texas","5/7/20","99","18","48355","18.18"
"Ochiltree","0","28","Texas","5/7/20","25","3","48357","12"
"Oldham","0","3","Texas","5/7/20","3","0","48359","0"
"Orange","2","81","Texas","5/7/20","70","11","48361","15.71"
"Palo Pinto","0","9","Texas","5/7/20","7","2","48363","28.57"
"Panola","5","139","Texas","5/7/20","107","32","48365","29.91"
"Parker","2","43","Texas","5/7/20","30","13","48367","43.33"
"Parmer","2","17","Texas","5/7/20","6","11","48369","183.33"
"Pecos","1","14","Texas","5/7/20","9","5","48371","55.56"
"Polk","2","30","Texas","5/7/20","19","11","48373","57.89"
"Potter","67","971","Texas","5/7/20","499","472","48375","94.59"
"Rains","0","2","Texas","5/7/20","2","0","48379","0"
"Randall","17","333","Texas","5/7/20","213","120","48381","56.34"
"Red River","0","2","Texas","5/7/20","1","1","48387","100"
"Reeves","0","5","Texas","5/7/20","5","0","48389","0"
"Refugio","0","1","Texas","5/7/20","0","1","48391","1"
"Roberts","0","2","Texas","5/7/20","2","0","48393","0"
"Robertson","0","5","Texas","5/7/20","4","1","48395","25"
"Rockwall","3","96","Texas","5/7/20","75","21","48397","28"
"Runnels","0","2","Texas","5/7/20","1","1","48399","100"
"Rusk","1","40","Texas","5/7/20","35","5","48401","14.29"
"Sabine","0","2","Texas","5/7/20","1","1","48403","100"
"San Augustine","1","21","Texas","5/7/20","16","5","48405","31.25"
"San Jacinto","0","10","Texas","5/7/20","9","1","48407","11.11"
"San Patricio","0","16","Texas","5/7/20","13","3","48409","23.08"
"Scurry","0","2","Texas","5/7/20","2","0","48415","0"
"Shackelford","0","1","Texas","5/7/20","0","1","48417","1"
"Shelby","5","144","Texas","5/7/20","106","38","48419","35.85"
"Sherman","1","19","Texas","5/7/20","15","4","48421","26.67"
"Smith","3","165","Texas","5/7/20","142","23","48423","16.2"
"Starr","0","10","Texas","5/7/20","9","1","48427","11.11"
"Stephens","0","1","Texas","5/7/20","1","0","48429","0"
"Swisher","0","11","Texas","5/7/20","9","2","48437","22.22"
"Tarrant","101","2956","Texas","5/7/20","2246","710","48439","31.61"
"Taylor","-12","206","Texas","5/7/20","291","-85","48441","-29.21"
"Terry","0","12","Texas","5/7/20","11","1","48445","9.09"
"Titus","2","27","Texas","5/7/20","16","11","48449","68.75"
"Tom Green","5","84","Texas","5/7/20","49","35","48451","71.43"
"Travis","50","2002","Texas","5/7/20","1654","348","48453","21.04"
"Trinity","0","10","Texas","5/7/20","8","2","48455","25"
"Tyler","0","7","Texas","5/7/20","6","1","48457","16.67"
"Upshur","0","16","Texas","5/7/20","14","2","48459","14.29"
"Uvalde","0","6","Texas","5/7/20","6","0","48463","0"
"Val Verde","0","13","Texas","5/7/20","13","0","48465","0"
"Van Zandt","1","18","Texas","5/7/20","14","4","48467","28.57"
"Victoria","2","146","Texas","5/7/20","132","14","48469","10.61"
"Walker","10","315","Texas","5/7/20","245","70","48471","28.57"
"Waller","1","37","Texas","5/7/20","32","5","48473","15.62"
"Washington","2","153","Texas","5/7/20","142","11","48477","7.75"
"Webb","7","410","Texas","5/7/20","358","52","48479","14.53"
"Wharton","0","40","Texas","5/7/20","37","3","48481","8.11"
"Wheeler","1","12","Texas","5/7/20","7","5","48483","71.43"
"Wichita","1","70","Texas","5/7/20","65","5","48485","7.69"
"Wilbarger","0","2","Texas","5/7/20","1","1","48487","100"
"Willacy","0","14","Texas","5/7/20","13","1","48489","7.69"
"Williamson","7","352","Texas","5/7/20","301","51","48491","16.94"
"Wilson","0","34","Texas","5/7/20","32","2","48493","6.25"
"Winkler","0","3","Texas","5/7/20","3","0","48495","0"
"Wise","2","28","Texas","5/7/20","17","11","48497","64.71"
"Wood","0","11","Texas","5/7/20","8","3","48499","37.5"
"Yoakum","0","2","Texas","5/7/20","1","1","48501","100"
"Young","0","4","Texas","5/7/20","4","0","48503","0"
"Zapata","0","7","Texas","5/7/20","7","0","48505","0"
"Zavala","0","1","Texas","5/7/20","1","0","48507","0"
"Bear River","1","64","Utah","5/7/20","60","4","00000","6.67"
"Central Utah","1","27","Utah","5/7/20","23","4","00000","17.39"
"Davis","4","315","Utah","5/7/20","285","30","49011","10.53"
"Salt Lake","82","3010","Utah","5/7/20","2438","572","49035","23.46"
"San Juan","12","132","Utah","5/7/20","46","86","49037","186.96"
"Southeast Utah","0","12","Utah","5/7/20","12","0","00000","0"
"Southwest Utah","5","132","Utah","5/7/20","98","34","00000","34.69"
"Summit","2","382","Utah","5/7/20","369","13","49043","3.52"
"Tooele","1","71","Utah","5/7/20","65","6","49045","9.23"
"TriCounty","0","14","Utah","5/7/20","13","1","00000","7.69"
"Utah","37","1219","Utah","5/7/20","957","262","49049","27.38"
"Wasatch","4","173","Utah","5/7/20","148","25","49051","16.89"
"Weber-Morgan","2","173","Utah","5/7/20","158","15","00000","9.49"
"Addison","0","61","Vermont","5/7/20","61","0","50001","0"
"Bennington","1","53","Vermont","5/7/20","44","9","50003","20.45"
"Caledonia","0","14","Vermont","5/7/20","13","1","50005","7.69"
"Chittenden","2","431","Vermont","5/7/20","418","13","50007","3.11"
"Essex","0","2","Vermont","5/7/20","2","0","50009","0"
"Franklin","1","99","Vermont","5/7/20","91","8","50011","8.79"
"Grand Isle","0","4","Vermont","5/7/20","3","1","50013","33.33"
"Lamoille","0","26","Vermont","5/7/20","26","0","50015","0"
"Orange","0","8","Vermont","5/7/20","7","1","50017","14.29"
"Orleans","0","9","Vermont","5/7/20","9","0","50019","0"
"Rutland","1","49","Vermont","5/7/20","45","4","50021","8.89"
"Washington","1","37","Vermont","5/7/20","33","4","50023","12.12"
"Windham","0","73","Vermont","5/7/20","71","2","50025","2.82"
"Windsor","1","46","Vermont","5/7/20","40","6","50027","15"
"","0","66","Virgin Islands","5/7/20","66","0",,"0"
"Accomack","28","463","Virginia","5/7/20","264","199","51001","75.38"
"Albemarle","1","112","Virginia","5/7/20","103","9","51003","8.74"
"Alexandria","44","1060","Virginia","5/7/20","754","306","51510","40.58"
"Alleghany","0","6","Virginia","5/7/20","6","0","51005","0"
"Amelia","0","17","Virginia","5/7/20","15","2","51007","13.33"
"Amherst","0","15","Virginia","5/7/20","12","3","51009","25"
"Appomattox","0","21","Virginia","5/7/20","20","1","51011","5"
"Arlington","40","1248","Virginia","5/7/20","967","281","51013","29.06"
"Augusta","2","55","Virginia","5/7/20","43","12","51015","27.91"
"Bedford","1","37","Virginia","5/7/20","30","7","51019","23.33"
"Botetourt","0","29","Virginia","5/7/20","28","1","51023","3.57"
"Bristol","0","2","Virginia","5/7/20","1","1","51520","100"
"Brunswick","0","16","Virginia","5/7/20","14","2","51025","14.29"
"Buchanan","0","16","Virginia","5/7/20","16","0","51027","0"
"Buckingham","24","225","Virginia","5/7/20","58","167","51029","287.93"
"Buena Vista","0","8","Virginia","5/7/20","6","2","51530","33.33"
"Campbell","0","13","Virginia","5/7/20","12","1","51031","8.33"
"Caroline","1","36","Virginia","5/7/20","27","9","51033","33.33"
"Carroll","2","25","Virginia","5/7/20","11","14","51035","127.27"
"Charles City","1","17","Virginia","5/7/20","13","4","51036","30.77"
"Charlotte","1","11","Virginia","5/7/20","7","4","51037","57.14"
"Charlottesville","1","65","Virginia","5/7/20","56","9","51540","16.07"
"Chesapeake","10","311","Virginia","5/7/20","242","69","51550","28.51"
"Chesterfield","25","707","Virginia","5/7/20","531","176","51041","33.15"
"Clarke","1","16","Virginia","5/7/20","8","8","51043","100"
"Colonial Heights","1","64","Virginia","5/7/20","54","10","51570","18.52"
"Covington","0","0","Virginia","5/7/20","1","-1","51580","-100"
"Craig","0","4","Virginia","5/7/20","3","1","51045","33.33"
"Culpeper","11","217","Virginia","5/7/20","141","76","51047","53.9"
"Cumberland","0","12","Virginia","5/7/20","13","-1","51049","-7.69"
"Danville","0","38","Virginia","5/7/20","35","3","51590","8.57"
"Dinwiddie","1","25","Virginia","5/7/20","16","9","51053","56.25"
"Emporia","3","47","Virginia","5/7/20","23","24","51595","104.35"
"Essex","2","18","Virginia","5/7/20","7","11","51057","157.14"
"Fairfax","205","5045","Virginia","5/7/20","3611","1434","51059","39.71"
"Fairfax City","1","35","Virginia","5/7/20","27","8","51600","29.63"
"Falls Church","1","36","Virginia","5/7/20","26","10","51610","38.46"
"Fauquier","5","149","Virginia","5/7/20","111","38","51061","34.23"
"Floyd","0","3","Virginia","5/7/20","2","1","51063","50"
"Fluvanna","1","78","Virginia","5/7/20","73","5","51065","6.85"
"Franklin","0","24","Virginia","5/7/20","21","3","51067","14.29"
"Franklin City","0","23","Virginia","5/7/20","20","3","51620","15"
"Frederick","6","147","Virginia","5/7/20","105","42","51069","40"
"Fredericksburg","3","52","Virginia","5/7/20","33","19","51630","57.58"
"Galax","4","32","Virginia","5/7/20","4","28","51640","700"
"Giles","0","4","Virginia","5/7/20","4","0","51071","0"
"Gloucester","1","27","Virginia","5/7/20","23","4","51073","17.39"
"Goochland","1","81","Virginia","5/7/20","76","5","51075","6.58"
"Grayson","0","5","Virginia","5/7/20","2","3","51077","150"
"Greene","0","13","Virginia","5/7/20","10","3","51079","30"
"Greensville","1","44","Virginia","5/7/20","39","5","51081","12.82"
"Halifax","0","19","Virginia","5/7/20","18","1","51083","5.56"
"Hampton","2","131","Virginia","5/7/20","115","16","51650","13.91"
"Hanover","5","154","Virginia","5/7/20","118","36","51085","30.51"
"Harrisonburg","18","552","Virginia","5/7/20","426","126","51660","29.58"
"Henrico","21","1025","Virginia","5/7/20","876","149","51087","17.01"
"Henry","1","20","Virginia","5/7/20","16","4","51089","25"
"Highland","0","2","Virginia","5/7/20","2","0","51091","0"
"Hopewell","1","33","Virginia","5/7/20","24","9","51670","37.5"
"Isle of Wight","1","103","Virginia","5/7/20","99","4","51093","4.04"
"James City","1","167","Virginia","5/7/20","158","9","51095","5.7"
"King and Queen","0","4","Virginia","5/7/20","2","2","51097","100"
"King George","1","38","Virginia","5/7/20","32","6","51099","18.75"
"King William","1","11","Virginia","5/7/20","5","6","51101","120"
"Lancaster","1","6","Virginia","5/7/20","2","4","51103","200"
"Lee","0","10","Virginia","5/7/20","9","1","51105","11.11"
"Lexington","0","5","Virginia","5/7/20","3","2","51678","66.67"
"Loudoun","42","1043","Virginia","5/7/20","746","297","51107","39.81"
"Louisa","1","51","Virginia","5/7/20","43","8","51109","18.6"
"Lunenburg","0","4","Virginia","5/7/20","4","0","51111","0"
"Lynchburg","2","68","Virginia","5/7/20","53","15","51680","28.3"
"Madison","1","18","Virginia","5/7/20","14","4","51113","28.57"
"Manassas","17","332","Virginia","5/7/20","216","116","51683","53.7"
"Manassas Park","6","106","Virginia","5/7/20","61","45","51685","73.77"
"Martinsville","0","2","Virginia","5/7/20","2","0","51690","0"
"Mathews","0","4","Virginia","5/7/20","4","0","51115","0"
"Mecklenburg","1","109","Virginia","5/7/20","100","9","51117","9"
"Middlesex","0","7","Virginia","5/7/20","8","-1","51119","-12.5"
"Montgomery","1","61","Virginia","5/7/20","56","5","51121","8.93"
"Nelson","0","9","Virginia","5/7/20","8","1","51125","12.5"
"New Kent","0","26","Virginia","5/7/20","23","3","51127","13.04"
"Newport News","3","137","Virginia","5/7/20","118","19","51700","16.1"
"Norfolk","10","270","Virginia","5/7/20","198","72","51710","36.36"
"Northampton","12","149","Virginia","5/7/20","64","85","51131","132.81"
"Northumberland","0","9","Virginia","5/7/20","9","0","51133","0"
"Norton","0","2","Virginia","5/7/20","2","0","51720","0"
"Nottoway","0","14","Virginia","5/7/20","12","2","51135","16.67"
"Orange","2","43","Virginia","5/7/20","31","12","51137","38.71"
"Page","3","122","Virginia","5/7/20","100","22","51139","22"
"Patrick","0","4","Virginia","5/7/20","2","2","51141","100"
"Petersburg","1","41","Virginia","5/7/20","31","10","51730","32.26"
"Pittsylvania","1","17","Virginia","5/7/20","13","4","51143","30.77"
"Poquoson","0","7","Virginia","5/7/20","6","1","51735","16.67"
"Portsmouth","5","193","Virginia","5/7/20","158","35","51740","22.15"
"Powhatan","1","17","Virginia","5/7/20","13","4","51145","30.77"
"Prince Edward","2","63","Virginia","5/7/20","49","14","51147","28.57"
"Prince George","1","42","Virginia","5/7/20","33","9","51149","27.27"
"Prince William","108","2398","Virginia","5/7/20","1645","753","51153","45.78"
"Pulaski","0","9","Virginia","5/7/20","9","0","51155","0"
"Radford","0","3","Virginia","5/7/20","3","0","51750","0"
"Rappahannock","0","7","Virginia","5/7/20","5","2","51157","40"
"Richmond","6","187","Virginia","5/7/20","144","43","51159","29.86"
"Richmond City","19","473","Virginia","5/7/20","339","134","51760","39.53"
"Roanoke","1","60","Virginia","5/7/20","51","9","51161","17.65"
"Roanoke City","2","88","Virginia","5/7/20","73","15","51770","20.55"
"Rockbridge","0","8","Virginia","5/7/20","6","2","51163","33.33"
"Rockingham","10","310","Virginia","5/7/20","240","70","51165","29.17"
"Russell","0","6","Virginia","5/7/20","3","3","51167","100"
"Salem","1","30","Virginia","5/7/20","26","4","51775","15.38"
"Scott","0","7","Virginia","5/7/20","7","0","51169","0"
"Shenandoah","15","213","Virginia","5/7/20","108","105","51171","97.22"
"Smyth","0","13","Virginia","5/7/20","13","0","51173","0"
"Southampton","0","128","Virginia","5/7/20","125","3","51175","2.4"
"Spotsylvania","12","230","Virginia","5/7/20","143","87","51177","60.84"
"Stafford","13","334","Virginia","5/7/20","240","94","51179","39.17"
"Staunton","0","14","Virginia","5/7/20","12","2","51790","16.67"
"Suffolk","6","208","Virginia","5/7/20","169","39","51800","23.08"
"Surry","0","4","Virginia","5/7/20","4","0","51181","0"
"Sussex","0","32","Virginia","5/7/20","31","1","51183","3.23"
"Tazewell","0","6","Virginia","5/7/20","6","0","51185","0"
"Virginia Beach","10","454","Virginia","5/7/20","385","69","51810","17.92"
"Warren","3","75","Virginia","5/7/20","52","23","51187","44.23"
"Washington","1","41","Virginia","5/7/20","36","5","51191","13.89"
"Waynesboro","1","20","Virginia","5/7/20","11","9","51820","81.82"
"Westmoreland","2","33","Virginia","5/7/20","21","12","51193","57.14"
"Williamsburg","2","29","Virginia","5/7/20","18","11","51830","61.11"
"Winchester","3","61","Virginia","5/7/20","37","24","51840","64.86"
"Wise","0","22","Virginia","5/7/20","22","0","51195","0"
"Wythe","0","12","Virginia","5/7/20","11","1","51197","9.09"
"York","1","51","Virginia","5/7/20","46","5","51199","10.87"
"Adams","0","49","Washington","5/7/20","47","2","53001","4.26"
"Asotin","0","18","Washington","5/7/20","18","0","53003","0"
"Benton","17","550","Washington","5/7/20","430","120","53005","27.91"
"Chelan","4","139","Washington","5/7/20","108","31","53007","28.7"
"Clallam","0","19","Washington","5/7/20","18","1","53009","5.56"
"Clark","3","342","Washington","5/7/20","321","21","53011","6.54"
"Columbia","0","1","Washington","5/7/20","1","0","53013","0"
"Cowlitz","2","62","Washington","5/7/20","45","17","53015","37.78"
"Douglas","3","98","Washington","5/7/20","78","20","53017","25.64"
"Ferry","0","1","Washington","5/7/20","1","0","53019","0"
"Franklin","17","401","Washington","5/7/20","279","122","53021","43.73"
"Grant","3","179","Washington","5/7/20","159","20","53025","12.58"
"Grays Harbor","0","13","Washington","5/7/20","12","1","53027","8.33"
"Island","1","173","Washington","5/7/20","168","5","53029","2.98"
"Jefferson","0","28","Washington","5/7/20","28","0","53031","0"
"King","86","6809","Washington","5/7/20","6207","602","53033","9.7"
"Kitsap","1","154","Washington","5/7/20","149","5","53035","3.36"
"Kittitas","0","15","Washington","5/7/20","14","1","53037","7.14"
"Klickitat","0","19","Washington","5/7/20","17","2","53039","11.76"
"Lewis","0","30","Washington","5/7/20","29","1","53041","3.45"
"Lincoln","0","2","Washington","5/7/20","2","0","53043","0"
"Mason","1","28","Washington","5/7/20","23","5","53045","21.74"
"Okanogan","0","21","Washington","5/7/20","22","-1","53047","-4.55"
"Pacific","0","4","Washington","5/7/20","4","0","53049","0"
"Pend Oreille","0","2","Washington","5/7/20","2","0","53051","0"
"Pierce","25","1496","Washington","5/7/20","1322","174","53053","13.16"
"San Juan","0","14","Washington","5/7/20","14","0","53055","0"
"Skagit","9","389","Washington","5/7/20","329","60","53057","18.24"
"Skamania","0","3","Washington","5/7/20","3","0","53059","0"
"Snohomish","28","2627","Washington","5/7/20","2433","194","53061","7.97"
"Spokane","3","380","Washington","5/7/20","357","23","53063","6.44"
"Stevens","0","9","Washington","5/7/20","9","0","53065","0"
"Thurston","1","115","Washington","5/7/20","105","10","53067","9.52"
"Wahkiakum","0","2","Washington","5/7/20","2","0","53069","0"
"Walla Walla","4","97","Washington","5/7/20","67","30","53071","44.78"
"Whatcom","4","328","Washington","5/7/20","302","26","53073","8.61"
"Whitman","0","14","Washington","5/7/20","14","0","53075","0"
"Yakima","60","1547","Washington","5/7/20","1128","419","53077","37.15"
"Barbour","0","6","West Virginia","5/7/20","5","1","54001","20"
"Berkeley","4","173","West Virginia","5/7/20","145","28","54003","19.31"
"Boone","0","6","West Virginia","5/7/20","3","3","54005","100"
"Braxton","0","2","West Virginia","5/7/20","2","0","54007","0"
"Brooke","0","3","West Virginia","5/7/20","3","0","54009","0"
"Cabell","1","48","West Virginia","5/7/20","42","6","54011","14.29"
"Fayette","2","28","West Virginia","5/7/20","13","15","54019","115.38"
"Gilmer","0","3","West Virginia","5/7/20","2","1","54021","50"
"Grant","0","3","West Virginia","5/7/20","1","2","54023","200"
"Greenbrier","1","8","West Virginia","5/7/20","3","5","54025","166.67"
"Hampshire","0","8","West Virginia","5/7/20","7","1","54027","14.29"
"Hancock","0","11","West Virginia","5/7/20","10","1","54029","10"
"Hardy","1","12","West Virginia","5/7/20","5","7","54031","140"
"Harrison","0","33","West Virginia","5/7/20","30","3","54033","10"
"Jackson","1","136","West Virginia","5/7/20","130","6","54035","4.62"
"Jefferson","1","83","West Virginia","5/7/20","79","4","54037","5.06"
"Kanawha","2","172","West Virginia","5/7/20","160","12","54039","7.5"
"Lewis","0","4","West Virginia","5/7/20","4","0","54041","0"
"Lincoln","0","3","West Virginia","5/7/20","2","1","54043","50"
"Logan","0","15","West Virginia","5/7/20","13","2","54045","15.38"
"Marion","0","46","West Virginia","5/7/20","45","1","54049","2.22"
"Marshall","1","20","West Virginia","5/7/20","12","8","54051","66.67"
"Mason","0","12","West Virginia","5/7/20","12","0","54053","0"
"McDowell","0","6","West Virginia","5/7/20","6","0","54047","0"
"Mercer","0","11","West Virginia","5/7/20","10","1","54055","10"
"Mineral","0","20","West Virginia","5/7/20","17","3","54057","17.65"
"Mingo","0","2","West Virginia","5/7/20","2","0","54059","0"
"Monongalia","1","111","West Virginia","5/7/20","102","9","54061","8.82"
"Monroe","0","6","West Virginia","5/7/20","5","1","54063","20"
"Morgan","1","16","West Virginia","5/7/20","11","5","54065","45.45"
"Nicholas","0","8","West Virginia","5/7/20","6","2","54067","33.33"
"Ohio","1","34","West Virginia","5/7/20","27","7","54069","25.93"
"Pendleton","0","5","West Virginia","5/7/20","3","2","54071","66.67"
"Pleasants","0","2","West Virginia","5/7/20","2","0","54073","0"
"Pocahontas","0","2","West Virginia","5/7/20","2","0","54075","0"
"Preston","0","14","West Virginia","5/7/20","13","1","54077","7.69"
"Putnam","0","27","West Virginia","5/7/20","25","2","54079","8"
"Raleigh","0","9","West Virginia","5/7/20","8","1","54081","12.5"
"Randolph","0","5","West Virginia","5/7/20","4","1","54083","25"
"Ritchie","0","1","West Virginia","5/7/20","0","1","54085","1"
"Roane","0","8","West Virginia","5/7/20","6","2","54087","33.33"
"Summers","0","1","West Virginia","5/7/20","1","0","54089","0"
"Taylor","0","9","West Virginia","5/7/20","6","3","54091","50"
"Tucker","0","4","West Virginia","5/7/20","4","0","54093","0"
"Tyler","0","3","West Virginia","5/7/20","3","0","54095","0"
"Upshur","0","5","West Virginia","5/7/20","4","1","54097","25"
"Wayne","1","93","West Virginia","5/7/20","85","8","54099","9.41"
"Wetzel","0","4","West Virginia","5/7/20","3","1","54103","33.33"
"Wirt","0","3","West Virginia","5/7/20","3","0","54105","0"
"Wood","1","42","West Virginia","5/7/20","38","4","54107","10.53"
"Wyoming","0","1","West Virginia","5/7/20","1","0","54109","0"
"Adams","0","4","Wisconsin","5/7/20","4","0","55001","0"
"Ashland","0","2","Wisconsin","5/7/20","2","0","55003","0"
"Barron","0","7","Wisconsin","5/7/20","6","1","55005","16.67"
"Bayfield","0","3","Wisconsin","5/7/20","3","0","55007","0"
"Brown","93","1706","Wisconsin","5/7/20","1057","649","55009","61.4"
"Buffalo","0","5","Wisconsin","5/7/20","4","1","55011","25"
"Calumet","1","22","Wisconsin","5/7/20","13","9","55015","69.23"
"Chippewa","1","27","Wisconsin","5/7/20","22","5","55017","22.73"
"Clark","0","23","Wisconsin","5/7/20","20","3","55019","15"
"Columbia","1","32","Wisconsin","5/7/20","27","5","55021","18.52"
"Crawford","2","16","Wisconsin","5/7/20","3","13","55023","433.33"
"Dane","3","447","Wisconsin","5/7/20","428","19","55025","4.44"
"Dodge","2","46","Wisconsin","5/7/20","33","13","55027","39.39"
"Door","1","18","Wisconsin","5/7/20","12","6","55029","50"
"Douglas","0","10","Wisconsin","5/7/20","9","1","55031","11.11"
"Dunn","1","14","Wisconsin","5/7/20","9","5","55033","55.56"
"Eau Claire","3","47","Wisconsin","5/7/20","28","19","55035","67.86"
"Florence","0","2","Wisconsin","5/7/20","2","0","55037","0"
"Fond du Lac","2","84","Wisconsin","5/7/20","69","15","55039","21.74"
"Forest","0","1","Wisconsin","5/7/20","0","1","55041","1"
"Grant","4","66","Wisconsin","5/7/20","37","29","55043","78.38"
"Green","1","21","Wisconsin","5/7/20","12","9","55045","75"
"Green Lake","0","5","Wisconsin","5/7/20","2","3","55047","150"
"Iowa","0","10","Wisconsin","5/7/20","7","3","55049","42.86"
"Iron","0","2","Wisconsin","5/7/20","2","0","55051","0"
"Jackson","0","12","Wisconsin","5/7/20","12","0","55053","0"
"Jefferson","1","50","Wisconsin","5/7/20","45","5","55055","11.11"
"Juneau","0","20","Wisconsin","5/7/20","17","3","55057","17.65"
"Kenosha","31","610","Wisconsin","5/7/20","391","219","55059","56.01"
"Kewaunee","2","25","Wisconsin","5/7/20","14","11","55061","78.57"
"La Crosse","1","32","Wisconsin","5/7/20","28","4","55063","14.29"
"Lafayette","1","9","Wisconsin","5/7/20","4","5","55065","125"
"Lincoln","0","1","Wisconsin","5/7/20","0","1","55069","1"
"Manitowoc","1","17","Wisconsin","5/7/20","11","6","55071","54.55"
"Marathon","0","21","Wisconsin","5/7/20","18","3","55073","16.67"
"Marinette","1","13","Wisconsin","5/7/20","8","5","55075","62.5"
"Marquette","0","3","Wisconsin","5/7/20","3","0","55077","0"
"Menominee","0","2","Wisconsin","5/7/20","1","1","55078","100"
"Milwaukee","90","3573","Wisconsin","5/7/20","2940","633","55079","21.53"
"Monroe","0","14","Wisconsin","5/7/20","14","0","55081","0"
"Oconto","2","26","Wisconsin","5/7/20","10","16","55083","160"
"Oneida","0","6","Wisconsin","5/7/20","6","0","55085","0"
"Outagamie","6","93","Wisconsin","5/7/20","54","39","55087","72.22"
"Ozaukee","2","99","Wisconsin","5/7/20","88","11","55089","12.5"
"Pierce","0","12","Wisconsin","5/7/20","10","2","55093","20"
"Polk","0","5","Wisconsin","5/7/20","4","1","55095","25"
"Portage","0","7","Wisconsin","5/7/20","5","2","55097","40"
"Price","0","1","Wisconsin","5/7/20","1","0","55099","0"
"Racine","34","590","Wisconsin","5/7/20","355","235","55101","66.2"
"Richland","0","13","Wisconsin","5/7/20","12","1","55103","8.33"
"Rock","18","324","Wisconsin","5/7/20","198","126","55105","63.64"
"Rusk","0","4","Wisconsin","5/7/20","4","0","55107","0"
"Sauk","3","69","Wisconsin","5/7/20","45","24","55111","53.33"
"Sawyer","0","4","Wisconsin","5/7/20","3","1","55113","33.33"
"Shawano","1","17","Wisconsin","5/7/20","10","7","55115","70"
"Sheboygan","3","65","Wisconsin","5/7/20","47","18","55117","38.3"
"St. Croix","1","23","Wisconsin","5/7/20","16","7","55109","43.75"
"Trempealeau","0","5","Wisconsin","5/7/20","3","2","55121","66.67"
"Vernon","0","2","Wisconsin","5/7/20","1","1","55123","100"
"Vilas","0","4","Wisconsin","5/7/20","4","0","55125","0"
"Walworth","9","226","Wisconsin","5/7/20","161","65","55127","40.37"
"Washburn","0","1","Wisconsin","5/7/20","1","0","55129","0"
"Washington","2","113","Wisconsin","5/7/20","98","15","55131","15.31"
"Waukesha","6","380","Wisconsin","5/7/20","336","44","55133","13.1"
"Waupaca","0","10","Wisconsin","5/7/20","8","2","55135","25"
"Waushara","0","4","Wisconsin","5/7/20","2","2","55137","100"
"Winnebago","5","88","Wisconsin","5/7/20","53","35","55139","66.04"
"Wood","0","2","Wisconsin","5/7/20","2","0","55141","0"
"Albany","0","8","Wyoming","5/7/20","8","0","56001","0"
"Big Horn","0","3","Wyoming","5/7/20","3","0","56003","0"
"Campbell","0","25","Wyoming","5/7/20","24","1","56005","4.17"
"Carbon","0","5","Wyoming","5/7/20","4","1","56007","25"
"Converse","0","23","Wyoming","5/7/20","22","1","56009","4.55"
"Crook","0","5","Wyoming","5/7/20","5","0","56011","0"
"Fremont","7","168","Wyoming","5/7/20","116","52","56013","44.83"
"Goshen","0","4","Wyoming","5/7/20","4","0","56015","0"
"Hot Springs","0","3","Wyoming","5/7/20","3","0","56017","0"
"Johnson","0","15","Wyoming","5/7/20","15","0","56019","0"
"Laramie","3","163","Wyoming","5/7/20","145","18","56021","12.41"
"Lincoln","0","10","Wyoming","5/7/20","9","1","56023","11.11"
"Natrona","0","48","Wyoming","5/7/20","49","-1","56025","-2.04"
"Niobrara","0","2","Wyoming","5/7/20","2","0","56027","0"
"Park","0","1","Wyoming","5/7/20","1","0","56029","0"
"Sheridan","0","16","Wyoming","5/7/20","16","0","56033","0"
"Sublette","0","3","Wyoming","5/7/20","3","0","56035","0"
"Sweetwater","0","19","Wyoming","5/7/20","18","1","56037","5.56"
"Teton","0","98","Wyoming","5/7/20","96","2","56039","2.08"
"Uinta","0","8","Wyoming","5/7/20","8","0","56041","0"
"Washakie","0","8","Wyoming","5/7/20","8","0","56043","0"
