"Locality","DailyAvgNewCasesPast7Days","TotalCases","State","Date","TotalCases7DaysAgo","NewCasesPast7Days","FIPS-Code","PercentIncreaseTotalCasesPast7Days"
"Autauga","5","93","Alabama","5/13/20","58","35","01001","60.34"
"Baldwin","5","231","Alabama","5/13/20","196","35","01003","17.86"
"Barbour","3","69","Alabama","5/13/20","47","22","01005","46.81"
"Bibb","0","46","Alabama","5/13/20","43","3","01007","6.98"
"Blount","0","45","Alabama","5/13/20","42","3","01009","7.14"
"Bullock","1","28","Alabama","5/13/20","18","10","01011","55.56"
"Butler","14","230","Alabama","5/13/20","130","100","01013","76.92"
"Calhoun","2","127","Alabama","5/13/20","114","13","01015","11.4"
"Chambers","3","324","Alabama","5/13/20","306","18","01017","5.88"
"Cherokee","1","24","Alabama","5/13/20","18","6","01019","33.33"
"Chilton","2","73","Alabama","5/13/20","61","12","01021","19.67"
"Choctaw","3","72","Alabama","5/13/20","54","18","01023","33.33"
"Clarke","3","65","Alabama","5/13/20","45","20","01025","44.44"
"Clay","0","27","Alabama","5/13/20","25","2","01027","8"
"Cleburne","0","13","Alabama","5/13/20","13","0","01029","0"
"Coffee","3","158","Alabama","5/13/20","138","20","01031","14.49"
"Colbert","4","74","Alabama","5/13/20","44","30","01033","68.18"
"Conecuh","1","16","Alabama","5/13/20","9","7","01035","77.78"
"Coosa","0","33","Alabama","5/13/20","31","2","01037","6.45"
"Covington","1","56","Alabama","5/13/20","46","10","01039","21.74"
"Crenshaw","3","48","Alabama","5/13/20","28","20","01041","71.43"
"Cullman","1","67","Alabama","5/13/20","59","8","01043","13.56"
"Dale","3","53","Alabama","5/13/20","34","19","01045","55.88"
"Dallas","8","129","Alabama","5/13/20","76","53","01047","69.74"
"DeKalb","10","179","Alabama","5/13/20","109","70","01049","64.22"
"Elmore","5","157","Alabama","5/13/20","121","36","01051","29.75"
"Escambia","1","38","Alabama","5/13/20","30","8","01053","26.67"
"Etowah","6","197","Alabama","5/13/20","158","39","01055","24.68"
"Fayette","0","9","Alabama","5/13/20","6","3","01057","50"
"Franklin","15","270","Alabama","5/13/20","164","106","01059","64.63"
"Geneva","1","17","Alabama","5/13/20","11","6","01061","54.55"
"Greene","1","74","Alabama","5/13/20","64","10","01063","15.62"
"Hale","2","74","Alabama","5/13/20","60","14","01065","23.33"
"Henry","1","33","Alabama","5/13/20","27","6","01067","22.22"
"Houston","2","115","Alabama","5/13/20","99","16","01069","16.16"
"Jackson","1","60","Alabama","5/13/20","53","7","01071","13.21"
"Jefferson","22","1199","Alabama","5/13/20","1048","151","01073","14.41"
"Lamar","0","14","Alabama","5/13/20","13","1","01075","7.69"
"Lauderdale","4","102","Alabama","5/13/20","71","31","01077","43.66"
"Lawrence","1","26","Alabama","5/13/20","17","9","01079","52.94"
"Lee","4","436","Alabama","5/13/20","410","26","01081","6.34"
"Limestone","2","60","Alabama","5/13/20","49","11","01083","22.45"
"Lowndes","4","111","Alabama","5/13/20","82","29","01085","35.37"
"Macon","2","53","Alabama","5/13/20","42","11","01087","26.19"
"Madison","3","259","Alabama","5/13/20","238","21","01089","8.82"
"Marengo","3","91","Alabama","5/13/20","68","23","01091","33.82"
"Marion","1","100","Alabama","5/13/20","92","8","01093","8.7"
"Marshall","17","586","Alabama","5/13/20","470","116","01095","24.68"
"Mobile","33","1545","Alabama","5/13/20","1311","234","01097","17.85"
"Monroe","0","18","Alabama","5/13/20","15","3","01099","20"
"Montgomery","33","705","Alabama","5/13/20","477","228","01101","47.8"
"Morgan","3","99","Alabama","5/13/20","81","18","01103","22.22"
"Perry","0","19","Alabama","5/13/20","16","3","01105","18.75"
"Pickens","2","70","Alabama","5/13/20","58","12","01107","20.69"
"Pike","3","102","Alabama","5/13/20","84","18","01109","21.43"
"Randolph","4","117","Alabama","5/13/20","91","26","01111","28.57"
"Russell","3","88","Alabama","5/13/20","66","22","01113","33.33"
"Shelby","6","381","Alabama","5/13/20","339","42","01117","12.39"
"St. Clair","1","87","Alabama","5/13/20","77","10","01115","12.99"
"Sumter","3","110","Alabama","5/13/20","87","23","01119","26.44"
"Talladega","1","76","Alabama","5/13/20","67","9","01121","13.43"
"Tallapoosa","5","338","Alabama","5/13/20","304","34","01123","11.18"
"Tuscaloosa","8","302","Alabama","5/13/20","248","54","01125","21.77"
"Walker","1","111","Alabama","5/13/20","101","10","01127","9.9"
"Washington","2","57","Alabama","5/13/20","42","15","01129","35.71"
"Wilcox","2","89","Alabama","5/13/20","73","16","01131","21.92"
"Winston","1","25","Alabama","5/13/20","17","8","01133","47.06"
"Anchorage","1","194","Alaska","5/13/20","190","4","02020","2.11"
"Bethel","0","1","Alaska","5/13/20","1","0","02050","0"
"Fairbanks North Star","0","84","Alaska","5/13/20","83","1","02090","1.2"
"Juneau","0","27","Alaska","5/13/20","27","0","02110","0"
"Kenai Peninsula","0","24","Alaska","5/13/20","22","2","02122","9.09"
"Ketchikan Gateway","0","16","Alaska","5/13/20","16","0","02130","0"
"Kodiak Island","0","1","Alaska","5/13/20","1","0","02150","0"
"Matanuska-Susitna","0","21","Alaska","5/13/20","21","0","02170","0"
"Nome","0","1","Alaska","5/13/20","1","0","02180","0"
"Petersburg","0","4","Alaska","5/13/20","4","0","02195","0"
"Prince of Wales-Hyder","0","2","Alaska","5/13/20","2","0","02198","0"
"Sitka","0","1","Alaska","5/13/20","1","0","02220","0"
"Southeast Fairbanks","0","2","Alaska","5/13/20","2","0","02240","0"
"Yukon-Koyukuk","0","1","Alaska","5/13/20","1","0","02290","0"
"Apache","29","817","Arizona","5/13/20","612","205","04001","33.5"
"Cochise","0","43","Arizona","5/13/20","40","3","04003","7.5"
"Coconino","26","772","Arizona","5/13/20","588","184","04005","31.29"
"Gila","1","19","Arizona","5/13/20","15","4","04007","26.67"
"Graham","0","21","Arizona","5/13/20","19","2","04009","10.53"
"Greenlee","0","2","Arizona","5/13/20","2","0","04011","0"
"La Paz","1","25","Arizona","5/13/20","18","7","04012","38.89"
"Maricopa","172","6341","Arizona","5/13/20","5138","1203","04013","23.41"
"Mohave","9","213","Arizona","5/13/20","150","63","04015","42"
"Navajo","30","1099","Arizona","5/13/20","892","207","04017","23.21"
"Pima","34","1661","Arizona","5/13/20","1425","236","04019","16.56"
"Pinal","21","643","Arizona","5/13/20","497","146","04021","29.38"
"Santa Cruz","2","50","Arizona","5/13/20","37","13","04023","35.14"
"Yavapai","12","227","Arizona","5/13/20","140","87","04025","62.14"
"Yuma","21","283","Arizona","5/13/20","134","149","04027","111.19"
"Arkansas","0","2","Arkansas","5/13/20","2","0","05001","0"
"Ashley","0","18","Arkansas","5/13/20","17","1","05003","5.88"
"Baxter","0","5","Arkansas","5/13/20","5","0","05005","0"
"Benton","3","131","Arkansas","5/13/20","111","20","05007","18.02"
"Boone","0","4","Arkansas","5/13/20","4","0","05009","0"
"Bradley","0","12","Arkansas","5/13/20","11","1","05011","9.09"
"Carroll","0","6","Arkansas","5/13/20","6","0","05015","0"
"Chicot","0","10","Arkansas","5/13/20","10","0","05017","0"
"Clark","0","35","Arkansas","5/13/20","32","3","05019","9.38"
"Clay","0","3","Arkansas","5/13/20","3","0","05021","0"
"Cleburne","0","72","Arkansas","5/13/20","72","0","05023","0"
"Cleveland","1","15","Arkansas","5/13/20","11","4","05025","36.36"
"Columbia","0","15","Arkansas","5/13/20","15","0","05027","0"
"Conway","0","14","Arkansas","5/13/20","13","1","05029","7.69"
"Craighead","4","113","Arkansas","5/13/20","88","25","05031","28.41"
"Crawford","1","8","Arkansas","5/13/20","4","4","05033","100"
"Crittenden","2","216","Arkansas","5/13/20","202","14","05035","6.93"
"Cross","1","34","Arkansas","5/13/20","27","7","05037","25.93"
"Dallas","0","1","Arkansas","5/13/20","1","0","05039","0"
"Desha","0","17","Arkansas","5/13/20","17","0","05041","0"
"Drew","0","19","Arkansas","5/13/20","19","0","05043","0"
"Faulkner","1","83","Arkansas","5/13/20","78","5","05045","6.41"
"Franklin","0","2","Arkansas","5/13/20","2","0","05047","0"
"Fulton","0","3","Arkansas","5/13/20","3","0","05049","0"
"Garland","1","121","Arkansas","5/13/20","117","4","05051","3.42"
"Grant","0","16","Arkansas","5/13/20","14","2","05053","14.29"
"Greene","0","24","Arkansas","5/13/20","21","3","05055","14.29"
"Hempstead","0","7","Arkansas","5/13/20","7","0","05057","0"
"Hot Spring","1","28","Arkansas","5/13/20","22","6","05059","27.27"
"Howard","0","14","Arkansas","5/13/20","14","0","05061","0"
"Independence","1","19","Arkansas","5/13/20","11","8","05063","72.73"
"Izard","0","13","Arkansas","5/13/20","11","2","05065","18.18"
"Jackson","0","1","Arkansas","5/13/20","1","0","05067","0"
"Jefferson","9","280","Arkansas","5/13/20","217","63","05069","29.03"
"Johnson","1","35","Arkansas","5/13/20","31","4","05071","12.9"
"Lafayette","0","9","Arkansas","5/13/20","9","0","05073","0"
"Lawrence","0","71","Arkansas","5/13/20","69","2","05075","2.9"
"Lee","1","9","Arkansas","5/13/20","4","5","05077","125"
"Lincoln","8","942","Arkansas","5/13/20","883","59","05079","6.68"
"Logan","0","4","Arkansas","5/13/20","3","1","05083","33.33"
"Lonoke","0","43","Arkansas","5/13/20","44","-1","05085","-2.27"
"Madison","0","1","Arkansas","5/13/20","1","0","05087","0"
"Marion","0","1","Arkansas","5/13/20","1","0","05089","0"
"Miller","1","40","Arkansas","5/13/20","35","5","05091","14.29"
"Mississippi","2","54","Arkansas","5/13/20","42","12","05093","28.57"
"Monroe","0","5","Arkansas","5/13/20","4","1","05095","25"
"Montgomery","0","1","Arkansas","5/13/20","1","0","05097","0"
"Nevada","0","3","Arkansas","5/13/20","2","1","05099","50"
"Newton","0","3","Arkansas","5/13/20","3","0","05101","0"
"Ouachita","0","9","Arkansas","5/13/20","7","2","05103","28.57"
"Perry","0","8","Arkansas","5/13/20","7","1","05105","14.29"
"Phillips","0","4","Arkansas","5/13/20","5","-1","05107","-20"
"Pike","0","3","Arkansas","5/13/20","3","0","05109","0"
"Poinsett","0","25","Arkansas","5/13/20","25","0","05111","0"
"Polk","0","7","Arkansas","5/13/20","7","0","05113","0"
"Pope","1","51","Arkansas","5/13/20","46","5","05115","10.87"
"Prairie","0","2","Arkansas","5/13/20","2","0","05117","0"
"Pulaski","10","647","Arkansas","5/13/20","576","71","05119","12.33"
"Randolph","0","22","Arkansas","5/13/20","21","1","05121","4.76"
"Saline","1","76","Arkansas","5/13/20","67","9","05125","13.43"
"Scott","0","1","Arkansas","5/13/20","1","0","05127","0"
"Searcy","0","6","Arkansas","5/13/20","6","0","05129","0"
"Sebastian","0","15","Arkansas","5/13/20","14","1","05131","7.14"
"Sevier","1","24","Arkansas","5/13/20","14","10","05133","71.43"
"Sharp","3","26","Arkansas","5/13/20","7","19","05135","271.43"
"St. Francis","30","310","Arkansas","5/13/20","98","212","05123","216.33"
"Stone","0","8","Arkansas","5/13/20","8","0","05137","0"
"Union","2","84","Arkansas","5/13/20","67","17","05139","25.37"
"Van Buren","0","28","Arkansas","5/13/20","28","0","05141","0"
"Washington","3","114","Arkansas","5/13/20","94","20","05143","21.28"
"White","0","36","Arkansas","5/13/20","35","1","05145","2.86"
"Woodruff","0","1","Arkansas","5/13/20","1","0","05147","0"
"Yell","0","7","Arkansas","5/13/20","7","0","05149","0"
"Alameda","45","2178","California","5/13/20","1863","315","06001","16.91"
"Alpine","0","2","California","5/13/20","2","0","06003","0"
"Amador","0","9","California","5/13/20","8","1","06005","12.5"
"Butte","0","20","California","5/13/20","18","2","06007","11.11"
"Calaveras","0","13","California","5/13/20","13","0","06009","0"
"Colusa","0","3","California","5/13/20","3","0","06011","0"
"Contra Costa","14","1080","California","5/13/20","985","95","06013","9.64"
"Del Norte","0","4","California","5/13/20","3","1","06015","33.33"
"El Dorado","1","60","California","5/13/20","54","6","06017","11.11"
"Fresno","30","984","California","5/13/20","777","207","06019","26.64"
"Glenn","0","6","California","5/13/20","5","1","06021","20"
"Humboldt","1","64","California","5/13/20","55","9","06023","16.36"
"Imperial","33","647","California","5/13/20","419","228","06025","54.42"
"Inyo","0","19","California","5/13/20","19","0","06027","0"
"Kern","39","1343","California","5/13/20","1073","270","06029","25.16"
"Kings","13","325","California","5/13/20","233","92","06031","39.48"
"Lake","0","8","California","5/13/20","8","0","06033","0"
"Los Angeles","839","34538","California","5/13/20","28665","5873","06037","20.49"
"Madera","2","69","California","5/13/20","55","14","06039","25.45"
"Marin","3","271","California","5/13/20","247","24","06041","9.72"
"Mariposa","0","15","California","5/13/20","15","0","06043","0"
"Mendocino","0","12","California","5/13/20","12","0","06045","0"
"Merced","4","180","California","5/13/20","152","28","06047","18.42"
"Mono","1","33","California","5/13/20","27","6","06051","22.22"
"Monterey","8","299","California","5/13/20","241","58","06053","24.07"
"Napa","0","81","California","5/13/20","78","3","06055","3.85"
"Nevada","0","41","California","5/13/20","41","0","06057","0"
"Orange","106","3749","California","5/13/20","3004","745","06059","24.8"
"Placer","1","170","California","5/13/20","163","7","06061","4.29"
"Plumas","0","4","California","5/13/20","4","0","06063","0"
"Riverside","82","5248","California","5/13/20","4672","576","06065","12.33"
"Sacramento","6","1183","California","5/13/20","1142","41","06067","3.59"
"San Benito","1","58","California","5/13/20","53","5","06069","9.43"
"San Bernardino","103","3153","California","5/13/20","2432","721","06071","29.65"
"San Diego","120","5161","California","5/13/20","4319","842","06073","19.5"
"San Francisco","34","1994","California","5/13/20","1754","240","06075","13.68"
"San Joaquin","8","638","California","5/13/20","579","59","06077","10.19"
"San Luis Obispo","3","232","California","5/13/20","208","24","06079","11.54"
"San Mateo","25","1515","California","5/13/20","1341","174","06081","12.98"
"Santa Barbara","108","1371","California","5/13/20","613","758","06083","123.65"
"Santa Clara","14","2364","California","5/13/20","2268","96","06085","4.23"
"Santa Cruz","1","146","California","5/13/20","138","8","06087","5.8"
"Shasta","0","32","California","5/13/20","31","1","06089","3.23"
"Siskiyou","0","5","California","5/13/20","5","0","06093","0"
"Solano","7","388","California","5/13/20","337","51","06095","15.13"
"Sonoma","9","333","California","5/13/20","272","61","06097","22.43"
"Stanislaus","8","517","California","5/13/20","461","56","06099","12.15"
"Sutter","1","35","California","5/13/20","31","4","06101","12.9"
"Tehama","0","1","California","5/13/20","1","0","06103","0"
"Trinity","0","2","California","5/13/20","0","2","06105","1"
"Tulare","50","1268","California","5/13/20","916","352","06107","38.43"
"Tuolumne","0","2","California","5/13/20","2","0","06109","0"
"Ventura","17","725","California","5/13/20","608","117","06111","19.24"
"Yolo","1","177","California","5/13/20","172","5","06113","2.91"
"Yuba","1","23","California","5/13/20","19","4","06115","21.05"
"Adams","60","2374","Colorado","5/13/20","1952","422","08001","21.62"
"Alamosa","2","33","Colorado","5/13/20","22","11","08003","50"
"Arapahoe","70","3464","Colorado","5/13/20","2977","487","08005","16.36"
"Archuleta","0","8","Colorado","5/13/20","8","0","08007","0"
"Baca","0","12","Colorado","5/13/20","12","0","08009","0"
"Bent","0","1","Colorado","5/13/20","0","1","08011","1"
"Boulder","14","797","Colorado","5/13/20","700","97","08013","13.86"
"Broomfield","3","203","Colorado","5/13/20","180","23","08014","12.78"
"Chaffee","0","69","Colorado","5/13/20","68","1","08015","1.47"
"Cheyenne","1","4","Colorado","5/13/20","0","4","08017","1"
"Clear Creek","0","15","Colorado","5/13/20","13","2","08019","15.38"
"Conejos","0","1","Colorado","5/13/20","0","1","08021","1"
"Costilla","0","4","Colorado","5/13/20","3","1","08023","33.33"
"Crowley","5","39","Colorado","5/13/20","4","35","08025","875"
"Custer","0","2","Colorado","5/13/20","2","0","08027","0"
"Delta","0","54","Colorado","5/13/20","52","2","08029","3.85"
"Denver","83","4254","Colorado","5/13/20","3674","580","08031","15.79"
"Douglas","8","612","Colorado","5/13/20","556","56","08035","10.07"
"Eagle","1","562","Colorado","5/13/20","552","10","08037","1.81"
"El Paso","17","1175","Colorado","5/13/20","1055","120","08041","11.37"
"Elbert","1","41","Colorado","5/13/20","37","4","08039","10.81"
"Fremont","0","23","Colorado","5/13/20","22","1","08043","4.55"
"Garfield","2","112","Colorado","5/13/20","99","13","08045","13.13"
"Gilpin","0","1","Colorado","5/13/20","1","0","08047","0"
"Grand","0","5","Colorado","5/13/20","5","0","08049","0"
"Gunnison","1","180","Colorado","5/13/20","172","8","08051","4.65"
"Hinsdale","0","3","Colorado","5/13/20","3","0","08053","0"
"Huerfano","0","3","Colorado","5/13/20","2","1","08055","50"
"Jefferson","30","1716","Colorado","5/13/20","1507","209","08059","13.87"
"Kit Carson","0","25","Colorado","5/13/20","24","1","08063","4.17"
"La Plata","0","66","Colorado","5/13/20","63","3","08067","4.76"
"Lake","0","23","Colorado","5/13/20","21","2","08065","9.52"
"Larimer","6","456","Colorado","5/13/20","415","41","08069","9.88"
"Las Animas","0","4","Colorado","5/13/20","4","0","08071","0"
"Lincoln","0","3","Colorado","5/13/20","3","0","08073","0"
"Logan","26","480","Colorado","5/13/20","295","185","08075","62.71"
"Mesa","0","51","Colorado","5/13/20","50","1","08077","2"
"Mineral","0","2","Colorado","5/13/20","2","0","08079","0"
"Moffat","0","6","Colorado","5/13/20","6","0","08081","0"
"Montezuma","1","25","Colorado","5/13/20","19","6","08083","31.58"
"Montrose","3","128","Colorado","5/13/20","110","18","08085","16.36"
"Morgan","13","527","Colorado","5/13/20","439","88","08087","20.05"
"Otero","0","11","Colorado","5/13/20","10","1","08089","10"
"Ouray","0","6","Colorado","5/13/20","5","1","08091","20"
"Park","0","16","Colorado","5/13/20","15","1","08093","6.67"
"Phillips","0","9","Colorado","5/13/20","6","3","08095","50"
"Pitkin","0","54","Colorado","5/13/20","53","1","08097","1.89"
"Prowers","0","9","Colorado","5/13/20","8","1","08099","12.5"
"Pueblo","4","188","Colorado","5/13/20","161","27","08101","16.77"
"Rio Blanco","0","1","Colorado","5/13/20","1","0","08103","0"
"Rio Grande","0","7","Colorado","5/13/20","7","0","08105","0"
"Routt","0","59","Colorado","5/13/20","58","1","08107","1.72"
"Saguache","1","8","Colorado","5/13/20","3","5","08109","166.67"
"San Juan","0","1","Colorado","5/13/20","1","0","08111","0"
"San Miguel","0","22","Colorado","5/13/20","20","2","08113","10"
"Summit","3","174","Colorado","5/13/20","155","19","08117","12.26"
"Teller","0","31","Colorado","5/13/20","30","1","08119","3.33"
"Washington","0","9","Colorado","5/13/20","9","0","08121","0"
"Weld","32","2211","Colorado","5/13/20","1988","223","08123","11.22"
"Yuma","0","11","Colorado","5/13/20","9","2","08125","22.22"
"Fairfield","169","13636","Connecticut","5/13/20","12455","1181","09001","9.48"
"Hartford","172","7732","Connecticut","5/13/20","6530","1202","09003","18.41"
"Litchfield","13","1179","Connecticut","5/13/20","1085","94","09005","8.66"
"Middlesex","14","837","Connecticut","5/13/20","742","95","09007","12.8"
"New Haven","164","9570","Connecticut","5/13/20","8419","1151","09009","13.67"
"New London","14","804","Connecticut","5/13/20","704","100","09011","14.2"
"Tolland","7","560","Connecticut","5/13/20","513","47","09013","9.16"
"Windham","6","287","Connecticut","5/13/20","242","45","09015","18.6"
"Kent","28","1084","Delaware","5/13/20","891","193","10001","21.66"
"New Castle","58","2496","Delaware","5/13/20","2087","409","10003","19.6"
"Sussex","82","3336","Delaware","5/13/20","2764","572","10005","20.69"
"","0","49","Diamond Princess","5/13/20","49","0",,"0"
"District of Columbia","160","6584","District of Columbia","5/13/20","5461","1123","11001","20.56"
"Alachua","4","326","Florida","5/13/20","295","31","12001","10.51"
"Baker","1","26","Florida","5/13/20","22","4","12003","18.18"
"Bay","0","77","Florida","5/13/20","76","1","12005","1.32"
"Bradford","0","48","Florida","5/13/20","48","0","12007","0"
"Brevard","3","344","Florida","5/13/20","320","24","12009","7.5"
"Broward","64","5998","Florida","5/13/20","5553","445","12011","8.01"
"Calhoun","2","31","Florida","5/13/20","19","12","12013","63.16"
"Charlotte","8","350","Florida","5/13/20","294","56","12015","19.05"
"Citrus","1","109","Florida","5/13/20","101","8","12017","7.92"
"Clay","2","303","Florida","5/13/20","288","15","12019","5.21"
"Collier","27","864","Florida","5/13/20","677","187","12021","27.62"
"Columbia","2","107","Florida","5/13/20","96","11","12023","11.46"
"DeSoto","1","52","Florida","5/13/20","42","10","12027","23.81"
"Dixie","1","15","Florida","5/13/20","10","5","12029","50"
"Duval","17","1199","Florida","5/13/20","1077","122","12031","11.33"
"Escambia","9","665","Florida","5/13/20","604","61","12033","10.1"
"Flagler","1","148","Florida","5/13/20","142","6","12035","4.23"
"Franklin","0","2","Florida","5/13/20","2","0","12037","0"
"Gadsden","3","139","Florida","5/13/20","120","19","12039","15.83"
"Gilchrist","0","7","Florida","5/13/20","6","1","12041","16.67"
"Glades","0","8","Florida","5/13/20","6","2","12043","33.33"
"Gulf","0","1","Florida","5/13/20","1","0","12045","0"
"Hamilton","11","86","Florida","5/13/20","7","79","12047","1128.57"
"Hardee","0","37","Florida","5/13/20","34","3","12049","8.82"
"Hendry","6","165","Florida","5/13/20","120","45","12051","37.5"
"Hernando","1","101","Florida","5/13/20","97","4","12053","4.12"
"Highlands","2","100","Florida","5/13/20","87","13","12055","14.94"
"Hillsborough","23","1494","Florida","5/13/20","1331","163","12057","12.25"
"Holmes","0","10","Florida","5/13/20","10","0","12059","0"
"Indian River","0","102","Florida","5/13/20","99","3","12061","3.03"
"Jackson","12","106","Florida","5/13/20","23","83","12063","360.87"
"Jefferson","0","28","Florida","5/13/20","28","0","12065","0"
"Lafayette","0","5","Florida","5/13/20","3","2","12067","66.67"
"Lake","2","247","Florida","5/13/20","236","11","12069","4.66"
"Lee","22","1332","Florida","5/13/20","1176","156","12071","13.27"
"Leon","4","271","Florida","5/13/20","243","28","12073","11.52"
"Levy","0","22","Florida","5/13/20","20","2","12075","10"
"Liberty","18","198","Florida","5/13/20","70","128","12077","182.86"
"Madison","0","61","Florida","5/13/20","61","0","12079","0"
"Manatee","12","806","Florida","5/13/20","722","84","12081","11.63"
"Marion","3","217","Florida","5/13/20","196","21","12083","10.71"
"Martin","7","275","Florida","5/13/20","224","51","12085","22.77"
"Miami-Dade","157","14468","Florida","5/13/20","13371","1097","12086","8.2"
"Monroe","2","96","Florida","5/13/20","80","16","12087","20"
"Nassau","0","62","Florida","5/13/20","60","2","12089","3.33"
"Okaloosa","1","170","Florida","5/13/20","162","8","12091","4.94"
"Okeechobee","1","25","Florida","5/13/20","18","7","12093","38.89"
"Orange","13","1553","Florida","5/13/20","1460","93","12095","6.37"
"Osceola","8","586","Florida","5/13/20","529","57","12097","10.78"
"Palm Beach","99","4176","Florida","5/13/20","3480","696","12099","20"
"Pasco","3","306","Florida","5/13/20","285","21","12101","7.37"
"Pinellas","17","923","Florida","5/13/20","801","122","12103","15.23"
"Polk","18","687","Florida","5/13/20","564","123","12105","21.81"
"Putnam","1","127","Florida","5/13/20","120","7","12107","5.83"
"Santa Rosa","3","179","Florida","5/13/20","158","21","12113","13.29"
"Sarasota","5","440","Florida","5/13/20","405","35","12115","8.64"
"Seminole","2","422","Florida","5/13/20","408","14","12117","3.43"
"St. Johns","2","229","Florida","5/13/20","216","13","12109","6.02"
"St. Lucie","5","299","Florida","5/13/20","265","34","12111","12.83"
"Sumter","2","245","Florida","5/13/20","234","11","12119","4.7"
"Suwannee","1","149","Florida","5/13/20","143","6","12121","4.2"
"Taylor","0","3","Florida","5/13/20","3","0","12123","0"
"Union","1","10","Florida","5/13/20","5","5","12125","100"
"Volusia","6","566","Florida","5/13/20","526","40","12127","7.6"
"Wakulla","0","31","Florida","5/13/20","29","2","12129","6.9"
"Walton","2","68","Florida","5/13/20","51","17","12131","33.33"
"Washington","0","12","Florida","5/13/20","12","0","12133","0"
"Appling","3","99","Georgia","5/13/20","78","21","13001","26.92"
"Atkinson","0","20","Georgia","5/13/20","17","3","13003","17.65"
"Bacon","3","48","Georgia","5/13/20","29","19","13005","65.52"
"Baker","1","34","Georgia","5/13/20","28","6","13007","21.43"
"Baldwin","2","277","Georgia","5/13/20","263","14","13009","5.32"
"Banks","1","39","Georgia","5/13/20","32","7","13011","21.88"
"Barrow","8","254","Georgia","5/13/20","197","57","13013","28.93"
"Bartow","3","377","Georgia","5/13/20","359","18","13015","5.01"
"Ben Hill","1","43","Georgia","5/13/20","36","7","13017","19.44"
"Berrien","0","19","Georgia","5/13/20","19","0","13019","0"
"Bibb","2","378","Georgia","5/13/20","367","11","13021","3"
"Bleckley","2","32","Georgia","5/13/20","21","11","13023","52.38"
"Brantley","1","28","Georgia","5/13/20","22","6","13025","27.27"
"Brooks","0","64","Georgia","5/13/20","64","0","13027","0"
"Bryan","1","61","Georgia","5/13/20","57","4","13029","7.02"
"Bulloch","0","45","Georgia","5/13/20","42","3","13031","7.14"
"Burke","3","113","Georgia","5/13/20","89","24","13033","26.97"
"Butts","4","192","Georgia","5/13/20","163","29","13035","17.79"
"Calhoun","1","117","Georgia","5/13/20","109","8","13037","7.34"
"Camden","1","43","Georgia","5/13/20","34","9","13039","26.47"
"Candler","0","10","Georgia","5/13/20","7","3","13043","42.86"
"Carroll","1","397","Georgia","5/13/20","391","6","13045","1.53"
"Catoosa","2","66","Georgia","5/13/20","52","14","13047","26.92"
"Charlton","1","19","Georgia","5/13/20","13","6","13049","46.15"
"Chatham","8","337","Georgia","5/13/20","282","55","13051","19.5"
"Chattahoochee","1","16","Georgia","5/13/20","12","4","13053","33.33"
"Chattooga","0","16","Georgia","5/13/20","15","1","13055","6.67"
"Cherokee","16","655","Georgia","5/13/20","544","111","13057","20.4"
"Clarke","2","190","Georgia","5/13/20","174","16","13059","9.2"
"Clay","0","26","Georgia","5/13/20","27","-1","13061","-3.7"
"Clayton","15","955","Georgia","5/13/20","849","106","13063","12.49"
"Clinch","3","36","Georgia","5/13/20","16","20","13065","125"
"Cobb","40","2280","Georgia","5/13/20","1999","281","13067","14.06"
"Coffee","4","187","Georgia","5/13/20","159","28","13069","17.61"
"Colquitt","4","229","Georgia","5/13/20","198","31","13071","15.66"
"Columbia","3","191","Georgia","5/13/20","170","21","13073","12.35"
"Cook","0","32","Georgia","5/13/20","31","1","13075","3.23"
"Coweta","5","280","Georgia","5/13/20","247","33","13077","13.36"
"Crawford","0","19","Georgia","5/13/20","19","0","13079","0"
"Crisp","2","191","Georgia","5/13/20","178","13","13081","7.3"
"Dade","0","17","Georgia","5/13/20","17","0","13083","0"
"Dawson","1","81","Georgia","5/13/20","72","9","13085","12.5"
"Decatur","1","115","Georgia","5/13/20","105","10","13087","9.52"
"DeKalb","39","2632","Georgia","5/13/20","2357","275","13089","11.67"
"Dodge","1","36","Georgia","5/13/20","32","4","13091","12.5"
"Dooly","3","151","Georgia","5/13/20","133","18","13093","13.53"
"Dougherty","13","1644","Georgia","5/13/20","1555","89","13095","5.72"
"Douglas","8","422","Georgia","5/13/20","363","59","13097","16.25"
"Early","1","229","Georgia","5/13/20","221","8","13099","3.62"
"Echols","1","10","Georgia","5/13/20","5","5","13101","100"
"Effingham","0","38","Georgia","5/13/20","38","0","13103","0"
"Elbert","2","46","Georgia","5/13/20","33","13","13105","39.39"
"Emanuel","0","25","Georgia","5/13/20","22","3","13107","13.64"
"Evans","0","4","Georgia","5/13/20","5","-1","13109","-20"
"Fannin","0","36","Georgia","5/13/20","33","3","13111","9.09"
"Fayette","2","202","Georgia","5/13/20","188","14","13113","7.45"
"Floyd","2","166","Georgia","5/13/20","152","14","13115","9.21"
"Forsyth","5","393","Georgia","5/13/20","356","37","13117","10.39"
"Franklin","1","29","Georgia","5/13/20","25","4","13119","16"
"Fulton","52","3614","Georgia","5/13/20","3251","363","13121","11.17"
"Gilmer","3","102","Georgia","5/13/20","83","19","13123","22.89"
"Glascock","0","1","Georgia","5/13/20","0","1","13125","1"
"Glynn","1","75","Georgia","5/13/20","68","7","13127","10.29"
"Gordon","1","124","Georgia","5/13/20","118","6","13129","5.08"
"Grady","2","88","Georgia","5/13/20","75","13","13131","17.33"
"Greene","0","57","Georgia","5/13/20","55","2","13133","3.64"
"Gwinnett","41","2510","Georgia","5/13/20","2222","288","13135","12.96"
"Habersham","3","398","Georgia","5/13/20","376","22","13137","5.85"
"Hall","28","2112","Georgia","5/13/20","1914","198","13139","10.34"
"Hancock","4","140","Georgia","5/13/20","110","30","13141","27.27"
"Haralson","0","34","Georgia","5/13/20","31","3","13143","9.68"
"Harris","2","73","Georgia","5/13/20","60","13","13145","21.67"
"Hart","1","19","Georgia","5/13/20","15","4","13147","26.67"
"Heard","0","17","Georgia","5/13/20","14","3","13149","21.43"
"Henry","10","615","Georgia","5/13/20","546","69","13151","12.64"
"Houston","2","290","Georgia","5/13/20","274","16","13153","5.84"
"Irwin","0","22","Georgia","5/13/20","20","2","13155","10"
"Jackson","1","126","Georgia","5/13/20","117","9","13157","7.69"
"Jasper","0","26","Georgia","5/13/20","26","0","13159","0"
"Jeff Davis","0","24","Georgia","5/13/20","22","2","13161","9.09"
"Jefferson","0","19","Georgia","5/13/20","17","2","13163","11.76"
"Jenkins","0","16","Georgia","5/13/20","17","-1","13165","-5.88"
"Johnson","1","70","Georgia","5/13/20","64","6","13167","9.38"
"Jones","0","30","Georgia","5/13/20","31","-1","13169","-3.23"
"Lamar","0","40","Georgia","5/13/20","39","1","13171","2.56"
"Lanier","0","11","Georgia","5/13/20","10","1","13173","10"
"Laurens","2","85","Georgia","5/13/20","70","15","13175","21.43"
"Lee","1","343","Georgia","5/13/20","338","5","13177","1.48"
"Liberty","1","45","Georgia","5/13/20","39","6","13179","15.38"
"Lincoln","0","12","Georgia","5/13/20","12","0","13181","0"
"Long","0","5","Georgia","5/13/20","5","0","13183","0"
"Lowndes","4","196","Georgia","5/13/20","170","26","13185","15.29"
"Lumpkin","1","80","Georgia","5/13/20","72","8","13187","11.11"
"Macon","1","88","Georgia","5/13/20","81","7","13193","8.64"
"Madison","0","29","Georgia","5/13/20","27","2","13195","7.41"
"Marion","0","38","Georgia","5/13/20","37","1","13197","2.7"
"McDuffie","0","53","Georgia","5/13/20","50","3","13189","6"
"McIntosh","1","9","Georgia","5/13/20","5","4","13191","80"
"Meriwether","1","68","Georgia","5/13/20","59","9","13199","15.25"
"Miller","1","35","Georgia","5/13/20","30","5","13201","16.67"
"Mitchell","6","381","Georgia","5/13/20","336","45","13205","13.39"
"Monroe","2","44","Georgia","5/13/20","33","11","13207","33.33"
"Montgomery","0","5","Georgia","5/13/20","2","3","13209","150"
"Morgan","0","33","Georgia","5/13/20","30","3","13211","10"
"Murray","3","53","Georgia","5/13/20","35","18","13213","51.43"
"Muscogee","7","398","Georgia","5/13/20","348","50","13215","14.37"
"Newton","4","262","Georgia","5/13/20","232","30","13217","12.93"
"Oconee","0","66","Georgia","5/13/20","67","-1","13219","-1.49"
"Oglethorpe","1","56","Georgia","5/13/20","51","5","13221","9.8"
"Out of GA","78","1561","Georgia","5/13/20","1017","544","80013","53.49"
"Paulding","3","234","Georgia","5/13/20","212","22","13223","10.38"
"Peach","1","69","Georgia","5/13/20","61","8","13225","13.11"
"Pickens","1","36","Georgia","5/13/20","29","7","13227","24.14"
"Pierce","2","69","Georgia","5/13/20","58","11","13229","18.97"
"Pike","1","45","Georgia","5/13/20","40","5","13231","12.5"
"Polk","1","69","Georgia","5/13/20","64","5","13233","7.81"
"Pulaski","0","34","Georgia","5/13/20","33","1","13235","3.03"
"Putnam","1","59","Georgia","5/13/20","51","8","13237","15.69"
"Quitman","0","7","Georgia","5/13/20","6","1","13239","16.67"
"Rabun","0","14","Georgia","5/13/20","13","1","13241","7.69"
"Randolph","0","169","Georgia","5/13/20","167","2","13243","1.2"
"Richmond","6","471","Georgia","5/13/20","429","42","13245","9.79"
"Rockdale","4","248","Georgia","5/13/20","223","25","13247","11.21"
"Schley","0","15","Georgia","5/13/20","15","0","13249","0"
"Screven","0","18","Georgia","5/13/20","16","2","13251","12.5"
"Seminole","1","39","Georgia","5/13/20","32","7","13253","21.88"
"Spalding","2","236","Georgia","5/13/20","223","13","13255","5.83"
"Stephens","0","94","Georgia","5/13/20","91","3","13257","3.3"
"Stewart","1","35","Georgia","5/13/20","26","9","13259","34.62"
"Sumter","3","409","Georgia","5/13/20","385","24","13261","6.23"
"Talbot","0","27","Georgia","5/13/20","24","3","13263","12.5"
"Taliaferro","0","1","Georgia","5/13/20","1","0","13265","0"
"Tattnall","0","10","Georgia","5/13/20","9","1","13267","11.11"
"Taylor","1","22","Georgia","5/13/20","18","4","13269","22.22"
"Telfair","0","29","Georgia","5/13/20","28","1","13271","3.57"
"Terrell","1","199","Georgia","5/13/20","193","6","13273","3.11"
"Thomas","7","267","Georgia","5/13/20","219","48","13275","21.92"
"Tift","4","164","Georgia","5/13/20","136","28","13277","20.59"
"Toombs","1","41","Georgia","5/13/20","37","4","13279","10.81"
"Towns","0","21","Georgia","5/13/20","20","1","13281","5"
"Treutlen","0","7","Georgia","5/13/20","4","3","13283","75"
"Troup","3","192","Georgia","5/13/20","168","24","13285","14.29"
"Turner","1","80","Georgia","5/13/20","71","9","13287","12.68"
"Twiggs","0","8","Georgia","5/13/20","8","0","13289","0"
"Union","1","36","Georgia","5/13/20","32","4","13291","12.5"
"Upson","1","255","Georgia","5/13/20","245","10","13293","4.08"
"Walker","2","73","Georgia","5/13/20","61","12","13295","19.67"
"Walton","2","159","Georgia","5/13/20","143","16","13297","11.19"
"Ware","3","166","Georgia","5/13/20","145","21","13299","14.48"
"Warren","0","16","Georgia","5/13/20","13","3","13301","23.08"
"Washington","2","62","Georgia","5/13/20","46","16","13303","34.78"
"Wayne","0","14","Georgia","5/13/20","13","1","13305","7.69"
"Webster","0","11","Georgia","5/13/20","10","1","13307","10"
"Wheeler","0","6","Georgia","5/13/20","5","1","13309","20"
"White","1","88","Georgia","5/13/20","83","5","13311","6.02"
"Whitfield","5","173","Georgia","5/13/20","135","38","13313","28.15"
"Wilcox","1","99","Georgia","5/13/20","90","9","13315","10"
"Wilkes","0","27","Georgia","5/13/20","26","1","13317","3.85"
"Wilkinson","0","40","Georgia","5/13/20","41","-1","13319","-2.44"
"Worth","2","191","Georgia","5/13/20","175","16","13321","9.14"
"","0","103","Grand Princess","5/13/20","103","0",,"0"
"","0","152","Guam","5/13/20","149","3",,"2.01"
"Hawaii","0","75","Hawaii","5/13/20","74","1","15001","1.35"
"Honolulu","1","414","Hawaii","5/13/20","405","9","15003","2.22"
"Kauai","0","21","Hawaii","5/13/20","21","0","15007","0"
"Maui","0","117","Hawaii","5/13/20","116","1","15009","0.86"
"Out of HI","0","11","Hawaii","5/13/20","10","1","80015","10"
"Ada","4","744","Idaho","5/13/20","717","27","16001","3.77"
"Adams","0","3","Idaho","5/13/20","3","0","16003","0"
"Bannock","0","13","Idaho","5/13/20","12","1","16005","8.33"
"Bingham","0","4","Idaho","5/13/20","4","0","16011","0"
"Blaine","1","506","Idaho","5/13/20","499","7","16013","1.4"
"Bonner","0","4","Idaho","5/13/20","4","0","16017","0"
"Bonneville","0","30","Idaho","5/13/20","28","2","16019","7.14"
"Camas","0","1","Idaho","5/13/20","1","0","16025","0"
"Canyon","1","274","Idaho","5/13/20","270","4","16027","1.48"
"Caribou","0","1","Idaho","5/13/20","1","0","16029","0"
"Cassia","0","15","Idaho","5/13/20","13","2","16031","15.38"
"Custer","0","2","Idaho","5/13/20","2","0","16037","0"
"Elmore","0","31","Idaho","5/13/20","31","0","16039","0"
"Fremont","0","3","Idaho","5/13/20","3","0","16043","0"
"Gem","0","16","Idaho","5/13/20","14","2","16045","14.29"
"Gooding","1","20","Idaho","5/13/20","14","6","16047","42.86"
"Idaho","0","3","Idaho","5/13/20","3","0","16049","0"
"Jefferson","0","5","Idaho","5/13/20","5","0","16051","0"
"Jerome","2","81","Idaho","5/13/20","64","17","16053","26.56"
"Kootenai","0","64","Idaho","5/13/20","62","2","16055","3.23"
"Latah","0","5","Idaho","5/13/20","5","0","16057","0"
"Lemhi","0","1","Idaho","5/13/20","1","0","16059","0"
"Lincoln","0","29","Idaho","5/13/20","29","0","16063","0"
"Madison","1","18","Idaho","5/13/20","13","5","16065","38.46"
"Minidoka","0","12","Idaho","5/13/20","11","1","16067","9.09"
"Nez Perce","0","79","Idaho","5/13/20","78","1","16069","1.28"
"Owyhee","0","8","Idaho","5/13/20","8","0","16073","0"
"Payette","0","17","Idaho","5/13/20","17","0","16075","0"
"Power","0","3","Idaho","5/13/20","2","1","16077","50"
"Teton","0","11","Idaho","5/13/20","10","1","16081","10"
"Twin Falls","7","280","Idaho","5/13/20","231","49","16083","21.21"
"Valley","0","2","Idaho","5/13/20","2","0","16085","0"
"Washington","1","8","Idaho","5/13/20","1","7","16087","700"
"Adams","0","41","Illinois","5/13/20","40","1","17001","2.5"
"Alexander","0","8","Illinois","5/13/20","6","2","17003","33.33"
"Bond","0","10","Illinois","5/13/20","8","2","17005","25"
"Boone","14","253","Illinois","5/13/20","155","98","17007","63.23"
"Brown","0","9","Illinois","5/13/20","6","3","17009","50"
"Bureau","0","15","Illinois","5/13/20","12","3","17011","25"
"Calhoun","0","1","Illinois","5/13/20","1","0","17013","0"
"Carroll","0","12","Illinois","5/13/20","10","2","17015","20"
"Cass","2","62","Illinois","5/13/20","48","14","17017","29.17"
"Champaign","15","318","Illinois","5/13/20","212","106","17019","50"
"Christian","0","30","Illinois","5/13/20","28","2","17021","7.14"
"Clark","0","8","Illinois","5/13/20","5","3","17023","60"
"Clay","0","2","Illinois","5/13/20","2","0","17025","0"
"Clinton","4","142","Illinois","5/13/20","116","26","17027","22.41"
"Coles","6","62","Illinois","5/13/20","22","40","17029","181.82"
"Cook","1388","56406","Illinois","5/13/20","46689","9717","17031","20.81"
"Crawford","0","11","Illinois","5/13/20","10","1","17033","10"
"Cumberland","0","7","Illinois","5/13/20","4","3","17035","75"
"De Witt","0","3","Illinois","5/13/20","3","0","17039","0"
"DeKalb","10","211","Illinois","5/13/20","141","70","17037","49.65"
"Douglas","0","22","Illinois","5/13/20","20","2","17041","10"
"DuPage","170","5244","Illinois","5/13/20","4056","1188","17043","29.29"
"Edwards","0","2","Illinois","5/13/20","0","2","17047","1"
"Effingham","0","6","Illinois","5/13/20","5","1","17049","20"
"Fayette","0","17","Illinois","5/13/20","16","1","17051","6.25"
"Ford","0","14","Illinois","5/13/20","11","3","17053","27.27"
"Franklin","0","12","Illinois","5/13/20","10","2","17055","20"
"Fulton","0","4","Illinois","5/13/20","3","1","17057","33.33"
"Gallatin","0","2","Illinois","5/13/20","2","0","17059","0"
"Greene","0","4","Illinois","5/13/20","3","1","17061","33.33"
"Grundy","2","62","Illinois","5/13/20","48","14","17063","29.17"
"Hamilton","0","2","Illinois","5/13/20","2","0","17065","0"
"Hancock","0","12","Illinois","5/13/20","10","2","17067","20"
"Hardin","0","1","Illinois","5/13/20","1","0","17069","0"
"Henderson","0","7","Illinois","5/13/20","5","2","17071","40"
"Henry","1","61","Illinois","5/13/20","54","7","17073","12.96"
"Iroquois","6","101","Illinois","5/13/20","62","39","17075","62.9"
"Jackson","2","171","Illinois","5/13/20","154","17","17077","11.04"
"Jasper","0","45","Illinois","5/13/20","46","-1","17079","-2.17"
"Jefferson","2","97","Illinois","5/13/20","86","11","17081","12.79"
"Jersey","0","17","Illinois","5/13/20","15","2","17083","13.33"
"Jo Daviess","1","19","Illinois","5/13/20","14","5","17085","35.71"
"Johnson","0","6","Illinois","5/13/20","4","2","17087","50"
"Kane","202","3744","Illinois","5/13/20","2331","1413","17089","60.62"
"Kankakee","27","607","Illinois","5/13/20","416","191","17091","45.91"
"Kendall","21","496","Illinois","5/13/20","346","150","17093","43.35"
"Knox","3","79","Illinois","5/13/20","61","18","17095","29.51"
"Lake","176","5758","Illinois","5/13/20","4529","1229","17097","27.14"
"LaSalle","4","111","Illinois","5/13/20","84","27","17099","32.14"
"Lawrence","0","4","Illinois","5/13/20","3","1","17101","33.33"
"Lee","3","70","Illinois","5/13/20","49","21","17103","42.86"
"Livingston","0","25","Illinois","5/13/20","23","2","17105","8.7"
"Logan","1","11","Illinois","5/13/20","7","4","17107","57.14"
"Macon","3","151","Illinois","5/13/20","129","22","17115","17.05"
"Macoupin","0","39","Illinois","5/13/20","39","0","17117","0"
"Madison","11","449","Illinois","5/13/20","374","75","17119","20.05"
"Marion","1","47","Illinois","5/13/20","38","9","17121","23.68"
"Marshall","0","4","Illinois","5/13/20","4","0","17123","0"
"Mason","0","15","Illinois","5/13/20","15","0","17125","0"
"Massac","0","6","Illinois","5/13/20","4","2","17127","50"
"McDonough","2","54","Illinois","5/13/20","42","12","17109","28.57"
"McHenry","34","1049","Illinois","5/13/20","814","235","17111","28.87"
"McLean","3","127","Illinois","5/13/20","108","19","17113","17.59"
"Menard","0","17","Illinois","5/13/20","16","1","17129","6.25"
"Mercer","0","12","Illinois","5/13/20","10","2","17131","20"
"Monroe","1","81","Illinois","5/13/20","74","7","17133","9.46"
"Montgomery","0","34","Illinois","5/13/20","33","1","17135","3.03"
"Morgan","1","33","Illinois","5/13/20","26","7","17137","26.92"
"Moultrie","0","6","Illinois","5/13/20","6","0","17139","0"
"Ogle","3","160","Illinois","5/13/20","137","23","17141","16.79"
"Out of IL","2","82","Illinois","5/13/20","68","14","80017","20.59"
"Peoria","3","148","Illinois","5/13/20","126","22","17143","17.46"
"Perry","0","38","Illinois","5/13/20","35","3","17145","8.57"
"Piatt","0","8","Illinois","5/13/20","7","1","17147","14.29"
"Pike","0","1","Illinois","5/13/20","1","0","17149","0"
"Pope","0","1","Illinois","5/13/20","0","1","17151","1"
"Pulaski","1","31","Illinois","5/13/20","23","8","17153","34.78"
"Randolph","3","227","Illinois","5/13/20","203","24","17157","11.82"
"Richland","0","3","Illinois","5/13/20","3","0","17159","0"
"Rock Island","10","538","Illinois","5/13/20","465","73","17161","15.7"
"Saline","0","5","Illinois","5/13/20","4","1","17165","25"
"Sangamon","7","279","Illinois","5/13/20","231","48","17167","20.78"
"Schuyler","1","7","Illinois","5/13/20","2","5","17169","250"
"Shelby","0","10","Illinois","5/13/20","10","0","17173","0"
"St. Clair","19","737","Illinois","5/13/20","601","136","17163","22.63"
"Stark","0","1","Illinois","5/13/20","1","0","17175","0"
"Stephenson","7","118","Illinois","5/13/20","72","46","17177","63.89"
"Tazewell","1","59","Illinois","5/13/20","53","6","17179","11.32"
"Union","8","105","Illinois","5/13/20","48","57","17181","118.75"
"Vermilion","1","29","Illinois","5/13/20","22","7","17183","31.82"
"Wabash","0","1","Illinois","5/13/20","1","0","17185","0"
"Warren","2","105","Illinois","5/13/20","88","17","17187","19.32"
"Washington","0","17","Illinois","5/13/20","15","2","17189","13.33"
"Wayne","1","10","Illinois","5/13/20","2","8","17191","400"
"White","0","2","Illinois","5/13/20","2","0","17193","0"
"Whiteside","2","110","Illinois","5/13/20","98","12","17195","12.24"
"Will","92","3973","Illinois","5/13/20","3332","641","17197","19.24"
"Williamson","2","52","Illinois","5/13/20","40","12","17199","30"
"Winnebago","73","1208","Illinois","5/13/20","696","512","17201","73.56"
"Woodford","0","15","Illinois","5/13/20","15","0","17203","0"
"Adams","0","8","Indiana","5/13/20","8","0","18001","0"
"Allen","23","877","Indiana","5/13/20","718","159","18003","22.14"
"Bartholomew","8","370","Indiana","5/13/20","314","56","18005","17.83"
"Benton","1","17","Indiana","5/13/20","10","7","18007","70"
"Blackford","0","14","Indiana","5/13/20","12","2","18009","16.67"
"Boone","4","235","Indiana","5/13/20","207","28","18011","13.53"
"Brown","1","28","Indiana","5/13/20","21","7","18013","33.33"
"Carroll","1","73","Indiana","5/13/20","65","8","18015","12.31"
"Cass","15","1544","Indiana","5/13/20","1442","102","18017","7.07"
"Clark","7","394","Indiana","5/13/20","347","47","18019","13.54"
"Clay","0","24","Indiana","5/13/20","23","1","18021","4.35"
"Clinton","6","111","Indiana","5/13/20","70","41","18023","58.57"
"Crawford","0","21","Indiana","5/13/20","19","2","18025","10.53"
"Daviess","1","56","Indiana","5/13/20","52","4","18027","7.69"
"Dearborn","2","154","Indiana","5/13/20","140","14","18029","10"
"Decatur","1","215","Indiana","5/13/20","206","9","18031","4.37"
"DeKalb","0","24","Indiana","5/13/20","23","1","18033","4.35"
"Delaware","3","230","Indiana","5/13/20","212","18","18035","8.49"
"Dubois","5","66","Indiana","5/13/20","30","36","18037","120"
"Elkhart","27","549","Indiana","5/13/20","361","188","18039","52.08"
"Fayette","1","39","Indiana","5/13/20","33","6","18041","18.18"
"Floyd","4","246","Indiana","5/13/20","218","28","18043","12.84"
"Fountain","0","16","Indiana","5/13/20","14","2","18045","14.29"
"Franklin","1","106","Indiana","5/13/20","101","5","18047","4.95"
"Fulton","0","37","Indiana","5/13/20","34","3","18049","8.82"
"Gibson","0","8","Indiana","5/13/20","7","1","18051","14.29"
"Grant","1","153","Indiana","5/13/20","149","4","18053","2.68"
"Greene","7","151","Indiana","5/13/20","101","50","18055","49.5"
"Hamilton","11","960","Indiana","5/13/20","882","78","18057","8.84"
"Hancock","6","276","Indiana","5/13/20","236","40","18059","16.95"
"Harrison","3","165","Indiana","5/13/20","145","20","18061","13.79"
"Hendricks","15","989","Indiana","5/13/20","883","106","18063","12"
"Henry","7","97","Indiana","5/13/20","47","50","18065","106.38"
"Howard","5","258","Indiana","5/13/20","220","38","18067","17.27"
"Huntington","1","17","Indiana","5/13/20","12","5","18069","41.67"
"Jackson","16","299","Indiana","5/13/20","188","111","18071","59.04"
"Jasper","0","40","Indiana","5/13/20","37","3","18073","8.11"
"Jay","1","22","Indiana","5/13/20","18","4","18075","22.22"
"Jefferson","1","35","Indiana","5/13/20","30","5","18077","16.67"
"Jennings","3","108","Indiana","5/13/20","87","21","18079","24.14"
"Johnson","13","838","Indiana","5/13/20","746","92","18081","12.33"
"Knox","0","22","Indiana","5/13/20","20","2","18083","10"
"Kosciusko","1","48","Indiana","5/13/20","39","9","18085","23.08"
"LaGrange","1","41","Indiana","5/13/20","36","5","18087","13.89"
"Lake","51","2588","Indiana","5/13/20","2233","355","18089","15.9"
"LaPorte","8","340","Indiana","5/13/20","284","56","18091","19.72"
"Lawrence","2","124","Indiana","5/13/20","111","13","18093","11.71"
"Madison","9","527","Indiana","5/13/20","462","65","18095","14.07"
"Marion","139","7703","Indiana","5/13/20","6730","973","18097","14.46"
"Marshall","1","37","Indiana","5/13/20","31","6","18099","19.35"
"Martin","0","7","Indiana","5/13/20","7","0","18101","0"
"Miami","1","129","Indiana","5/13/20","121","8","18103","6.61"
"Monroe","1","145","Indiana","5/13/20","135","10","18105","7.41"
"Montgomery","5","147","Indiana","5/13/20","110","37","18107","33.64"
"Morgan","7","224","Indiana","5/13/20","176","48","18109","27.27"
"Newton","1","68","Indiana","5/13/20","61","7","18111","11.48"
"Noble","3","142","Indiana","5/13/20","123","19","18113","15.45"
"Ohio","1","11","Indiana","5/13/20","7","4","18115","57.14"
"Orange","2","118","Indiana","5/13/20","107","11","18117","10.28"
"Owen","0","27","Indiana","5/13/20","24","3","18119","12.5"
"Parke","0","16","Indiana","5/13/20","13","3","18121","23.08"
"Perry","1","19","Indiana","5/13/20","11","8","18123","72.73"
"Pike","0","3","Indiana","5/13/20","2","1","18125","50"
"Porter","12","363","Indiana","5/13/20","281","82","18127","29.18"
"Posey","0","16","Indiana","5/13/20","14","2","18129","14.29"
"Pulaski","0","34","Indiana","5/13/20","31","3","18131","9.68"
"Putnam","2","92","Indiana","5/13/20","80","12","18133","15"
"Randolph","1","26","Indiana","5/13/20","18","8","18135","44.44"
"Ripley","1","105","Indiana","5/13/20","99","6","18137","6.06"
"Rush","0","37","Indiana","5/13/20","37","0","18139","0"
"Scott","5","89","Indiana","5/13/20","54","35","18143","64.81"
"Shelby","5","273","Indiana","5/13/20","241","32","18145","13.28"
"Spencer","0","7","Indiana","5/13/20","6","1","18147","16.67"
"St. Joseph","20","857","Indiana","5/13/20","714","143","18141","20.03"
"Starke","1","24","Indiana","5/13/20","17","7","18149","41.18"
"Steuben","1","64","Indiana","5/13/20","59","5","18151","8.47"
"Sullivan","1","22","Indiana","5/13/20","16","6","18153","37.5"
"Switzerland","0","14","Indiana","5/13/20","15","-1","18155","-6.67"
"Tippecanoe","9","261","Indiana","5/13/20","197","64","18157","32.49"
"Tipton","0","21","Indiana","5/13/20","20","1","18159","5"
"Union","0","8","Indiana","5/13/20","8","0","18161","0"
"Vanderburgh","4","194","Indiana","5/13/20","163","31","18163","19.02"
"Vermillion","0","7","Indiana","5/13/20","7","0","18165","0"
"Vigo","2","86","Indiana","5/13/20","73","13","18167","17.81"
"Wabash","1","67","Indiana","5/13/20","63","4","18169","6.35"
"Warren","0","12","Indiana","5/13/20","12","0","18171","0"
"Warrick","3","133","Indiana","5/13/20","110","23","18173","20.91"
"Washington","1","49","Indiana","5/13/20","45","4","18175","8.89"
"Wayne","2","56","Indiana","5/13/20","44","12","18177","27.27"
"Wells","1","12","Indiana","5/13/20","7","5","18179","71.43"
"White","8","165","Indiana","5/13/20","106","59","18181","55.66"
"Whitley","0","23","Indiana","5/13/20","22","1","18183","4.55"
"Adair","0","4","Iowa","5/13/20","3","1","19001","33.33"
"Allamakee","2","113","Iowa","5/13/20","98","15","19005","15.31"
"Appanoose","0","7","Iowa","5/13/20","4","3","19007","75"
"Audubon","0","10","Iowa","5/13/20","8","2","19009","25"
"Benton","0","35","Iowa","5/13/20","34","1","19011","2.94"
"Black Hawk","19","1528","Iowa","5/13/20","1396","132","19013","9.46"
"Boone","2","41","Iowa","5/13/20","29","12","19015","41.38"
"Bremer","1","62","Iowa","5/13/20","55","7","19017","12.73"
"Buchanan","0","24","Iowa","5/13/20","22","2","19019","9.09"
"Buena Vista","4","45","Iowa","5/13/20","16","29","19021","181.25"
"Butler","0","12","Iowa","5/13/20","10","2","19023","20"
"Calhoun","0","1","Iowa","5/13/20","1","0","19025","0"
"Carroll","0","7","Iowa","5/13/20","5","2","19027","40"
"Cass","0","1","Iowa","5/13/20","1","0","19029","0"
"Cedar","1","44","Iowa","5/13/20","38","6","19031","15.79"
"Cerro Gordo","0","14","Iowa","5/13/20","14","0","19033","0"
"Cherokee","0","6","Iowa","5/13/20","4","2","19035","50"
"Chickasaw","0","7","Iowa","5/13/20","6","1","19037","16.67"
"Clarke","1","9","Iowa","5/13/20","3","6","19039","200"
"Clay","0","9","Iowa","5/13/20","7","2","19041","28.57"
"Clayton","1","28","Iowa","5/13/20","18","10","19043","55.56"
"Clinton","1","58","Iowa","5/13/20","51","7","19045","13.73"
"Crawford","15","207","Iowa","5/13/20","103","104","19047","100.97"
"Dallas","16","741","Iowa","5/13/20","626","115","19049","18.37"
"Davis","1","12","Iowa","5/13/20","5","7","19051","140"
"Delaware","0","10","Iowa","5/13/20","8","2","19055","25"
"Des Moines","3","44","Iowa","5/13/20","24","20","19057","83.33"
"Dickinson","0","6","Iowa","5/13/20","6","0","19059","0"
"Dubuque","10","235","Iowa","5/13/20","162","73","19061","45.06"
"Emmet","0","1","Iowa","5/13/20","0","1","19063","1"
"Fayette","0","24","Iowa","5/13/20","24","0","19065","0"
"Floyd","1","9","Iowa","5/13/20","2","7","19067","350"
"Franklin","0","7","Iowa","5/13/20","6","1","19069","16.67"
"Fremont","0","3","Iowa","5/13/20","0","3","19071","1"
"Greene","0","13","Iowa","5/13/20","11","2","19073","18.18"
"Grundy","0","16","Iowa","5/13/20","17","-1","19075","-5.88"
"Guthrie","1","36","Iowa","5/13/20","31","5","19077","16.13"
"Hamilton","1","11","Iowa","5/13/20","7","4","19079","57.14"
"Hancock","0","3","Iowa","5/13/20","3","0","19081","0"
"Hardin","0","12","Iowa","5/13/20","9","3","19083","33.33"
"Harrison","0","17","Iowa","5/13/20","17","0","19085","0"
"Henry","0","43","Iowa","5/13/20","40","3","19087","7.5"
"Howard","0","12","Iowa","5/13/20","12","0","19089","0"
"Humboldt","0","7","Iowa","5/13/20","4","3","19091","75"
"Ida","0","2","Iowa","5/13/20","0","2","19093","1"
"Iowa","0","26","Iowa","5/13/20","24","2","19095","8.33"
"Jackson","0","7","Iowa","5/13/20","5","2","19097","40"
"Jasper","3","239","Iowa","5/13/20","220","19","19099","8.64"
"Jefferson","0","9","Iowa","5/13/20","6","3","19101","50"
"Johnson","4","558","Iowa","5/13/20","530","28","19103","5.28"
"Jones","1","34","Iowa","5/13/20","25","9","19105","36"
"Keokuk","1","9","Iowa","5/13/20","3","6","19107","200"
"Kossuth","0","2","Iowa","5/13/20","2","0","19109","0"
"Lee","0","18","Iowa","5/13/20","16","2","19111","12.5"
"Linn","13","858","Iowa","5/13/20","770","88","19113","11.43"
"Louisa","1","289","Iowa","5/13/20","279","10","19115","3.58"
"Lyon","0","16","Iowa","5/13/20","15","1","19119","6.67"
"Madison","0","13","Iowa","5/13/20","10","3","19121","30"
"Mahaska","0","21","Iowa","5/13/20","19","2","19123","10.53"
"Marion","1","17","Iowa","5/13/20","12","5","19125","41.67"
"Marshall","13","748","Iowa","5/13/20","655","93","19127","14.2"
"Mills","1","9","Iowa","5/13/20","5","4","19129","80"
"Mitchell","0","3","Iowa","5/13/20","3","0","19131","0"
"Monona","0","13","Iowa","5/13/20","11","2","19133","18.18"
"Monroe","2","18","Iowa","5/13/20","1","17","19135","1700"
"Montgomery","1","5","Iowa","5/13/20","1","4","19137","400"
"Muscatine","11","513","Iowa","5/13/20","435","78","19139","17.93"
"O'Brien","1","19","Iowa","5/13/20","11","8","19141","72.73"
"Osceola","1","23","Iowa","5/13/20","13","10","19143","76.92"
"Page","0","10","Iowa","5/13/20","9","1","19145","11.11"
"Palo Alto","0","1","Iowa","5/13/20","0","1","19147","1"
"Plymouth","5","71","Iowa","5/13/20","34","37","19149","108.82"
"Pocahontas","0","3","Iowa","5/13/20","3","0","19151","0"
"Polk","97","2551","Iowa","5/13/20","1875","676","19153","36.05"
"Pottawattamie","6","105","Iowa","5/13/20","63","42","19155","66.67"
"Poweshiek","1","83","Iowa","5/13/20","73","10","19157","13.7"
"Sac","0","3","Iowa","5/13/20","2","1","19161","50"
"Scott","4","291","Iowa","5/13/20","260","31","19163","11.92"
"Shelby","1","20","Iowa","5/13/20","13","7","19165","53.85"
"Sioux","11","103","Iowa","5/13/20","25","78","19167","312"
"Story","4","65","Iowa","5/13/20","40","25","19169","62.5"
"Tama","6","345","Iowa","5/13/20","303","42","19171","13.86"
"Taylor","0","1","Iowa","5/13/20","1","0","19173","0"
"Union","0","2","Iowa","5/13/20","1","1","19175","100"
"Van Buren","0","8","Iowa","5/13/20","8","0","19177","0"
"Wapello","26","306","Iowa","5/13/20","125","181","19179","144.8"
"Warren","3","52","Iowa","5/13/20","34","18","19181","52.94"
"Washington","2","163","Iowa","5/13/20","152","11","19183","7.24"
"Wayne","0","1","Iowa","5/13/20","1","0","19185","0"
"Webster","1","12","Iowa","5/13/20","8","4","19187","50"
"Winnebago","0","5","Iowa","5/13/20","3","2","19189","66.67"
"Winneshiek","0","18","Iowa","5/13/20","18","0","19191","0"
"Woodbury","104","2054","Iowa","5/13/20","1323","731","19193","55.25"
"Worth","0","2","Iowa","5/13/20","1","1","19195","100"
"Wright","0","6","Iowa","5/13/20","5","1","19197","20"
"Anderson","0","1","Kansas","5/13/20","0","1","20003","1"
"Atchison","0","15","Kansas","5/13/20","12","3","20005","25"
"Barber","0","1","Kansas","5/13/20","1","0","20007","0"
"Barton","2","24","Kansas","5/13/20","12","12","20009","100"
"Bourbon","0","6","Kansas","5/13/20","6","0","20011","0"
"Brown","0","1","Kansas","5/13/20","1","0","20013","0"
"Butler","0","14","Kansas","5/13/20","14","0","20015","0"
"Chase","0","3","Kansas","5/13/20","3","0","20017","0"
"Chautauqua","0","4","Kansas","5/13/20","4","0","20019","0"
"Cherokee","0","8","Kansas","5/13/20","8","0","20021","0"
"Cheyenne","0","2","Kansas","5/13/20","2","0","20023","0"
"Clark","1","19","Kansas","5/13/20","9","10","20025","111.11"
"Clay","0","4","Kansas","5/13/20","4","0","20027","0"
"Cloud","0","4","Kansas","5/13/20","4","0","20029","0"
"Coffey","0","50","Kansas","5/13/20","50","0","20031","0"
"Cowley","0","3","Kansas","5/13/20","3","0","20035","0"
"Crawford","0","8","Kansas","5/13/20","8","0","20037","0"
"Dickinson","0","2","Kansas","5/13/20","2","0","20041","0"
"Doniphan","1","9","Kansas","5/13/20","4","5","20043","125"
"Douglas","0","58","Kansas","5/13/20","56","2","20045","3.57"
"Edwards","0","4","Kansas","5/13/20","4","0","20047","0"
"Ellis","0","8","Kansas","5/13/20","8","0","20051","0"
"Ellsworth","0","2","Kansas","5/13/20","1","1","20053","100"
"Finney","52","1101","Kansas","5/13/20","740","361","20055","48.78"
"Ford","50","1229","Kansas","5/13/20","880","349","20057","39.66"
"Franklin","1","30","Kansas","5/13/20","20","10","20059","50"
"Geary","0","14","Kansas","5/13/20","13","1","20061","7.69"
"Gove","0","1","Kansas","5/13/20","1","0","20063","0"
"Grant","1","12","Kansas","5/13/20","8","4","20067","50"
"Gray","1","10","Kansas","5/13/20","6","4","20069","66.67"
"Greenwood","0","3","Kansas","5/13/20","3","0","20073","0"
"Hamilton","1","8","Kansas","5/13/20","4","4","20075","100"
"Harper","0","1","Kansas","5/13/20","1","0","20077","0"
"Harvey","0","9","Kansas","5/13/20","9","0","20079","0"
"Haskell","1","16","Kansas","5/13/20","8","8","20081","100"
"Jackson","1","12","Kansas","5/13/20","2","10","20085","500"
"Jefferson","1","16","Kansas","5/13/20","11","5","20087","45.45"
"Jewell","0","4","Kansas","5/13/20","4","0","20089","0"
"Johnson","13","612","Kansas","5/13/20","521","91","20091","17.47"
"Kearny","1","34","Kansas","5/13/20","24","10","20093","41.67"
"Kiowa","0","2","Kansas","5/13/20","2","0","20097","0"
"Labette","0","22","Kansas","5/13/20","22","0","20099","0"
"Leavenworth","24","950","Kansas","5/13/20","783","167","20103","21.33"
"Linn","0","6","Kansas","5/13/20","6","0","20107","0"
"Lyon","5","305","Kansas","5/13/20","271","34","20111","12.55"
"Marion","0","5","Kansas","5/13/20","5","0","20115","0"
"McPherson","0","26","Kansas","5/13/20","25","1","20113","4"
"Meade","1","22","Kansas","5/13/20","13","9","20119","69.23"
"Miami","0","6","Kansas","5/13/20","5","1","20121","20"
"Mitchell","0","3","Kansas","5/13/20","3","0","20123","0"
"Montgomery","0","20","Kansas","5/13/20","20","0","20125","0"
"Morris","0","3","Kansas","5/13/20","3","0","20127","0"
"Morton","0","4","Kansas","5/13/20","3","1","20129","33.33"
"Nemaha","0","1","Kansas","5/13/20","1","0","20131","0"
"Neosho","0","2","Kansas","5/13/20","2","0","20133","0"
"Norton","0","2","Kansas","5/13/20","2","0","20137","0"
"Osage","0","6","Kansas","5/13/20","5","1","20139","20"
"Osborne","0","2","Kansas","5/13/20","2","0","20141","0"
"Ottawa","0","4","Kansas","5/13/20","4","0","20143","0"
"Phillips","0","1","Kansas","5/13/20","1","0","20147","0"
"Pottawatomie","0","18","Kansas","5/13/20","15","3","20149","20"
"Pratt","0","1","Kansas","5/13/20","1","0","20151","0"
"Reno","0","41","Kansas","5/13/20","40","1","20155","2.5"
"Republic","0","4","Kansas","5/13/20","4","0","20157","0"
"Rice","0","4","Kansas","5/13/20","3","1","20159","33.33"
"Riley","1","59","Kansas","5/13/20","55","4","20161","7.27"
"Rooks","0","6","Kansas","5/13/20","6","0","20163","0"
"Saline","0","23","Kansas","5/13/20","21","2","20169","9.52"
"Scott","1","6","Kansas","5/13/20","2","4","20171","200"
"Sedgwick","9","507","Kansas","5/13/20","441","66","20173","14.97"
"Seward","15","743","Kansas","5/13/20","640","103","20175","16.09"
"Shawnee","6","178","Kansas","5/13/20","137","41","20177","29.93"
"Sheridan","0","2","Kansas","5/13/20","2","0","20179","0"
"Sherman","0","5","Kansas","5/13/20","5","0","20181","0"
"Smith","0","2","Kansas","5/13/20","2","0","20183","0"
"Stafford","0","1","Kansas","5/13/20","1","0","20185","0"
"Stanton","0","9","Kansas","5/13/20","7","2","20187","28.57"
"Stevens","1","18","Kansas","5/13/20","14","4","20189","28.57"
"Sumner","0","5","Kansas","5/13/20","4","1","20191","25"
"Wabaunsee","0","27","Kansas","5/13/20","27","0","20197","0"
"Wilson","0","1","Kansas","5/13/20","1","0","20205","0"
"Woodson","0","6","Kansas","5/13/20","6","0","20207","0"
"Wyandotte","27","1098","Kansas","5/13/20","910","188","20209","20.66"
"Adair","1","88","Kentucky","5/13/20","82","6","21001","7.32"
"Allen","2","30","Kentucky","5/13/20","19","11","21003","57.89"
"Anderson","0","10","Kentucky","5/13/20","9","1","21005","11.11"
"Ballard","0","8","Kentucky","5/13/20","8","0","21007","0"
"Barren","1","30","Kentucky","5/13/20","22","8","21009","36.36"
"Bath","0","7","Kentucky","5/13/20","4","3","21011","75"
"Boone","6","238","Kentucky","5/13/20","196","42","21015","21.43"
"Bourbon","0","8","Kentucky","5/13/20","8","0","21017","0"
"Boyd","1","37","Kentucky","5/13/20","31","6","21019","19.35"
"Boyle","0","17","Kentucky","5/13/20","16","1","21021","6.25"
"Bracken","0","9","Kentucky","5/13/20","9","0","21023","0"
"Breathitt","0","2","Kentucky","5/13/20","2","0","21025","0"
"Breckinridge","0","13","Kentucky","5/13/20","11","2","21027","18.18"
"Bullitt","2","86","Kentucky","5/13/20","72","14","21029","19.44"
"Butler","2","200","Kentucky","5/13/20","183","17","21031","9.29"
"Caldwell","0","12","Kentucky","5/13/20","12","0","21033","0"
"Calloway","1","43","Kentucky","5/13/20","35","8","21035","22.86"
"Campbell","2","120","Kentucky","5/13/20","107","13","21037","12.15"
"Carlisle","0","3","Kentucky","5/13/20","2","1","21039","50"
"Carroll","0","2","Kentucky","5/13/20","2","0","21041","0"
"Carter","0","7","Kentucky","5/13/20","6","1","21043","16.67"
"Casey","0","1","Kentucky","5/13/20","1","0","21045","0"
"Christian","0","95","Kentucky","5/13/20","92","3","21047","3.26"
"Clark","0","20","Kentucky","5/13/20","20","0","21049","0"
"Clay","0","2","Kentucky","5/13/20","1","1","21051","100"
"Clinton","0","3","Kentucky","5/13/20","3","0","21053","0"
"Crittenden","0","4","Kentucky","5/13/20","4","0","21055","0"
"Cumberland","0","5","Kentucky","5/13/20","5","0","21057","0"
"Daviess","4","274","Kentucky","5/13/20","247","27","21059","10.93"
"Edmonson","1","45","Kentucky","5/13/20","38","7","21061","18.42"
"Fayette","15","409","Kentucky","5/13/20","306","103","21067","33.66"
"Fleming","0","1","Kentucky","5/13/20","2","-1","21069","-50"
"Floyd","0","15","Kentucky","5/13/20","12","3","21071","25"
"Franklin","0","18","Kentucky","5/13/20","16","2","21073","12.5"
"Fulton","0","1","Kentucky","5/13/20","1","0","21075","0"
"Gallatin","0","1","Kentucky","5/13/20","1","0","21077","0"
"Garrard","0","4","Kentucky","5/13/20","2","2","21079","100"
"Grant","1","31","Kentucky","5/13/20","27","4","21081","14.81"
"Graves","1","149","Kentucky","5/13/20","142","7","21083","4.93"
"Grayson","1","99","Kentucky","5/13/20","90","9","21085","10"
"Green","0","1","Kentucky","5/13/20","1","0","21087","0"
"Greenup","0","13","Kentucky","5/13/20","12","1","21089","8.33"
"Hancock","0","6","Kentucky","5/13/20","6","0","21091","0"
"Hardin","1","63","Kentucky","5/13/20","55","8","21093","14.55"
"Harlan","0","1","Kentucky","5/13/20","0","1","21095","1"
"Harrison","0","19","Kentucky","5/13/20","18","1","21097","5.56"
"Hart","0","9","Kentucky","5/13/20","8","1","21099","12.5"
"Henderson","1","80","Kentucky","5/13/20","72","8","21101","11.11"
"Henry","0","10","Kentucky","5/13/20","8","2","21103","25"
"Hickman","0","5","Kentucky","5/13/20","5","0","21105","0"
"Hopkins","0","214","Kentucky","5/13/20","211","3","21107","1.42"
"Jackson","-1","56","Kentucky","5/13/20","60","-4","21109","-6.67"
"Jefferson","25","1713","Kentucky","5/13/20","1535","178","21111","11.6"
"Jessamine","1","49","Kentucky","5/13/20","40","9","21113","22.5"
"Johnson","0","5","Kentucky","5/13/20","3","2","21115","66.67"
"Kenton","8","408","Kentucky","5/13/20","353","55","21117","15.58"
"Knott","0","4","Kentucky","5/13/20","4","0","21119","0"
"Knox","0","7","Kentucky","5/13/20","6","1","21121","16.67"
"Larue","0","6","Kentucky","5/13/20","6","0","21123","0"
"Laurel","0","21","Kentucky","5/13/20","20","1","21125","5"
"Lawrence","0","1","Kentucky","5/13/20","1","0","21127","0"
"Leslie","0","5","Kentucky","5/13/20","4","1","21131","25"
"Letcher","0","3","Kentucky","5/13/20","3","0","21133","0"
"Lewis","0","6","Kentucky","5/13/20","3","3","21135","100"
"Lincoln","0","5","Kentucky","5/13/20","6","-1","21137","-16.67"
"Livingston","0","7","Kentucky","5/13/20","6","1","21139","16.67"
"Logan","8","69","Kentucky","5/13/20","15","54","21141","360"
"Lyon","0","14","Kentucky","5/13/20","13","1","21143","7.69"
"Madison","1","35","Kentucky","5/13/20","31","4","21151","12.9"
"Marion","0","17","Kentucky","5/13/20","17","0","21155","0"
"Marshall","0","34","Kentucky","5/13/20","33","1","21157","3.03"
"Martin","0","3","Kentucky","5/13/20","3","0","21159","0"
"Mason","0","7","Kentucky","5/13/20","6","1","21161","16.67"
"McCracken","1","73","Kentucky","5/13/20","65","8","21145","12.31"
"McCreary","0","13","Kentucky","5/13/20","11","2","21147","18.18"
"McLean","0","17","Kentucky","5/13/20","16","1","21149","6.25"
"Meade","0","18","Kentucky","5/13/20","17","1","21163","5.88"
"Menifee","0","3","Kentucky","5/13/20","3","0","21165","0"
"Mercer","0","12","Kentucky","5/13/20","10","2","21167","20"
"Metcalfe","0","3","Kentucky","5/13/20","1","2","21169","200"
"Monroe","0","6","Kentucky","5/13/20","6","0","21171","0"
"Montgomery","0","13","Kentucky","5/13/20","11","2","21173","18.18"
"Morgan","0","1","Kentucky","5/13/20","1","0","21175","0"
"Muhlenberg","2","457","Kentucky","5/13/20","446","11","21177","2.47"
"Nelson","1","31","Kentucky","5/13/20","24","7","21179","29.17"
"Nicholas","0","1","Kentucky","5/13/20","1","0","21181","0"
"Ohio","2","73","Kentucky","5/13/20","62","11","21183","17.74"
"Oldham","1","41","Kentucky","5/13/20","35","6","21185","17.14"
"Owen","0","1","Kentucky","5/13/20","1","0","21187","0"
"Owsley","0","2","Kentucky","5/13/20","2","0","21189","0"
"Pendleton","0","6","Kentucky","5/13/20","5","1","21191","20"
"Perry","0","16","Kentucky","5/13/20","14","2","21193","14.29"
"Pike","1","18","Kentucky","5/13/20","14","4","21195","28.57"
"Powell","0","1","Kentucky","5/13/20","1","0","21197","0"
"Pulaski","0","45","Kentucky","5/13/20","43","2","21199","4.65"
"Rockcastle","0","13","Kentucky","5/13/20","13","0","21203","0"
"Rowan","1","6","Kentucky","5/13/20","2","4","21205","200"
"Russell","0","18","Kentucky","5/13/20","17","1","21207","5.88"
"Scott","1","33","Kentucky","5/13/20","24","9","21209","37.5"
"Shelby","3","54","Kentucky","5/13/20","34","20","21211","58.82"
"Simpson","0","32","Kentucky","5/13/20","31","1","21213","3.23"
"Spencer","0","16","Kentucky","5/13/20","16","0","21215","0"
"Taylor","0","9","Kentucky","5/13/20","8","1","21217","12.5"
"Todd","0","15","Kentucky","5/13/20","13","2","21219","15.38"
"Trigg","0","9","Kentucky","5/13/20","9","0","21221","0"
"Trimble","0","3","Kentucky","5/13/20","3","0","21223","0"
"Union","0","10","Kentucky","5/13/20","10","0","21225","0"
"Warren","27","637","Kentucky","5/13/20","447","190","21227","42.51"
"Washington","0","5","Kentucky","5/13/20","5","0","21229","0"
"Wayne","0","8","Kentucky","5/13/20","8","0","21231","0"
"Webster","0","29","Kentucky","5/13/20","26","3","21233","11.54"
"Whitley","0","12","Kentucky","5/13/20","11","1","21235","9.09"
"Woodford","0","19","Kentucky","5/13/20","17","2","21239","11.76"
"Acadia","2","151","Louisiana","5/13/20","140","11","22001","7.86"
"Allen","1","94","Louisiana","5/13/20","90","4","22003","4.44"
"Ascension","6","704","Louisiana","5/13/20","664","40","22005","6.02"
"Assumption","4","231","Louisiana","5/13/20","203","28","22007","13.79"
"Avoyelles","1","79","Louisiana","5/13/20","74","5","22009","6.76"
"Beauregard","1","48","Louisiana","5/13/20","44","4","22011","9.09"
"Bienville","0","80","Louisiana","5/13/20","78","2","22013","2.56"
"Bossier","3","324","Louisiana","5/13/20","303","21","22015","6.93"
"Caddo","19","1800","Louisiana","5/13/20","1667","133","22017","7.98"
"Calcasieu","4","505","Louisiana","5/13/20","475","30","22019","6.32"
"Caldwell","1","48","Louisiana","5/13/20","41","7","22021","17.07"
"Cameron","0","3","Louisiana","5/13/20","3","0","22023","0"
"Catahoula","8","103","Louisiana","5/13/20","46","57","22025","123.91"
"Claiborne","0","59","Louisiana","5/13/20","58","1","22027","1.72"
"Concordia","1","51","Louisiana","5/13/20","42","9","22029","21.43"
"De Soto","2","221","Louisiana","5/13/20","205","16","22031","7.8"
"East Baton Rouge","38","2487","Louisiana","5/13/20","2224","263","22033","11.83"
"East Carroll","2","25","Louisiana","5/13/20","11","14","22035","127.27"
"East Feliciana","2","145","Louisiana","5/13/20","132","13","22037","9.85"
"Evangeline","2","74","Louisiana","5/13/20","63","11","22039","17.46"
"Franklin","16","256","Louisiana","5/13/20","146","110","22041","75.34"
"Grant","0","18","Louisiana","5/13/20","17","1","22043","5.88"
"Iberia","11","352","Louisiana","5/13/20","278","74","22045","26.62"
"Iberville","3","507","Louisiana","5/13/20","489","18","22047","3.68"
"Jackson","2","67","Louisiana","5/13/20","56","11","22049","19.64"
"Jefferson","40","6833","Louisiana","5/13/20","6554","279","22051","4.26"
"Jefferson Davis","0","69","Louisiana","5/13/20","66","3","22053","4.55"
"Lafayette","9","537","Louisiana","5/13/20","477","60","22055","12.58"
"Lafourche","3","716","Louisiana","5/13/20","692","24","22057","3.47"
"LaSalle","1","35","Louisiana","5/13/20","29","6","22059","20.69"
"Lincoln","2","115","Louisiana","5/13/20","99","16","22061","16.16"
"Livingston","4","293","Louisiana","5/13/20","266","27","22063","10.15"
"Madison","1","14","Louisiana","5/13/20","8","6","22065","75"
"Morehouse","5","87","Louisiana","5/13/20","55","32","22067","58.18"
"Natchitoches","1","100","Louisiana","5/13/20","91","9","22069","9.89"
"Orleans","21","6753","Louisiana","5/13/20","6608","145","22071","2.19"
"Ouachita","8","861","Louisiana","5/13/20","806","55","22073","6.82"
"Plaquemines","1","191","Louisiana","5/13/20","183","8","22075","4.37"
"Pointe Coupee","3","139","Louisiana","5/13/20","117","22","22077","18.8"
"Rapides","11","394","Louisiana","5/13/20","316","78","22079","24.68"
"Red River","0","37","Louisiana","5/13/20","34","3","22081","8.82"
"Richland","3","104","Louisiana","5/13/20","86","18","22083","20.93"
"Sabine","2","28","Louisiana","5/13/20","17","11","22085","64.71"
"St. Bernard","1","515","Louisiana","5/13/20","505","10","22087","1.98"
"St. Charles","1","600","Louisiana","5/13/20","590","10","22089","1.69"
"St. Helena","1","38","Louisiana","5/13/20","32","6","22091","18.75"
"St. James","2","268","Louisiana","5/13/20","256","12","22093","4.69"
"St. John the Baptist","3","808","Louisiana","5/13/20","790","18","22095","2.28"
"St. Landry","6","241","Louisiana","5/13/20","202","39","22097","19.31"
"St. Martin","3","276","Louisiana","5/13/20","252","24","22099","9.52"
"St. Mary","6","257","Louisiana","5/13/20","215","42","22101","19.53"
"St. Tammany","12","1492","Louisiana","5/13/20","1406","86","22103","6.12"
"Tangipahoa","8","687","Louisiana","5/13/20","631","56","22105","8.87"
"Tensas","1","6","Louisiana","5/13/20","2","4","22107","200"
"Terrebonne","9","542","Louisiana","5/13/20","476","66","22109","13.87"
"Union","11","227","Louisiana","5/13/20","148","79","22111","53.38"
"Vermilion","0","42","Louisiana","5/13/20","40","2","22113","5"
"Vernon","0","19","Louisiana","5/13/20","17","2","22115","11.76"
"Washington","7","350","Louisiana","5/13/20","298","52","22117","17.45"
"Webster","2","112","Louisiana","5/13/20","96","16","22119","16.67"
"West Baton Rouge","1","124","Louisiana","5/13/20","118","6","22121","5.08"
"West Carroll","0","5","Louisiana","5/13/20","4","1","22123","25"
"West Feliciana","4","187","Louisiana","5/13/20","158","29","22125","18.35"
"Winn","2","64","Louisiana","5/13/20","47","17","22127","36.17"
"Androscoggin","5","103","Maine","5/13/20","67","36","23001","53.73"
"Aroostook","0","6","Maine","5/13/20","6","0","23003","0"
"Cumberland","23","744","Maine","5/13/20","583","161","23005","27.62"
"Franklin","0","31","Maine","5/13/20","29","2","23007","6.9"
"Hancock","0","10","Maine","5/13/20","10","0","23009","0"
"Kennebec","1","112","Maine","5/13/20","106","6","23011","5.66"
"Knox","0","19","Maine","5/13/20","17","2","23013","11.76"
"Lincoln","0","15","Maine","5/13/20","14","1","23015","7.14"
"Oxford","0","17","Maine","5/13/20","16","1","23017","6.25"
"Penobscot","0","90","Maine","5/13/20","87","3","23019","3.45"
"Piscataquis","0","1","Maine","5/13/20","1","0","23021","0"
"Sagadahoc","0","23","Maine","5/13/20","20","3","23023","15"
"Somerset","0","18","Maine","5/13/20","17","1","23025","5.88"
"Waldo","0","49","Maine","5/13/20","49","0","23027","0"
"Washington","0","2","Maine","5/13/20","2","0","23029","0"
"York","6","269","Maine","5/13/20","230","39","23031","16.96"
"Allegany","3","149","Maryland","5/13/20","129","20","24001","15.5"
"Anne Arundel","73","2596","Maryland","5/13/20","2085","511","24003","24.51"
"Baltimore","90","4160","Maryland","5/13/20","3527","633","24005","17.95"
"Baltimore City","103","3476","Maryland","5/13/20","2752","724","24510","26.31"
"Calvert","4","214","Maryland","5/13/20","184","30","24009","16.3"
"Caroline","11","177","Maryland","5/13/20","101","76","24011","75.25"
"Carroll","11","595","Maryland","5/13/20","521","74","24013","14.2"
"Cecil","10","271","Maryland","5/13/20","200","71","24015","35.5"
"Charles","15","778","Maryland","5/13/20","670","108","24017","16.12"
"Dorchester","3","102","Maryland","5/13/20","79","23","24019","29.11"
"Frederick","28","1302","Maryland","5/13/20","1108","194","24021","17.51"
"Garrett","0","6","Maryland","5/13/20","4","2","24023","50"
"Harford","14","629","Maryland","5/13/20","532","97","24025","18.23"
"Howard","28","1258","Maryland","5/13/20","1061","197","24027","18.57"
"Kent","4","123","Maryland","5/13/20","94","29","24029","30.85"
"Montgomery","213","7283","Maryland","5/13/20","5790","1493","24031","25.79"
"Prince George's","277","10072","Maryland","5/13/20","8135","1937","24033","23.81"
"Queen Anne's","5","104","Maryland","5/13/20","67","37","24035","55.22"
"Somerset","2","51","Maryland","5/13/20","39","12","24039","30.77"
"St. Mary's","10","254","Maryland","5/13/20","186","68","24037","36.56"
"Talbot","2","62","Maryland","5/13/20","45","17","24041","37.78"
"Washington","5","287","Maryland","5/13/20","251","36","24043","14.34"
"Wicomico","32","738","Maryland","5/13/20","517","221","24045","42.75"
"Worcester","6","125","Maryland","5/13/20","86","39","24047","45.35"
"Barnstable","20","1178","Massachusetts","5/13/20","1039","139","25001","13.38"
"Berkshire","4","498","Massachusetts","5/13/20","469","29","25003","6.18"
"Bristol","129","5361","Massachusetts","5/13/20","4457","904","25005","20.28"
"Dukes and Nantucket","1","42","Massachusetts","5/13/20","36","6","00000","16.67"
"Essex","203","11955","Massachusetts","5/13/20","10533","1422","25009","13.5"
"Franklin","4","312","Massachusetts","5/13/20","284","28","25011","9.86"
"Hampden","85","4978","Massachusetts","5/13/20","4383","595","25013","13.58"
"Hampshire","19","731","Massachusetts","5/13/20","599","132","25015","22.04"
"Middlesex","291","18680","Massachusetts","5/13/20","16643","2037","25017","12.24"
"Norfolk","87","7457","Massachusetts","5/13/20","6847","610","25021","8.91"
"Plymouth","107","6811","Massachusetts","5/13/20","6060","751","25023","12.39"
"Suffolk","177","15964","Massachusetts","5/13/20","14722","1242","25025","8.44"
"Worcester","184","8391","Massachusetts","5/13/20","7105","1286","25027","18.1"
"Alcona","0","7","Michigan","5/13/20","7","0","26001","0"
"Allegan","6","194","Michigan","5/13/20","151","43","26005","28.48"
"Alpena","0","95","Michigan","5/13/20","93","2","26007","2.15"
"Antrim","0","11","Michigan","5/13/20","11","0","26009","0"
"Arenac","0","32","Michigan","5/13/20","31","1","26011","3.23"
"Baraga","0","1","Michigan","5/13/20","1","0","26013","0"
"Barry","2","67","Michigan","5/13/20","52","15","26015","28.85"
"Bay","6","248","Michigan","5/13/20","207","41","26017","19.81"
"Benzie","0","4","Michigan","5/13/20","4","0","26019","0"
"Berrien","13","545","Michigan","5/13/20","453","92","26021","20.31"
"Branch","2","90","Michigan","5/13/20","77","13","26023","16.88"
"Calhoun","5","313","Michigan","5/13/20","279","34","26025","12.19"
"Cass","1","55","Michigan","5/13/20","46","9","26027","19.57"
"Charlevoix","0","14","Michigan","5/13/20","15","-1","26029","-6.67"
"Cheboygan","0","24","Michigan","5/13/20","24","0","26031","0"
"Chippewa","0","3","Michigan","5/13/20","3","0","26033","0"
"Clare","0","12","Michigan","5/13/20","12","0","26035","0"
"Clinton","1","146","Michigan","5/13/20","136","10","26037","7.35"
"Crawford","0","61","Michigan","5/13/20","60","1","26039","1.67"
"Delta","0","16","Michigan","5/13/20","15","1","26041","6.67"
"Dickinson","0","5","Michigan","5/13/20","4","1","26043","25"
"Eaton","3","184","Michigan","5/13/20","163","21","26045","12.88"
"Emmet","0","25","Michigan","5/13/20","25","0","26047","0"
"Federal Correctional Institution (FCI)","1","114","Michigan","5/13/20","104","10","00000","9.62"
"Genesee","25","2046","Michigan","5/13/20","1873","173","26049","9.24"
"Gladwin","0","18","Michigan","5/13/20","15","3","26051","20"
"Gogebic","0","4","Michigan","5/13/20","4","0","26053","0"
"Grand Traverse","0","22","Michigan","5/13/20","21","1","26055","4.76"
"Gratiot","1","39","Michigan","5/13/20","29","10","26057","34.48"
"Hillsdale","2","156","Michigan","5/13/20","140","16","26059","11.43"
"Houghton","0","2","Michigan","5/13/20","2","0","26061","0"
"Huron","1","43","Michigan","5/13/20","35","8","26063","22.86"
"Ingham","11","637","Michigan","5/13/20","561","76","26065","13.55"
"Ionia","2","121","Michigan","5/13/20","107","14","26067","13.08"
"Iosco","1","68","Michigan","5/13/20","64","4","26069","6.25"
"Isabella","0","76","Michigan","5/13/20","76","0","26073","0"
"Jackson","5","426","Michigan","5/13/20","394","32","26075","8.12"
"Kalamazoo","15","683","Michigan","5/13/20","577","106","26077","18.37"
"Kalkaska","0","28","Michigan","5/13/20","28","0","26079","0"
"Kent","65","2627","Michigan","5/13/20","2169","458","26081","21.12"
"Lake","0","3","Michigan","5/13/20","3","0","26085","0"
"Lapeer","1","188","Michigan","5/13/20","184","4","26087","2.17"
"Leelanau","0","9","Michigan","5/13/20","9","0","26089","0"
"Lenawee","3","161","Michigan","5/13/20","143","18","26091","12.59"
"Livingston","4","453","Michigan","5/13/20","428","25","26093","5.84"
"Luce","0","1","Michigan","5/13/20","1","0","26095","0"
"Mackinac","0","6","Michigan","5/13/20","6","0","26097","0"
"Macomb","48","6227","Michigan","5/13/20","5892","335","26099","5.69"
"Manistee","0","12","Michigan","5/13/20","12","0","26101","0"
"Marquette","0","51","Michigan","5/13/20","51","0","26103","0"
"Mason","1","26","Michigan","5/13/20","17","9","26105","52.94"
"Mecosta","0","19","Michigan","5/13/20","18","1","26107","5.56"
"Menominee","0","6","Michigan","5/13/20","6","0","26109","0"
"Michigan Department of Corrections (MDOC)","42","2230","Michigan","5/13/20","1936","294","00000","15.19"
"Midland","1","100","Michigan","5/13/20","92","8","26111","8.7"
"Missaukee","0","22","Michigan","5/13/20","22","0","26113","0"
"Monroe","8","435","Michigan","5/13/20","379","56","26115","14.78"
"Montcalm","1","55","Michigan","5/13/20","48","7","26117","14.58"
"Montmorency","0","5","Michigan","5/13/20","5","0","26119","0"
"Muskegon","10","408","Michigan","5/13/20","335","73","26121","21.79"
"Newaygo","1","40","Michigan","5/13/20","35","5","26123","14.29"
"Oakland","91","9121","Michigan","5/13/20","8482","639","26125","7.53"
"Oceana","3","46","Michigan","5/13/20","26","20","26127","76.92"
"Ogemaw","0","20","Michigan","5/13/20","19","1","26129","5.26"
"Osceola","0","11","Michigan","5/13/20","10","1","26133","10"
"Oscoda","0","8","Michigan","5/13/20","6","2","26135","33.33"
"Otsego","0","116","Michigan","5/13/20","113","3","26137","2.65"
"Ottawa","13","497","Michigan","5/13/20","408","89","26139","21.81"
"Out of MI","3","84","Michigan","5/13/20","64","20","80026","31.25"
"Presque Isle","0","11","Michigan","5/13/20","11","0","26141","0"
"Roscommon","0","22","Michigan","5/13/20","20","2","26143","10"
"Saginaw","14","866","Michigan","5/13/20","771","95","26145","12.32"
"Sanilac","0","39","Michigan","5/13/20","39","0","26151","0"
"Schoolcraft","0","4","Michigan","5/13/20","3","1","26153","33.33"
"Shiawassee","3","230","Michigan","5/13/20","211","19","26155","9"
"St. Clair","6","431","Michigan","5/13/20","390","41","26147","10.51"
"St. Joseph","5","78","Michigan","5/13/20","45","33","26149","73.33"
"Tuscola","6","164","Michigan","5/13/20","120","44","26157","36.67"
"Van Buren","4","113","Michigan","5/13/20","85","28","26159","32.94"
"Washtenaw","14","1346","Michigan","5/13/20","1249","97","26161","7.77"
"Wayne","131","18870","Michigan","5/13/20","17952","918","26163","5.11"
"Wexford","0","13","Michigan","5/13/20","11","2","26165","18.18"
"Aitkin","0","2","Minnesota","5/13/20","1","1","27001","100"
"Anoka","37","640","Minnesota","5/13/20","382","258","27003","67.54"
"Becker","2","28","Minnesota","5/13/20","16","12","27005","75"
"Beltrami","0","6","Minnesota","5/13/20","6","0","27007","0"
"Benton","6","102","Minnesota","5/13/20","59","43","27009","72.88"
"Big Stone","0","2","Minnesota","5/13/20","2","0","27011","0"
"Blue Earth","2","69","Minnesota","5/13/20","53","16","27013","30.19"
"Brown","0","10","Minnesota","5/13/20","9","1","27015","11.11"
"Carlton","1","65","Minnesota","5/13/20","61","4","27017","6.56"
"Carver","7","99","Minnesota","5/13/20","51","48","27019","94.12"
"Cass","0","8","Minnesota","5/13/20","7","1","27021","14.29"
"Chippewa","3","26","Minnesota","5/13/20","4","22","27023","550"
"Chisago","2","25","Minnesota","5/13/20","14","11","27025","78.57"
"Clay","6","256","Minnesota","5/13/20","215","41","27027","19.07"
"Clearwater","0","2","Minnesota","5/13/20","2","0","27029","0"
"Cottonwood","1","47","Minnesota","5/13/20","42","5","27033","11.9"
"Crow Wing","0","23","Minnesota","5/13/20","21","2","27035","9.52"
"Dakota","33","524","Minnesota","5/13/20","292","232","27037","79.45"
"Dodge","1","26","Minnesota","5/13/20","21","5","27039","23.81"
"Douglas","1","17","Minnesota","5/13/20","12","5","27041","41.67"
"Faribault","0","8","Minnesota","5/13/20","8","0","27043","0"
"Fillmore","0","14","Minnesota","5/13/20","12","2","27045","16.67"
"Freeborn","1","47","Minnesota","5/13/20","38","9","27047","23.68"
"Goodhue","1","27","Minnesota","5/13/20","23","4","27049","17.39"
"Grant","0","2","Minnesota","5/13/20","1","1","27051","100"
"Hennepin","203","4183","Minnesota","5/13/20","2764","1419","27053","51.34"
"Houston","0","2","Minnesota","5/13/20","1","1","27055","100"
"Isanti","0","10","Minnesota","5/13/20","7","3","27059","42.86"
"Itasca","2","40","Minnesota","5/13/20","24","16","27061","66.67"
"Jackson","1","33","Minnesota","5/13/20","25","8","27063","32"
"Kanabec","1","11","Minnesota","5/13/20","2","9","27065","450"
"Kandiyohi","25","383","Minnesota","5/13/20","211","172","27067","81.52"
"Kittson","0","1","Minnesota","5/13/20","1","0","27069","0"
"Koochiching","0","2","Minnesota","5/13/20","1","1","27071","100"
"Lac qui Parle","0","2","Minnesota","5/13/20","2","0","27073","0"
"Lake","0","1","Minnesota","5/13/20","0","1","27075","1"
"Le Sueur","1","31","Minnesota","5/13/20","26","5","27079","19.23"
"Lincoln","0","4","Minnesota","5/13/20","3","1","27081","33.33"
"Lyon","2","22","Minnesota","5/13/20","11","11","27083","100"
"Mahnomen","0","3","Minnesota","5/13/20","2","1","27087","50"
"Marshall","0","8","Minnesota","5/13/20","7","1","27089","14.29"
"Martin","0","113","Minnesota","5/13/20","111","2","27091","1.8"
"McLeod","1","15","Minnesota","5/13/20","6","9","27085","150"
"Meeker","1","23","Minnesota","5/13/20","18","5","27093","27.78"
"Mille Lacs","0","7","Minnesota","5/13/20","5","2","27095","40"
"Morrison","1","18","Minnesota","5/13/20","9","9","27097","100"
"Mower","2","48","Minnesota","5/13/20","35","13","27099","37.14"
"Murray","1","30","Minnesota","5/13/20","20","10","27101","50"
"Nicollet","1","23","Minnesota","5/13/20","17","6","27103","35.29"
"Nobles","30","1290","Minnesota","5/13/20","1082","208","27105","19.22"
"Norman","0","11","Minnesota","5/13/20","9","2","27107","22.22"
"Olmsted","9","385","Minnesota","5/13/20","322","63","27109","19.57"
"Otter Tail","1","27","Minnesota","5/13/20","19","8","27111","42.11"
"Pennington","0","1","Minnesota","5/13/20","1","0","27113","0"
"Pine","2","73","Minnesota","5/13/20","61","12","27115","19.67"
"Pipestone","1","8","Minnesota","5/13/20","4","4","27117","100"
"Polk","2","55","Minnesota","5/13/20","43","12","27119","27.91"
"Pope","1","5","Minnesota","5/13/20","1","4","27121","400"
"Ramsey","67","1124","Minnesota","5/13/20","656","468","27123","71.34"
"Red Lake","0","2","Minnesota","5/13/20","1","1","27125","100"
"Redwood","0","3","Minnesota","5/13/20","3","0","27127","0"
"Renville","0","6","Minnesota","5/13/20","6","0","27129","0"
"Rice","18","153","Minnesota","5/13/20","30","123","27131","410"
"Rock","0","19","Minnesota","5/13/20","18","1","27133","5.56"
"Roseau","0","1","Minnesota","5/13/20","1","0","27135","0"
"Scott","12","177","Minnesota","5/13/20","90","87","27139","96.67"
"Sherburne","7","126","Minnesota","5/13/20","80","46","27141","57.5"
"Sibley","0","4","Minnesota","5/13/20","2","2","27143","100"
"St. Louis","2","99","Minnesota","5/13/20","86","13","27137","15.12"
"Stearns","83","1558","Minnesota","5/13/20","975","583","27145","59.79"
"Steele","7","77","Minnesota","5/13/20","29","48","27147","165.52"
"Stevens","0","1","Minnesota","5/13/20","0","1","27149","1"
"Swift","1","10","Minnesota","5/13/20","2","8","27151","400"
"Todd","4","44","Minnesota","5/13/20","18","26","27153","144.44"
"Traverse","0","3","Minnesota","5/13/20","2","1","27155","50"
"Wabasha","1","15","Minnesota","5/13/20","10","5","27157","50"
"Wadena","0","4","Minnesota","5/13/20","3","1","27159","33.33"
"Waseca","2","18","Minnesota","5/13/20","7","11","27161","157.14"
"Washington","13","274","Minnesota","5/13/20","181","93","27163","51.38"
"Watonwan","2","30","Minnesota","5/13/20","15","15","27165","100"
"Wilkin","0","11","Minnesota","5/13/20","11","0","27167","0"
"Winona","1","72","Minnesota","5/13/20","68","4","27169","5.88"
"Wright","8","124","Minnesota","5/13/20","69","55","27171","79.71"
"Yellow Medicine","0","3","Minnesota","5/13/20","3","0","27173","0"
"Adams","1","163","Mississippi","5/13/20","154","9","28001","5.84"
"Alcorn","0","11","Mississippi","5/13/20","10","1","28003","10"
"Amite","1","38","Mississippi","5/13/20","32","6","28005","18.75"
"Attala","7","206","Mississippi","5/13/20","159","47","28007","29.56"
"Benton","0","14","Mississippi","5/13/20","12","2","28009","16.67"
"Bolivar","1","120","Mississippi","5/13/20","115","5","28011","4.35"
"Calhoun","0","58","Mississippi","5/13/20","57","1","28013","1.75"
"Carroll","0","105","Mississippi","5/13/20","102","3","28015","2.94"
"Chickasaw","2","95","Mississippi","5/13/20","83","12","28017","14.46"
"Choctaw","0","17","Mississippi","5/13/20","14","3","28019","21.43"
"Claiborne","1","41","Mississippi","5/13/20","33","8","28021","24.24"
"Clarke","3","90","Mississippi","5/13/20","68","22","28023","32.35"
"Clay","2","72","Mississippi","5/13/20","58","14","28025","24.14"
"Coahoma","0","72","Mississippi","5/13/20","70","2","28027","2.86"
"Copiah","5","170","Mississippi","5/13/20","137","33","28029","24.09"
"Covington","2","99","Mississippi","5/13/20","82","17","28031","20.73"
"DeSoto","6","350","Mississippi","5/13/20","310","40","28033","12.9"
"Forrest","9","336","Mississippi","5/13/20","273","63","28035","23.08"
"Franklin","0","19","Mississippi","5/13/20","17","2","28037","11.76"
"George","0","16","Mississippi","5/13/20","15","1","28039","6.67"
"Greene","0","6","Mississippi","5/13/20","6","0","28041","0"
"Grenada","2","55","Mississippi","5/13/20","41","14","28043","34.15"
"Hancock","1","75","Mississippi","5/13/20","68","7","28045","10.29"
"Harrison","3","210","Mississippi","5/13/20","187","23","28047","12.3"
"Hinds","16","698","Mississippi","5/13/20","588","110","28049","18.71"
"Holmes","8","231","Mississippi","5/13/20","176","55","28051","31.25"
"Humphreys","2","39","Mississippi","5/13/20","27","12","28053","44.44"
"Itawamba","1","71","Mississippi","5/13/20","65","6","28057","9.23"
"Jackson","1","278","Mississippi","5/13/20","271","7","28059","2.58"
"Jasper","4","97","Mississippi","5/13/20","66","31","28061","46.97"
"Jefferson","1","32","Mississippi","5/13/20","26","6","28063","23.08"
"Jefferson Davis","2","60","Mississippi","5/13/20","45","15","28065","33.33"
"Jones","9","264","Mississippi","5/13/20","199","65","28067","32.66"
"Kemper","3","99","Mississippi","5/13/20","80","19","28069","23.75"
"Lafayette","1","102","Mississippi","5/13/20","96","6","28071","6.25"
"Lamar","4","158","Mississippi","5/13/20","127","31","28073","24.41"
"Lauderdale","11","523","Mississippi","5/13/20","448","75","28075","16.74"
"Lawrence","1","71","Mississippi","5/13/20","61","10","28077","16.39"
"Leake","9","323","Mississippi","5/13/20","257","66","28079","25.68"
"Lee","1","81","Mississippi","5/13/20","73","8","28081","10.96"
"Leflore","2","192","Mississippi","5/13/20","177","15","28083","8.47"
"Lincoln","4","191","Mississippi","5/13/20","166","25","28085","15.06"
"Lowndes","4","93","Mississippi","5/13/20","64","29","28087","45.31"
"Madison","25","493","Mississippi","5/13/20","318","175","28089","55.03"
"Marion","1","86","Mississippi","5/13/20","77","9","28091","11.69"
"Marshall","2","62","Mississippi","5/13/20","49","13","28093","26.53"
"Monroe","4","203","Mississippi","5/13/20","178","25","28095","14.04"
"Montgomery","3","69","Mississippi","5/13/20","51","18","28097","35.29"
"Neshoba","12","338","Mississippi","5/13/20","254","84","28099","33.07"
"Newton","6","155","Mississippi","5/13/20","113","42","28101","37.17"
"Noxubee","4","117","Mississippi","5/13/20","92","25","28103","27.17"
"Oktibbeha","5","94","Mississippi","5/13/20","59","35","28105","59.32"
"Panola","0","45","Mississippi","5/13/20","42","3","28107","7.14"
"Pearl River","1","190","Mississippi","5/13/20","183","7","28109","3.83"
"Perry","0","35","Mississippi","5/13/20","32","3","28111","9.38"
"Pike","2","173","Mississippi","5/13/20","159","14","28113","8.81"
"Pontotoc","0","24","Mississippi","5/13/20","22","2","28115","9.09"
"Prentiss","0","36","Mississippi","5/13/20","33","3","28117","9.09"
"Quitman","0","18","Mississippi","5/13/20","16","2","28119","12.5"
"Rankin","5","262","Mississippi","5/13/20","226","36","28121","15.93"
"Scott","10","483","Mississippi","5/13/20","410","73","28123","17.8"
"Sharkey","0","5","Mississippi","5/13/20","5","0","28125","0"
"Simpson","1","65","Mississippi","5/13/20","55","10","28127","18.18"
"Smith","2","107","Mississippi","5/13/20","92","15","28129","16.3"
"Stone","0","23","Mississippi","5/13/20","23","0","28131","0"
"Sunflower","0","64","Mississippi","5/13/20","61","3","28133","4.92"
"Tallahatchie","0","14","Mississippi","5/13/20","12","2","28135","16.67"
"Tate","1","54","Mississippi","5/13/20","45","9","28137","20"
"Tippah","1","66","Mississippi","5/13/20","61","5","28139","8.2"
"Tishomingo","0","10","Mississippi","5/13/20","8","2","28141","25"
"Tunica","0","40","Mississippi","5/13/20","37","3","28143","8.11"
"Union","2","55","Mississippi","5/13/20","40","15","28145","37.5"
"Walthall","1","42","Mississippi","5/13/20","36","6","28147","16.67"
"Warren","5","123","Mississippi","5/13/20","90","33","28149","36.67"
"Washington","1","87","Mississippi","5/13/20","80","7","28151","8.75"
"Wayne","0","29","Mississippi","5/13/20","26","3","28153","11.54"
"Webster","0","22","Mississippi","5/13/20","21","1","28155","4.76"
"Wilkinson","1","78","Mississippi","5/13/20","72","6","28157","8.33"
"Winston","2","67","Mississippi","5/13/20","53","14","28159","26.42"
"Yalobusha","3","44","Mississippi","5/13/20","23","21","28161","91.3"
"Yazoo","2","171","Mississippi","5/13/20","155","16","28163","10.32"
"Adair","0","12","Missouri","5/13/20","12","0","29001","0"
"Andrew","1","11","Missouri","5/13/20","6","5","29003","83.33"
"Atchison","0","2","Missouri","5/13/20","2","0","29005","0"
"Audrain","0","2","Missouri","5/13/20","1","1","29007","100"
"Barry","0","6","Missouri","5/13/20","5","1","29009","20"
"Bates","0","6","Missouri","5/13/20","6","0","29013","0"
"Benton","0","8","Missouri","5/13/20","8","0","29015","0"
"Bollinger","0","4","Missouri","5/13/20","4","0","29017","0"
"Boone","0","100","Missouri","5/13/20","98","2","29019","2.04"
"Buchanan","13","476","Missouri","5/13/20","386","90","29021","23.32"
"Butler","0","27","Missouri","5/13/20","26","1","29023","3.85"
"Caldwell","0","3","Missouri","5/13/20","3","0","29025","0"
"Callaway","0","23","Missouri","5/13/20","23","0","29027","0"
"Camden","0","36","Missouri","5/13/20","35","1","29029","2.86"
"Cape Girardeau","0","52","Missouri","5/13/20","49","3","29031","6.12"
"Carroll","0","4","Missouri","5/13/20","2","2","29033","100"
"Carter","0","3","Missouri","5/13/20","3","0","29035","0"
"Cass","1","69","Missouri","5/13/20","64","5","29037","7.81"
"Cedar","0","9","Missouri","5/13/20","7","2","29039","28.57"
"Chariton","0","6","Missouri","5/13/20","5","1","29041","20"
"Christian","0","21","Missouri","5/13/20","19","2","29043","10.53"
"Clark","0","1","Missouri","5/13/20","1","0","29045","0"
"Clay","2","102","Missouri","5/13/20","85","17","29047","20"
"Clinton","0","14","Missouri","5/13/20","13","1","29049","7.69"
"Cole","0","56","Missouri","5/13/20","53","3","29051","5.66"
"Cooper","0","9","Missouri","5/13/20","9","0","29053","0"
"Crawford","0","8","Missouri","5/13/20","8","0","29055","0"
"Dallas","0","2","Missouri","5/13/20","2","0","29059","0"
"Daviess","0","3","Missouri","5/13/20","3","0","29061","0"
"DeKalb","0","4","Missouri","5/13/20","3","1","29063","33.33"
"Dunklin","0","24","Missouri","5/13/20","23","1","29069","4.35"
"Franklin","0","133","Missouri","5/13/20","132","1","29071","0.76"
"Gasconade","0","2","Missouri","5/13/20","2","0","29073","0"
"Gentry","0","1","Missouri","5/13/20","1","0","29075","0"
"Greene","1","104","Missouri","5/13/20","99","5","29077","5.05"
"Harrison","0","7","Missouri","5/13/20","6","1","29081","16.67"
"Henry","0","9","Missouri","5/13/20","8","1","29083","12.5"
"Holt","0","1","Missouri","5/13/20","1","0","29087","0"
"Howard","0","3","Missouri","5/13/20","2","1","29089","50"
"Howell","0","5","Missouri","5/13/20","5","0","29091","0"
"Iron","0","2","Missouri","5/13/20","2","0","29093","0"
"Jackson","6","401","Missouri","5/13/20","362","39","29095","10.77"
"Jasper","1","29","Missouri","5/13/20","24","5","29097","20.83"
"Jefferson","2","314","Missouri","5/13/20","301","13","29099","4.32"
"Johnson","1","65","Missouri","5/13/20","60","5","29101","8.33"
"Kansas City","15","808","Missouri","5/13/20","706","102","00000","14.45"
"Laclede","0","3","Missouri","5/13/20","0","3","29105","1"
"Lafayette","2","65","Missouri","5/13/20","50","15","29107","30"
"Lawrence","1","7","Missouri","5/13/20","1","6","29109","600"
"Lewis","0","6","Missouri","5/13/20","6","0","29111","0"
"Lincoln","4","103","Missouri","5/13/20","74","29","29113","39.19"
"Linn","0","5","Missouri","5/13/20","5","0","29115","0"
"Livingston","0","3","Missouri","5/13/20","4","-1","29117","-25"
"Macon","0","2","Missouri","5/13/20","2","0","29121","0"
"Madison","0","3","Missouri","5/13/20","2","1","29123","50"
"Maries","0","2","Missouri","5/13/20","2","0","29125","0"
"Marion","0","5","Missouri","5/13/20","5","0","29127","0"
"McDonald","0","5","Missouri","5/13/20","4","1","29119","25"
"Miller","0","4","Missouri","5/13/20","2","2","29131","100"
"Mississippi","2","49","Missouri","5/13/20","32","17","29133","53.12"
"Moniteau","-1","44","Missouri","5/13/20","51","-7","29135","-13.73"
"Montgomery","0","7","Missouri","5/13/20","7","0","29139","0"
"Morgan","0","7","Missouri","5/13/20","6","1","29141","16.67"
"New Madrid","0","13","Missouri","5/13/20","11","2","29143","18.18"
"Newton","0","12","Missouri","5/13/20","11","1","29145","9.09"
"Nodaway","0","5","Missouri","5/13/20","5","0","29147","0"
"Oregon","0","2","Missouri","5/13/20","2","0","29149","0"
"Osage","0","5","Missouri","5/13/20","5","0","29151","0"
"Pemiscot","3","67","Missouri","5/13/20","48","19","29155","39.58"
"Perry","0","46","Missouri","5/13/20","44","2","29157","4.55"
"Pettis","2","69","Missouri","5/13/20","55","14","29159","25.45"
"Phelps","0","2","Missouri","5/13/20","3","-1","29161","-33.33"
"Pike","0","13","Missouri","5/13/20","12","1","29163","8.33"
"Platte","2","50","Missouri","5/13/20","36","14","29165","38.89"
"Polk","0","1","Missouri","5/13/20","1","0","29167","0"
"Pulaski","0","36","Missouri","5/13/20","36","0","29169","0"
"Ralls","0","2","Missouri","5/13/20","1","1","29173","100"
"Randolph","0","8","Missouri","5/13/20","8","0","29175","0"
"Ray","0","12","Missouri","5/13/20","12","0","29177","0"
"Reynolds","0","2","Missouri","5/13/20","2","0","29179","0"
"Ripley","0","5","Missouri","5/13/20","5","0","29181","0"
"Saline","3","227","Missouri","5/13/20","208","19","29195","9.13"
"Scotland","0","4","Missouri","5/13/20","4","0","29199","0"
"Scott","1","83","Missouri","5/13/20","76","7","29201","9.21"
"Shelby","0","1","Missouri","5/13/20","1","0","29205","0"
"St. Charles","7","680","Missouri","5/13/20","631","49","29183","7.77"
"St. Clair","0","2","Missouri","5/13/20","2","0","29185","0"
"St. Francois","1","33","Missouri","5/13/20","29","4","29187","13.79"
"St. Louis","52","4137","Missouri","5/13/20","3772","365","29189","9.68"
"St. Louis City","27","1571","Missouri","5/13/20","1384","187","29510","13.51"
"Ste. Genevieve","0","8","Missouri","5/13/20","9","-1","29186","-11.11"
"Stoddard","1","30","Missouri","5/13/20","24","6","29207","25"
"Stone","0","3","Missouri","5/13/20","3","0","29209","0"
"Sullivan","0","3","Missouri","5/13/20","1","2","29211","200"
"Taney","0","12","Missouri","5/13/20","12","0","29213","0"
"Vernon","0","4","Missouri","5/13/20","5","-1","29217","-20"
"Warren","0","28","Missouri","5/13/20","26","2","29219","7.69"
"Washington","0","9","Missouri","5/13/20","9","0","29221","0"
"Webster","0","16","Missouri","5/13/20","15","1","29225","6.67"
"Worth","0","1","Missouri","5/13/20","1","0","29227","0"
"Wright","0","10","Missouri","5/13/20","10","0","29229","0"
"Beaverhead","0","1","Montana","5/13/20","1","0","30001","0"
"Big Horn","0","4","Montana","5/13/20","3","1","30003","33.33"
"Broadwater","0","4","Montana","5/13/20","4","0","30007","0"
"Carbon","0","6","Montana","5/13/20","6","0","30009","0"
"Cascade","0","17","Montana","5/13/20","16","1","30013","6.25"
"Deer Lodge","0","3","Montana","5/13/20","3","0","30023","0"
"Flathead","0","37","Montana","5/13/20","37","0","30029","0"
"Gallatin","0","149","Montana","5/13/20","146","3","30031","2.05"
"Glacier","0","6","Montana","5/13/20","6","0","30035","0"
"Golden Valley","0","3","Montana","5/13/20","3","0","30037","0"
"Hill","0","1","Montana","5/13/20","1","0","30041","0"
"Jefferson","0","3","Montana","5/13/20","2","1","30043","50"
"Lake","0","5","Montana","5/13/20","5","0","30047","0"
"Lewis and Clark","0","16","Montana","5/13/20","16","0","30049","0"
"Liberty","0","1","Montana","5/13/20","1","0","30051","0"
"Lincoln","0","7","Montana","5/13/20","7","0","30053","0"
"Madison","0","8","Montana","5/13/20","8","0","30057","0"
"Meagher","0","1","Montana","5/13/20","1","0","30059","0"
"Missoula","0","39","Montana","5/13/20","39","0","30063","0"
"Musselshell","0","1","Montana","5/13/20","1","0","30065","0"
"Park","0","8","Montana","5/13/20","8","0","30067","0"
"Pondera","0","2","Montana","5/13/20","2","0","30073","0"
"Ravalli","0","5","Montana","5/13/20","5","0","30081","0"
"Richland","0","3","Montana","5/13/20","3","0","30083","0"
"Roosevelt","0","7","Montana","5/13/20","7","0","30085","0"
"Silver Bow","0","11","Montana","5/13/20","11","0","30093","0"
"Stillwater","0","1","Montana","5/13/20","1","0","30095","0"
"Toole","0","29","Montana","5/13/20","29","0","30101","0"
"Wheatland","0","1","Montana","5/13/20","1","0","30107","0"
"Yellowstone","0","83","Montana","5/13/20","83","0","30111","0"
"Adams","3","236","Nebraska","5/13/20","212","24","31001","11.32"
"Antelope","0","5","Nebraska","5/13/20","4","1","31003","25"
"Boone","0","2","Nebraska","5/13/20","2","0","31011","0"
"Box Butte","0","1","Nebraska","5/13/20","1","0","31013","0"
"Buffalo","2","128","Nebraska","5/13/20","116","12","31019","10.34"
"Burt","0","5","Nebraska","5/13/20","5","0","31021","0"
"Butler","2","23","Nebraska","5/13/20","10","13","31023","130"
"Cass","1","15","Nebraska","5/13/20","7","8","31025","114.29"
"Cedar","0","6","Nebraska","5/13/20","4","2","31027","50"
"Cherry","0","1","Nebraska","5/13/20","1","0","31031","0"
"Cheyenne","0","8","Nebraska","5/13/20","7","1","31033","14.29"
"Clay","0","13","Nebraska","5/13/20","10","3","31035","30"
"Colfax","22","446","Nebraska","5/13/20","292","154","31037","52.74"
"Cuming","1","15","Nebraska","5/13/20","10","5","31039","50"
"Custer","0","29","Nebraska","5/13/20","26","3","31041","11.54"
"Dakota","57","1376","Nebraska","5/13/20","980","396","31043","40.41"
"Dawes","0","1","Nebraska","5/13/20","0","1","31045","1"
"Dawson","11","753","Nebraska","5/13/20","676","77","31047","11.39"
"Dixon","2","25","Nebraska","5/13/20","14","11","31051","78.57"
"Dodge","11","202","Nebraska","5/13/20","126","76","31053","60.32"
"Douglas","95","1779","Nebraska","5/13/20","1113","666","31055","59.84"
"Fillmore","0","3","Nebraska","5/13/20","3","0","31059","0"
"Franklin","0","5","Nebraska","5/13/20","5","0","31061","0"
"Frontier","0","1","Nebraska","5/13/20","1","0","31063","0"
"Furnas","0","4","Nebraska","5/13/20","4","0","31065","0"
"Gage","0","41","Nebraska","5/13/20","39","2","31067","5.13"
"Gosper","0","13","Nebraska","5/13/20","12","1","31073","8.33"
"Greeley","0","2","Nebraska","5/13/20","2","0","31077","0"
"Hall","13","1377","Nebraska","5/13/20","1287","90","31079","6.99"
"Hamilton","0","47","Nebraska","5/13/20","45","2","31081","4.44"
"Hitchcock","0","1","Nebraska","5/13/20","1","0","31087","0"
"Holt","0","1","Nebraska","5/13/20","1","0","31089","0"
"Howard","1","28","Nebraska","5/13/20","19","9","31093","47.37"
"Jefferson","0","6","Nebraska","5/13/20","4","2","31095","50"
"Johnson","0","5","Nebraska","5/13/20","4","1","31097","25"
"Kearney","0","9","Nebraska","5/13/20","6","3","31099","50"
"Keith","0","2","Nebraska","5/13/20","1","1","31101","100"
"Kimball","0","9","Nebraska","5/13/20","9","0","31105","0"
"Knox","0","6","Nebraska","5/13/20","5","1","31107","20"
"Lancaster","34","687","Nebraska","5/13/20","452","235","31109","51.99"
"Lincoln","1","40","Nebraska","5/13/20","36","4","31111","11.11"
"Madison","5","264","Nebraska","5/13/20","226","38","31119","16.81"
"McPherson","-1","0","Nebraska","5/13/20","10","-10","31117","-100"
"Merrick","1","26","Nebraska","5/13/20","20","6","31121","30"
"Morrill","0","9","Nebraska","5/13/20","7","2","31123","28.57"
"Nance","0","4","Nebraska","5/13/20","4","0","31125","0"
"Nemaha","0","2","Nebraska","5/13/20","1","1","31127","100"
"Otoe","0","4","Nebraska","5/13/20","3","1","31131","33.33"
"Phelps","1","11","Nebraska","5/13/20","6","5","31137","83.33"
"Pierce","0","1","Nebraska","5/13/20","1","0","31139","0"
"Platte","19","390","Nebraska","5/13/20","260","130","31141","50"
"Polk","0","9","Nebraska","5/13/20","9","0","31143","0"
"Red Willow","0","5","Nebraska","5/13/20","5","0","31145","0"
"Richardson","0","1","Nebraska","5/13/20","0","1","31147","1"
"Saline","15","392","Nebraska","5/13/20","285","107","31151","37.54"
"Sarpy","13","272","Nebraska","5/13/20","180","92","31153","51.11"
"Saunders","0","12","Nebraska","5/13/20","10","2","31155","20"
"Scotts Bluff","2","47","Nebraska","5/13/20","35","12","31157","34.29"
"Seward","1","18","Nebraska","5/13/20","13","5","31159","38.46"
"Sherman","0","3","Nebraska","5/13/20","2","1","31163","50"
"Stanton","0","8","Nebraska","5/13/20","8","0","31167","0"
"Thomas","0","1","Nebraska","5/13/20","1","0","31171","0"
"Thurston","2","19","Nebraska","5/13/20","7","12","31173","171.43"
"Valley","0","2","Nebraska","5/13/20","1","1","31175","100"
"Washington","0","23","Nebraska","5/13/20","22","1","31177","4.55"
"Wayne","0","3","Nebraska","5/13/20","1","2","31179","200"
"Webster","0","5","Nebraska","5/13/20","5","0","31181","0"
"York","1","25","Nebraska","5/13/20","15","10","31185","66.67"
"Carson City","1","58","Nevada","5/13/20","51","7","32510","13.73"
"Churchill","0","5","Nevada","5/13/20","3","2","32001","66.67"
"Clark","82","5045","Nevada","5/13/20","4473","572","32003","12.79"
"Douglas","0","24","Nevada","5/13/20","22","2","32005","9.09"
"Elko","0","18","Nevada","5/13/20","15","3","32007","20"
"Humboldt","2","71","Nevada","5/13/20","58","13","32013","22.41"
"Lander","1","19","Nevada","5/13/20","14","5","32015","35.71"
"Lincoln","0","2","Nevada","5/13/20","1","1","32017","100"
"Lyon","1","46","Nevada","5/13/20","36","10","32019","27.78"
"Mineral","0","4","Nevada","5/13/20","4","0","32021","0"
"Nye","1","49","Nevada","5/13/20","39","10","32023","25.64"
"Washoe","16","1132","Nevada","5/13/20","1022","110","32031","10.76"
"White Pine","0","3","Nevada","5/13/20","3","0","32033","0"
"Belknap","1","47","New Hampshire","5/13/20","41","6","33001","14.63"
"Carroll","0","37","New Hampshire","5/13/20","34","3","33003","8.82"
"Cheshire","1","45","New Hampshire","5/13/20","41","4","33005","9.76"
"Coos","0","2","New Hampshire","5/13/20","2","0","33007","0"
"Grafton","1","58","New Hampshire","5/13/20","54","4","33009","7.41"
"Hillsborough","49","1592","New Hampshire","5/13/20","1252","340","33011","27.16"
"Merrimack","6","256","New Hampshire","5/13/20","213","43","33013","20.19"
"Rockingham","17","1021","New Hampshire","5/13/20","903","118","33015","13.07"
"Strafford","5","201","New Hampshire","5/13/20","168","33","33017","19.64"
"Sullivan","0","14","New Hampshire","5/13/20","13","1","33019","7.69"
"Atlantic","48","1584","New Jersey","5/13/20","1246","338","34001","27.13"
"Bergen","90","17150","New Jersey","5/13/20","16520","630","34003","3.81"
"Burlington","70","3726","New Jersey","5/13/20","3235","491","34005","15.18"
"Camden","113","5099","New Jersey","5/13/20","4307","792","34007","18.39"
"Cape May","14","479","New Jersey","5/13/20","378","101","34009","26.72"
"Cumberland","55","1447","New Jersey","5/13/20","1059","388","34011","36.64"
"Essex","136","15905","New Jersey","5/13/20","14951","954","34013","6.38"
"Gloucester","33","1728","New Jersey","5/13/20","1499","229","34015","15.28"
"Hudson","179","17451","New Jersey","5/13/20","16197","1254","34017","7.74"
"Hunterdon","7","732","New Jersey","5/13/20","682","50","34019","7.33"
"Mercer","91","5499","New Jersey","5/13/20","4860","639","34021","13.15"
"Middlesex","141","14241","New Jersey","5/13/20","13254","987","34023","7.45"
"Monmouth","77","7090","New Jersey","5/13/20","6552","538","34025","8.21"
"Morris","39","5926","New Jersey","5/13/20","5655","271","34027","4.79"
"Ocean","80","7688","New Jersey","5/13/20","7125","563","34029","7.9"
"Passaic","112","14757","New Jersey","5/13/20","13971","786","34031","5.63"
"Salem","11","428","New Jersey","5/13/20","353","75","34033","21.25"
"Somerset","38","4127","New Jersey","5/13/20","3860","267","34035","6.92"
"Sussex","7","1042","New Jersey","5/13/20","995","47","34037","4.72"
"Union","100","14306","New Jersey","5/13/20","13604","702","34039","5.16"
"Warren","10","1066","New Jersey","5/13/20","993","73","34041","7.35"
"Bernalillo","20","1124","New Mexico","5/13/20","981","143","35001","14.58"
"Catron","0","2","New Mexico","5/13/20","2","0","35003","0"
"Chaves","1","30","New Mexico","5/13/20","25","5","35005","20"
"Cibola","2","93","New Mexico","5/13/20","82","11","35006","13.41"
"Colfax","0","5","New Mexico","5/13/20","5","0","35007","0"
"Curry","2","34","New Mexico","5/13/20","23","11","35009","47.83"
"De Baca","0","0","New Mexico","5/13/20","1","-1","35011","-100"
"Dona Ana","10","249","New Mexico","5/13/20","180","69","35013","38.33"
"Eddy","0","14","New Mexico","5/13/20","13","1","35015","7.69"
"Grant","0","15","New Mexico","5/13/20","15","0","35017","0"
"Guadalupe","0","17","New Mexico","5/13/20","15","2","35019","13.33"
"Harding","0","1","New Mexico","5/13/20","1","0","35021","0"
"Lea","0","15","New Mexico","5/13/20","14","1","35025","7.14"
"Lincoln","0","2","New Mexico","5/13/20","2","0","35027","0"
"Los Alamos","0","6","New Mexico","5/13/20","6","0","35028","0"
"Luna","0","8","New Mexico","5/13/20","7","1","35029","14.29"
"McKinley","49","1681","New Mexico","5/13/20","1337","344","35031","25.73"
"Otero","0","8","New Mexico","5/13/20","9","-1","35035","-11.11"
"Quay","0","5","New Mexico","5/13/20","4","1","35037","25"
"Rio Arriba","1","28","New Mexico","5/13/20","24","4","35039","16.67"
"Roosevelt","0","13","New Mexico","5/13/20","11","2","35041","18.18"
"San Juan","51","1203","New Mexico","5/13/20","844","359","35045","42.54"
"San Miguel","0","7","New Mexico","5/13/20","4","3","35047","75"
"Sandoval","6","477","New Mexico","5/13/20","432","45","35043","10.42"
"Santa Fe","0","113","New Mexico","5/13/20","110","3","35049","2.73"
"Sierra","0","1","New Mexico","5/13/20","1","0","35051","0"
"Socorro","0","49","New Mexico","5/13/20","48","1","35053","2.08"
"Taos","0","22","New Mexico","5/13/20","20","2","35055","10"
"Torrance","0","18","New Mexico","5/13/20","17","1","35057","5.88"
"Union","0","3","New Mexico","5/13/20","3","0","35059","0"
"Valencia","1","59","New Mexico","5/13/20","55","4","35061","7.27"
"Albany","25","1494","New York","5/13/20","1321","173","36001","13.1"
"Allegany","1","44","New York","5/13/20","35","9","36003","25.71"
"Broome","5","382","New York","5/13/20","345","37","36007","10.72"
"Cattaraugus","1","61","New York","5/13/20","54","7","36009","12.96"
"Cayuga","1","60","New York","5/13/20","51","9","36011","17.65"
"Chautauqua","1","43","New York","5/13/20","38","5","36013","13.16"
"Chemung","1","132","New York","5/13/20","128","4","36015","3.12"
"Chenango","1","112","New York","5/13/20","102","10","36017","9.8"
"Clinton","1","78","New York","5/13/20","69","9","36019","13.04"
"Columbia","4","318","New York","5/13/20","291","27","36021","9.28"
"Cortland","0","31","New York","5/13/20","28","3","36023","10.71"
"Delaware","1","66","New York","5/13/20","62","4","36025","6.45"
"Dutchess","34","3429","New York","5/13/20","3192","237","36027","7.42"
"Erie","85","4606","New York","5/13/20","4008","598","36029","14.92"
"Essex","0","32","New York","5/13/20","30","2","36031","6.67"
"Franklin","0","17","New York","5/13/20","16","1","36033","6.25"
"Fulton","6","140","New York","5/13/20","100","40","36035","40"
"Genesee","2","174","New York","5/13/20","162","12","36037","7.41"
"Greene","3","206","New York","5/13/20","188","18","36039","9.57"
"Hamilton","0","5","New York","5/13/20","5","0","36041","0"
"Herkimer","2","84","New York","5/13/20","68","16","36043","23.53"
"Jefferson","1","68","New York","5/13/20","63","5","36045","7.94"
"Lewis","0","11","New York","5/13/20","9","2","36049","22.22"
"Livingston","2","103","New York","5/13/20","89","14","36051","15.73"
"Madison","3","253","New York","5/13/20","231","22","36053","9.52"
"Monroe","43","1959","New York","5/13/20","1655","304","36055","18.37"
"Montgomery","1","68","New York","5/13/20","63","5","36057","7.94"
"Nassau","177","38587","New York","5/13/20","37350","1237","36059","3.31"
"New York","1271","187250","New York","5/13/20","178351","8899","36061","4.99"
"Niagara","20","690","New York","5/13/20","549","141","36063","25.68"
"Oneida","15","686","New York","5/13/20","579","107","36065","18.48"
"Onondaga","48","1395","New York","5/13/20","1056","339","36067","32.1"
"Ontario","1","109","New York","5/13/20","99","10","36069","10.1"
"Orange","68","9693","New York","5/13/20","9215","478","36071","5.19"
"Orleans","6","142","New York","5/13/20","103","39","36073","37.86"
"Oswego","1","76","New York","5/13/20","70","6","36075","8.57"
"Otsego","0","67","New York","5/13/20","67","0","36077","0"
"Putnam","10","1108","New York","5/13/20","1040","68","36079","6.54"
"Rensselaer","10","420","New York","5/13/20","347","73","36083","21.04"
"Rockland","48","12543","New York","5/13/20","12204","339","36087","2.78"
"Saratoga","6","410","New York","5/13/20","371","39","36091","10.51"
"Schenectady","5","587","New York","5/13/20","551","36","36093","6.53"
"Schoharie","0","47","New York","5/13/20","45","2","36095","4.44"
"Schuyler","0","8","New York","5/13/20","7","1","36097","14.29"
"Seneca","0","49","New York","5/13/20","46","3","36099","6.52"
"St. Lawrence","2","192","New York","5/13/20","180","12","36089","6.67"
"Steuben","1","230","New York","5/13/20","223","7","36101","3.14"
"Suffolk","252","37305","New York","5/13/20","35543","1762","36103","4.96"
"Sullivan","20","1135","New York","5/13/20","996","139","36105","13.96"
"Tioga","2","108","New York","5/13/20","96","12","36107","12.5"
"Tompkins","1","136","New York","5/13/20","129","7","36109","5.43"
"Ulster","14","1481","New York","5/13/20","1383","98","36111","7.09"
"Warren","4","223","New York","5/13/20","193","30","36113","15.54"
"Washington","4","214","New York","5/13/20","189","25","36115","13.23"
"Wayne","1","84","New York","5/13/20","78","6","36117","7.69"
"Westchester","169","31611","New York","5/13/20","30426","1185","36119","3.89"
"Wyoming","1","77","New York","5/13/20","70","7","36121","10"
"Yates","0","22","New York","5/13/20","19","3","36123","15.79"
"Alamance","9","190","North Carolina","5/13/20","128","62","37001","48.44"
"Alexander","1","14","North Carolina","5/13/20","6","8","37003","133.33"
"Alleghany","0","10","North Carolina","5/13/20","7","3","37005","42.86"
"Anson","1","40","North Carolina","5/13/20","31","9","37007","29.03"
"Ashe","2","16","North Carolina","5/13/20","5","11","37009","220"
"Beaufort","1","27","North Carolina","5/13/20","22","5","37013","22.73"
"Bertie","3","72","North Carolina","5/13/20","53","19","37015","35.85"
"Bladen","3","64","North Carolina","5/13/20","40","24","37017","60"
"Brunswick","0","51","North Carolina","5/13/20","50","1","37019","2"
"Buncombe","4","108","North Carolina","5/13/20","79","29","37021","36.71"
"Burke","6","162","North Carolina","5/13/20","117","45","37023","38.46"
"Cabarrus","5","361","North Carolina","5/13/20","326","35","37025","10.74"
"Caldwell","3","69","North Carolina","5/13/20","45","24","37027","53.33"
"Camden","0","2","North Carolina","5/13/20","2","0","37029","0"
"Carteret","1","35","North Carolina","5/13/20","29","6","37031","20.69"
"Caswell","1","42","North Carolina","5/13/20","36","6","37033","16.67"
"Catawba","4","92","North Carolina","5/13/20","65","27","37035","41.54"
"Chatham","8","468","North Carolina","5/13/20","412","56","37037","13.59"
"Cherokee","1","27","North Carolina","5/13/20","19","8","37039","42.11"
"Chowan","1","12","North Carolina","5/13/20","7","5","37041","71.43"
"Clay","0","8","North Carolina","5/13/20","6","2","37043","33.33"
"Cleveland","0","51","North Carolina","5/13/20","48","3","37045","6.25"
"Columbus","7","226","North Carolina","5/13/20","177","49","37047","27.68"
"Craven","4","70","North Carolina","5/13/20","44","26","37049","59.09"
"Cumberland","14","425","North Carolina","5/13/20","330","95","37051","28.79"
"Currituck","1","9","North Carolina","5/13/20","5","4","37053","80"
"Dare","0","21","North Carolina","5/13/20","18","3","37055","16.67"
"Davidson","7","242","North Carolina","5/13/20","191","51","37057","26.7"
"Davie","1","40","North Carolina","5/13/20","31","9","37059","29.03"
"Duplin","20","285","North Carolina","5/13/20","146","139","37061","95.21"
"Durham","16","932","North Carolina","5/13/20","818","114","37063","13.94"
"Edgecombe","4","157","North Carolina","5/13/20","128","29","37065","22.66"
"Forsyth","24","495","North Carolina","5/13/20","329","166","37067","50.46"
"Franklin","2","119","North Carolina","5/13/20","106","13","37069","12.26"
"Gaston","6","195","North Carolina","5/13/20","155","40","37071","25.81"
"Gates","0","11","North Carolina","5/13/20","10","1","37073","10"
"Graham","0","2","North Carolina","5/13/20","2","0","37075","0"
"Granville","1","171","North Carolina","5/13/20","161","10","37077","6.21"
"Greene","2","38","North Carolina","5/13/20","22","16","37079","72.73"
"Guilford","22","683","North Carolina","5/13/20","527","156","37081","29.6"
"Halifax","4","100","North Carolina","5/13/20","73","27","37083","36.99"
"Harnett","6","233","North Carolina","5/13/20","192","41","37085","21.35"
"Haywood","0","19","North Carolina","5/13/20","18","1","37087","5.56"
"Henderson","7","260","North Carolina","5/13/20","213","47","37089","22.07"
"Hertford","1","51","North Carolina","5/13/20","46","5","37091","10.87"
"Hoke","4","128","North Carolina","5/13/20","103","25","37093","24.27"
"Hyde","0","1","North Carolina","5/13/20","1","0","37095","0"
"Iredell","4","164","North Carolina","5/13/20","138","26","37097","18.84"
"Jackson","0","23","North Carolina","5/13/20","20","3","37099","15"
"Johnston","4","220","North Carolina","5/13/20","189","31","37101","16.4"
"Jones","0","21","North Carolina","5/13/20","19","2","37103","10.53"
"Lee","9","290","North Carolina","5/13/20","228","62","37105","27.19"
"Lenoir","5","132","North Carolina","5/13/20","95","37","37107","38.95"
"Lincoln","1","44","North Carolina","5/13/20","37","7","37109","18.92"
"Macon","0","3","North Carolina","5/13/20","3","0","37113","0"
"Madison","0","1","North Carolina","5/13/20","1","0","37115","0"
"Martin","1","33","North Carolina","5/13/20","25","8","37117","32"
"McDowell","0","30","North Carolina","5/13/20","28","2","37111","7.14"
"Mecklenburg","59","2283","North Carolina","5/13/20","1870","413","37119","22.09"
"Mitchell","0","5","North Carolina","5/13/20","5","0","37121","0"
"Montgomery","1","46","North Carolina","5/13/20","41","5","37123","12.2"
"Moore","2","162","North Carolina","5/13/20","148","14","37125","9.46"
"Nash","4","137","North Carolina","5/13/20","106","31","37127","29.25"
"New Hanover","3","117","North Carolina","5/13/20","97","20","37129","20.62"
"Northampton","5","125","North Carolina","5/13/20","93","32","37131","34.41"
"Onslow","2","63","North Carolina","5/13/20","52","11","37133","21.15"
"Orange","4","259","North Carolina","5/13/20","230","29","37135","12.61"
"Pamlico","0","8","North Carolina","5/13/20","8","0","37137","0"
"Pasquotank","6","82","North Carolina","5/13/20","38","44","37139","115.79"
"Pender","3","42","North Carolina","5/13/20","19","23","37141","121.05"
"Perquimans","1","19","North Carolina","5/13/20","14","5","37143","35.71"
"Person","1","32","North Carolina","5/13/20","23","9","37145","39.13"
"Pitt","5","182","North Carolina","5/13/20","147","35","37147","23.81"
"Polk","1","31","North Carolina","5/13/20","27","4","37149","14.81"
"Randolph","15","389","North Carolina","5/13/20","285","104","37151","36.49"
"Richmond","5","98","North Carolina","5/13/20","65","33","37153","50.77"
"Robeson","19","459","North Carolina","5/13/20","323","136","37155","42.11"
"Rockingham","1","43","North Carolina","5/13/20","34","9","37157","26.47"
"Rowan","8","497","North Carolina","5/13/20","439","58","37159","13.21"
"Rutherford","1","154","North Carolina","5/13/20","147","7","37161","4.76"
"Sampson","12","193","North Carolina","5/13/20","108","85","37163","78.7"
"Scotland","2","44","North Carolina","5/13/20","32","12","37165","37.5"
"Stanly","0","30","North Carolina","5/13/20","30","0","37167","0"
"Stokes","2","22","North Carolina","5/13/20","11","11","37169","100"
"Surry","4","47","North Carolina","5/13/20","20","27","37171","135"
"Swain","0","5","North Carolina","5/13/20","4","1","37173","25"
"Transylvania","0","7","North Carolina","5/13/20","8","-1","37175","-12.5"
"Tyrrell","0","4","North Carolina","5/13/20","4","0","37177","0"
"Union","5","313","North Carolina","5/13/20","278","35","37179","12.59"
"Vance","8","173","North Carolina","5/13/20","120","53","37181","44.17"
"Wake","21","1102","North Carolina","5/13/20","958","144","37183","15.03"
"Warren","1","23","North Carolina","5/13/20","18","5","37185","27.78"
"Washington","0","25","North Carolina","5/13/20","25","0","37187","0"
"Watauga","0","9","North Carolina","5/13/20","9","0","37189","0"
"Wayne","10","760","North Carolina","5/13/20","688","72","37191","10.47"
"Wilkes","16","262","North Carolina","5/13/20","147","115","37193","78.23"
"Wilson","4","217","North Carolina","5/13/20","192","25","37195","13.02"
"Yadkin","7","79","North Carolina","5/13/20","27","52","37197","192.59"
"Yancey","1","9","North Carolina","5/13/20","1","8","37199","800"
"Barnes","0","4","North Dakota","5/13/20","4","0","38003","0"
"Benson","0","2","North Dakota","5/13/20","0","2","38005","1"
"Bowman","0","1","North Dakota","5/13/20","1","0","38011","0"
"Burke","0","5","North Dakota","5/13/20","5","0","38013","0"
"Burleigh","1","106","North Dakota","5/13/20","102","4","38015","3.92"
"Cass","36","935","North Dakota","5/13/20","686","249","38017","36.3"
"Divide","0","1","North Dakota","5/13/20","1","0","38023","0"
"Dunn","0","11","North Dakota","5/13/20","11","0","38025","0"
"Eddy","0","2","North Dakota","5/13/20","1","1","38027","100"
"Emmons","0","1","North Dakota","5/13/20","1","0","38029","0"
"Foster","0","1","North Dakota","5/13/20","1","0","38031","0"
"Grand Forks","4","297","North Dakota","5/13/20","271","26","38035","9.59"
"Grant","0","2","North Dakota","5/13/20","1","1","38037","100"
"McHenry","0","2","North Dakota","5/13/20","1","1","38049","100"
"McIntosh","0","1","North Dakota","5/13/20","1","0","38051","0"
"McKenzie","0","15","North Dakota","5/13/20","13","2","38053","15.38"
"McLean","0","5","North Dakota","5/13/20","5","0","38055","0"
"Mercer","0","4","North Dakota","5/13/20","3","1","38057","33.33"
"Morton","0","38","North Dakota","5/13/20","35","3","38059","8.57"
"Mountrail","0","37","North Dakota","5/13/20","36","1","38061","2.78"
"Nelson","0","1","North Dakota","5/13/20","1","0","38063","0"
"Oliver","0","1","North Dakota","5/13/20","1","0","38065","0"
"Pembina","0","6","North Dakota","5/13/20","4","2","38067","50"
"Pierce","0","3","North Dakota","5/13/20","2","1","38069","50"
"Ramsey","1","7","North Dakota","5/13/20","3","4","38071","133.33"
"Ransom","0","3","North Dakota","5/13/20","2","1","38073","50"
"Renville","0","1","North Dakota","5/13/20","1","0","38075","0"
"Richland","0","8","North Dakota","5/13/20","7","1","38077","14.29"
"Rolette","0","3","North Dakota","5/13/20","1","2","38079","200"
"Sargent","0","3","North Dakota","5/13/20","2","1","38081","50"
"Sioux","0","1","North Dakota","5/13/20","1","0","38085","0"
"Slope","0","3","North Dakota","5/13/20","3","0","38087","0"
"Stark","1","61","North Dakota","5/13/20","57","4","38089","7.02"
"Stutsman","1","16","North Dakota","5/13/20","12","4","38093","33.33"
"Traill","0","1","North Dakota","5/13/20","0","1","38097","1"
"Walsh","0","9","North Dakota","5/13/20","7","2","38099","28.57"
"Ward","0","28","North Dakota","5/13/20","25","3","38101","12"
"Wells","0","2","North Dakota","5/13/20","2","0","38103","0"
"Williams","1","20","North Dakota","5/13/20","13","7","38105","53.85"
"","1","19","Northern Mariana Islands","5/13/20","15","4",,"26.67"
"Adams","0","6","Ohio","5/13/20","5","1","39001","20"
"Allen","2","155","Ohio","5/13/20","139","16","39003","11.51"
"Ashland","0","15","Ohio","5/13/20","12","3","39005","25"
"Ashtabula","6","208","Ohio","5/13/20","165","43","39007","26.06"
"Athens","0","6","Ohio","5/13/20","4","2","39009","50"
"Auglaize","2","47","Ohio","5/13/20","36","11","39011","30.56"
"Belmont","11","276","Ohio","5/13/20","201","75","39013","37.31"
"Brown","1","21","Ohio","5/13/20","13","8","39015","61.54"
"Butler","21","509","Ohio","5/13/20","361","148","39017","41"
"Carroll","0","24","Ohio","5/13/20","21","3","39019","14.29"
"Champaign","1","21","Ohio","5/13/20","15","6","39021","40"
"Clark","6","114","Ohio","5/13/20","71","43","39023","60.56"
"Clermont","3","129","Ohio","5/13/20","110","19","39025","17.27"
"Clinton","1","36","Ohio","5/13/20","31","5","39027","16.13"
"Columbiana","8","354","Ohio","5/13/20","297","57","39029","19.19"
"Coshocton","0","19","Ohio","5/13/20","17","2","39031","11.76"
"Crawford","4","86","Ohio","5/13/20","60","26","39033","43.33"
"Cuyahoga","62","2979","Ohio","5/13/20","2542","437","39035","17.19"
"Darke","2","93","Ohio","5/13/20","79","14","39037","17.72"
"Defiance","1","25","Ohio","5/13/20","21","4","39039","19.05"
"Delaware","6","234","Ohio","5/13/20","190","44","39041","23.16"
"Erie","2","86","Ohio","5/13/20","71","15","39043","21.13"
"Fairfield","5","191","Ohio","5/13/20","158","33","39045","20.89"
"Fayette","0","23","Ohio","5/13/20","21","2","39047","9.52"
"Franklin","125","4113","Ohio","5/13/20","3237","876","39049","27.06"
"Fulton","0","32","Ohio","5/13/20","30","2","39051","6.67"
"Gallia","0","6","Ohio","5/13/20","6","0","39053","0"
"Geauga","2","198","Ohio","5/13/20","181","17","39055","9.39"
"Greene","3","68","Ohio","5/13/20","50","18","39057","36"
"Guernsey","0","21","Ohio","5/13/20","20","1","39059","5"
"Hamilton","51","1886","Ohio","5/13/20","1527","359","39061","23.51"
"Hancock","0","40","Ohio","5/13/20","39","1","39063","2.56"
"Hardin","0","29","Ohio","5/13/20","26","3","39065","11.54"
"Harrison","0","8","Ohio","5/13/20","6","2","39067","33.33"
"Henry","1","10","Ohio","5/13/20","6","4","39069","66.67"
"Highland","0","14","Ohio","5/13/20","11","3","39071","27.27"
"Hocking","1","28","Ohio","5/13/20","20","8","39073","40"
"Holmes","0","8","Ohio","5/13/20","6","2","39075","33.33"
"Huron","1","39","Ohio","5/13/20","34","5","39077","14.71"
"Jackson","0","9","Ohio","5/13/20","7","2","39079","28.57"
"Jefferson","1","56","Ohio","5/13/20","48","8","39081","16.67"
"Knox","0","20","Ohio","5/13/20","20","0","39083","0"
"Lake","4","206","Ohio","5/13/20","180","26","39085","14.44"
"Lawrence","0","26","Ohio","5/13/20","24","2","39087","8.33"
"Licking","5","175","Ohio","5/13/20","137","38","39089","27.74"
"Logan","1","23","Ohio","5/13/20","19","4","39091","21.05"
"Lorain","7","569","Ohio","5/13/20","518","51","39093","9.85"
"Lucas","47","1858","Ohio","5/13/20","1527","331","39095","21.68"
"Madison","2","88","Ohio","5/13/20","73","15","39097","20.55"
"Mahoning","20","1163","Ohio","5/13/20","1024","139","39099","13.57"
"Marion","10","2419","Ohio","5/13/20","2347","72","39101","3.07"
"Medina","3","205","Ohio","5/13/20","184","21","39103","11.41"
"Meigs","0","3","Ohio","5/13/20","3","0","39105","0"
"Mercer","7","90","Ohio","5/13/20","42","48","39107","114.29"
"Miami","25","316","Ohio","5/13/20","144","172","39109","119.44"
"Monroe","3","25","Ohio","5/13/20","4","21","39111","525"
"Montgomery","16","442","Ohio","5/13/20","332","110","39113","33.13"
"Morgan","0","5","Ohio","5/13/20","5","0","39115","0"
"Morrow","1","91","Ohio","5/13/20","83","8","39117","9.64"
"Muskingum","1","32","Ohio","5/13/20","22","10","39119","45.45"
"Noble","0","5","Ohio","5/13/20","6","-1","39121","-16.67"
"Ottawa","1","52","Ohio","5/13/20","44","8","39123","18.18"
"Paulding","0","10","Ohio","5/13/20","8","2","39125","25"
"Perry","0","14","Ohio","5/13/20","13","1","39127","7.69"
"Pickaway","17","1958","Ohio","5/13/20","1836","122","39129","6.64"
"Pike","0","5","Ohio","5/13/20","4","1","39131","25"
"Portage","3","280","Ohio","5/13/20","262","18","39133","6.87"
"Preble","0","28","Ohio","5/13/20","27","1","39135","3.7"
"Putnam","1","77","Ohio","5/13/20","71","6","39137","8.45"
"Richland","6","135","Ohio","5/13/20","92","43","39139","46.74"
"Ross","2","55","Ohio","5/13/20","42","13","39141","30.95"
"Sandusky","2","53","Ohio","5/13/20","40","13","39143","32.5"
"Scioto","0","13","Ohio","5/13/20","13","0","39145","0"
"Seneca","0","14","Ohio","5/13/20","14","0","39147","0"
"Shelby","0","33","Ohio","5/13/20","30","3","39149","10"
"Stark","14","526","Ohio","5/13/20","427","99","39151","23.19"
"Summit","23","946","Ohio","5/13/20","787","159","39153","20.2"
"Trumbull","8","420","Ohio","5/13/20","363","57","39155","15.7"
"Tuscarawas","12","229","Ohio","5/13/20","144","85","39157","59.03"
"Union","0","28","Ohio","5/13/20","26","2","39159","7.69"
"Van Wert","0","3","Ohio","5/13/20","3","0","39161","0"
"Vinton","1","15","Ohio","5/13/20","8","7","39163","87.5"
"Warren","8","237","Ohio","5/13/20","179","58","39165","32.4"
"Washington","1","115","Ohio","5/13/20","106","9","39167","8.49"
"Wayne","3","192","Ohio","5/13/20","173","19","39169","10.98"
"Williams","0","44","Ohio","5/13/20","42","2","39171","4.76"
"Wood","3","229","Ohio","5/13/20","210","19","39173","9.05"
"Wyandot","0","27","Ohio","5/13/20","24","3","39175","12.5"
"Adair","1","74","Oklahoma","5/13/20","68","6","40001","8.82"
"Alfalfa","0","1","Oklahoma","5/13/20","1","0","40003","0"
"Atoka","0","2","Oklahoma","5/13/20","1","1","40005","100"
"Beaver","1","20","Oklahoma","5/13/20","15","5","40007","33.33"
"Beckham","0","6","Oklahoma","5/13/20","6","0","40009","0"
"Blaine","0","2","Oklahoma","5/13/20","2","0","40011","0"
"Bryan","0","12","Oklahoma","5/13/20","12","0","40013","0"
"Caddo","5","110","Oklahoma","5/13/20","77","33","40015","42.86"
"Canadian","2","115","Oklahoma","5/13/20","103","12","40017","11.65"
"Carter","0","6","Oklahoma","5/13/20","5","1","40019","20"
"Cherokee","0","30","Oklahoma","5/13/20","29","1","40021","3.45"
"Choctaw","0","3","Oklahoma","5/13/20","3","0","40023","0"
"Cimarron","0","1","Oklahoma","5/13/20","1","0","40025","0"
"Cleveland","2","458","Oklahoma","5/13/20","447","11","40027","2.46"
"Comanche","10","184","Oklahoma","5/13/20","113","71","40031","62.83"
"Cotton","0","5","Oklahoma","5/13/20","5","0","40033","0"
"Craig","0","12","Oklahoma","5/13/20","13","-1","40035","-7.69"
"Creek","0","83","Oklahoma","5/13/20","81","2","40037","2.47"
"Custer","0","12","Oklahoma","5/13/20","11","1","40039","9.09"
"Delaware","0","94","Oklahoma","5/13/20","92","2","40041","2.17"
"Dewey","0","2","Oklahoma","5/13/20","2","0","40043","0"
"Garfield","0","22","Oklahoma","5/13/20","21","1","40047","4.76"
"Garvin","0","15","Oklahoma","5/13/20","14","1","40049","7.14"
"Grady","2","54","Oklahoma","5/13/20","41","13","40051","31.71"
"Grant","0","2","Oklahoma","5/13/20","2","0","40053","0"
"Greer","0","66","Oklahoma","5/13/20","65","1","40055","1.54"
"Harper","0","1","Oklahoma","5/13/20","1","0","40059","0"
"Haskell","0","5","Oklahoma","5/13/20","5","0","40061","0"
"Jackson","0","20","Oklahoma","5/13/20","19","1","40065","5.26"
"Jefferson","0","3","Oklahoma","5/13/20","2","1","40067","50"
"Johnston","0","3","Oklahoma","5/13/20","3","0","40069","0"
"Kay","0","49","Oklahoma","5/13/20","48","1","40071","2.08"
"Kingfisher","0","10","Oklahoma","5/13/20","8","2","40073","25"
"Kiowa","0","6","Oklahoma","5/13/20","5","1","40075","20"
"Latimer","0","5","Oklahoma","5/13/20","5","0","40077","0"
"Le Flore","0","13","Oklahoma","5/13/20","13","0","40079","0"
"Lincoln","0","17","Oklahoma","5/13/20","16","1","40081","6.25"
"Logan","0","18","Oklahoma","5/13/20","17","1","40083","5.88"
"Love","0","3","Oklahoma","5/13/20","2","1","40085","50"
"Major","0","6","Oklahoma","5/13/20","4","2","40093","50"
"Marshall","0","2","Oklahoma","5/13/20","2","0","40095","0"
"Mayes","0","26","Oklahoma","5/13/20","24","2","40097","8.33"
"McClain","0","86","Oklahoma","5/13/20","84","2","40087","2.38"
"McCurtain","0","8","Oklahoma","5/13/20","8","0","40089","0"
"McIntosh","0","5","Oklahoma","5/13/20","4","1","40091","25"
"Murray","0","2","Oklahoma","5/13/20","2","0","40099","0"
"Muskogee","0","29","Oklahoma","5/13/20","27","2","40101","7.41"
"Noble","0","7","Oklahoma","5/13/20","7","0","40103","0"
"Nowata","0","23","Oklahoma","5/13/20","21","2","40105","9.52"
"Okfuskee","0","2","Oklahoma","5/13/20","1","1","40107","100"
"Oklahoma","20","1007","Oklahoma","5/13/20","868","139","40109","16.01"
"Okmulgee","0","16","Oklahoma","5/13/20","16","0","40111","0"
"Osage","2","90","Oklahoma","5/13/20","77","13","40113","16.88"
"Ottawa","0","34","Oklahoma","5/13/20","34","0","40115","0"
"Pawnee","0","29","Oklahoma","5/13/20","29","0","40117","0"
"Payne","0","44","Oklahoma","5/13/20","44","0","40119","0"
"Pittsburg","0","39","Oklahoma","5/13/20","39","0","40121","0"
"Pontotoc","0","10","Oklahoma","5/13/20","10","0","40123","0"
"Pottawatomie","0","55","Oklahoma","5/13/20","52","3","40125","5.77"
"Pushmataha","0","1","Oklahoma","5/13/20","1","0","40127","0"
"Rogers","1","72","Oklahoma","5/13/20","68","4","40131","5.88"
"Seminole","0","21","Oklahoma","5/13/20","19","2","40133","10.53"
"Sequoyah","0","14","Oklahoma","5/13/20","13","1","40135","7.69"
"Stephens","0","22","Oklahoma","5/13/20","22","0","40137","0"
"Texas","29","474","Oklahoma","5/13/20","274","200","40139","72.99"
"Tillman","1","20","Oklahoma","5/13/20","15","5","40141","33.33"
"Tulsa","12","734","Oklahoma","5/13/20","653","81","40143","12.4"
"Wagoner","1","131","Oklahoma","5/13/20","123","8","40145","6.5"
"Washington","2","300","Oklahoma","5/13/20","283","17","40147","6.01"
"Woods","0","3","Oklahoma","5/13/20","3","0","40151","0"
"Woodward","0","1","Oklahoma","5/13/20","1","0","40153","0"
"Baker","0","1","Oregon","5/13/20","1","0","41001","0"
"Benton","1","50","Oregon","5/13/20","40","10","41003","25"
"Clackamas","6","274","Oregon","5/13/20","235","39","41005","16.6"
"Clatsop","3","37","Oregon","5/13/20","17","20","41007","117.65"
"Columbia","0","16","Oregon","5/13/20","15","1","41009","6.67"
"Coos","0","30","Oregon","5/13/20","28","2","41011","7.14"
"Crook","0","1","Oregon","5/13/20","1","0","41013","0"
"Curry","0","4","Oregon","5/13/20","4","0","41015","0"
"Deschutes","1","89","Oregon","5/13/20","81","8","41017","9.88"
"Douglas","0","24","Oregon","5/13/20","24","0","41019","0"
"Grant","0","1","Oregon","5/13/20","1","0","41023","0"
"Harney","0","1","Oregon","5/13/20","1","0","41025","0"
"Hood River","0","14","Oregon","5/13/20","11","3","41027","27.27"
"Jackson","0","50","Oregon","5/13/20","49","1","41029","2.04"
"Jefferson","1","24","Oregon","5/13/20","18","6","41031","33.33"
"Josephine","0","25","Oregon","5/13/20","24","1","41033","4.17"
"Klamath","0","41","Oregon","5/13/20","39","2","41035","5.13"
"Lane","1","61","Oregon","5/13/20","57","4","41039","7.02"
"Lincoln","0","6","Oregon","5/13/20","6","0","41041","0"
"Linn","1","105","Oregon","5/13/20","99","6","41043","6.06"
"Malheur","0","15","Oregon","5/13/20","13","2","41045","15.38"
"Marion","22","746","Oregon","5/13/20","592","154","41047","26.01"
"Morrow","0","12","Oregon","5/13/20","10","2","41049","20"
"Multnomah","18","921","Oregon","5/13/20","793","128","41051","16.14"
"Polk","2","90","Oregon","5/13/20","75","15","41053","20"
"Sherman","0","1","Oregon","5/13/20","1","0","41055","0"
"Tillamook","0","6","Oregon","5/13/20","6","0","41057","0"
"Umatilla","1","86","Oregon","5/13/20","77","9","41059","11.69"
"Union","0","4","Oregon","5/13/20","4","0","41061","0"
"Wallowa","0","1","Oregon","5/13/20","1","0","41063","0"
"Wasco","0","16","Oregon","5/13/20","14","2","41065","14.29"
"Washington","11","614","Oregon","5/13/20","537","77","41067","14.34"
"Yamhill","1","50","Oregon","5/13/20","42","8","41071","19.05"
"Adams","3","169","Pennsylvania","5/13/20","148","21","42001","14.19"
"Allegheny","22","1545","Pennsylvania","5/13/20","1394","151","42003","10.83"
"Armstrong","0","56","Pennsylvania","5/13/20","55","1","42005","1.82"
"Beaver","5","509","Pennsylvania","5/13/20","471","38","42007","8.07"
"Bedford","0","29","Pennsylvania","5/13/20","27","2","42009","7.41"
"Berks","62","3485","Pennsylvania","5/13/20","3048","437","42011","14.34"
"Blair","1","31","Pennsylvania","5/13/20","25","6","42013","24"
"Bradford","0","39","Pennsylvania","5/13/20","36","3","42015","8.33"
"Bucks","94","4166","Pennsylvania","5/13/20","3508","658","42017","18.76"
"Butler","2","197","Pennsylvania","5/13/20","185","12","42019","6.49"
"Cambria","1","45","Pennsylvania","5/13/20","35","10","42021","28.57"
"Cameron","0","2","Pennsylvania","5/13/20","2","0","42023","0"
"Carbon","3","205","Pennsylvania","5/13/20","186","19","42025","10.22"
"Centre","2","126","Pennsylvania","5/13/20","113","13","42027","11.5"
"Chester","46","1955","Pennsylvania","5/13/20","1636","319","42029","19.5"
"Clarion","0","24","Pennsylvania","5/13/20","23","1","42031","4.35"
"Clearfield","1","31","Pennsylvania","5/13/20","21","10","42033","47.62"
"Clinton","1","41","Pennsylvania","5/13/20","34","7","42035","20.59"
"Columbia","4","330","Pennsylvania","5/13/20","302","28","42037","9.27"
"Crawford","0","21","Pennsylvania","5/13/20","20","1","42039","5"
"Cumberland","11","463","Pennsylvania","5/13/20","386","77","42041","19.95"
"Dauphin","23","871","Pennsylvania","5/13/20","711","160","42043","22.5"
"Delaware","112","5157","Pennsylvania","5/13/20","4373","784","42045","17.93"
"Elk","0","6","Pennsylvania","5/13/20","4","2","42047","50"
"Erie","4","125","Pennsylvania","5/13/20","95","30","42049","31.58"
"Fayette","0","85","Pennsylvania","5/13/20","84","1","42051","1.19"
"Forest","0","7","Pennsylvania","5/13/20","7","0","42053","0"
"Franklin","20","545","Pennsylvania","5/13/20","406","139","42055","34.24"
"Fulton","0","8","Pennsylvania","5/13/20","7","1","42057","14.29"
"Greene","0","27","Pennsylvania","5/13/20","27","0","42059","0"
"Huntingdon","20","197","Pennsylvania","5/13/20","60","137","42061","228.33"
"Indiana","0","78","Pennsylvania","5/13/20","75","3","42063","4"
"Jefferson","0","7","Pennsylvania","5/13/20","7","0","42065","0"
"Juniata","1","94","Pennsylvania","5/13/20","86","8","42067","9.3"
"Lackawanna","22","1232","Pennsylvania","5/13/20","1076","156","42069","14.5"
"Lancaster","41","2325","Pennsylvania","5/13/20","2041","284","42071","13.91"
"Lawrence","0","71","Pennsylvania","5/13/20","68","3","42073","4.41"
"Lebanon","11","849","Pennsylvania","5/13/20","774","75","42075","9.69"
"Lehigh","36","3318","Pennsylvania","5/13/20","3063","255","42077","8.33"
"Luzerne","23","2467","Pennsylvania","5/13/20","2306","161","42079","6.98"
"Lycoming","7","139","Pennsylvania","5/13/20","90","49","42081","54.44"
"McKean","0","8","Pennsylvania","5/13/20","6","2","42083","33.33"
"Mercer","1","78","Pennsylvania","5/13/20","69","9","42085","13.04"
"Mifflin","1","53","Pennsylvania","5/13/20","45","8","42087","17.78"
"Monroe","5","1228","Pennsylvania","5/13/20","1190","38","42089","3.19"
"Montgomery","98","5513","Pennsylvania","5/13/20","4827","686","42091","14.21"
"Montour","0","50","Pennsylvania","5/13/20","50","0","42093","0"
"Northampton","29","2518","Pennsylvania","5/13/20","2313","205","42095","8.86"
"Northumberland","2","128","Pennsylvania","5/13/20","111","17","42097","15.32"
"Perry","0","35","Pennsylvania","5/13/20","34","1","42099","2.94"
"Philadelphia","297","18779","Pennsylvania","5/13/20","16697","2082","42101","12.47"
"Pike","5","451","Pennsylvania","5/13/20","415","36","42103","8.67"
"Potter","0","4","Pennsylvania","5/13/20","4","0","42105","0"
"Schuylkill","8","478","Pennsylvania","5/13/20","419","59","42107","14.08"
"Snyder","0","33","Pennsylvania","5/13/20","33","0","42109","0"
"Somerset","0","32","Pennsylvania","5/13/20","32","0","42111","0"
"Sullivan","0","1","Pennsylvania","5/13/20","1","0","42113","0"
"Susquehanna","-1","81","Pennsylvania","5/13/20","87","-6","42115","-6.9"
"Tioga","0","16","Pennsylvania","5/13/20","16","0","42117","0"
"Union","0","42","Pennsylvania","5/13/20","39","3","42119","7.69"
"Venango","0","7","Pennsylvania","5/13/20","7","0","42121","0"
"Warren","0","2","Pennsylvania","5/13/20","1","1","42123","100"
"Washington","1","127","Pennsylvania","5/13/20","121","6","42125","4.96"
"Wayne","0","107","Pennsylvania","5/13/20","110","-3","42127","-2.73"
"Westmoreland","1","419","Pennsylvania","5/13/20","409","10","42129","2.44"
"Wyoming","1","31","Pennsylvania","5/13/20","27","4","42131","14.81"
"York","12","803","Pennsylvania","5/13/20","722","81","42133","11.22"
"","52","2329","Puerto Rico","5/13/20","1968","361",,"18.34"
"Bristol","3","172","Rhode Island","5/13/20","154","18","44001","11.69"
"Kent","26","883","Rhode Island","5/13/20","703","180","44003","25.6"
"Newport","5","197","Rhode Island","5/13/20","161","36","44005","22.36"
"Providence","282","9112","Rhode Island","5/13/20","7138","1974","44007","27.65"
"Washington","9","425","Rhode Island","5/13/20","363","62","44009","17.08"
"Abbeville","0","34","South Carolina","5/13/20","33","1","45001","3.03"
"Aiken","3","132","South Carolina","5/13/20","108","24","45003","22.22"
"Allendale","2","29","South Carolina","5/13/20","18","11","45005","61.11"
"Anderson","3","191","South Carolina","5/13/20","173","18","45007","10.4"
"Bamberg","0","16","South Carolina","5/13/20","14","2","45009","14.29"
"Barnwell","1","36","South Carolina","5/13/20","28","8","45011","28.57"
"Beaufort","2","282","South Carolina","5/13/20","269","13","45013","4.83"
"Berkeley","1","198","South Carolina","5/13/20","189","9","45015","4.76"
"Calhoun","0","9","South Carolina","5/13/20","7","2","45017","28.57"
"Charleston","4","491","South Carolina","5/13/20","464","27","45019","5.82"
"Cherokee","0","22","South Carolina","5/13/20","19","3","45021","15.79"
"Chester","1","39","South Carolina","5/13/20","34","5","45023","14.71"
"Chesterfield","3","85","South Carolina","5/13/20","65","20","45025","30.77"
"Clarendon","3","266","South Carolina","5/13/20","248","18","45027","7.26"
"Colleton","0","33","South Carolina","5/13/20","32","1","45029","3.12"
"Darlington","4","177","South Carolina","5/13/20","151","26","45031","17.22"
"Dillon","4","104","South Carolina","5/13/20","74","30","45033","40.54"
"Dorchester","1","109","South Carolina","5/13/20","103","6","45035","5.83"
"Edgefield","1","41","South Carolina","5/13/20","35","6","45037","17.14"
"Fairfield","1","83","South Carolina","5/13/20","74","9","45039","12.16"
"Florence","16","469","South Carolina","5/13/20","358","111","45041","31.01"
"Georgetown","0","51","South Carolina","5/13/20","48","3","45043","6.25"
"Greenville","25","981","South Carolina","5/13/20","803","178","45045","22.17"
"Greenwood","1","67","South Carolina","5/13/20","61","6","45047","9.84"
"Hampton","0","28","South Carolina","5/13/20","27","1","45049","3.7"
"Horry","5","273","South Carolina","5/13/20","238","35","45051","14.71"
"Jasper","1","25","South Carolina","5/13/20","21","4","45053","19.05"
"Kershaw","2","257","South Carolina","5/13/20","245","12","45055","4.9"
"Lancaster","2","110","South Carolina","5/13/20","99","11","45057","11.11"
"Laurens","1","47","South Carolina","5/13/20","42","5","45059","11.9"
"Lee","7","122","South Carolina","5/13/20","70","52","45061","74.29"
"Lexington","7","492","South Carolina","5/13/20","442","50","45063","11.31"
"Marion","1","48","South Carolina","5/13/20","41","7","45067","17.07"
"Marlboro","1","60","South Carolina","5/13/20","54","6","45069","11.11"
"McCormick","0","7","South Carolina","5/13/20","7","0","45065","0"
"Newberry","0","31","South Carolina","5/13/20","31","0","45071","0"
"Oconee","1","39","South Carolina","5/13/20","31","8","45073","25.81"
"Orangeburg","2","106","South Carolina","5/13/20","95","11","45075","11.58"
"Pickens","3","85","South Carolina","5/13/20","61","24","45077","39.34"
"Richland","22","1167","South Carolina","5/13/20","1014","153","45079","15.09"
"Saluda","3","92","South Carolina","5/13/20","73","19","45081","26.03"
"Spartanburg","5","354","South Carolina","5/13/20","318","36","45083","11.32"
"Sumter","4","296","South Carolina","5/13/20","271","25","45085","9.23"
"Union","1","31","South Carolina","5/13/20","26","5","45087","19.23"
"Williamsburg","7","150","South Carolina","5/13/20","100","50","45089","50"
"York","6","265","South Carolina","5/13/20","222","43","45091","19.37"
"Aurora","0","2","South Dakota","5/13/20","1","1","46003","100"
"Beadle","0","22","South Dakota","5/13/20","21","1","46005","4.76"
"Bon Homme","0","4","South Dakota","5/13/20","4","0","46009","0"
"Brookings","0","14","South Dakota","5/13/20","14","0","46011","0"
"Brown","10","143","South Dakota","5/13/20","76","67","46013","88.16"
"Buffalo","0","1","South Dakota","5/13/20","1","0","46017","0"
"Charles Mix","0","6","South Dakota","5/13/20","5","1","46023","20"
"Clark","0","3","South Dakota","5/13/20","1","2","46025","200"
"Clay","1","11","South Dakota","5/13/20","7","4","46027","57.14"
"Codington","0","16","South Dakota","5/13/20","15","1","46029","6.67"
"Corson","0","2","South Dakota","5/13/20","1","1","46031","100"
"Davison","0","8","South Dakota","5/13/20","7","1","46035","14.29"
"Day","0","10","South Dakota","5/13/20","10","0","46037","0"
"Deuel","0","1","South Dakota","5/13/20","1","0","46039","0"
"Dewey","0","0","South Dakota","5/13/20","1","-1","46041","-100"
"Douglas","0","1","South Dakota","5/13/20","1","0","46043","0"
"Fall River","0","2","South Dakota","5/13/20","2","0","46047","0"
"Faulk","0","1","South Dakota","5/13/20","1","0","46049","0"
"Grant","0","4","South Dakota","5/13/20","2","2","46051","100"
"Hamlin","0","2","South Dakota","5/13/20","2","0","46057","0"
"Hand","0","1","South Dakota","5/13/20","1","0","46059","0"
"Hughes","0","15","South Dakota","5/13/20","13","2","46065","15.38"
"Hutchinson","0","3","South Dakota","5/13/20","3","0","46067","0"
"Hyde","0","1","South Dakota","5/13/20","1","0","46069","0"
"Jerauld","0","6","South Dakota","5/13/20","6","0","46073","0"
"Lake","0","5","South Dakota","5/13/20","4","1","46079","25"
"Lawrence","0","9","South Dakota","5/13/20","9","0","46081","0"
"Lincoln","3","193","South Dakota","5/13/20","170","23","46083","13.53"
"Lyman","0","3","South Dakota","5/13/20","3","0","46085","0"
"Marshall","0","1","South Dakota","5/13/20","1","0","46091","0"
"McCook","0","5","South Dakota","5/13/20","4","1","46087","25"
"McPherson","0","1","South Dakota","5/13/20","1","0","46089","0"
"Meade","0","5","South Dakota","5/13/20","2","3","46093","150"
"Miner","0","1","South Dakota","5/13/20","1","0","46097","0"
"Minnehaha","112","3017","South Dakota","5/13/20","2231","786","46099","35.23"
"Moody","1","17","South Dakota","5/13/20","7","10","46101","142.86"
"Oglala Lakota","0","3","South Dakota","5/13/20","2","1","46102","50"
"Pennington","3","36","South Dakota","5/13/20","16","20","46103","125"
"Roberts","0","14","South Dakota","5/13/20","11","3","46109","27.27"
"Sanborn","0","3","South Dakota","5/13/20","3","0","46111","0"
"Spink","0","4","South Dakota","5/13/20","3","1","46115","33.33"
"Stanley","0","8","South Dakota","5/13/20","8","0","46117","0"
"Sully","0","1","South Dakota","5/13/20","1","0","46119","0"
"Todd","1","14","South Dakota","5/13/20","7","7","46121","100"
"Turner","0","18","South Dakota","5/13/20","18","0","46125","0"
"Union","1","56","South Dakota","5/13/20","46","10","46127","21.74"
"Walworth","0","5","South Dakota","5/13/20","5","0","46129","0"
"Yankton","1","33","South Dakota","5/13/20","29","4","46135","13.79"
"Ziebach","0","1","South Dakota","5/13/20","1","0","46137","0"
"Anderson","1","35","Tennessee","5/13/20","29","6","47001","20.69"
"Bedford","5","246","Tennessee","5/13/20","212","34","47003","16.04"
"Benton","0","6","Tennessee","5/13/20","7","-1","47005","-14.29"
"Bledsoe","0","603","Tennessee","5/13/20","601","2","47007","0.33"
"Blount","1","74","Tennessee","5/13/20","69","5","47009","7.25"
"Bradley","2","75","Tennessee","5/13/20","61","14","47011","22.95"
"Campbell","0","17","Tennessee","5/13/20","16","1","47013","6.25"
"Cannon","0","13","Tennessee","5/13/20","12","1","47015","8.33"
"Carroll","1","22","Tennessee","5/13/20","18","4","47017","22.22"
"Carter","0","18","Tennessee","5/13/20","16","2","47019","12.5"
"Cheatham","3","78","Tennessee","5/13/20","58","20","47021","34.48"
"Chester","0","12","Tennessee","5/13/20","10","2","47023","20"
"Claiborne","0","7","Tennessee","5/13/20","6","1","47025","16.67"
"Clay","0","6","Tennessee","5/13/20","6","0","47027","0"
"Cocke","0","19","Tennessee","5/13/20","16","3","47029","18.75"
"Coffee","2","56","Tennessee","5/13/20","45","11","47031","24.44"
"Crockett","1","12","Tennessee","5/13/20","7","5","47033","71.43"
"Cumberland","0","87","Tennessee","5/13/20","85","2","47035","2.35"
"Davidson","71","3623","Tennessee","5/13/20","3128","495","47037","15.82"
"Decatur","0","4","Tennessee","5/13/20","4","0","47039","0"
"DeKalb","0","28","Tennessee","5/13/20","25","3","47041","12"
"Dickson","1","88","Tennessee","5/13/20","84","4","47043","4.76"
"Dyer","1","44","Tennessee","5/13/20","38","6","47045","15.79"
"Fayette","2","85","Tennessee","5/13/20","73","12","47047","16.44"
"Fentress","0","6","Tennessee","5/13/20","5","1","47049","20"
"Franklin","1","41","Tennessee","5/13/20","36","5","47051","13.89"
"Gibson","1","57","Tennessee","5/13/20","50","7","47053","14"
"Giles","0","9","Tennessee","5/13/20","9","0","47055","0"
"Grainger","0","6","Tennessee","5/13/20","6","0","47057","0"
"Greene","1","47","Tennessee","5/13/20","43","4","47059","9.3"
"Grundy","0","30","Tennessee","5/13/20","28","2","47061","7.14"
"Hamblen","1","25","Tennessee","5/13/20","19","6","47063","31.58"
"Hamilton","13","286","Tennessee","5/13/20","196","90","47065","45.92"
"Hardeman","22","177","Tennessee","5/13/20","22","155","47069","704.55"
"Hardin","0","8","Tennessee","5/13/20","7","1","47071","14.29"
"Hawkins","0","31","Tennessee","5/13/20","31","0","47073","0"
"Haywood","0","28","Tennessee","5/13/20","26","2","47075","7.69"
"Henderson","0","10","Tennessee","5/13/20","10","0","47077","0"
"Henry","0","15","Tennessee","5/13/20","13","2","47079","15.38"
"Hickman","1","52","Tennessee","5/13/20","47","5","47081","10.64"
"Houston","0","6","Tennessee","5/13/20","6","0","47083","0"
"Humphreys","0","12","Tennessee","5/13/20","11","1","47085","9.09"
"Jackson","0","10","Tennessee","5/13/20","7","3","47087","42.86"
"Jefferson","0","26","Tennessee","5/13/20","26","0","47089","0"
"Johnson","1","15","Tennessee","5/13/20","7","8","47091","114.29"
"Knox","6","295","Tennessee","5/13/20","252","43","47093","17.06"
"Lake","34","300","Tennessee","5/13/20","59","241","47095","408.47"
"Lauderdale","2","40","Tennessee","5/13/20","25","15","47097","60"
"Lawrence","1","21","Tennessee","5/13/20","17","4","47099","23.53"
"Lewis","0","2","Tennessee","5/13/20","2","0","47101","0"
"Lincoln","0","16","Tennessee","5/13/20","16","0","47103","0"
"Loudon","1","46","Tennessee","5/13/20","39","7","47105","17.95"
"Macon","2","71","Tennessee","5/13/20","54","17","47111","31.48"
"Madison","2","156","Tennessee","5/13/20","144","12","47113","8.33"
"Marion","0","29","Tennessee","5/13/20","29","0","47115","0"
"Marshall","0","24","Tennessee","5/13/20","23","1","47117","4.35"
"Maury","1","58","Tennessee","5/13/20","51","7","47119","13.73"
"McMinn","2","123","Tennessee","5/13/20","107","16","47107","14.95"
"McNairy","0","12","Tennessee","5/13/20","11","1","47109","9.09"
"Meigs","2","22","Tennessee","5/13/20","11","11","47121","100"
"Monroe","1","33","Tennessee","5/13/20","26","7","47123","26.92"
"Montgomery","5","191","Tennessee","5/13/20","153","38","47125","24.84"
"Moore","0","3","Tennessee","5/13/20","3","0","47127","0"
"Morgan","1","12","Tennessee","5/13/20","6","6","47129","100"
"Obion","0","16","Tennessee","5/13/20","15","1","47131","6.67"
"Out of TN","-4","318","Tennessee","5/13/20","344","-26","80047","-7.56"
"Overton","1","14","Tennessee","5/13/20","10","4","47133","40"
"Perry","0","13","Tennessee","5/13/20","13","0","47135","0"
"Pickett","0","1","Tennessee","5/13/20","0","1","47137","1"
"Polk","0","12","Tennessee","5/13/20","12","0","47139","0"
"Putnam","4","190","Tennessee","5/13/20","162","28","47141","17.28"
"Rhea","0","6","Tennessee","5/13/20","6","0","47143","0"
"Roane","0","8","Tennessee","5/13/20","7","1","47145","14.29"
"Robertson","8","245","Tennessee","5/13/20","186","59","47147","31.72"
"Rutherford","18","780","Tennessee","5/13/20","655","125","47149","19.08"
"Scott","0","11","Tennessee","5/13/20","11","0","47151","0"
"Sequatchie","0","7","Tennessee","5/13/20","7","0","47153","0"
"Sevier","1","65","Tennessee","5/13/20","60","5","47155","8.33"
"Shelby","66","3475","Tennessee","5/13/20","3010","465","47157","15.45"
"Smith","0","24","Tennessee","5/13/20","23","1","47159","4.35"
"Stewart","0","7","Tennessee","5/13/20","7","0","47161","0"
"Sullivan","0","54","Tennessee","5/13/20","52","2","47163","3.85"
"Sumner","6","714","Tennessee","5/13/20","671","43","47165","6.41"
"Tipton","35","400","Tennessee","5/13/20","155","245","47167","158.06"
"Trousdale","4","1381","Tennessee","5/13/20","1355","26","47169","1.92"
"Unicoi","0","3","Tennessee","5/13/20","2","1","47171","50"
"Union","0","4","Tennessee","5/13/20","3","1","47173","33.33"
"Van Buren","0","2","Tennessee","5/13/20","2","0","47175","0"
"Warren","0","13","Tennessee","5/13/20","10","3","47177","30"
"Washington","1","64","Tennessee","5/13/20","59","5","47179","8.47"
"Wayne","0","3","Tennessee","5/13/20","4","-1","47181","-25"
"Weakley","0","24","Tennessee","5/13/20","24","0","47183","0"
"White","0","17","Tennessee","5/13/20","15","2","47185","13.33"
"Williamson","2","453","Tennessee","5/13/20","436","17","47187","3.9"
"Wilson","3","309","Tennessee","5/13/20","287","22","47189","7.67"
"Anderson","1","50","Texas","5/13/20","40","10","48001","25"
"Andrews","0","22","Texas","5/13/20","21","1","48003","4.76"
"Angelina","4","117","Texas","5/13/20","86","31","48005","36.05"
"Aransas","0","2","Texas","5/13/20","2","0","48007","0"
"Armstrong","0","2","Texas","5/13/20","2","0","48011","0"
"Atascosa","1","27","Texas","5/13/20","21","6","48013","28.57"
"Austin","0","15","Texas","5/13/20","14","1","48015","7.14"
"Bailey","0","3","Texas","5/13/20","2","1","48017","50"
"Bandera","0","6","Texas","5/13/20","6","0","48019","0"
"Bastrop","3","120","Texas","5/13/20","100","20","48021","20"
"Bee","0","6","Texas","5/13/20","6","0","48025","0"
"Bell","3","231","Texas","5/13/20","210","21","48027","10"
"Bexar","38","1942","Texas","5/13/20","1677","265","48029","15.8"
"Blanco","0","6","Texas","5/13/20","6","0","48031","0"
"Bosque","0","6","Texas","5/13/20","5","1","48035","20"
"Bowie","1","82","Texas","5/13/20","76","6","48037","7.89"
"Brazoria","14","686","Texas","5/13/20","588","98","48039","16.67"
"Brazos","10","287","Texas","5/13/20","219","68","48041","31.05"
"Brewster","0","1","Texas","5/13/20","1","0","48043","0"
"Briscoe","0","1","Texas","5/13/20","1","0","48045","0"
"Brooks","0","1","Texas","5/13/20","1","0","48047","0"
"Brown","2","51","Texas","5/13/20","38","13","48049","34.21"
"Burleson","0","16","Texas","5/13/20","14","2","48051","14.29"
"Burnet","1","28","Texas","5/13/20","24","4","48053","16.67"
"Caldwell","1","33","Texas","5/13/20","24","9","48055","37.5"
"Calhoun","0","36","Texas","5/13/20","34","2","48057","5.88"
"Callahan","1","7","Texas","5/13/20","2","5","48059","250"
"Cameron","13","544","Texas","5/13/20","454","90","48061","19.82"
"Camp","1","11","Texas","5/13/20","7","4","48063","57.14"
"Carson","0","3","Texas","5/13/20","3","0","48065","0"
"Cass","1","21","Texas","5/13/20","17","4","48067","23.53"
"Castro","1","24","Texas","5/13/20","20","4","48069","20"
"Chambers","1","50","Texas","5/13/20","45","5","48071","11.11"
"Cherokee","1","27","Texas","5/13/20","20","7","48073","35"
"Childress","0","2","Texas","5/13/20","1","1","48075","100"
"Clay","0","3","Texas","5/13/20","3","0","48077","0"
"Cochran","0","1","Texas","5/13/20","1","0","48079","0"
"Coke","0","1","Texas","5/13/20","1","0","48081","0"
"Coleman","0","2","Texas","5/13/20","1","1","48083","100"
"Collin","19","963","Texas","5/13/20","828","135","48085","16.3"
"Collingsworth","0","4","Texas","5/13/20","1","3","48087","300"
"Colorado","1","18","Texas","5/13/20","12","6","48089","50"
"Comal","1","68","Texas","5/13/20","59","9","48091","15.25"
"Comanche","0","3","Texas","5/13/20","3","0","48093","0"
"Concho","0","1","Texas","5/13/20","1","0","48095","0"
"Cooke","0","13","Texas","5/13/20","11","2","48097","18.18"
"Coryell","4","217","Texas","5/13/20","190","27","48099","14.21"
"Cottle","0","4","Texas","5/13/20","3","1","48101","33.33"
"Crane","0","2","Texas","5/13/20","2","0","48103","0"
"Crosby","0","2","Texas","5/13/20","2","0","48107","0"
"Dallam","1","17","Texas","5/13/20","11","6","48111","54.55"
"Dallas","248","6602","Texas","5/13/20","4869","1733","48113","35.59"
"Dawson","0","32","Texas","5/13/20","30","2","48115","6.67"
"Deaf Smith","7","92","Texas","5/13/20","41","51","48117","124.39"
"Delta","0","1","Texas","5/13/20","1","0","48119","0"
"Denton","19","968","Texas","5/13/20","832","136","48121","16.35"
"DeWitt","0","17","Texas","5/13/20","15","2","48123","13.33"
"Dickens","0","1","Texas","5/13/20","1","0","48125","0"
"Dimmit","0","1","Texas","5/13/20","1","0","48127","0"
"Donley","0","25","Texas","5/13/20","25","0","48129","0"
"Duval","0","5","Texas","5/13/20","3","2","48131","66.67"
"Eastland","0","3","Texas","5/13/20","3","0","48133","0"
"Ector","2","100","Texas","5/13/20","85","15","48135","17.65"
"El Paso","48","1413","Texas","5/13/20","1080","333","48141","30.83"
"Ellis","5","221","Texas","5/13/20","184","37","48139","20.11"
"Erath","0","14","Texas","5/13/20","13","1","48143","7.69"
"Falls","0","6","Texas","5/13/20","6","0","48145","0"
"Fannin","0","24","Texas","5/13/20","22","2","48147","9.09"
"Fayette","1","26","Texas","5/13/20","17","9","48149","52.94"
"Floyd","0","4","Texas","5/13/20","4","0","48153","0"
"Fort Bend","23","1404","Texas","5/13/20","1245","159","48157","12.77"
"Franklin","0","3","Texas","5/13/20","3","0","48159","0"
"Freestone","0","7","Texas","5/13/20","7","0","48161","0"
"Frio","3","34","Texas","5/13/20","10","24","48163","240"
"Gaines","0","4","Texas","5/13/20","3","1","48165","33.33"
"Galveston","4","688","Texas","5/13/20","659","29","48167","4.4"
"Garza","0","4","Texas","5/13/20","3","1","48169","33.33"
"Gillespie","0","4","Texas","5/13/20","4","0","48171","0"
"Glasscock","0","1","Texas","5/13/20","1","0","48173","0"
"Goliad","0","7","Texas","5/13/20","7","0","48175","0"
"Gonzales","4","62","Texas","5/13/20","31","31","48177","100"
"Gray","1","77","Texas","5/13/20","71","6","48179","8.45"
"Grayson","8","112","Texas","5/13/20","58","54","48181","93.1"
"Gregg","4","136","Texas","5/13/20","107","29","48183","27.1"
"Grimes","4","54","Texas","5/13/20","25","29","48185","116"
"Guadalupe","2","99","Texas","5/13/20","88","11","48187","12.5"
"Hale","1","40","Texas","5/13/20","31","9","48189","29.03"
"Hamilton","0","7","Texas","5/13/20","5","2","48193","40"
"Hansford","0","13","Texas","5/13/20","11","2","48195","18.18"
"Hardin","0","115","Texas","5/13/20","112","3","48199","2.68"
"Harris","197","8621","Texas","5/13/20","7244","1377","48201","19.01"
"Harrison","5","192","Texas","5/13/20","160","32","48203","20"
"Hartley","0","9","Texas","5/13/20","7","2","48205","28.57"
"Hays","5","214","Texas","5/13/20","176","38","48209","21.59"
"Hemphill","0","1","Texas","5/13/20","1","0","48211","0"
"Henderson","2","47","Texas","5/13/20","33","14","48213","42.42"
"Hidalgo","7","403","Texas","5/13/20","353","50","48215","14.16"
"Hill","0","21","Texas","5/13/20","18","3","48217","16.67"
"Hockley","0","23","Texas","5/13/20","20","3","48219","15"
"Hood","0","22","Texas","5/13/20","20","2","48221","10"
"Hopkins","0","8","Texas","5/13/20","6","2","48223","33.33"
"Houston","2","21","Texas","5/13/20","9","12","48225","133.33"
"Howard","0","6","Texas","5/13/20","6","0","48227","0"
"Hunt","1","58","Texas","5/13/20","54","4","48231","7.41"
"Hutchinson","1","25","Texas","5/13/20","20","5","48233","25"
"Jack","0","4","Texas","5/13/20","4","0","48237","0"
"Jackson","0","15","Texas","5/13/20","14","1","48239","7.14"
"Jasper","0","19","Texas","5/13/20","18","1","48241","5.56"
"Jefferson","9","399","Texas","5/13/20","335","64","48245","19.1"
"Jim Hogg","0","3","Texas","5/13/20","3","0","48247","0"
"Jim Wells","0","7","Texas","5/13/20","5","2","48249","40"
"Johnson","2","110","Texas","5/13/20","95","15","48251","15.79"
"Jones","2","101","Texas","5/13/20","84","17","48253","20.24"
"Karnes","0","4","Texas","5/13/20","3","1","48255","33.33"
"Kaufman","5","133","Texas","5/13/20","101","32","48257","31.68"
"Kendall","0","20","Texas","5/13/20","17","3","48259","17.65"
"Kerr","0","9","Texas","5/13/20","6","3","48265","50"
"Kimble","0","1","Texas","5/13/20","0","1","48267","1"
"Kleberg","0","11","Texas","5/13/20","10","1","48273","10"
"Knox","0","1","Texas","5/13/20","1","0","48275","0"
"La Salle","0","3","Texas","5/13/20","1","2","48283","200"
"Lamar","5","104","Texas","5/13/20","71","33","48277","46.48"
"Lamb","1","8","Texas","5/13/20","4","4","48279","100"
"Lampasas","0","8","Texas","5/13/20","5","3","48281","60"
"Lavaca","0","7","Texas","5/13/20","6","1","48285","16.67"
"Lee","1","6","Texas","5/13/20","2","4","48287","200"
"Leon","0","9","Texas","5/13/20","7","2","48289","28.57"
"Liberty","4","72","Texas","5/13/20","47","25","48291","53.19"
"Limestone","0","15","Texas","5/13/20","13","2","48293","15.38"
"Lipscomb","0","2","Texas","5/13/20","2","0","48295","0"
"Live Oak","0","5","Texas","5/13/20","5","0","48297","0"
"Llano","0","3","Texas","5/13/20","3","0","48299","0"
"Lubbock","5","605","Texas","5/13/20","567","38","48303","6.7"
"Lynn","0","5","Texas","5/13/20","5","0","48305","0"
"Madison","0","2","Texas","5/13/20","1","1","48313","100"
"Marion","0","15","Texas","5/13/20","15","0","48315","0"
"Martin","0","3","Texas","5/13/20","3","0","48317","0"
"Mason","0","28","Texas","5/13/20","27","1","48319","3.7"
"Matagorda","0","64","Texas","5/13/20","64","0","48321","0"
"Maverick","3","45","Texas","5/13/20","26","19","48323","73.08"
"McCulloch","0","3","Texas","5/13/20","3","0","48307","0"
"McLennan","1","96","Texas","5/13/20","92","4","48309","4.35"
"Medina","4","45","Texas","5/13/20","20","25","48325","125"
"Midland","3","112","Texas","5/13/20","91","21","48329","23.08"
"Milam","0","20","Texas","5/13/20","18","2","48331","11.11"
"Mills","0","1","Texas","5/13/20","0","1","48333","1"
"Mitchell","0","1","Texas","5/13/20","1","0","48335","0"
"Montague","0","9","Texas","5/13/20","9","0","48337","0"
"Montgomery","12","758","Texas","5/13/20","672","86","48339","12.8"
"Moore","11","526","Texas","5/13/20","448","78","48341","17.41"
"Morris","0","9","Texas","5/13/20","9","0","48343","0"
"Motley","0","1","Texas","5/13/20","1","0","48345","0"
"Nacogdoches","5","224","Texas","5/13/20","189","35","48347","18.52"
"Navarro","1","37","Texas","5/13/20","33","4","48349","12.12"
"Newton","0","4","Texas","5/13/20","4","0","48351","0"
"Nolan","0","2","Texas","5/13/20","2","0","48353","0"
"Nueces","9","174","Texas","5/13/20","114","60","48355","52.63"
"Ochiltree","2","40","Texas","5/13/20","26","14","48357","53.85"
"Oldham","0","3","Texas","5/13/20","3","0","48359","0"
"Orange","1","84","Texas","5/13/20","79","5","48361","6.33"
"Palo Pinto","0","9","Texas","5/13/20","9","0","48363","0"
"Panola","4","162","Texas","5/13/20","136","26","48365","19.12"
"Parker","1","47","Texas","5/13/20","41","6","48367","14.63"
"Parmer","1","22","Texas","5/13/20","14","8","48369","57.14"
"Pecos","1","20","Texas","5/13/20","14","6","48371","42.86"
"Polk","1","40","Texas","5/13/20","30","10","48373","33.33"
"Potter","60","1327","Texas","5/13/20","907","420","48375","46.31"
"Rains","0","2","Texas","5/13/20","2","0","48379","0"
"Randall","15","413","Texas","5/13/20","310","103","48381","33.23"
"Red River","4","28","Texas","5/13/20","1","27","48387","2700"
"Reeves","0","7","Texas","5/13/20","5","2","48389","40"
"Refugio","0","3","Texas","5/13/20","1","2","48391","200"
"Roberts","0","2","Texas","5/13/20","2","0","48393","0"
"Robertson","0","6","Texas","5/13/20","4","2","48395","50"
"Rockwall","4","126","Texas","5/13/20","95","31","48397","32.63"
"Runnels","0","2","Texas","5/13/20","2","0","48399","0"
"Rusk","0","40","Texas","5/13/20","39","1","48401","2.56"
"Sabine","0","3","Texas","5/13/20","1","2","48403","200"
"San Augustine","0","22","Texas","5/13/20","21","1","48405","4.76"
"San Jacinto","0","11","Texas","5/13/20","10","1","48407","10"
"San Patricio","1","22","Texas","5/13/20","14","8","48409","57.14"
"Scurry","0","2","Texas","5/13/20","2","0","48415","0"
"Shackelford","0","1","Texas","5/13/20","0","1","48417","1"
"Shelby","5","163","Texas","5/13/20","131","32","48419","24.43"
"Sherman","1","23","Texas","5/13/20","18","5","48421","27.78"
"Smith","4","185","Texas","5/13/20","156","29","48423","18.59"
"Starr","1","14","Texas","5/13/20","10","4","48427","40"
"Stephens","0","2","Texas","5/13/20","1","1","48429","100"
"Swisher","0","13","Texas","5/13/20","11","2","48437","18.18"
"Tarrant","161","3810","Texas","5/13/20","2686","1124","48439","41.85"
"Taylor","-24","213","Texas","5/13/20","378","-165","48441","-43.65"
"Terry","0","12","Texas","5/13/20","12","0","48445","0"
"Titus","5","59","Texas","5/13/20","23","36","48449","156.52"
"Tom Green","0","84","Texas","5/13/20","83","1","48451","1.2"
"Travis","49","2288","Texas","5/13/20","1946","342","48453","17.57"
"Trinity","0","11","Texas","5/13/20","10","1","48455","10"
"Tyler","0","7","Texas","5/13/20","7","0","48457","0"
"Upshur","0","17","Texas","5/13/20","16","1","48459","6.25"
"Uvalde","0","6","Texas","5/13/20","6","0","48463","0"
"Val Verde","0","13","Texas","5/13/20","13","0","48465","0"
"Van Zandt","1","22","Texas","5/13/20","18","4","48467","22.22"
"Victoria","1","150","Texas","5/13/20","146","4","48469","2.74"
"Walker","13","393","Texas","5/13/20","303","90","48471","29.7"
"Waller","0","39","Texas","5/13/20","36","3","48473","8.33"
"Washington","4","175","Texas","5/13/20","150","25","48477","16.67"
"Webb","6","444","Texas","5/13/20","400","44","48479","11"
"Wharton","0","42","Texas","5/13/20","40","2","48481","5"
"Wheeler","0","14","Texas","5/13/20","12","2","48483","16.67"
"Wichita","1","76","Texas","5/13/20","70","6","48485","8.57"
"Wilbarger","0","2","Texas","5/13/20","2","0","48487","0"
"Willacy","0","14","Texas","5/13/20","13","1","48489","7.69"
"Williamson","12","424","Texas","5/13/20","341","83","48491","24.34"
"Wilson","0","36","Texas","5/13/20","34","2","48493","5.88"
"Winkler","0","3","Texas","5/13/20","3","0","48495","0"
"Wise","1","35","Texas","5/13/20","28","7","48497","25"
"Wood","1","15","Texas","5/13/20","11","4","48499","36.36"
"Yoakum","0","2","Texas","5/13/20","2","0","48501","0"
"Young","0","4","Texas","5/13/20","4","0","48503","0"
"Zapata","0","7","Texas","5/13/20","7","0","48505","0"
"Zavala","1","9","Texas","5/13/20","1","8","48507","800"
"Bear River","3","83","Utah","5/13/20","64","19","00000","29.69"
"Central Utah","0","29","Utah","5/13/20","26","3","00000","11.54"
"Davis","5","344","Utah","5/13/20","308","36","49011","11.69"
"Salt Lake","88","3530","Utah","5/13/20","2912","618","49035","21.22"
"San Juan","4","152","Utah","5/13/20","126","26","49037","20.63"
"Southeast Utah","0","13","Utah","5/13/20","12","1","00000","8.33"
"Southwest Utah","7","180","Utah","5/13/20","128","52","00000","40.62"
"Summit","1","392","Utah","5/13/20","382","10","49043","2.62"
"Tooele","2","85","Utah","5/13/20","70","15","49045","21.43"
"TriCounty","0","16","Utah","5/13/20","14","2","00000","14.29"
"Utah","27","1400","Utah","5/13/20","1210","190","49049","15.7"
"Wasatch","2","185","Utah","5/13/20","170","15","49051","8.82"
"Weber-Morgan","5","211","Utah","5/13/20","173","38","00000","21.97"
"Addison","0","62","Vermont","5/13/20","61","1","50001","1.64"
"Bennington","1","60","Vermont","5/13/20","53","7","50003","13.21"
"Caledonia","0","14","Vermont","5/13/20","14","0","50005","0"
"Chittenden","1","432","Vermont","5/13/20","426","6","50007","1.41"
"Essex","0","2","Vermont","5/13/20","2","0","50009","0"
"Franklin","0","99","Vermont","5/13/20","99","0","50011","0"
"Grand Isle","0","4","Vermont","5/13/20","4","0","50013","0"
"Lamoille","0","27","Vermont","5/13/20","26","1","50015","3.85"
"Orange","0","8","Vermont","5/13/20","8","0","50017","0"
"Orleans","0","9","Vermont","5/13/20","9","0","50019","0"
"Rutland","0","49","Vermont","5/13/20","49","0","50021","0"
"Washington","0","38","Vermont","5/13/20","36","2","50023","5.56"
"Windham","0","75","Vermont","5/13/20","73","2","50025","2.74"
"Windsor","0","46","Vermont","5/13/20","44","2","50027","4.55"
"","0","69","Virgin Islands","5/13/20","66","3",,"4.55"
"Accomack","16","545","Virginia","5/13/20","433","112","51001","25.87"
"Albemarle","2","126","Virginia","5/13/20","111","15","51003","13.51"
"Alexandria","40","1305","Virginia","5/13/20","1022","283","51510","27.69"
"Alleghany","0","6","Virginia","5/13/20","6","0","51005","0"
"Amelia","0","17","Virginia","5/13/20","18","-1","51007","-5.56"
"Amherst","1","20","Virginia","5/13/20","15","5","51009","33.33"
"Appomattox","0","22","Virginia","5/13/20","21","1","51011","4.76"
"Arlington","37","1460","Virginia","5/13/20","1200","260","51013","21.67"
"Augusta","2","66","Virginia","5/13/20","54","12","51015","22.22"
"Bedford","0","40","Virginia","5/13/20","37","3","51019","8.11"
"Botetourt","0","30","Virginia","5/13/20","30","0","51023","0"
"Bristol","0","3","Virginia","5/13/20","2","1","51520","50"
"Brunswick","1","20","Virginia","5/13/20","15","5","51025","33.33"
"Buchanan","0","16","Virginia","5/13/20","16","0","51027","0"
"Buckingham","21","347","Virginia","5/13/20","201","146","51029","72.64"
"Buena Vista","0","8","Virginia","5/13/20","8","0","51530","0"
"Campbell","0","13","Virginia","5/13/20","13","0","51031","0"
"Caroline","1","39","Virginia","5/13/20","35","4","51033","11.43"
"Carroll","3","39","Virginia","5/13/20","21","18","51035","85.71"
"Charles City","1","21","Virginia","5/13/20","17","4","51036","23.53"
"Charlotte","0","11","Virginia","5/13/20","11","0","51037","0"
"Charlottesville","1","68","Virginia","5/13/20","63","5","51540","7.94"
"Chesapeake","7","354","Virginia","5/13/20","306","48","51550","15.69"
"Chesterfield","26","862","Virginia","5/13/20","681","181","51041","26.58"
"Clarke","0","16","Virginia","5/13/20","15","1","51043","6.67"
"Colonial Heights","1","71","Virginia","5/13/20","62","9","51570","14.52"
"Covington","0","1","Virginia","5/13/20","0","1","51580","1"
"Craig","0","4","Virginia","5/13/20","4","0","51045","0"
"Culpeper","16","320","Virginia","5/13/20","209","111","51047","53.11"
"Cumberland","1","18","Virginia","5/13/20","12","6","51049","50"
"Danville","0","41","Virginia","5/13/20","38","3","51590","7.89"
"Dinwiddie","1","30","Virginia","5/13/20","25","5","51053","20"
"Emporia","1","50","Virginia","5/13/20","46","4","51595","8.7"
"Essex","2","29","Virginia","5/13/20","17","12","51057","70.59"
"Fairfax","236","6666","Virginia","5/13/20","5016","1650","51059","32.89"
"Fairfax City","1","43","Virginia","5/13/20","34","9","51600","26.47"
"Falls Church","0","39","Virginia","5/13/20","36","3","51610","8.33"
"Fauquier","6","190","Virginia","5/13/20","148","42","51061","28.38"
"Floyd","0","4","Virginia","5/13/20","3","1","51063","33.33"
"Fluvanna","0","79","Virginia","5/13/20","76","3","51065","3.95"
"Franklin","1","30","Virginia","5/13/20","23","7","51067","30.43"
"Franklin City","0","25","Virginia","5/13/20","23","2","51620","8.7"
"Frederick","5","182","Virginia","5/13/20","144","38","51069","26.39"
"Fredericksburg","3","72","Virginia","5/13/20","48","24","51630","50"
"Galax","5","64","Virginia","5/13/20","31","33","51640","106.45"
"Giles","0","5","Virginia","5/13/20","4","1","51071","25"
"Gloucester","0","28","Virginia","5/13/20","26","2","51073","7.69"
"Goochland","0","82","Virginia","5/13/20","81","1","51075","1.23"
"Grayson","2","18","Virginia","5/13/20","5","13","51077","260"
"Greene","0","16","Virginia","5/13/20","13","3","51079","23.08"
"Greensville","1","49","Virginia","5/13/20","43","6","51081","13.95"
"Halifax","1","25","Virginia","5/13/20","18","7","51083","38.89"
"Hampton","2","148","Virginia","5/13/20","131","17","51650","12.98"
"Hanover","4","183","Virginia","5/13/20","153","30","51085","19.61"
"Harrisonburg","9","607","Virginia","5/13/20","544","63","51660","11.58"
"Henrico","21","1146","Virginia","5/13/20","1000","146","51087","14.6"
"Henry","1","28","Virginia","5/13/20","20","8","51089","40"
"Highland","0","2","Virginia","5/13/20","2","0","51091","0"
"Hopewell","2","45","Virginia","5/13/20","33","12","51670","36.36"
"Isle of Wight","2","113","Virginia","5/13/20","101","12","51093","11.88"
"James City","1","174","Virginia","5/13/20","166","8","51095","4.82"
"King and Queen","0","6","Virginia","5/13/20","3","3","51097","100"
"King George","1","44","Virginia","5/13/20","38","6","51099","15.79"
"King William","0","12","Virginia","5/13/20","11","1","51101","9.09"
"Lancaster","0","7","Virginia","5/13/20","5","2","51103","40"
"Lee","0","10","Virginia","5/13/20","10","0","51105","0"
"Lexington","0","5","Virginia","5/13/20","5","0","51678","0"
"Loudoun","37","1283","Virginia","5/13/20","1025","258","51107","25.17"
"Louisa","1","59","Virginia","5/13/20","50","9","51109","18"
"Lunenburg","0","6","Virginia","5/13/20","4","2","51111","50"
"Lynchburg","1","72","Virginia","5/13/20","68","4","51680","5.88"
"Madison","1","22","Virginia","5/13/20","18","4","51113","22.22"
"Manassas","21","459","Virginia","5/13/20","310","149","51683","48.06"
"Manassas Park","7","152","Virginia","5/13/20","101","51","51685","50.5"
"Martinsville","0","2","Virginia","5/13/20","2","0","51690","0"
"Mathews","0","5","Virginia","5/13/20","4","1","51115","25"
"Mecklenburg","4","138","Virginia","5/13/20","107","31","51117","28.97"
"Middlesex","0","10","Virginia","5/13/20","7","3","51119","42.86"
"Montgomery","1","66","Virginia","5/13/20","61","5","51121","8.2"
"Nelson","0","12","Virginia","5/13/20","9","3","51125","33.33"
"New Kent","0","28","Virginia","5/13/20","26","2","51127","7.69"
"Newport News","5","171","Virginia","5/13/20","134","37","51700","27.61"
"Norfolk","10","327","Virginia","5/13/20","257","70","51710","27.24"
"Northampton","4","174","Virginia","5/13/20","143","31","51131","21.68"
"Northumberland","0","11","Virginia","5/13/20","9","2","51133","22.22"
"Norton","0","2","Virginia","5/13/20","2","0","51720","0"
"Nottoway","0","14","Virginia","5/13/20","14","0","51135","0"
"Orange","1","50","Virginia","5/13/20","42","8","51137","19.05"
"Page","3","140","Virginia","5/13/20","120","20","51139","16.67"
"Patrick","0","6","Virginia","5/13/20","3","3","51141","100"
"Petersburg","2","53","Virginia","5/13/20","42","11","51730","26.19"
"Pittsylvania","0","17","Virginia","5/13/20","17","0","51143","0"
"Poquoson","0","7","Virginia","5/13/20","7","0","51735","0"
"Portsmouth","3","213","Virginia","5/13/20","189","24","51740","12.7"
"Powhatan","1","22","Virginia","5/13/20","16","6","51145","37.5"
"Prince Edward","1","69","Virginia","5/13/20","62","7","51147","11.29"
"Prince George","1","46","Virginia","5/13/20","40","6","51149","15"
"Prince William","125","3181","Virginia","5/13/20","2304","877","51153","38.06"
"Pulaski","0","9","Virginia","5/13/20","9","0","51155","0"
"Radford","0","3","Virginia","5/13/20","3","0","51750","0"
"Rappahannock","1","10","Virginia","5/13/20","6","4","51157","66.67"
"Richmond","8","200","Virginia","5/13/20","144","56","51159","38.89"
"Richmond City","20","592","Virginia","5/13/20","453","139","51760","30.68"
"Roanoke","3","80","Virginia","5/13/20","59","21","51161","35.59"
"Roanoke City","5","116","Virginia","5/13/20","84","32","51770","38.1"
"Rockbridge","0","11","Virginia","5/13/20","8","3","51163","37.5"
"Rockingham","10","373","Virginia","5/13/20","302","71","51165","23.51"
"Russell","0","6","Virginia","5/13/20","6","0","51167","0"
"Salem","0","32","Virginia","5/13/20","30","2","51775","6.67"
"Scott","0","7","Virginia","5/13/20","7","0","51169","0"
"Shenandoah","12","271","Virginia","5/13/20","190","81","51171","42.63"
"Smyth","0","15","Virginia","5/13/20","13","2","51173","15.38"
"Southampton","1","132","Virginia","5/13/20","128","4","51175","3.12"
"Spotsylvania","7","270","Virginia","5/13/20","223","47","51177","21.08"
"Stafford","13","413","Virginia","5/13/20","321","92","51179","28.66"
"Staunton","1","21","Virginia","5/13/20","14","7","51790","50"
"Suffolk","2","221","Virginia","5/13/20","207","14","51800","6.76"
"Surry","0","6","Virginia","5/13/20","4","2","51181","50"
"Sussex","1","38","Virginia","5/13/20","32","6","51183","18.75"
"Tazewell","0","6","Virginia","5/13/20","6","0","51185","0"
"Virginia Beach","10","519","Virginia","5/13/20","449","70","51810","15.59"
"Warren","2","88","Virginia","5/13/20","71","17","51187","23.94"
"Washington","1","49","Virginia","5/13/20","41","8","51191","19.51"
"Waynesboro","0","21","Virginia","5/13/20","20","1","51820","5"
"Westmoreland","2","42","Virginia","5/13/20","31","11","51193","35.48"
"Williamsburg","2","42","Virginia","5/13/20","29","13","51830","44.83"
"Winchester","2","73","Virginia","5/13/20","60","13","51840","21.67"
"Wise","0","23","Virginia","5/13/20","22","1","51195","4.55"
"Wythe","0","15","Virginia","5/13/20","12","3","51197","25"
"York","1","60","Virginia","5/13/20","50","10","51199","20"
"Adams","0","50","Washington","5/13/20","49","1","53001","2.04"
"Asotin","0","18","Washington","5/13/20","18","0","53003","0"
"Benton","7","595","Washington","5/13/20","548","47","53005","8.58"
"Chelan","2","153","Washington","5/13/20","137","16","53007","11.68"
"Clallam","0","19","Washington","5/13/20","19","0","53009","0"
"Clark","5","377","Washington","5/13/20","341","36","53011","10.56"
"Columbia","0","1","Washington","5/13/20","1","0","53013","0"
"Cowlitz","1","66","Washington","5/13/20","62","4","53015","6.45"
"Douglas","3","116","Washington","5/13/20","95","21","53017","22.11"
"Ferry","0","1","Washington","5/13/20","1","0","53019","0"
"Franklin","5","422","Washington","5/13/20","387","35","53021","9.04"
"Grant","1","185","Washington","5/13/20","179","6","53025","3.35"
"Grays Harbor","0","13","Washington","5/13/20","12","1","53027","8.33"
"Island","1","176","Washington","5/13/20","172","4","53029","2.33"
"Jefferson","0","29","Washington","5/13/20","28","1","53031","3.57"
"King","73","7212","Washington","5/13/20","6704","508","53033","7.58"
"Kitsap","1","156","Washington","5/13/20","151","5","53035","3.31"
"Kittitas","4","40","Washington","5/13/20","15","25","53037","166.67"
"Klickitat","1","22","Washington","5/13/20","18","4","53039","22.22"
"Lewis","1","33","Washington","5/13/20","29","4","53041","13.79"
"Lincoln","0","2","Washington","5/13/20","2","0","53043","0"
"Mason","1","30","Washington","5/13/20","26","4","53045","15.38"
"Okanogan","1","29","Washington","5/13/20","21","8","53047","38.1"
"Pacific","1","9","Washington","5/13/20","4","5","53049","125"
"Pend Oreille","0","2","Washington","5/13/20","2","0","53051","0"
"Pierce","21","1604","Washington","5/13/20","1454","150","53053","10.32"
"San Juan","0","15","Washington","5/13/20","14","1","53055","7.14"
"Skagit","5","411","Washington","5/13/20","379","32","53057","8.44"
"Skamania","0","3","Washington","5/13/20","3","0","53059","0"
"Snohomish","19","2720","Washington","5/13/20","2584","136","53061","5.26"
"Spokane","1","387","Washington","5/13/20","379","8","53063","2.11"
"Stevens","0","9","Washington","5/13/20","9","0","53065","0"
"Thurston","1","122","Washington","5/13/20","116","6","53067","5.17"
"Wahkiakum","0","4","Washington","5/13/20","2","2","53069","100"
"Walla Walla","1","105","Washington","5/13/20","96","9","53071","9.38"
"Whatcom","2","341","Washington","5/13/20","324","17","53073","5.25"
"Whitman","0","16","Washington","5/13/20","14","2","53075","14.29"
"Yakima","71","1946","Washington","5/13/20","1449","497","53077","34.3"
"Barbour","0","7","West Virginia","5/13/20","6","1","54001","16.67"
"Berkeley","4","197","West Virginia","5/13/20","166","31","54003","18.67"
"Boone","0","9","West Virginia","5/13/20","6","3","54005","50"
"Braxton","0","2","West Virginia","5/13/20","2","0","54007","0"
"Brooke","0","3","West Virginia","5/13/20","3","0","54009","0"
"Cabell","1","53","West Virginia","5/13/20","44","9","54011","20.45"
"Clay","0","2","West Virginia","5/13/20","0","2","54015","1"
"Fayette","2","34","West Virginia","5/13/20","20","14","54019","70"
"Gilmer","1","8","West Virginia","5/13/20","3","5","54021","166.67"
"Grant","0","5","West Virginia","5/13/20","3","2","54023","66.67"
"Greenbrier","0","8","West Virginia","5/13/20","7","1","54025","14.29"
"Hampshire","0","10","West Virginia","5/13/20","8","2","54027","25"
"Hancock","0","12","West Virginia","5/13/20","11","1","54029","9.09"
"Hardy","2","20","West Virginia","5/13/20","9","11","54031","122.22"
"Harrison","0","34","West Virginia","5/13/20","31","3","54033","9.68"
"Jackson","0","136","West Virginia","5/13/20","134","2","54035","1.49"
"Jefferson","1","91","West Virginia","5/13/20","83","8","54037","9.64"
"Kanawha","3","189","West Virginia","5/13/20","170","19","54039","11.18"
"Lewis","0","4","West Virginia","5/13/20","4","0","54041","0"
"Lincoln","0","5","West Virginia","5/13/20","2","3","54043","150"
"Logan","0","14","West Virginia","5/13/20","14","0","54045","0"
"Marion","0","46","West Virginia","5/13/20","46","0","54049","0"
"Marshall","0","22","West Virginia","5/13/20","19","3","54051","15.79"
"Mason","0","14","West Virginia","5/13/20","12","2","54053","16.67"
"McDowell","0","6","West Virginia","5/13/20","6","0","54047","0"
"Mercer","0","12","West Virginia","5/13/20","11","1","54055","9.09"
"Mineral","1","25","West Virginia","5/13/20","18","7","54057","38.89"
"Mingo","0","3","West Virginia","5/13/20","2","1","54059","50"
"Monongalia","1","114","West Virginia","5/13/20","108","6","54061","5.56"
"Monroe","0","6","West Virginia","5/13/20","6","0","54063","0"
"Morgan","0","17","West Virginia","5/13/20","14","3","54065","21.43"
"Nicholas","0","8","West Virginia","5/13/20","8","0","54067","0"
"Ohio","0","37","West Virginia","5/13/20","34","3","54069","8.82"
"Pendleton","0","5","West Virginia","5/13/20","5","0","54071","0"
"Pleasants","0","2","West Virginia","5/13/20","2","0","54073","0"
"Pocahontas","0","2","West Virginia","5/13/20","2","0","54075","0"
"Preston","0","14","West Virginia","5/13/20","13","1","54077","7.69"
"Putnam","0","29","West Virginia","5/13/20","27","2","54079","7.41"
"Raleigh","0","10","West Virginia","5/13/20","9","1","54081","11.11"
"Randolph","0","5","West Virginia","5/13/20","5","0","54083","0"
"Ritchie","0","1","West Virginia","5/13/20","1","0","54085","0"
"Roane","0","8","West Virginia","5/13/20","6","2","54087","33.33"
"Summers","0","1","West Virginia","5/13/20","1","0","54089","0"
"Taylor","0","8","West Virginia","5/13/20","9","-1","54091","-11.11"
"Tucker","0","4","West Virginia","5/13/20","4","0","54093","0"
"Tyler","0","3","West Virginia","5/13/20","3","0","54095","0"
"Upshur","0","6","West Virginia","5/13/20","5","1","54097","20"
"Wayne","0","93","West Virginia","5/13/20","91","2","54099","2.2"
"Wetzel","0","6","West Virginia","5/13/20","3","3","54103","100"
"Wirt","0","3","West Virginia","5/13/20","3","0","54105","0"
"Wood","0","44","West Virginia","5/13/20","42","2","54107","4.76"
"Wyoming","0","1","West Virginia","5/13/20","1","0","54109","0"
"Adams","0","4","Wisconsin","5/13/20","4","0","55001","0"
"Ashland","0","2","Wisconsin","5/13/20","2","0","55003","0"
"Barron","1","11","Wisconsin","5/13/20","7","4","55005","57.14"
"Bayfield","0","3","Wisconsin","5/13/20","3","0","55007","0"
"Brown","47","1982","Wisconsin","5/13/20","1653","329","55009","19.9"
"Buffalo","0","5","Wisconsin","5/13/20","6","-1","55011","-16.67"
"Calumet","3","44","Wisconsin","5/13/20","20","24","55015","120"
"Chippewa","1","31","Wisconsin","5/13/20","27","4","55017","14.81"
"Clark","0","24","Wisconsin","5/13/20","22","2","55019","9.09"
"Columbia","0","34","Wisconsin","5/13/20","32","2","55021","6.25"
"Crawford","1","17","Wisconsin","5/13/20","7","10","55023","142.86"
"Dane","6","490","Wisconsin","5/13/20","445","45","55025","10.11"
"Dodge","5","79","Wisconsin","5/13/20","42","37","55027","88.1"
"Door","1","23","Wisconsin","5/13/20","18","5","55029","27.78"
"Douglas","0","11","Wisconsin","5/13/20","10","1","55031","10"
"Dunn","1","19","Wisconsin","5/13/20","13","6","55033","46.15"
"Eau Claire","2","61","Wisconsin","5/13/20","45","16","55035","35.56"
"Florence","0","2","Wisconsin","5/13/20","2","0","55037","0"
"Fond du Lac","4","111","Wisconsin","5/13/20","83","28","55039","33.73"
"Forest","1","5","Wisconsin","5/13/20","1","4","55041","400"
"Grant","1","70","Wisconsin","5/13/20","60","10","55043","16.67"
"Green","2","36","Wisconsin","5/13/20","20","16","55045","80"
"Green Lake","1","10","Wisconsin","5/13/20","5","5","55047","100"
"Iowa","0","10","Wisconsin","5/13/20","10","0","55049","0"
"Iron","0","2","Wisconsin","5/13/20","2","0","55051","0"
"Jackson","0","14","Wisconsin","5/13/20","12","2","55053","16.67"
"Jefferson","1","54","Wisconsin","5/13/20","47","7","55055","14.89"
"Juneau","0","21","Wisconsin","5/13/20","19","2","55057","10.53"
"Kenosha","22","736","Wisconsin","5/13/20","580","156","55059","26.9"
"Kewaunee","1","29","Wisconsin","5/13/20","25","4","55061","16"
"La Crosse","0","34","Wisconsin","5/13/20","32","2","55063","6.25"
"Lafayette","1","14","Wisconsin","5/13/20","8","6","55065","75"
"Lincoln","0","1","Wisconsin","5/13/20","1","0","55069","0"
"Manitowoc","0","20","Wisconsin","5/13/20","17","3","55071","17.65"
"Marathon","1","28","Wisconsin","5/13/20","21","7","55073","33.33"
"Marinette","1","21","Wisconsin","5/13/20","13","8","55075","61.54"
"Marquette","0","3","Wisconsin","5/13/20","3","0","55077","0"
"Menominee","0","2","Wisconsin","5/13/20","1","1","55078","100"
"Milwaukee","107","4215","Wisconsin","5/13/20","3469","746","55079","21.5"
"Monroe","0","15","Wisconsin","5/13/20","14","1","55081","7.14"
"Oconto","1","28","Wisconsin","5/13/20","23","5","55083","21.74"
"Oneida","0","7","Wisconsin","5/13/20","6","1","55085","16.67"
"Outagamie","6","122","Wisconsin","5/13/20","83","39","55087","46.99"
"Ozaukee","2","110","Wisconsin","5/13/20","95","15","55089","15.79"
"Pierce","0","14","Wisconsin","5/13/20","11","3","55093","27.27"
"Polk","0","5","Wisconsin","5/13/20","5","0","55095","0"
"Portage","0","7","Wisconsin","5/13/20","7","0","55097","0"
"Price","0","1","Wisconsin","5/13/20","1","0","55099","0"
"Racine","32","785","Wisconsin","5/13/20","559","226","55101","40.43"
"Richland","0","13","Wisconsin","5/13/20","13","0","55103","0"
"Rock","10","380","Wisconsin","5/13/20","311","69","55105","22.19"
"Rusk","0","4","Wisconsin","5/13/20","4","0","55107","0"
"Sauk","0","73","Wisconsin","5/13/20","70","3","55111","4.29"
"Sawyer","0","4","Wisconsin","5/13/20","4","0","55113","0"
"Shawano","1","27","Wisconsin","5/13/20","17","10","55115","58.82"
"Sheboygan","1","66","Wisconsin","5/13/20","59","7","55117","11.86"
"St. Croix","2","36","Wisconsin","5/13/20","23","13","55109","56.52"
"Trempealeau","0","6","Wisconsin","5/13/20","5","1","55121","20"
"Vernon","1","6","Wisconsin","5/13/20","2","4","55123","200"
"Vilas","0","4","Wisconsin","5/13/20","4","0","55125","0"
"Walworth","4","243","Wisconsin","5/13/20","215","28","55127","13.02"
"Washburn","0","1","Wisconsin","5/13/20","1","0","55129","0"
"Washington","2","122","Wisconsin","5/13/20","107","15","55131","14.02"
"Waukesha","7","421","Wisconsin","5/13/20","374","47","55133","12.57"
"Waupaca","1","14","Wisconsin","5/13/20","10","4","55135","40"
"Waushara","0","4","Wisconsin","5/13/20","4","0","55137","0"
"Winnebago","2","102","Wisconsin","5/13/20","85","17","55139","20"
"Wood","0","4","Wisconsin","5/13/20","2","2","55141","100"
"Albany","0","8","Wyoming","5/13/20","8","0","56001","0"
"Big Horn","0","3","Wyoming","5/13/20","3","0","56003","0"
"Campbell","1","29","Wyoming","5/13/20","25","4","56005","16"
"Carbon","0","5","Wyoming","5/13/20","5","0","56007","0"
"Converse","0","23","Wyoming","5/13/20","23","0","56009","0"
"Crook","0","5","Wyoming","5/13/20","5","0","56011","0"
"Fremont","5","202","Wyoming","5/13/20","164","38","56013","23.17"
"Goshen","0","5","Wyoming","5/13/20","4","1","56015","25"
"Hot Springs","0","3","Wyoming","5/13/20","3","0","56017","0"
"Johnson","0","15","Wyoming","5/13/20","15","0","56019","0"
"Laramie","1","173","Wyoming","5/13/20","163","10","56021","6.13"
"Lincoln","0","11","Wyoming","5/13/20","10","1","56023","10"
"Natrona","0","48","Wyoming","5/13/20","48","0","56025","0"
"Niobrara","0","2","Wyoming","5/13/20","2","0","56027","0"
"Park","0","1","Wyoming","5/13/20","1","0","56029","0"
"Sheridan","0","16","Wyoming","5/13/20","16","0","56033","0"
"Sublette","0","3","Wyoming","5/13/20","3","0","56035","0"
"Sweetwater","0","20","Wyoming","5/13/20","19","1","56037","5.26"
"Teton","0","99","Wyoming","5/13/20","98","1","56039","1.02"
"Uinta","0","9","Wyoming","5/13/20","8","1","56041","12.5"
"Washakie","0","8","Wyoming","5/13/20","8","0","56043","0"
