"Locality","DailyAvgNewCasesPast7Days","TotalCases","State","Date","TotalCases7DaysAgo","NewCasesPast7Days","FIPS-Code","PercentIncreaseTotalCasesPast7Days"
"Autauga","9","212","Alabama","5/29/20","149","63","01001","42.28"
"Baldwin","2","282","Alabama","5/29/20","271","11","01003","4.06"
"Barbour","6","147","Alabama","5/29/20","104","43","01005","41.35"
"Bibb","2","71","Alabama","5/29/20","55","16","01007","29.09"
"Blount","2","60","Alabama","5/29/20","49","11","01009","22.45"
"Bullock","16","201","Alabama","5/29/20","89","112","01011","125.84"
"Butler","10","396","Alabama","5/29/20","329","67","01013","20.36"
"Calhoun","2","153","Alabama","5/29/20","137","16","01015","11.68"
"Chambers","3","352","Alabama","5/29/20","330","22","01017","6.67"
"Cherokee","0","36","Alabama","5/29/20","33","3","01019","9.09"
"Chilton","2","99","Alabama","5/29/20","85","14","01021","16.47"
"Choctaw","2","149","Alabama","5/29/20","135","14","01023","10.37"
"Clarke","6","134","Alabama","5/29/20","92","42","01025","45.65"
"Clay","0","27","Alabama","5/29/20","27","0","01027","0"
"Cleburne","0","14","Alabama","5/29/20","13","1","01029","7.69"
"Coffee","5","226","Alabama","5/29/20","189","37","01031","19.58"
"Colbert","7","165","Alabama","5/29/20","117","48","01033","41.03"
"Conecuh","2","38","Alabama","5/29/20","24","14","01035","58.33"
"Coosa","1","38","Alabama","5/29/20","33","5","01037","15.15"
"Covington","2","77","Alabama","5/29/20","63","14","01039","22.22"
"Crenshaw","3","73","Alabama","5/29/20","53","20","01041","37.74"
"Cullman","6","114","Alabama","5/29/20","73","41","01043","56.16"
"Dale","4","106","Alabama","5/29/20","77","29","01045","37.66"
"Dallas","10","255","Alabama","5/29/20","182","73","01047","40.11"
"DeKalb","5","243","Alabama","5/29/20","209","34","01049","16.27"
"Elmore","12","323","Alabama","5/29/20","242","81","01051","33.47"
"Escambia","3","57","Alabama","5/29/20","39","18","01053","46.15"
"Etowah","3","247","Alabama","5/29/20","225","22","01055","9.78"
"Fayette","0","13","Alabama","5/29/20","11","2","01057","18.18"
"Franklin","17","540","Alabama","5/29/20","422","118","01059","27.96"
"Geneva","2","39","Alabama","5/29/20","28","11","01061","39.29"
"Greene","1","93","Alabama","5/29/20","88","5","01063","5.68"
"Hale","5","157","Alabama","5/29/20","119","38","01065","31.93"
"Henry","3","73","Alabama","5/29/20","50","23","01067","46"
"Houston","7","204","Alabama","5/29/20","156","48","01069","30.77"
"Jackson","1","76","Alabama","5/29/20","69","7","01071","10.14"
"Jefferson","35","1744","Alabama","5/29/20","1498","246","01073","16.42"
"Lamar","1","23","Alabama","5/29/20","17","6","01075","35.29"
"Lauderdale","5","156","Alabama","5/29/20","122","34","01077","27.87"
"Lawrence","1","48","Alabama","5/29/20","40","8","01079","20"
"Lee","9","536","Alabama","5/29/20","471","65","01081","13.8"
"Limestone","3","92","Alabama","5/29/20","72","20","01083","27.78"
"Lowndes","8","227","Alabama","5/29/20","172","55","01085","31.98"
"Macon","2","72","Alabama","5/29/20","58","14","01087","24.14"
"Madison","5","324","Alabama","5/29/20","286","38","01089","13.29"
"Marengo","5","160","Alabama","5/29/20","125","35","01091","28"
"Marion","2","120","Alabama","5/29/20","107","13","01093","12.15"
"Marshall","6","681","Alabama","5/29/20","642","39","01095","6.07"
"Mobile","35","2162","Alabama","5/29/20","1916","246","01097","12.84"
"Monroe","2","36","Alabama","5/29/20","23","13","01099","56.52"
"Montgomery","71","1590","Alabama","5/29/20","1096","494","01101","45.07"
"Morgan","14","244","Alabama","5/29/20","144","100","01103","69.44"
"Perry","1","35","Alabama","5/29/20","28","7","01105","25"
"Pickens","3","109","Alabama","5/29/20","86","23","01107","26.74"
"Pike","9","191","Alabama","5/29/20","127","64","01109","50.39"
"Randolph","0","125","Alabama","5/29/20","123","2","01111","1.63"
"Russell","6","162","Alabama","5/29/20","120","42","01113","35"
"Shelby","11","497","Alabama","5/29/20","420","77","01117","18.33"
"St. Clair","3","118","Alabama","5/29/20","98","20","01115","20.41"
"Sumter","6","216","Alabama","5/29/20","172","44","01119","25.58"
"Talladega","3","106","Alabama","5/29/20","85","21","01121","24.71"
"Tallapoosa","5","422","Alabama","5/29/20","387","35","01123","9.04"
"Tuscaloosa","37","720","Alabama","5/29/20","464","256","01125","55.17"
"Walker","22","330","Alabama","5/29/20","179","151","01127","84.36"
"Washington","1","67","Alabama","5/29/20","63","4","01129","6.35"
"Wilcox","4","141","Alabama","5/29/20","110","31","01131","28.18"
"Winston","5","87","Alabama","5/29/20","52","35","01133","67.31"
"Anchorage","1","213","Alaska","5/29/20","206","7","02020","3.4"
"Bethel","0","3","Alaska","5/29/20","2","1","02050","50"
"Fairbanks North Star","0","85","Alaska","5/29/20","85","0","02090","0"
"Juneau","0","33","Alaska","5/29/20","31","2","02110","6.45"
"Kenai Peninsula","1","36","Alaska","5/29/20","26","10","02122","38.46"
"Ketchikan Gateway","0","16","Alaska","5/29/20","16","0","02130","0"
"Kodiak Island","0","1","Alaska","5/29/20","1","0","02150","0"
"Matanuska-Susitna","0","24","Alaska","5/29/20","22","2","02170","9.09"
"Nome","0","3","Alaska","5/29/20","2","1","02180","50"
"North Slope","0","1","Alaska","5/29/20","0","1","02185","1"
"Northwest Arctic","0","2","Alaska","5/29/20","1","1","02188","100"
"Petersburg","0","4","Alaska","5/29/20","4","0","02195","0"
"Prince of Wales-Hyder","0","2","Alaska","5/29/20","2","0","02198","0"
"Sitka","0","2","Alaska","5/29/20","1","1","02220","100"
"Southeast Fairbanks","0","3","Alaska","5/29/20","3","0","02240","0"
"Yukon-Koyukuk","0","1","Alaska","5/29/20","1","0","02290","0"
"Apache","39","1414","Arizona","5/29/20","1139","275","04001","24.14"
"Cochise","2","67","Arizona","5/29/20","56","11","04003","19.64"
"Coconino","18","1104","Arizona","5/29/20","979","125","04005","12.77"
"Gila","1","28","Arizona","5/29/20","24","4","04007","16.67"
"Graham","1","27","Arizona","5/29/20","21","6","04009","28.57"
"Greenlee","0","4","Arizona","5/29/20","3","1","04011","33.33"
"La Paz","1","54","Arizona","5/29/20","48","6","04012","12.5"
"Maricopa","166","9112","Arizona","5/29/20","7950","1162","04013","14.62"
"Mohave","12","369","Arizona","5/29/20","288","81","04015","28.12"
"Navajo","40","1752","Arizona","5/29/20","1470","282","04017","19.18"
"Pima","37","2234","Arizona","5/29/20","1974","260","04019","13.17"
"Pinal","9","814","Arizona","5/29/20","749","65","04021","8.68"
"Santa Cruz","19","262","Arizona","5/29/20","131","131","04023","100"
"Yavapai","2","295","Arizona","5/29/20","284","11","04025","3.87"
"Yuma","61","936","Arizona","5/29/20","508","428","04027","84.25"
"Arkansas","0","4","Arkansas","5/29/20","2","2","05001","100"
"Ashley","0","19","Arkansas","5/29/20","19","0","05003","0"
"Baxter","0","9","Arkansas","5/29/20","6","3","05005","50"
"Benton","37","468","Arkansas","5/29/20","212","256","05007","120.75"
"Boone","0","6","Arkansas","5/29/20","5","1","05009","20"
"Bradley","0","18","Arkansas","5/29/20","16","2","05011","12.5"
"Carroll","2","24","Arkansas","5/29/20","9","15","05015","166.67"
"Chicot","0","15","Arkansas","5/29/20","12","3","05017","25"
"Clark","0","39","Arkansas","5/29/20","36","3","05019","8.33"
"Clay","0","4","Arkansas","5/29/20","4","0","05021","0"
"Cleburne","0","73","Arkansas","5/29/20","73","0","05023","0"
"Cleveland","0","19","Arkansas","5/29/20","18","1","05025","5.56"
"Columbia","0","21","Arkansas","5/29/20","20","1","05027","5"
"Conway","0","14","Arkansas","5/29/20","14","0","05029","0"
"Craighead","5","206","Arkansas","5/29/20","174","32","05031","18.39"
"Crawford","1","18","Arkansas","5/29/20","12","6","05033","50"
"Crittenden","9","341","Arkansas","5/29/20","276","65","05035","23.55"
"Cross","1","50","Arkansas","5/29/20","42","8","05037","19.05"
"Dallas","0","1","Arkansas","5/29/20","1","0","05039","0"
"Desha","0","19","Arkansas","5/29/20","18","1","05041","5.56"
"Drew","0","19","Arkansas","5/29/20","19","0","05043","0"
"Faulkner","1","102","Arkansas","5/29/20","98","4","05045","4.08"
"Franklin","0","4","Arkansas","5/29/20","2","2","05047","100"
"Fulton","0","7","Arkansas","5/29/20","6","1","05049","16.67"
"Garland","1","136","Arkansas","5/29/20","132","4","05051","3.03"
"Grant","0","18","Arkansas","5/29/20","16","2","05053","12.5"
"Greene","3","63","Arkansas","5/29/20","42","21","05055","50"
"Hempstead","1","15","Arkansas","5/29/20","11","4","05057","36.36"
"Hot Spring","0","32","Arkansas","5/29/20","29","3","05059","10.34"
"Howard","1","19","Arkansas","5/29/20","15","4","05061","26.67"
"Independence","0","30","Arkansas","5/29/20","27","3","05063","11.11"
"Izard","0","16","Arkansas","5/29/20","14","2","05065","14.29"
"Jackson","0","1","Arkansas","5/29/20","1","0","05067","0"
"Jefferson","2","516","Arkansas","5/29/20","501","15","05069","2.99"
"Johnson","1","42","Arkansas","5/29/20","36","6","05071","16.67"
"Lafayette","0","9","Arkansas","5/29/20","9","0","05073","0"
"Lawrence","0","82","Arkansas","5/29/20","81","1","05075","1.23"
"Lee","1","18","Arkansas","5/29/20","13","5","05077","38.46"
"Lincoln","1","975","Arkansas","5/29/20","966","9","05079","0.93"
"Little River","1","6","Arkansas","5/29/20","1","5","05081","500"
"Logan","0","5","Arkansas","5/29/20","4","1","05083","25"
"Lonoke","0","47","Arkansas","5/29/20","46","1","05085","2.17"
"Madison","1","13","Arkansas","5/29/20","3","10","05087","333.33"
"Marion","0","1","Arkansas","5/29/20","1","0","05089","0"
"Miller","0","42","Arkansas","5/29/20","42","0","05091","0"
"Mississippi","0","73","Arkansas","5/29/20","70","3","05093","4.29"
"Monroe","0","5","Arkansas","5/29/20","5","0","05095","0"
"Montgomery","0","2","Arkansas","5/29/20","1","1","05097","100"
"Nevada","0","5","Arkansas","5/29/20","4","1","05099","25"
"Newton","0","3","Arkansas","5/29/20","3","0","05101","0"
"Ouachita","0","10","Arkansas","5/29/20","10","0","05103","0"
"Perry","0","14","Arkansas","5/29/20","12","2","05105","16.67"
"Phillips","2","19","Arkansas","5/29/20","7","12","05107","171.43"
"Pike","0","5","Arkansas","5/29/20","4","1","05109","25"
"Poinsett","0","31","Arkansas","5/29/20","31","0","05111","0"
"Polk","1","17","Arkansas","5/29/20","9","8","05113","88.89"
"Pope","5","136","Arkansas","5/29/20","100","36","05115","36"
"Prairie","0","2","Arkansas","5/29/20","2","0","05117","0"
"Pulaski","12","846","Arkansas","5/29/20","761","85","05119","11.17"
"Randolph","0","26","Arkansas","5/29/20","25","1","05121","4"
"Saline","4","110","Arkansas","5/29/20","83","27","05125","32.53"
"Scott","0","1","Arkansas","5/29/20","1","0","05127","0"
"Searcy","0","7","Arkansas","5/29/20","6","1","05129","16.67"
"Sebastian","2","29","Arkansas","5/29/20","18","11","05131","61.11"
"Sevier","14","162","Arkansas","5/29/20","62","100","05133","161.29"
"Sharp","1","46","Arkansas","5/29/20","42","4","05135","9.52"
"St. Francis","6","664","Arkansas","5/29/20","621","43","05123","6.92"
"Stone","0","8","Arkansas","5/29/20","8","0","05137","0"
"Union","3","166","Arkansas","5/29/20","144","22","05139","15.28"
"Van Buren","0","28","Arkansas","5/29/20","28","0","05141","0"
"Washington","28","410","Arkansas","5/29/20","213","197","05143","92.49"
"White","1","43","Arkansas","5/29/20","37","6","05145","16.22"
"Woodruff","0","2","Arkansas","5/29/20","1","1","05147","100"
"Yell","7","128","Arkansas","5/29/20","76","52","05149","68.42"
"Alameda","70","3195","California","5/29/20","2708","487","06001","17.98"
"Alpine","0","2","California","5/29/20","2","0","06003","0"
"Amador","0","10","California","5/29/20","10","0","06005","0"
"Butte","1","44","California","5/29/20","34","10","06007","29.41"
"Calaveras","0","15","California","5/29/20","13","2","06009","15.38"
"Colusa","0","5","California","5/29/20","5","0","06011","0"
"Contra Costa","21","1404","California","5/29/20","1259","145","06013","11.52"
"Del Norte","3","44","California","5/29/20","20","24","06015","120"
"El Dorado","2","84","California","5/29/20","67","17","06017","25.37"
"Fresno","41","1658","California","5/29/20","1372","286","06019","20.85"
"Glenn","0","14","California","5/29/20","12","2","06021","16.67"
"Humboldt","1","98","California","5/29/20","88","10","06023","11.36"
"Imperial","80","1634","California","5/29/20","1076","558","06025","51.86"
"Inyo","0","20","California","5/29/20","19","1","06027","5.26"
"Kern","54","2076","California","5/29/20","1695","381","06029","22.48"
"Kings","32","714","California","5/29/20","488","226","06031","46.31"
"Lake","2","23","California","5/29/20","12","11","06033","91.67"
"Lassen","1","5","California","5/29/20","0","5","06035","1"
"Los Angeles","1230","51678","California","5/29/20","43070","8608","06037","19.99"
"Madera","2","98","California","5/29/20","83","15","06039","18.07"
"Marin","12","436","California","5/29/20","352","84","06041","23.86"
"Mariposa","0","16","California","5/29/20","15","1","06043","6.67"
"Mendocino","1","30","California","5/29/20","21","9","06045","42.86"
"Merced","4","280","California","5/29/20","251","29","06047","11.55"
"Mono","0","35","California","5/29/20","34","1","06051","2.94"
"Monterey","16","477","California","5/29/20","362","115","06053","31.77"
"Napa","2","111","California","5/29/20","96","15","06055","15.62"
"Nevada","0","41","California","5/29/20","41","0","06057","0"
"Orange","140","5923","California","5/29/20","4941","982","06059","19.87"
"Placer","2","199","California","5/29/20","184","15","06061","8.15"
"Plumas","0","4","California","5/29/20","4","0","06063","0"
"Riverside","146","7486","California","5/29/20","6464","1022","06065","15.81"
"Sacramento","14","1373","California","5/29/20","1272","101","06067","7.94"
"San Benito","3","85","California","5/29/20","66","19","06069","28.79"
"San Bernardino","127","5034","California","5/29/20","4146","888","06071","21.42"
"San Diego","112","7100","California","5/29/20","6315","785","06073","12.43"
"San Francisco","22","2473","California","5/29/20","2320","153","06075","6.59"
"San Joaquin","15","858","California","5/29/20","752","106","06077","14.1"
"San Luis Obispo","2","269","California","5/29/20","253","16","06079","6.32"
"San Mateo","40","2061","California","5/29/20","1783","278","06081","15.59"
"Santa Barbara","14","1636","California","5/29/20","1540","96","06083","6.23"
"Santa Clara","31","2707","California","5/29/20","2492","215","06085","8.63"
"Santa Cruz","3","206","California","5/29/20","186","20","06087","10.75"
"Shasta","0","37","California","5/29/20","34","3","06089","8.82"
"Sierra","0","1","California","5/29/20","1","0","06091","0"
"Siskiyou","0","7","California","5/29/20","6","1","06093","16.67"
"Solano","9","509","California","5/29/20","449","60","06095","13.36"
"Sonoma","12","531","California","5/29/20","444","87","06097","19.59"
"Stanislaus","10","683","California","5/29/20","611","72","06099","11.78"
"Sutter","0","42","California","5/29/20","40","2","06101","5"
"Tehama","0","4","California","5/29/20","3","1","06103","33.33"
"Trinity","0","1","California","5/29/20","1","0","06105","0"
"Tulare","29","1844","California","5/29/20","1641","203","06107","12.37"
"Tuolumne","0","4","California","5/29/20","2","2","06109","100"
"Ventura","26","1062","California","5/29/20","883","179","06111","20.27"
"Yolo","3","207","California","5/29/20","186","21","06113","11.29"
"Yuba","0","29","California","5/29/20","28","1","06115","3.57"
"Adams","49","3142","Colorado","5/29/20","2802","340","08001","12.13"
"Alamosa","2","65","Colorado","5/29/20","51","14","08003","27.45"
"Arapahoe","40","4254","Colorado","5/29/20","3974","280","08005","7.05"
"Archuleta","0","8","Colorado","5/29/20","8","0","08007","0"
"Baca","0","12","Colorado","5/29/20","12","0","08009","0"
"Bent","0","2","Colorado","5/29/20","2","0","08011","0"
"Boulder","9","964","Colorado","5/29/20","898","66","08013","7.35"
"Broomfield","2","232","Colorado","5/29/20","220","12","08014","5.45"
"Chaffee","0","72","Colorado","5/29/20","69","3","08015","4.35"
"Cheyenne","0","5","Colorado","5/29/20","5","0","08017","0"
"Clear Creek","0","16","Colorado","5/29/20","16","0","08019","0"
"Conejos","0","1","Colorado","5/29/20","1","0","08021","0"
"Costilla","0","5","Colorado","5/29/20","3","2","08023","66.67"
"Crowley","3","63","Colorado","5/29/20","44","19","08025","43.18"
"Custer","0","2","Colorado","5/29/20","2","0","08027","0"
"Delta","1","68","Colorado","5/29/20","61","7","08029","11.48"
"Denver","73","5569","Colorado","5/29/20","5056","513","08031","10.15"
"Douglas","5","705","Colorado","5/29/20","669","36","08035","5.38"
"Eagle","1","586","Colorado","5/29/20","577","9","08037","1.56"
"El Paso","31","1674","Colorado","5/29/20","1460","214","08041","14.66"
"Elbert","1","52","Colorado","5/29/20","48","4","08039","8.33"
"Fremont","0","26","Colorado","5/29/20","26","0","08043","0"
"Garfield","2","137","Colorado","5/29/20","120","17","08045","14.17"
"Gilpin","0","3","Colorado","5/29/20","3","0","08047","0"
"Grand","1","12","Colorado","5/29/20","5","7","08049","140"
"Gunnison","0","177","Colorado","5/29/20","177","0","08051","0"
"Hinsdale","0","3","Colorado","5/29/20","3","0","08053","0"
"Huerfano","0","3","Colorado","5/29/20","3","0","08055","0"
"Jefferson","25","2171","Colorado","5/29/20","1999","172","08059","8.6"
"Kit Carson","0","26","Colorado","5/29/20","26","0","08063","0"
"La Plata","1","80","Colorado","5/29/20","73","7","08067","9.59"
"Lake","0","29","Colorado","5/29/20","27","2","08065","7.41"
"Larimer","7","570","Colorado","5/29/20","520","50","08069","9.62"
"Las Animas","0","5","Colorado","5/29/20","5","0","08071","0"
"Lincoln","0","3","Colorado","5/29/20","3","0","08073","0"
"Logan","16","601","Colorado","5/29/20","491","110","08075","22.4"
"Mesa","1","54","Colorado","5/29/20","50","4","08077","8"
"Mineral","0","2","Colorado","5/29/20","2","0","08079","0"
"Moffat","0","7","Colorado","5/29/20","6","1","08081","16.67"
"Montezuma","1","39","Colorado","5/29/20","35","4","08083","11.43"
"Montrose","2","168","Colorado","5/29/20","152","16","08085","10.53"
"Morgan","5","623","Colorado","5/29/20","591","32","08087","5.41"
"Otero","1","18","Colorado","5/29/20","14","4","08089","28.57"
"Ouray","0","8","Colorado","5/29/20","7","1","08091","14.29"
"Park","0","23","Colorado","5/29/20","21","2","08093","9.52"
"Phillips","0","13","Colorado","5/29/20","10","3","08095","30"
"Pitkin","0","57","Colorado","5/29/20","57","0","08097","0"
"Prowers","0","13","Colorado","5/29/20","11","2","08099","18.18"
"Pueblo","7","281","Colorado","5/29/20","233","48","08101","20.6"
"Rio Blanco","0","1","Colorado","5/29/20","1","0","08103","0"
"Rio Grande","0","16","Colorado","5/29/20","15","1","08105","6.67"
"Routt","0","61","Colorado","5/29/20","59","2","08107","3.39"
"Saguache","4","48","Colorado","5/29/20","23","25","08109","108.7"
"San Juan","0","1","Colorado","5/29/20","1","0","08111","0"
"San Miguel","0","23","Colorado","5/29/20","23","0","08113","0"
"Summit","3","219","Colorado","5/29/20","197","22","08117","11.17"
"Teller","0","32","Colorado","5/29/20","32","0","08119","0"
"Washington","4","40","Colorado","5/29/20","15","25","08121","166.67"
"Weld","15","2472","Colorado","5/29/20","2367","105","08123","4.44"
"Yuma","3","36","Colorado","5/29/20","12","24","08125","200"
"Fairfield","74","15409","Connecticut","5/29/20","14889","520","09001","3.49"
"Hartford","98","10146","Connecticut","5/29/20","9463","683","09003","7.22"
"Litchfield","11","1375","Connecticut","5/29/20","1298","77","09005","5.93"
"Middlesex","14","1090","Connecticut","5/29/20","992","98","09007","9.88"
"New Haven","69","11241","Connecticut","5/29/20","10756","485","09009","4.51"
"New London","23","1068","Connecticut","5/29/20","910","158","09011","17.36"
"Tolland","4","827","Connecticut","5/29/20","796","31","09013","3.89"
"Windham","5","380","Connecticut","5/29/20","348","32","09015","9.2"
"Kent","15","1401","Delaware","5/29/20","1296","105","10001","8.1"
"New Castle","71","3629","Delaware","5/29/20","3132","497","10003","15.87"
"Sussex","15","4155","Delaware","5/29/20","4048","107","10005","2.64"
"","0","49","Diamond Princess","5/29/20","49","0",,"0"
"District of Columbia","92","8538","District of Columbia","5/29/20","7893","645","11001","8.17"
"Alachua","3","378","Florida","5/29/20","354","24","12001","6.78"
"Baker","0","28","Florida","5/29/20","26","2","12003","7.69"
"Bay","1","98","Florida","5/29/20","92","6","12005","6.52"
"Bradford","0","51","Florida","5/29/20","50","1","12007","2"
"Brevard","4","409","Florida","5/29/20","380","29","12009","7.63"
"Broward","56","6975","Florida","5/29/20","6580","395","12011","6"
"Calhoun","0","53","Florida","5/29/20","52","1","12013","1.92"
"Charlotte","5","446","Florida","5/29/20","412","34","12015","8.25"
"Citrus","0","120","Florida","5/29/20","118","2","12017","1.69"
"Clay","3","374","Florida","5/29/20","354","20","12019","5.65"
"Collier","42","1454","Florida","5/29/20","1160","294","12021","25.34"
"Columbia","3","140","Florida","5/29/20","121","19","12023","15.7"
"DeSoto","11","171","Florida","5/29/20","97","74","12027","76.29"
"Dixie","2","49","Florida","5/29/20","33","16","12029","48.48"
"Duval","26","1561","Florida","5/29/20","1376","185","12031","13.44"
"Escambia","7","791","Florida","5/29/20","740","51","12033","6.89"
"Flagler","1","182","Florida","5/29/20","173","9","12035","5.2"
"Franklin","0","2","Florida","5/29/20","2","0","12037","0"
"Gadsden","2","269","Florida","5/29/20","252","17","12039","6.75"
"Gilchrist","0","12","Florida","5/29/20","10","2","12041","20"
"Glades","1","27","Florida","5/29/20","19","8","12043","42.11"
"Gulf","0","1","Florida","5/29/20","1","0","12045","0"
"Hamilton","9","221","Florida","5/29/20","159","62","12047","38.99"
"Hardee","4","91","Florida","5/29/20","60","31","12049","51.67"
"Hendry","20","387","Florida","5/29/20","250","137","12051","54.8"
"Hernando","0","113","Florida","5/29/20","110","3","12053","2.73"
"Highlands","1","120","Florida","5/29/20","111","9","12055","8.11"
"Hillsborough","40","2069","Florida","5/29/20","1790","279","12057","15.59"
"Holmes","0","19","Florida","5/29/20","16","3","12059","18.75"
"Indian River","1","122","Florida","5/29/20","112","10","12061","8.93"
"Jackson","4","248","Florida","5/29/20","219","29","12063","13.24"
"Jefferson","0","29","Florida","5/29/20","29","0","12065","0"
"Lafayette","0","8","Florida","5/29/20","7","1","12067","14.29"
"Lake","4","291","Florida","5/29/20","266","25","12069","9.4"
"Lee","26","1847","Florida","5/29/20","1666","181","12071","10.86"
"Leon","10","401","Florida","5/29/20","329","72","12073","21.88"
"Levy","1","31","Florida","5/29/20","27","4","12075","14.81"
"Liberty","1","213","Florida","5/29/20","204","9","12077","4.41"
"Madison","0","69","Florida","5/29/20","66","3","12079","4.55"
"Manatee","11","1022","Florida","5/29/20","946","76","12081","8.03"
"Marion","1","243","Florida","5/29/20","233","10","12083","4.29"
"Martin","18","601","Florida","5/29/20","476","125","12085","26.26"
"Miami-Dade","160","17641","Florida","5/29/20","16522","1119","12086","6.77"
"Monroe","1","108","Florida","5/29/20","101","7","12087","6.93"
"Nassau","1","74","Florida","5/29/20","69","5","12089","7.25"
"Okaloosa","3","207","Florida","5/29/20","185","22","12091","11.89"
"Okeechobee","2","70","Florida","5/29/20","55","15","12093","27.27"
"Orange","29","1945","Florida","5/29/20","1744","201","12095","11.53"
"Osceola","6","688","Florida","5/29/20","644","44","12097","6.83"
"Palm Beach","99","5765","Florida","5/29/20","5072","693","12099","13.66"
"Pasco","6","377","Florida","5/29/20","338","39","12101","11.54"
"Pinellas","17","1238","Florida","5/29/20","1116","122","12103","10.93"
"Polk","20","977","Florida","5/29/20","840","137","12105","16.31"
"Putnam","2","149","Florida","5/29/20","138","11","12107","7.97"
"Santa Rosa","5","240","Florida","5/29/20","202","38","12113","18.81"
"Sarasota","8","622","Florida","5/29/20","565","57","12115","10.09"
"Seminole","5","481","Florida","5/29/20","449","32","12117","7.13"
"St. Johns","2","252","Florida","5/29/20","236","16","12109","6.78"
"St. Lucie","12","449","Florida","5/29/20","363","86","12111","23.69"
"Sumter","0","253","Florida","5/29/20","252","1","12119","0.4"
"Suwannee","0","166","Florida","5/29/20","164","2","12121","1.22"
"Taylor","1","19","Florida","5/29/20","10","9","12123","90"
"Union","0","31","Florida","5/29/20","28","3","12125","10.71"
"Volusia","12","725","Florida","5/29/20","640","85","12127","13.28"
"Wakulla","0","33","Florida","5/29/20","32","1","12129","3.12"
"Walton","2","114","Florida","5/29/20","100","14","12131","14"
"Washington","4","54","Florida","5/29/20","24","30","12133","125"
"Appling","5","156","Georgia","5/29/20","121","35","13001","28.93"
"Atkinson","3","46","Georgia","5/29/20","26","20","13003","76.92"
"Bacon","3","92","Georgia","5/29/20","73","19","13005","26.03"
"Baker","0","34","Georgia","5/29/20","32","2","13007","6.25"
"Baldwin","3","348","Georgia","5/29/20","329","19","13009","5.78"
"Banks","3","92","Georgia","5/29/20","73","19","13011","26.03"
"Barrow","6","325","Georgia","5/29/20","281","44","13013","15.66"
"Bartow","7","477","Georgia","5/29/20","427","50","13015","11.71"
"Ben Hill","2","72","Georgia","5/29/20","55","17","13017","30.91"
"Berrien","2","46","Georgia","5/29/20","34","12","13019","35.29"
"Bibb","4","451","Georgia","5/29/20","423","28","13021","6.62"
"Bleckley","1","45","Georgia","5/29/20","37","8","13023","21.62"
"Brantley","1","54","Georgia","5/29/20","48","6","13025","12.5"
"Brooks","0","69","Georgia","5/29/20","66","3","13027","4.55"
"Bryan","1","74","Georgia","5/29/20","68","6","13029","8.82"
"Bulloch","2","60","Georgia","5/29/20","49","11","13031","22.45"
"Burke","0","121","Georgia","5/29/20","120","1","13033","0.83"
"Butts","3","229","Georgia","5/29/20","206","23","13035","11.17"
"Calhoun","1","131","Georgia","5/29/20","123","8","13037","6.5"
"Camden","1","62","Georgia","5/29/20","53","9","13039","16.98"
"Candler","0","13","Georgia","5/29/20","12","1","13043","8.33"
"Carroll","11","519","Georgia","5/29/20","439","80","13045","18.22"
"Catoosa","5","129","Georgia","5/29/20","97","32","13047","32.99"
"Charlton","1","33","Georgia","5/29/20","28","5","13049","17.86"
"Chatham","9","491","Georgia","5/29/20","428","63","13051","14.72"
"Chattahoochee","3","39","Georgia","5/29/20","20","19","13053","95"
"Chattooga","0","24","Georgia","5/29/20","24","0","13055","0"
"Cherokee","14","885","Georgia","5/29/20","790","95","13057","12.03"
"Clarke","9","279","Georgia","5/29/20","219","60","13059","27.4"
"Clay","1","39","Georgia","5/29/20","34","5","13061","14.71"
"Clayton","21","1217","Georgia","5/29/20","1071","146","13063","13.63"
"Clinch","2","58","Georgia","5/29/20","46","12","13065","26.09"
"Cobb","47","2987","Georgia","5/29/20","2655","332","13067","12.5"
"Coffee","6","265","Georgia","5/29/20","225","40","13069","17.78"
"Colquitt","26","461","Georgia","5/29/20","280","181","13071","64.64"
"Columbia","4","248","Georgia","5/29/20","223","25","13073","11.21"
"Cook","1","48","Georgia","5/29/20","44","4","13075","9.09"
"Coweta","15","414","Georgia","5/29/20","311","103","13077","33.12"
"Crawford","1","28","Georgia","5/29/20","24","4","13079","16.67"
"Crisp","3","231","Georgia","5/29/20","210","21","13081","10"
"Dade","0","28","Georgia","5/29/20","26","2","13083","7.69"
"Dawson","1","109","Georgia","5/29/20","101","8","13085","7.92"
"Decatur","6","185","Georgia","5/29/20","145","40","13087","27.59"
"DeKalb","91","3718","Georgia","5/29/20","3080","638","13089","20.71"
"Dodge","0","51","Georgia","5/29/20","48","3","13091","6.25"
"Dooly","2","179","Georgia","5/29/20","164","15","13093","9.15"
"Dougherty","6","1764","Georgia","5/29/20","1723","41","13095","2.38"
"Douglas","9","539","Georgia","5/29/20","478","61","13097","12.76"
"Early","1","238","Georgia","5/29/20","234","4","13099","1.71"
"Echols","7","107","Georgia","5/29/20","59","48","13101","81.36"
"Effingham","2","75","Georgia","5/29/20","61","14","13103","22.95"
"Elbert","0","74","Georgia","5/29/20","71","3","13105","4.23"
"Emanuel","0","27","Georgia","5/29/20","26","1","13107","3.85"
"Evans","0","5","Georgia","5/29/20","5","0","13109","0"
"Fannin","1","43","Georgia","5/29/20","39","4","13111","10.26"
"Fayette","3","234","Georgia","5/29/20","215","19","13113","8.84"
"Floyd","5","260","Georgia","5/29/20","224","36","13115","16.07"
"Forsyth","10","512","Georgia","5/29/20","444","68","13117","15.32"
"Franklin","2","46","Georgia","5/29/20","35","11","13119","31.43"
"Fulton","80","4490","Georgia","5/29/20","3931","559","13121","14.22"
"Gilmer","3","148","Georgia","5/29/20","126","22","13123","17.46"
"Glascock","0","1","Georgia","5/29/20","1","0","13125","0"
"Glynn","5","115","Georgia","5/29/20","83","32","13127","38.55"
"Gordon","2","152","Georgia","5/29/20","136","16","13129","11.76"
"Grady","0","94","Georgia","5/29/20","93","1","13131","1.08"
"Greene","1","68","Georgia","5/29/20","63","5","13133","7.94"
"Gwinnett","110","3733","Georgia","5/29/20","2961","772","13135","26.07"
"Habersham","6","519","Georgia","5/29/20","479","40","13137","8.35"
"Hall","28","2465","Georgia","5/29/20","2269","196","13139","8.64"
"Hancock","3","194","Georgia","5/29/20","175","19","13141","10.86"
"Haralson","1","43","Georgia","5/29/20","36","7","13143","19.44"
"Harris","2","91","Georgia","5/29/20","79","12","13145","15.19"
"Hart","0","28","Georgia","5/29/20","26","2","13147","7.69"
"Heard","1","32","Georgia","5/29/20","26","6","13149","23.08"
"Henry","8","686","Georgia","5/29/20","627","59","13151","9.41"
"Houston","4","364","Georgia","5/29/20","339","25","13153","7.37"
"Irwin","1","29","Georgia","5/29/20","23","6","13155","26.09"
"Jackson","6","184","Georgia","5/29/20","145","39","13157","26.9"
"Jasper","0","33","Georgia","5/29/20","31","2","13159","6.45"
"Jeff Davis","1","38","Georgia","5/29/20","31","7","13161","22.58"
"Jefferson","1","36","Georgia","5/29/20","26","10","13163","38.46"
"Jenkins","0","19","Georgia","5/29/20","18","1","13165","5.56"
"Johnson","1","82","Georgia","5/29/20","78","4","13167","5.13"
"Jones","0","35","Georgia","5/29/20","32","3","13169","9.38"
"Lamar","2","67","Georgia","5/29/20","50","17","13171","34"
"Lanier","1","21","Georgia","5/29/20","12","9","13173","75"
"Laurens","1","104","Georgia","5/29/20","96","8","13175","8.33"
"Lee","3","361","Georgia","5/29/20","342","19","13177","5.56"
"Liberty","3","81","Georgia","5/29/20","63","18","13179","28.57"
"Lincoln","0","16","Georgia","5/29/20","15","1","13181","6.67"
"Long","0","15","Georgia","5/29/20","12","3","13183","25"
"Lowndes","9","298","Georgia","5/29/20","232","66","13185","28.45"
"Lumpkin","2","99","Georgia","5/29/20","88","11","13187","12.5"
"Macon","1","100","Georgia","5/29/20","96","4","13193","4.17"
"Madison","3","54","Georgia","5/29/20","32","22","13195","68.75"
"Marion","1","57","Georgia","5/29/20","48","9","13197","18.75"
"McDuffie","1","67","Georgia","5/29/20","62","5","13189","8.06"
"McIntosh","1","16","Georgia","5/29/20","11","5","13191","45.45"
"Meriwether","1","84","Georgia","5/29/20","78","6","13199","7.69"
"Miller","0","41","Georgia","5/29/20","38","3","13201","7.89"
"Mitchell","2","409","Georgia","5/29/20","397","12","13205","3.02"
"Monroe","1","120","Georgia","5/29/20","114","6","13207","5.26"
"Montgomery","0","9","Georgia","5/29/20","8","1","13209","12.5"
"Morgan","0","37","Georgia","5/29/20","35","2","13211","5.71"
"Murray","2","86","Georgia","5/29/20","72","14","13213","19.44"
"Muscogee","13","602","Georgia","5/29/20","509","93","13215","18.27"
"Newton","9","351","Georgia","5/29/20","286","65","13217","22.73"
"Oconee","2","116","Georgia","5/29/20","103","13","13219","12.62"
"Oglethorpe","0","60","Georgia","5/29/20","58","2","13221","3.45"
"Out of GA","32","1975","Georgia","5/29/20","1748","227","80013","12.99"
"Paulding","7","320","Georgia","5/29/20","273","47","13223","17.22"
"Peach","0","72","Georgia","5/29/20","70","2","13225","2.86"
"Pickens","1","47","Georgia","5/29/20","41","6","13227","14.63"
"Pierce","1","98","Georgia","5/29/20","88","10","13229","11.36"
"Pike","1","54","Georgia","5/29/20","48","6","13231","12.5"
"Polk","4","118","Georgia","5/29/20","93","25","13233","26.88"
"Pulaski","1","42","Georgia","5/29/20","38","4","13235","10.53"
"Putnam","1","89","Georgia","5/29/20","84","5","13237","5.95"
"Quitman","0","12","Georgia","5/29/20","10","2","13239","20"
"Rabun","1","20","Georgia","5/29/20","15","5","13241","33.33"
"Randolph","1","179","Georgia","5/29/20","170","9","13243","5.29"
"Richmond","10","595","Georgia","5/29/20","523","72","13245","13.77"
"Rockdale","4","283","Georgia","5/29/20","257","26","13247","10.12"
"Schley","0","16","Georgia","5/29/20","16","0","13249","0"
"Screven","4","50","Georgia","5/29/20","25","25","13251","100"
"Seminole","0","44","Georgia","5/29/20","42","2","13253","4.76"
"Spalding","4","275","Georgia","5/29/20","250","25","13255","10"
"Stephens","2","138","Georgia","5/29/20","122","16","13257","13.11"
"Stewart","2","52","Georgia","5/29/20","40","12","13259","30"
"Sumter","6","476","Georgia","5/29/20","436","40","13261","9.17"
"Talbot","1","38","Georgia","5/29/20","34","4","13263","11.76"
"Taliaferro","0","1","Georgia","5/29/20","1","0","13265","0"
"Tattnall","1","23","Georgia","5/29/20","13","10","13267","76.92"
"Taylor","0","23","Georgia","5/29/20","21","2","13269","9.52"
"Telfair","1","37","Georgia","5/29/20","32","5","13271","15.62"
"Terrell","1","213","Georgia","5/29/20","209","4","13273","1.91"
"Thomas","2","324","Georgia","5/29/20","308","16","13275","5.19"
"Tift","6","255","Georgia","5/29/20","212","43","13277","20.28"
"Toombs","1","56","Georgia","5/29/20","50","6","13279","12"
"Towns","0","24","Georgia","5/29/20","22","2","13281","9.09"
"Treutlen","0","9","Georgia","5/29/20","8","1","13283","12.5"
"Troup","8","292","Georgia","5/29/20","238","54","13285","22.69"
"Turner","3","115","Georgia","5/29/20","92","23","13287","25"
"Twiggs","1","15","Georgia","5/29/20","11","4","13289","36.36"
"Union","1","44","Georgia","5/29/20","39","5","13291","12.82"
"Upson","1","280","Georgia","5/29/20","271","9","13293","3.32"
"Walker","6","138","Georgia","5/29/20","94","44","13295","46.81"
"Walton","11","261","Georgia","5/29/20","186","75","13297","40.32"
"Ware","4","229","Georgia","5/29/20","201","28","13299","13.93"
"Warren","0","18","Georgia","5/29/20","17","1","13301","5.88"
"Washington","0","74","Georgia","5/29/20","72","2","13303","2.78"
"Wayne","1","19","Georgia","5/29/20","15","4","13305","26.67"
"Webster","0","12","Georgia","5/29/20","11","1","13307","9.09"
"Wheeler","1","13","Georgia","5/29/20","9","4","13309","44.44"
"White","1","101","Georgia","5/29/20","92","9","13311","9.78"
"Whitfield","12","331","Georgia","5/29/20","249","82","13313","32.93"
"Wilcox","2","109","Georgia","5/29/20","98","11","13315","11.22"
"Wilkes","0","33","Georgia","5/29/20","32","1","13317","3.12"
"Wilkinson","1","69","Georgia","5/29/20","63","6","13319","9.52"
"Worth","1","209","Georgia","5/29/20","204","5","13321","2.45"
"","0","103","Grand Princess","5/29/20","103","0",,"0"
"","1","172","Guam","5/29/20","165","7",,"4.24"
"Hawaii","0","82","Hawaii","5/29/20","81","1","15001","1.23"
"Honolulu","1","419","Hawaii","5/29/20","414","5","15003","1.21"
"Kauai","0","20","Hawaii","5/29/20","20","0","15007","0"
"Maui","0","118","Hawaii","5/29/20","117","1","15009","0.85"
"Out of HI","0","10","Hawaii","5/29/20","10","0","80015","0"
"Ada","1","803","Idaho","5/29/20","794","9","16001","1.13"
"Adams","0","3","Idaho","5/29/20","3","0","16003","0"
"Bannock","1","24","Idaho","5/29/20","17","7","16005","41.18"
"Benewah","1","9","Idaho","5/29/20","0","9","16009","1"
"Bingham","0","6","Idaho","5/29/20","6","0","16011","0"
"Blaine","0","512","Idaho","5/29/20","510","2","16013","0.39"
"Bonner","0","4","Idaho","5/29/20","4","0","16017","0"
"Bonneville","1","37","Idaho","5/29/20","32","5","16019","15.62"
"Camas","0","1","Idaho","5/29/20","1","0","16025","0"
"Canyon","1","294","Idaho","5/29/20","284","10","16027","3.52"
"Caribou","0","1","Idaho","5/29/20","1","0","16029","0"
"Cassia","5","56","Idaho","5/29/20","22","34","16031","154.55"
"Custer","0","2","Idaho","5/29/20","2","0","16037","0"
"Elmore","0","31","Idaho","5/29/20","31","0","16039","0"
"Fremont","0","3","Idaho","5/29/20","3","0","16043","0"
"Gem","0","17","Idaho","5/29/20","17","0","16045","0"
"Gooding","2","46","Idaho","5/29/20","35","11","16047","31.43"
"Idaho","0","3","Idaho","5/29/20","3","0","16049","0"
"Jefferson","0","7","Idaho","5/29/20","7","0","16051","0"
"Jerome","3","161","Idaho","5/29/20","137","24","16053","17.52"
"Kootenai","0","67","Idaho","5/29/20","66","1","16055","1.52"
"Latah","0","7","Idaho","5/29/20","7","0","16057","0"
"Lemhi","0","1","Idaho","5/29/20","1","0","16059","0"
"Lincoln","0","33","Idaho","5/29/20","30","3","16063","10"
"Madison","0","21","Idaho","5/29/20","20","1","16065","5"
"Minidoka","3","45","Idaho","5/29/20","26","19","16067","73.08"
"Nez Perce","0","82","Idaho","5/29/20","81","1","16069","1.23"
"Owyhee","0","8","Idaho","5/29/20","8","0","16073","0"
"Payette","0","23","Idaho","5/29/20","23","0","16075","0"
"Power","0","3","Idaho","5/29/20","3","0","16077","0"
"Teton","0","11","Idaho","5/29/20","11","0","16081","0"
"Twin Falls","5","410","Idaho","5/29/20","374","36","16083","9.63"
"Valley","0","2","Idaho","5/29/20","2","0","16085","0"
"Washington","0","36","Idaho","5/29/20","34","2","16087","5.88"
"Adams","0","44","Illinois","5/29/20","44","0","17001","0"
"Alexander","0","8","Illinois","5/29/20","8","0","17003","0"
"Bond","0","12","Illinois","5/29/20","10","2","17005","20"
"Boone","9","428","Illinois","5/29/20","368","60","17007","16.3"
"Brown","0","10","Illinois","5/29/20","10","0","17009","0"
"Bureau","0","15","Illinois","5/29/20","15","0","17011","0"
"Calhoun","0","1","Illinois","5/29/20","1","0","17013","0"
"Carroll","0","14","Illinois","5/29/20","13","1","17015","7.69"
"Cass","1","71","Illinois","5/29/20","67","4","17017","5.97"
"Champaign","15","617","Illinois","5/29/20","515","102","17019","19.81"
"Christian","0","33","Illinois","5/29/20","32","1","17021","3.12"
"Clark","0","11","Illinois","5/29/20","10","1","17023","10"
"Clay","0","2","Illinois","5/29/20","2","0","17025","0"
"Clinton","1","181","Illinois","5/29/20","173","8","17027","4.62"
"Coles","4","125","Illinois","5/29/20","95","30","17029","31.58"
"Cook","1045","76266","Illinois","5/29/20","68949","7317","17031","10.61"
"Crawford","0","11","Illinois","5/29/20","11","0","17033","0"
"Cumberland","0","10","Illinois","5/29/20","10","0","17035","0"
"De Witt","0","4","Illinois","5/29/20","4","0","17039","0"
"DeKalb","13","392","Illinois","5/29/20","299","93","17037","31.1"
"Douglas","0","26","Illinois","5/29/20","27","-1","17041","-3.7"
"DuPage","114","7543","Illinois","5/29/20","6744","799","17043","11.85"
"Edgar","0","1","Illinois","5/29/20","0","1","17045","1"
"Edwards","0","2","Illinois","5/29/20","2","0","17047","0"
"Effingham","0","7","Illinois","5/29/20","6","1","17049","16.67"
"Fayette","0","20","Illinois","5/29/20","19","1","17051","5.26"
"Ford","0","20","Illinois","5/29/20","19","1","17053","5.26"
"Franklin","0","12","Illinois","5/29/20","11","1","17055","9.09"
"Fulton","0","11","Illinois","5/29/20","10","1","17057","10"
"Gallatin","0","2","Illinois","5/29/20","2","0","17059","0"
"Greene","0","5","Illinois","5/29/20","5","0","17061","0"
"Grundy","2","95","Illinois","5/29/20","84","11","17063","13.1"
"Hamilton","0","2","Illinois","5/29/20","2","0","17065","0"
"Hancock","0","16","Illinois","5/29/20","13","3","17067","23.08"
"Hardin","0","1","Illinois","5/29/20","1","0","17069","0"
"Henderson","0","8","Illinois","5/29/20","8","0","17071","0"
"Henry","0","68","Illinois","5/29/20","65","3","17073","4.62"
"Iroquois","1","131","Illinois","5/29/20","124","7","17075","5.65"
"Jackson","10","268","Illinois","5/29/20","197","71","17077","36.04"
"Jasper","0","45","Illinois","5/29/20","45","0","17079","0"
"Jefferson","0","101","Illinois","5/29/20","99","2","17081","2.02"
"Jersey","0","20","Illinois","5/29/20","20","0","17083","0"
"Jo Daviess","1","32","Illinois","5/29/20","24","8","17085","33.33"
"Johnson","0","7","Illinois","5/29/20","7","0","17087","0"
"Kane","123","6188","Illinois","5/29/20","5327","861","17089","16.16"
"Kankakee","17","871","Illinois","5/29/20","753","118","17091","15.67"
"Kendall","14","769","Illinois","5/29/20","673","96","17093","14.26"
"Knox","1","97","Illinois","5/29/20","93","4","17095","4.3"
"Lake","110","8063","Illinois","5/29/20","7291","772","17097","10.59"
"LaSalle","2","147","Illinois","5/29/20","130","17","17099","13.08"
"Lawrence","0","4","Illinois","5/29/20","4","0","17101","0"
"Lee","1","79","Illinois","5/29/20","75","4","17103","5.33"
"Livingston","0","32","Illinois","5/29/20","30","2","17105","6.67"
"Logan","0","10","Illinois","5/29/20","10","0","17107","0"
"Macon","2","195","Illinois","5/29/20","184","11","17115","5.98"
"Macoupin","1","45","Illinois","5/29/20","41","4","17117","9.76"
"Madison","7","565","Illinois","5/29/20","516","49","17119","9.5"
"Marion","0","50","Illinois","5/29/20","50","0","17121","0"
"Marshall","0","5","Illinois","5/29/20","5","0","17123","0"
"Mason","0","18","Illinois","5/29/20","16","2","17125","12.5"
"Massac","0","7","Illinois","5/29/20","7","0","17127","0"
"McDonough","2","87","Illinois","5/29/20","75","12","17109","16"
"McHenry","27","1514","Illinois","5/29/20","1323","191","17111","14.44"
"McLean","3","217","Illinois","5/29/20","195","22","17113","11.28"
"Menard","1","21","Illinois","5/29/20","17","4","17129","23.53"
"Mercer","0","17","Illinois","5/29/20","14","3","17131","21.43"
"Monroe","0","94","Illinois","5/29/20","91","3","17133","3.3"
"Montgomery","0","39","Illinois","5/29/20","38","1","17135","2.63"
"Morgan","0","35","Illinois","5/29/20","34","1","17137","2.94"
"Moultrie","0","11","Illinois","5/29/20","8","3","17139","37.5"
"Ogle","2","202","Illinois","5/29/20","185","17","17141","9.19"
"Out of IL","1","119","Illinois","5/29/20","112","7","80017","6.25"
"Peoria","5","212","Illinois","5/29/20","176","36","17143","20.45"
"Perry","0","42","Illinois","5/29/20","40","2","17145","5"
"Piatt","0","12","Illinois","5/29/20","9","3","17147","33.33"
"Pike","0","1","Illinois","5/29/20","1","0","17149","0"
"Pope","0","1","Illinois","5/29/20","1","0","17151","0"
"Pulaski","2","51","Illinois","5/29/20","40","11","17153","27.5"
"Putnam","0","1","Illinois","5/29/20","1","0","17155","0"
"Randolph","2","267","Illinois","5/29/20","251","16","17157","6.37"
"Richland","0","3","Illinois","5/29/20","3","0","17159","0"
"Rock Island","4","646","Illinois","5/29/20","617","29","17161","4.7"
"Saline","0","7","Illinois","5/29/20","6","1","17165","16.67"
"Sangamon","3","346","Illinois","5/29/20","325","21","17167","6.46"
"Schuyler","0","12","Illinois","5/29/20","9","3","17169","33.33"
"Shelby","0","16","Illinois","5/29/20","15","1","17173","6.67"
"St. Clair","26","1091","Illinois","5/29/20","907","184","17163","20.29"
"Stark","0","3","Illinois","5/29/20","3","0","17175","0"
"Stephenson","4","199","Illinois","5/29/20","173","26","17177","15.03"
"Tazewell","1","71","Illinois","5/29/20","66","5","17179","7.58"
"Union","2","151","Illinois","5/29/20","136","15","17181","11.03"
"Vermilion","0","39","Illinois","5/29/20","39","0","17183","0"
"Wabash","0","2","Illinois","5/29/20","1","1","17185","100"
"Warren","0","113","Illinois","5/29/20","112","1","17187","0.89"
"Washington","0","18","Illinois","5/29/20","18","0","17189","0"
"Wayne","0","9","Illinois","5/29/20","9","0","17191","0"
"White","0","2","Illinois","5/29/20","2","0","17193","0"
"Whiteside","1","135","Illinois","5/29/20","131","4","17195","3.05"
"Will","73","5442","Illinois","5/29/20","4929","513","17197","10.41"
"Williamson","1","64","Illinois","5/29/20","54","10","17199","18.52"
"Winnebago","54","2156","Illinois","5/29/20","1780","376","17201","21.12"
"Woodford","0","19","Illinois","5/29/20","17","2","17203","11.76"
"Adams","0","13","Indiana","5/29/20","11","2","18001","18.18"
"Allen","37","1451","Indiana","5/29/20","1191","260","18003","21.83"
"Bartholomew","6","500","Indiana","5/29/20","456","44","18005","9.65"
"Benton","1","30","Indiana","5/29/20","24","6","18007","25"
"Blackford","1","24","Indiana","5/29/20","18","6","18009","33.33"
"Boone","4","309","Indiana","5/29/20","278","31","18011","11.15"
"Brown","0","33","Indiana","5/29/20","33","0","18013","0"
"Carroll","1","92","Indiana","5/29/20","87","5","18015","5.75"
"Cass","2","1589","Indiana","5/29/20","1578","11","18017","0.7"
"Clark","7","492","Indiana","5/29/20","446","46","18019","10.31"
"Clay","2","47","Indiana","5/29/20","36","11","18021","30.56"
"Clinton","4","223","Indiana","5/29/20","194","29","18023","14.95"
"Crawford","0","24","Indiana","5/29/20","23","1","18025","4.35"
"Daviess","2","85","Indiana","5/29/20","73","12","18027","16.44"
"Dearborn","1","166","Indiana","5/29/20","161","5","18029","3.11"
"Decatur","1","224","Indiana","5/29/20","220","4","18031","1.82"
"DeKalb","1","33","Indiana","5/29/20","26","7","18033","26.92"
"Delaware","7","377","Indiana","5/29/20","328","49","18035","14.94"
"Dubois","3","192","Indiana","5/29/20","171","21","18037","12.28"
"Elkhart","37","1163","Indiana","5/29/20","903","260","18039","28.79"
"Fayette","4","76","Indiana","5/29/20","50","26","18041","52"
"Floyd","1","318","Indiana","5/29/20","311","7","18043","2.25"
"Fountain","0","20","Indiana","5/29/20","17","3","18045","17.65"
"Franklin","0","109","Indiana","5/29/20","106","3","18047","2.83"
"Fulton","0","48","Indiana","5/29/20","46","2","18049","4.35"
"Gibson","0","14","Indiana","5/29/20","13","1","18051","7.69"
"Grant","5","206","Indiana","5/29/20","174","32","18053","18.39"
"Greene","0","168","Indiana","5/29/20","167","1","18055","0.6"
"Hamilton","10","1156","Indiana","5/29/20","1084","72","18057","6.64"
"Hancock","2","327","Indiana","5/29/20","312","15","18059","4.81"
"Harrison","2","192","Indiana","5/29/20","179","13","18061","7.26"
"Hendricks","9","1161","Indiana","5/29/20","1095","66","18063","6.03"
"Henry","2","169","Indiana","5/29/20","153","16","18065","10.46"
"Howard","8","395","Indiana","5/29/20","339","56","18067","16.52"
"Huntington","1","27","Indiana","5/29/20","20","7","18069","35"
"Jackson","4","379","Indiana","5/29/20","351","28","18071","7.98"
"Jasper","2","65","Indiana","5/29/20","50","15","18073","30"
"Jay","2","50","Indiana","5/29/20","38","12","18075","31.58"
"Jefferson","0","43","Indiana","5/29/20","41","2","18077","4.88"
"Jennings","1","130","Indiana","5/29/20","125","5","18079","4"
"Johnson","6","1093","Indiana","5/29/20","1052","41","18081","3.9"
"Knox","1","29","Indiana","5/29/20","23","6","18083","26.09"
"Kosciusko","6","111","Indiana","5/29/20","71","40","18085","56.34"
"LaGrange","2","71","Indiana","5/29/20","58","13","18087","22.41"
"Lake","59","3538","Indiana","5/29/20","3128","410","18089","13.11"
"LaPorte","7","424","Indiana","5/29/20","376","48","18091","12.77"
"Lawrence","2","154","Indiana","5/29/20","141","13","18093","9.22"
"Madison","1","585","Indiana","5/29/20","576","9","18095","1.56"
"Marion","98","9616","Indiana","5/29/20","8928","688","18097","7.71"
"Marshall","5","90","Indiana","5/29/20","54","36","18099","66.67"
"Martin","0","11","Indiana","5/29/20","8","3","18101","37.5"
"Miami","1","141","Indiana","5/29/20","134","7","18103","5.22"
"Monroe","1","166","Indiana","5/29/20","157","9","18105","5.73"
"Montgomery","5","235","Indiana","5/29/20","202","33","18107","16.34"
"Morgan","4","278","Indiana","5/29/20","253","25","18109","9.88"
"Newton","1","77","Indiana","5/29/20","72","5","18111","6.94"
"Noble","6","211","Indiana","5/29/20","167","44","18113","26.35"
"Ohio","0","13","Indiana","5/29/20","13","0","18115","0"
"Orange","0","125","Indiana","5/29/20","122","3","18117","2.46"
"Owen","1","34","Indiana","5/29/20","29","5","18119","17.24"
"Parke","0","17","Indiana","5/29/20","17","0","18121","0"
"Perry","1","31","Indiana","5/29/20","22","9","18123","40.91"
"Pike","0","6","Indiana","5/29/20","5","1","18125","20"
"Porter","8","516","Indiana","5/29/20","458","58","18127","12.66"
"Posey","0","16","Indiana","5/29/20","16","0","18129","0"
"Pulaski","1","46","Indiana","5/29/20","37","9","18131","24.32"
"Putnam","1","136","Indiana","5/29/20","127","9","18133","7.09"
"Randolph","2","46","Indiana","5/29/20","35","11","18135","31.43"
"Ripley","0","108","Indiana","5/29/20","110","-2","18137","-1.82"
"Rush","0","46","Indiana","5/29/20","44","2","18139","4.55"
"Scott","2","119","Indiana","5/29/20","106","13","18143","12.26"
"Shelby","8","368","Indiana","5/29/20","309","59","18145","19.09"
"Spencer","1","19","Indiana","5/29/20","14","5","18147","35.71"
"St. Joseph","22","1248","Indiana","5/29/20","1097","151","18141","13.76"
"Starke","1","36","Indiana","5/29/20","30","6","18149","20"
"Steuben","1","81","Indiana","5/29/20","77","4","18151","5.19"
"Sullivan","0","34","Indiana","5/29/20","31","3","18153","9.68"
"Switzerland","0","20","Indiana","5/29/20","19","1","18155","5.26"
"Tippecanoe","6","390","Indiana","5/29/20","348","42","18157","12.07"
"Tipton","1","25","Indiana","5/29/20","21","4","18159","19.05"
"Union","0","8","Indiana","5/29/20","8","0","18161","0"
"Vanderburgh","5","265","Indiana","5/29/20","230","35","18163","15.22"
"Vermillion","0","10","Indiana","5/29/20","8","2","18165","25"
"Vigo","5","164","Indiana","5/29/20","131","33","18167","25.19"
"Wabash","1","76","Indiana","5/29/20","71","5","18169","7.04"
"Warren","0","12","Indiana","5/29/20","12","0","18171","0"
"Warrick","1","166","Indiana","5/29/20","158","8","18173","5.06"
"Washington","0","52","Indiana","5/29/20","52","0","18175","0"
"Wayne","2","77","Indiana","5/29/20","65","12","18177","18.46"
"Wells","1","28","Indiana","5/29/20","22","6","18179","27.27"
"White","4","231","Indiana","5/29/20","206","25","18181","12.14"
"Whitley","1","39","Indiana","5/29/20","31","8","18183","25.81"
"Adair","0","9","Iowa","5/29/20","6","3","19001","50"
"Adams","0","7","Iowa","5/29/20","4","3","19003","75"
"Allamakee","0","120","Iowa","5/29/20","118","2","19005","1.69"
"Appanoose","1","14","Iowa","5/29/20","8","6","19007","75"
"Audubon","0","12","Iowa","5/29/20","11","1","19009","9.09"
"Benton","0","40","Iowa","5/29/20","37","3","19011","8.11"
"Black Hawk","10","1730","Iowa","5/29/20","1662","68","19013","4.09"
"Boone","1","58","Iowa","5/29/20","52","6","19015","11.54"
"Bremer","1","69","Iowa","5/29/20","65","4","19017","6.15"
"Buchanan","0","32","Iowa","5/29/20","31","1","19019","3.23"
"Buena Vista","83","721","Iowa","5/29/20","140","581","19021","415"
"Butler","0","15","Iowa","5/29/20","15","0","19023","0"
"Calhoun","0","2","Iowa","5/29/20","2","0","19025","0"
"Carroll","0","9","Iowa","5/29/20","8","1","19027","12.5"
"Cass","1","12","Iowa","5/29/20","6","6","19029","100"
"Cedar","0","46","Iowa","5/29/20","44","2","19031","4.55"
"Cerro Gordo","1","27","Iowa","5/29/20","20","7","19033","35"
"Cherokee","2","27","Iowa","5/29/20","10","17","19035","170"
"Chickasaw","0","10","Iowa","5/29/20","8","2","19037","25"
"Clarke","3","50","Iowa","5/29/20","29","21","19039","72.41"
"Clay","1","13","Iowa","5/29/20","9","4","19041","44.44"
"Clayton","0","33","Iowa","5/29/20","30","3","19043","10"
"Clinton","0","60","Iowa","5/29/20","61","-1","19045","-1.64"
"Crawford","8","501","Iowa","5/29/20","445","56","19047","12.58"
"Dallas","9","886","Iowa","5/29/20","821","65","19049","7.92"
"Davis","0","20","Iowa","5/29/20","17","3","19051","17.65"
"Decatur","0","1","Iowa","5/29/20","0","1","19053","1"
"Delaware","0","15","Iowa","5/29/20","14","1","19055","7.14"
"Des Moines","1","62","Iowa","5/29/20","52","10","19057","19.23"
"Dickinson","2","19","Iowa","5/29/20","8","11","19059","137.5"
"Dubuque","5","341","Iowa","5/29/20","307","34","19061","11.07"
"Emmet","1","13","Iowa","5/29/20","7","6","19063","85.71"
"Fayette","0","26","Iowa","5/29/20","26","0","19065","0"
"Floyd","1","19","Iowa","5/29/20","15","4","19067","26.67"
"Franklin","1","12","Iowa","5/29/20","7","5","19069","71.43"
"Fremont","0","4","Iowa","5/29/20","4","0","19071","0"
"Greene","0","13","Iowa","5/29/20","13","0","19073","0"
"Grundy","0","20","Iowa","5/29/20","20","0","19075","0"
"Guthrie","1","50","Iowa","5/29/20","42","8","19077","19.05"
"Hamilton","2","30","Iowa","5/29/20","15","15","19079","100"
"Hancock","1","16","Iowa","5/29/20","11","5","19081","45.45"
"Hardin","0","16","Iowa","5/29/20","13","3","19083","23.08"
"Harrison","0","21","Iowa","5/29/20","18","3","19085","16.67"
"Henry","2","70","Iowa","5/29/20","56","14","19087","25"
"Howard","0","12","Iowa","5/29/20","12","0","19089","0"
"Humboldt","1","16","Iowa","5/29/20","10","6","19091","60"
"Ida","1","14","Iowa","5/29/20","8","6","19093","75"
"Iowa","0","34","Iowa","5/29/20","35","-1","19095","-2.86"
"Jackson","0","12","Iowa","5/29/20","9","3","19097","33.33"
"Jasper","1","260","Iowa","5/29/20","250","10","19099","4"
"Jefferson","1","21","Iowa","5/29/20","14","7","19101","50"
"Johnson","3","610","Iowa","5/29/20","591","19","19103","3.21"
"Jones","0","36","Iowa","5/29/20","36","0","19105","0"
"Keokuk","0","14","Iowa","5/29/20","13","1","19107","7.69"
"Kossuth","0","9","Iowa","5/29/20","7","2","19109","28.57"
"Lee","1","25","Iowa","5/29/20","20","5","19111","25"
"Linn","4","945","Iowa","5/29/20","916","29","19113","3.17"
"Louisa","2","341","Iowa","5/29/20","327","14","19115","4.28"
"Lucas","1","13","Iowa","5/29/20","4","9","19117","225"
"Lyon","0","20","Iowa","5/29/20","19","1","19119","5.26"
"Madison","1","27","Iowa","5/29/20","21","6","19121","28.57"
"Mahaska","6","92","Iowa","5/29/20","48","44","19123","91.67"
"Marion","1","32","Iowa","5/29/20","28","4","19125","14.29"
"Marshall","6","891","Iowa","5/29/20","852","39","19127","4.58"
"Mills","0","16","Iowa","5/29/20","14","2","19129","14.29"
"Mitchell","0","5","Iowa","5/29/20","4","1","19131","25"
"Monona","1","24","Iowa","5/29/20","19","5","19133","26.32"
"Monroe","1","38","Iowa","5/29/20","29","9","19135","31.03"
"Montgomery","0","6","Iowa","5/29/20","5","1","19137","20"
"Muscatine","2","554","Iowa","5/29/20","540","14","19139","2.59"
"O'Brien","1","28","Iowa","5/29/20","24","4","19141","16.67"
"Osceola","0","32","Iowa","5/29/20","30","2","19143","6.67"
"Page","0","11","Iowa","5/29/20","10","1","19145","10"
"Palo Alto","0","6","Iowa","5/29/20","3","3","19147","100"
"Plymouth","4","127","Iowa","5/29/20","101","26","19149","25.74"
"Pocahontas","1","11","Iowa","5/29/20","3","8","19151","266.67"
"Polk","77","4056","Iowa","5/29/20","3518","538","19153","15.29"
"Pottawattamie","7","244","Iowa","5/29/20","196","48","19155","24.49"
"Poweshiek","0","89","Iowa","5/29/20","87","2","19157","2.3"
"Ringgold","0","4","Iowa","5/29/20","2","2","19159","100"
"Sac","1","18","Iowa","5/29/20","8","10","19161","125"
"Scott","4","357","Iowa","5/29/20","329","28","19163","8.51"
"Shelby","1","35","Iowa","5/29/20","28","7","19165","25"
"Sioux","4","214","Iowa","5/29/20","188","26","19167","13.83"
"Story","2","105","Iowa","5/29/20","88","17","19169","19.32"
"Tama","3","401","Iowa","5/29/20","383","18","19171","4.7"
"Taylor","6","51","Iowa","5/29/20","6","45","19173","750"
"Union","0","7","Iowa","5/29/20","5","2","19175","40"
"Van Buren","0","9","Iowa","5/29/20","8","1","19177","12.5"
"Wapello","13","556","Iowa","5/29/20","462","94","19179","20.35"
"Warren","3","121","Iowa","5/29/20","97","24","19181","24.74"
"Washington","1","187","Iowa","5/29/20","178","9","19183","5.06"
"Wayne","0","1","Iowa","5/29/20","1","0","19185","0"
"Webster","2","37","Iowa","5/29/20","25","12","19187","48"
"Winnebago","0","11","Iowa","5/29/20","10","1","19189","10"
"Winneshiek","0","23","Iowa","5/29/20","21","2","19191","9.52"
"Woodbury","36","2721","Iowa","5/29/20","2469","252","19193","10.21"
"Worth","0","3","Iowa","5/29/20","3","0","19195","0"
"Wright","10","153","Iowa","5/29/20","85","68","19197","80"
"Allen","0","1","Kansas","5/29/20","1","0","20001","0"
"Anderson","0","1","Kansas","5/29/20","1","0","20003","0"
"Atchison","1","22","Kansas","5/29/20","18","4","20005","22.22"
"Barber","0","1","Kansas","5/29/20","1","0","20007","0"
"Barton","1","45","Kansas","5/29/20","36","9","20009","25"
"Bourbon","0","7","Kansas","5/29/20","7","0","20011","0"
"Brown","0","6","Kansas","5/29/20","5","1","20013","20"
"Butler","1","31","Kansas","5/29/20","24","7","20015","29.17"
"Chase","0","4","Kansas","5/29/20","3","1","20017","33.33"
"Chautauqua","0","4","Kansas","5/29/20","4","0","20019","0"
"Cherokee","0","9","Kansas","5/29/20","9","0","20021","0"
"Cheyenne","0","2","Kansas","5/29/20","2","0","20023","0"
"Clark","0","33","Kansas","5/29/20","31","2","20025","6.45"
"Clay","0","5","Kansas","5/29/20","5","0","20027","0"
"Cloud","0","5","Kansas","5/29/20","4","1","20029","25"
"Coffey","0","50","Kansas","5/29/20","50","0","20031","0"
"Comanche","0","2","Kansas","5/29/20","1","1","20033","100"
"Cowley","0","5","Kansas","5/29/20","4","1","20035","25"
"Crawford","0","8","Kansas","5/29/20","8","0","20037","0"
"Dickinson","0","3","Kansas","5/29/20","4","-1","20041","-25"
"Doniphan","0","15","Kansas","5/29/20","12","3","20043","25"
"Douglas","0","66","Kansas","5/29/20","63","3","20045","4.76"
"Edwards","0","5","Kansas","5/29/20","5","0","20047","0"
"Ellis","0","8","Kansas","5/29/20","8","0","20051","0"
"Ellsworth","0","2","Kansas","5/29/20","2","0","20053","0"
"Finney","9","1481","Kansas","5/29/20","1418","63","20055","4.44"
"Ford","25","1732","Kansas","5/29/20","1555","177","20057","11.38"
"Franklin","0","34","Kansas","5/29/20","32","2","20059","6.25"
"Geary","1","20","Kansas","5/29/20","16","4","20061","25"
"Gove","0","1","Kansas","5/29/20","1","0","20063","0"
"Grant","0","18","Kansas","5/29/20","18","0","20067","0"
"Gray","0","22","Kansas","5/29/20","21","1","20069","4.76"
"Greenwood","1","8","Kansas","5/29/20","3","5","20073","166.67"
"Hamilton","1","17","Kansas","5/29/20","10","7","20075","70"
"Harper","0","2","Kansas","5/29/20","1","1","20077","100"
"Harvey","0","11","Kansas","5/29/20","11","0","20079","0"
"Haskell","1","21","Kansas","5/29/20","17","4","20081","23.53"
"Hodgeman","0","4","Kansas","5/29/20","1","3","20083","300"
"Jackson","2","96","Kansas","5/29/20","84","12","20085","14.29"
"Jefferson","0","22","Kansas","5/29/20","21","1","20087","4.76"
"Jewell","0","4","Kansas","5/29/20","4","0","20089","0"
"Johnson","17","801","Kansas","5/29/20","684","117","20091","17.11"
"Kearny","1","45","Kansas","5/29/20","40","5","20093","12.5"
"Kiowa","0","2","Kansas","5/29/20","2","0","20097","0"
"Labette","0","22","Kansas","5/29/20","22","0","20099","0"
"Lane","0","3","Kansas","5/29/20","1","2","20101","200"
"Leavenworth","2","1082","Kansas","5/29/20","1067","15","20103","1.41"
"Linn","1","11","Kansas","5/29/20","7","4","20107","57.14"
"Lyon","4","354","Kansas","5/29/20","328","26","20111","7.93"
"Marion","0","5","Kansas","5/29/20","5","0","20115","0"
"McPherson","0","27","Kansas","5/29/20","27","0","20113","0"
"Meade","1","29","Kansas","5/29/20","24","5","20119","20.83"
"Miami","0","7","Kansas","5/29/20","6","1","20121","16.67"
"Mitchell","0","4","Kansas","5/29/20","3","1","20123","33.33"
"Montgomery","0","20","Kansas","5/29/20","20","0","20125","0"
"Morris","0","5","Kansas","5/29/20","3","2","20127","66.67"
"Morton","0","5","Kansas","5/29/20","4","1","20129","25"
"Nemaha","1","16","Kansas","5/29/20","9","7","20131","77.78"
"Neosho","0","2","Kansas","5/29/20","2","0","20133","0"
"Ness","0","1","Kansas","5/29/20","1","0","20135","0"
"Norton","0","2","Kansas","5/29/20","2","0","20137","0"
"Osage","0","7","Kansas","5/29/20","7","0","20139","0"
"Osborne","0","2","Kansas","5/29/20","2","0","20141","0"
"Ottawa","0","4","Kansas","5/29/20","4","0","20143","0"
"Phillips","0","2","Kansas","5/29/20","2","0","20147","0"
"Pottawatomie","0","25","Kansas","5/29/20","22","3","20149","13.64"
"Pratt","0","2","Kansas","5/29/20","1","1","20151","100"
"Reno","0","43","Kansas","5/29/20","43","0","20155","0"
"Republic","0","4","Kansas","5/29/20","4","0","20157","0"
"Rice","0","4","Kansas","5/29/20","4","0","20159","0"
"Riley","0","64","Kansas","5/29/20","61","3","20161","4.92"
"Rooks","0","6","Kansas","5/29/20","6","0","20163","0"
"Saline","0","25","Kansas","5/29/20","24","1","20169","4.17"
"Scott","0","14","Kansas","5/29/20","13","1","20171","7.69"
"Sedgwick","4","575","Kansas","5/29/20","545","30","20173","5.5"
"Seward","9","883","Kansas","5/29/20","821","62","20175","7.55"
"Shawnee","7","294","Kansas","5/29/20","247","47","20177","19.03"
"Sheridan","0","2","Kansas","5/29/20","2","0","20179","0"
"Sherman","0","7","Kansas","5/29/20","6","1","20181","16.67"
"Smith","0","2","Kansas","5/29/20","2","0","20183","0"
"Stafford","0","1","Kansas","5/29/20","1","0","20185","0"
"Stanton","0","9","Kansas","5/29/20","9","0","20187","0"
"Stevens","0","29","Kansas","5/29/20","26","3","20189","11.54"
"Sumner","0","8","Kansas","5/29/20","6","2","20191","33.33"
"Trego","0","1","Kansas","5/29/20","1","0","20195","0"
"Wabaunsee","0","31","Kansas","5/29/20","29","2","20197","6.9"
"Wilson","0","1","Kansas","5/29/20","1","0","20205","0"
"Woodson","0","6","Kansas","5/29/20","6","0","20207","0"
"Wyandotte","14","1335","Kansas","5/29/20","1236","99","20209","8.01"
"Adair","0","97","Kentucky","5/29/20","96","1","21001","1.04"
"Allen","4","70","Kentucky","5/29/20","44","26","21003","59.09"
"Anderson","0","18","Kentucky","5/29/20","15","3","21005","20"
"Ballard","0","10","Kentucky","5/29/20","9","1","21007","11.11"
"Barren","1","45","Kentucky","5/29/20","40","5","21009","12.5"
"Bath","0","9","Kentucky","5/29/20","8","1","21011","12.5"
"Bell","0","1","Kentucky","5/29/20","1","0","21013","0"
"Boone","6","423","Kentucky","5/29/20","379","44","21015","11.61"
"Bourbon","0","10","Kentucky","5/29/20","9","1","21017","11.11"
"Boyd","0","39","Kentucky","5/29/20","39","0","21019","0"
"Boyle","0","23","Kentucky","5/29/20","20","3","21021","15"
"Bracken","0","11","Kentucky","5/29/20","11","0","21023","0"
"Breathitt","0","3","Kentucky","5/29/20","2","1","21025","50"
"Breckinridge","0","17","Kentucky","5/29/20","16","1","21027","6.25"
"Bullitt","1","111","Kentucky","5/29/20","101","10","21029","9.9"
"Butler","1","228","Kentucky","5/29/20","219","9","21031","4.11"
"Caldwell","0","12","Kentucky","5/29/20","12","0","21033","0"
"Calloway","0","50","Kentucky","5/29/20","49","1","21035","2.04"
"Campbell","3","164","Kentucky","5/29/20","144","20","21037","13.89"
"Carlisle","0","5","Kentucky","5/29/20","5","0","21039","0"
"Carroll","1","11","Kentucky","5/29/20","6","5","21041","83.33"
"Carter","0","9","Kentucky","5/29/20","9","0","21043","0"
"Casey","0","3","Kentucky","5/29/20","2","1","21045","50"
"Christian","1","109","Kentucky","5/29/20","101","8","21047","7.92"
"Clark","0","39","Kentucky","5/29/20","37","2","21049","5.41"
"Clay","1","7","Kentucky","5/29/20","3","4","21051","133.33"
"Clinton","0","3","Kentucky","5/29/20","3","0","21053","0"
"Crittenden","0","6","Kentucky","5/29/20","5","1","21055","20"
"Cumberland","0","5","Kentucky","5/29/20","5","0","21057","0"
"Daviess","2","316","Kentucky","5/29/20","300","16","21059","5.33"
"Edmonson","0","56","Kentucky","5/29/20","53","3","21061","5.66"
"Elliott","0","1","Kentucky","5/29/20","1","0","21063","0"
"Fayette","14","702","Kentucky","5/29/20","603","99","21067","16.42"
"Fleming","0","3","Kentucky","5/29/20","2","1","21069","50"
"Floyd","0","16","Kentucky","5/29/20","16","0","21071","0"
"Franklin","2","35","Kentucky","5/29/20","24","11","21073","45.83"
"Fulton","0","6","Kentucky","5/29/20","3","3","21075","100"
"Gallatin","4","33","Kentucky","5/29/20","5","28","21077","560"
"Garrard","0","5","Kentucky","5/29/20","4","1","21079","25"
"Grant","1","41","Kentucky","5/29/20","36","5","21081","13.89"
"Graves","1","162","Kentucky","5/29/20","152","10","21083","6.58"
"Grayson","1","124","Kentucky","5/29/20","120","4","21085","3.33"
"Green","0","1","Kentucky","5/29/20","1","0","21087","0"
"Greenup","0","14","Kentucky","5/29/20","13","1","21089","7.69"
"Hancock","0","7","Kentucky","5/29/20","6","1","21091","16.67"
"Hardin","1","100","Kentucky","5/29/20","90","10","21093","11.11"
"Harlan","0","1","Kentucky","5/29/20","1","0","21095","0"
"Harrison","0","18","Kentucky","5/29/20","18","0","21097","0"
"Hart","1","21","Kentucky","5/29/20","17","4","21099","23.53"
"Henderson","2","106","Kentucky","5/29/20","93","13","21101","13.98"
"Henry","1","19","Kentucky","5/29/20","14","5","21103","35.71"
"Hickman","0","5","Kentucky","5/29/20","5","0","21105","0"
"Hopkins","0","221","Kentucky","5/29/20","218","3","21107","1.38"
"Jackson","0","61","Kentucky","5/29/20","60","1","21109","1.67"
"Jefferson","44","2329","Kentucky","5/29/20","2021","308","21111","15.24"
"Jessamine","1","57","Kentucky","5/29/20","50","7","21113","14"
"Johnson","0","5","Kentucky","5/29/20","5","0","21115","0"
"Kenton","7","566","Kentucky","5/29/20","520","46","21117","8.85"
"Knott","0","4","Kentucky","5/29/20","4","0","21119","0"
"Knox","0","8","Kentucky","5/29/20","8","0","21121","0"
"Larue","0","7","Kentucky","5/29/20","6","1","21123","16.67"
"Laurel","0","21","Kentucky","5/29/20","21","0","21125","0"
"Lawrence","0","2","Kentucky","5/29/20","1","1","21127","100"
"Lee","0","1","Kentucky","5/29/20","0","1","21129","1"
"Leslie","0","6","Kentucky","5/29/20","6","0","21131","0"
"Letcher","0","4","Kentucky","5/29/20","4","0","21133","0"
"Lewis","0","7","Kentucky","5/29/20","7","0","21135","0"
"Lincoln","0","8","Kentucky","5/29/20","8","0","21137","0"
"Livingston","0","9","Kentucky","5/29/20","8","1","21139","12.5"
"Logan","4","139","Kentucky","5/29/20","113","26","21141","23.01"
"Lyon","0","14","Kentucky","5/29/20","14","0","21143","0"
"Madison","1","50","Kentucky","5/29/20","45","5","21151","11.11"
"Magoffin","0","2","Kentucky","5/29/20","1","1","21153","100"
"Marion","0","20","Kentucky","5/29/20","18","2","21155","11.11"
"Marshall","0","38","Kentucky","5/29/20","37","1","21157","2.7"
"Martin","0","3","Kentucky","5/29/20","3","0","21159","0"
"Mason","0","9","Kentucky","5/29/20","8","1","21161","12.5"
"McCracken","1","95","Kentucky","5/29/20","85","10","21145","11.76"
"McCreary","0","13","Kentucky","5/29/20","13","0","21147","0"
"McLean","0","22","Kentucky","5/29/20","19","3","21149","15.79"
"Meade","0","21","Kentucky","5/29/20","21","0","21163","0"
"Menifee","0","10","Kentucky","5/29/20","8","2","21165","25"
"Mercer","0","13","Kentucky","5/29/20","12","1","21167","8.33"
"Metcalfe","0","6","Kentucky","5/29/20","4","2","21169","50"
"Monroe","1","16","Kentucky","5/29/20","7","9","21171","128.57"
"Montgomery","1","23","Kentucky","5/29/20","17","6","21173","35.29"
"Morgan","0","1","Kentucky","5/29/20","1","0","21175","0"
"Muhlenberg","2","482","Kentucky","5/29/20","468","14","21177","2.99"
"Nelson","1","41","Kentucky","5/29/20","36","5","21179","13.89"
"Nicholas","0","3","Kentucky","5/29/20","1","2","21181","200"
"Ohio","3","141","Kentucky","5/29/20","117","24","21183","20.51"
"Oldham","2","74","Kentucky","5/29/20","60","14","21185","23.33"
"Owen","0","2","Kentucky","5/29/20","1","1","21187","100"
"Owsley","0","2","Kentucky","5/29/20","2","0","21189","0"
"Pendleton","0","8","Kentucky","5/29/20","7","1","21191","14.29"
"Perry","0","19","Kentucky","5/29/20","19","0","21193","0"
"Pike","0","29","Kentucky","5/29/20","28","1","21195","3.57"
"Powell","0","1","Kentucky","5/29/20","1","0","21197","0"
"Pulaski","0","56","Kentucky","5/29/20","53","3","21199","5.66"
"Rockcastle","0","13","Kentucky","5/29/20","13","0","21203","0"
"Rowan","0","7","Kentucky","5/29/20","7","0","21205","0"
"Russell","0","23","Kentucky","5/29/20","22","1","21207","4.55"
"Scott","0","35","Kentucky","5/29/20","34","1","21209","2.94"
"Shelby","10","156","Kentucky","5/29/20","89","67","21211","75.28"
"Simpson","1","51","Kentucky","5/29/20","44","7","21213","15.91"
"Spencer","0","19","Kentucky","5/29/20","16","3","21215","18.75"
"Taylor","0","11","Kentucky","5/29/20","10","1","21217","10"
"Todd","0","17","Kentucky","5/29/20","16","1","21219","6.25"
"Trigg","0","10","Kentucky","5/29/20","9","1","21221","11.11"
"Trimble","0","5","Kentucky","5/29/20","5","0","21223","0"
"Union","0","11","Kentucky","5/29/20","10","1","21225","10"
"Warren","13","995","Kentucky","5/29/20","906","89","21227","9.82"
"Washington","0","6","Kentucky","5/29/20","5","1","21229","20"
"Wayne","0","8","Kentucky","5/29/20","8","0","21231","0"
"Webster","0","32","Kentucky","5/29/20","32","0","21233","0"
"Whitley","0","13","Kentucky","5/29/20","13","0","21235","0"
"Wolfe","0","1","Kentucky","5/29/20","1","0","21237","0"
"Woodford","0","27","Kentucky","5/29/20","25","2","21239","8"
"Acadia","16","401","Louisiana","5/29/20","289","112","22001","38.75"
"Allen","0","184","Louisiana","5/29/20","182","2","22003","1.1"
"Ascension","4","810","Louisiana","5/29/20","785","25","22005","3.18"
"Assumption","1","248","Louisiana","5/29/20","238","10","22007","4.2"
"Avoyelles","3","120","Louisiana","5/29/20","101","19","22009","18.81"
"Beauregard","1","61","Louisiana","5/29/20","56","5","22011","8.93"
"Bienville","0","139","Louisiana","5/29/20","136","3","22013","2.21"
"Bossier","4","406","Louisiana","5/29/20","380","26","22015","6.84"
"Caddo","27","2480","Louisiana","5/29/20","2293","187","22017","8.16"
"Calcasieu","3","588","Louisiana","5/29/20","567","21","22019","3.7"
"Caldwell","0","52","Louisiana","5/29/20","51","1","22021","1.96"
"Cameron","0","3","Louisiana","5/29/20","3","0","22023","0"
"Catahoula","0","112","Louisiana","5/29/20","112","0","22025","0"
"Claiborne","1","62","Louisiana","5/29/20","58","4","22027","6.9"
"Concordia","2","86","Louisiana","5/29/20","69","17","22029","24.64"
"De Soto","1","242","Louisiana","5/29/20","236","6","22031","2.54"
"East Baton Rouge","22","3526","Louisiana","5/29/20","3370","156","22033","4.63"
"East Carroll","8","118","Louisiana","5/29/20","62","56","22035","90.32"
"East Feliciana","1","192","Louisiana","5/29/20","184","8","22037","4.35"
"Evangeline","-2","75","Louisiana","5/29/20","87","-12","22039","-13.79"
"Franklin","3","311","Louisiana","5/29/20","287","24","22041","8.36"
"Grant","0","28","Louisiana","5/29/20","26","2","22043","7.69"
"Iberia","2","404","Louisiana","5/29/20","388","16","22045","4.12"
"Iberville","3","563","Louisiana","5/29/20","541","22","22047","4.07"
"Jackson","3","100","Louisiana","5/29/20","82","18","22049","21.95"
"Jefferson","27","7424","Louisiana","5/29/20","7232","192","22051","2.65"
"Jefferson Davis","0","75","Louisiana","5/29/20","73","2","22053","2.74"
"Lafayette","8","695","Louisiana","5/29/20","637","58","22055","9.11"
"Lafourche","3","789","Louisiana","5/29/20","766","23","22057","3"
"LaSalle","0","48","Louisiana","5/29/20","45","3","22059","6.67"
"Lincoln","2","144","Louisiana","5/29/20","133","11","22061","8.27"
"Livingston","6","408","Louisiana","5/29/20","366","42","22063","11.48"
"Madison","4","79","Louisiana","5/29/20","54","25","22065","46.3"
"Morehouse","2","121","Louisiana","5/29/20","110","11","22067","10"
"Natchitoches","2","157","Louisiana","5/29/20","145","12","22069","8.28"
"Orleans","18","7067","Louisiana","5/29/20","6944","123","22071","1.77"
"Ouachita","18","1166","Louisiana","5/29/20","1041","125","22073","12.01"
"Plaquemines","0","201","Louisiana","5/29/20","198","3","22075","1.52"
"Pointe Coupee","1","192","Louisiana","5/29/20","182","10","22077","5.49"
"Rapides","15","703","Louisiana","5/29/20","600","103","22079","17.17"
"Red River","0","49","Louisiana","5/29/20","46","3","22081","6.52"
"Richland","2","125","Louisiana","5/29/20","114","11","22083","9.65"
"Sabine","0","41","Louisiana","5/29/20","39","2","22085","5.13"
"St. Bernard","2","534","Louisiana","5/29/20","521","13","22087","2.5"
"St. Charles","2","633","Louisiana","5/29/20","622","11","22089","1.77"
"St. Helena","1","51","Louisiana","5/29/20","44","7","22091","15.91"
"St. James","1","294","Louisiana","5/29/20","289","5","22093","1.73"
"St. John the Baptist","2","850","Louisiana","5/29/20","838","12","22095","1.43"
"St. Landry","1","252","Louisiana","5/29/20","247","5","22097","2.02"
"St. Martin","1","293","Louisiana","5/29/20","288","5","22099","1.74"
"St. Mary","2","309","Louisiana","5/29/20","294","15","22101","5.1"
"St. Tammany","13","1703","Louisiana","5/29/20","1609","94","22103","5.84"
"Tangipahoa","9","831","Louisiana","5/29/20","767","64","22105","8.34"
"Tensas","0","10","Louisiana","5/29/20","10","0","22107","0"
"Terrebonne","4","653","Louisiana","5/29/20","623","30","22109","4.82"
"Union","3","306","Louisiana","5/29/20","287","19","22111","6.62"
"Vermilion","0","53","Louisiana","5/29/20","50","3","22113","6"
"Vernon","0","25","Louisiana","5/29/20","23","2","22115","8.7"
"Washington","4","410","Louisiana","5/29/20","383","27","22117","7.05"
"Webster","2","143","Louisiana","5/29/20","126","17","22119","13.49"
"West Baton Rouge","1","159","Louisiana","5/29/20","154","5","22121","3.25"
"West Carroll","3","56","Louisiana","5/29/20","33","23","22123","69.7"
"West Feliciana","2","205","Louisiana","5/29/20","194","11","22125","5.67"
"Winn","6","153","Louisiana","5/29/20","112","41","22127","36.61"
"Androscoggin","9","269","Maine","5/29/20","209","60","23001","28.71"
"Aroostook","0","10","Maine","5/29/20","8","2","23003","25"
"Cumberland","21","1117","Maine","5/29/20","968","149","23005","15.39"
"Franklin","0","36","Maine","5/29/20","36","0","23007","0"
"Hancock","0","11","Maine","5/29/20","11","0","23009","0"
"Kennebec","1","128","Maine","5/29/20","124","4","23011","3.23"
"Knox","0","20","Maine","5/29/20","20","0","23013","0"
"Lincoln","0","20","Maine","5/29/20","18","2","23015","11.11"
"Oxford","2","32","Maine","5/29/20","19","13","23017","68.42"
"Penobscot","0","100","Maine","5/29/20","98","2","23019","2.04"
"Piscataquis","0","1","Maine","5/29/20","1","0","23021","0"
"Sagadahoc","0","30","Maine","5/29/20","28","2","23023","7.14"
"Somerset","0","22","Maine","5/29/20","21","1","23025","4.76"
"Waldo","0","51","Maine","5/29/20","51","0","23027","0"
"Washington","0","2","Maine","5/29/20","2","0","23029","0"
"York","6","373","Maine","5/29/20","331","42","23031","12.69"
"Allegany","1","177","Maryland","5/29/20","168","9","24001","5.36"
"Anne Arundel","62","3643","Maryland","5/29/20","3207","436","24003","13.6"
"Baltimore","93","5819","Maryland","5/29/20","5170","649","24005","12.55"
"Baltimore City","133","5426","Maryland","5/29/20","4492","934","24510","20.79"
"Calvert","5","329","Maryland","5/29/20","291","38","24009","13.06"
"Caroline","4","248","Maryland","5/29/20","223","25","24011","11.21"
"Carroll","15","861","Maryland","5/29/20","755","106","24013","14.04"
"Cecil","4","364","Maryland","5/29/20","339","25","24015","7.37"
"Charles","14","1056","Maryland","5/29/20","956","100","24017","10.46"
"Dorchester","2","140","Maryland","5/29/20","126","14","24019","11.11"
"Frederick","33","1856","Maryland","5/29/20","1625","231","24021","14.22"
"Garrett","0","10","Maryland","5/29/20","7","3","24023","42.86"
"Harford","15","854","Maryland","5/29/20","746","108","24025","14.48"
"Howard","40","1868","Maryland","5/29/20","1586","282","24027","17.78"
"Kent","3","167","Maryland","5/29/20","146","21","24029","14.38"
"Montgomery","229","11035","Maryland","5/29/20","9432","1603","24031","17"
"Prince George's","242","14773","Maryland","5/29/20","13077","1696","24033","12.97"
"Queen Anne's","3","160","Maryland","5/29/20","141","19","24035","13.48"
"Somerset","0","73","Maryland","5/29/20","71","2","24039","2.82"
"St. Mary's","13","460","Maryland","5/29/20","370","90","24037","24.32"
"Talbot","3","91","Maryland","5/29/20","73","18","24041","24.66"
"Washington","7","441","Maryland","5/29/20","389","52","24043","13.37"
"Wicomico","11","931","Maryland","5/29/20","854","77","24045","9.02"
"Worcester","4","206","Maryland","5/29/20","180","26","24047","14.44"
"Barnstable","9","1408","Massachusetts","5/29/20","1346","62","25001","4.61"
"Berkshire","5","566","Massachusetts","5/29/20","531","35","25003","6.59"
"Bristol","84","7089","Massachusetts","5/29/20","6503","586","25005","9.01"
"Dukes and Nantucket","0","52","Massachusetts","5/29/20","51","1","00000","1.96"
"Essex","119","14415","Massachusetts","5/29/20","13580","835","25009","6.15"
"Franklin","2","333","Massachusetts","5/29/20","321","12","25011","3.74"
"Hampden","55","6068","Massachusetts","5/29/20","5683","385","25013","6.77"
"Hampshire","6","881","Massachusetts","5/29/20","840","41","25015","4.88"
"Middlesex","144","21787","Massachusetts","5/29/20","20776","1011","25017","4.87"
"Norfolk","41","8436","Massachusetts","5/29/20","8148","288","25021","3.53"
"Plymouth","52","8071","Massachusetts","5/29/20","7704","367","25023","4.76"
"Suffolk","97","18361","Massachusetts","5/29/20","17680","681","25025","3.85"
"Worcester","112","11086","Massachusetts","5/29/20","10301","785","25027","7.62"
"Alcona","1","17","Michigan","5/29/20","12","5","26001","41.67"
"Allegan","3","253","Michigan","5/29/20","231","22","26005","9.52"
"Alpena","0","101","Michigan","5/29/20","100","1","26007","1"
"Antrim","0","13","Michigan","5/29/20","12","1","26009","8.33"
"Arenac","0","38","Michigan","5/29/20","36","2","26011","5.56"
"Baraga","0","1","Michigan","5/29/20","1","0","26013","0"
"Barry","1","79","Michigan","5/29/20","73","6","26015","8.22"
"Bay","5","338","Michigan","5/29/20","305","33","26017","10.82"
"Benzie","0","4","Michigan","5/29/20","4","0","26019","0"
"Berrien","7","746","Michigan","5/29/20","699","47","26021","6.72"
"Branch","2","121","Michigan","5/29/20","107","14","26023","13.08"
"Calhoun","5","406","Michigan","5/29/20","371","35","26025","9.43"
"Cass","1","93","Michigan","5/29/20","84","9","26027","10.71"
"Charlevoix","0","18","Michigan","5/29/20","17","1","26029","5.88"
"Cheboygan","0","26","Michigan","5/29/20","26","0","26031","0"
"Chippewa","0","3","Michigan","5/29/20","3","0","26033","0"
"Clare","0","19","Michigan","5/29/20","18","1","26035","5.56"
"Clinton","2","175","Michigan","5/29/20","164","11","26037","6.71"
"Crawford","0","62","Michigan","5/29/20","62","0","26039","0"
"Delta","0","20","Michigan","5/29/20","20","0","26041","0"
"Dickinson","0","5","Michigan","5/29/20","5","0","26043","0"
"Eaton","3","237","Michigan","5/29/20","219","18","26045","8.22"
"Emmet","0","26","Michigan","5/29/20","25","1","26047","4"
"Federal Correctional Institution (FCI)","2","142","Michigan","5/29/20","125","17","00000","13.6"
"Genesee","17","2442","Michigan","5/29/20","2326","116","26049","4.99"
"Gladwin","0","18","Michigan","5/29/20","17","1","26051","5.88"
"Gogebic","0","5","Michigan","5/29/20","5","0","26053","0"
"Grand Traverse","0","26","Michigan","5/29/20","24","2","26055","8.33"
"Gratiot","2","83","Michigan","5/29/20","72","11","26057","15.28"
"Hillsdale","0","176","Michigan","5/29/20","174","2","26059","1.15"
"Houghton","0","5","Michigan","5/29/20","2","3","26061","150"
"Huron","0","52","Michigan","5/29/20","50","2","26063","4"
"Ingham","8","771","Michigan","5/29/20","716","55","26065","7.68"
"Ionia","2","165","Michigan","5/29/20","153","12","26067","7.84"
"Iosco","3","109","Michigan","5/29/20","91","18","26069","19.78"
"Isabella","1","91","Michigan","5/29/20","82","9","26073","10.98"
"Jackson","12","532","Michigan","5/29/20","451","81","26075","17.96"
"Kalamazoo","8","883","Michigan","5/29/20","824","59","26077","7.16"
"Kalkaska","0","30","Michigan","5/29/20","29","1","26079","3.45"
"Kent","55","3828","Michigan","5/29/20","3442","386","26081","11.21"
"Lake","0","8","Michigan","5/29/20","6","2","26085","33.33"
"Lapeer","1","214","Michigan","5/29/20","204","10","26087","4.9"
"Leelanau","0","11","Michigan","5/29/20","11","0","26089","0"
"Lenawee","1","184","Michigan","5/29/20","177","7","26091","3.95"
"Livingston","2","491","Michigan","5/29/20","476","15","26093","3.15"
"Luce","0","3","Michigan","5/29/20","3","0","26095","0"
"Mackinac","0","8","Michigan","5/29/20","6","2","26097","33.33"
"Macomb","27","6761","Michigan","5/29/20","6572","189","26099","2.88"
"Manistee","0","12","Michigan","5/29/20","12","0","26101","0"
"Marquette","0","54","Michigan","5/29/20","52","2","26103","3.85"
"Mason","0","38","Michigan","5/29/20","37","1","26105","2.7"
"Mecosta","0","24","Michigan","5/29/20","22","2","26107","9.09"
"Menominee","0","8","Michigan","5/29/20","8","0","26109","0"
"Michigan Department of Corrections (MDOC)","68","3853","Michigan","5/29/20","3378","475","00000","14.06"
"Midland","0","118","Michigan","5/29/20","116","2","26111","1.72"
"Missaukee","0","22","Michigan","5/29/20","22","0","26113","0"
"Monroe","3","524","Michigan","5/29/20","501","23","26115","4.59"
"Montcalm","0","71","Michigan","5/29/20","68","3","26117","4.41"
"Montmorency","0","5","Michigan","5/29/20","5","0","26119","0"
"Muskegon","11","640","Michigan","5/29/20","564","76","26121","13.48"
"Newaygo","4","108","Michigan","5/29/20","80","28","26123","35"
"Oakland","74","10627","Michigan","5/29/20","10109","518","26125","5.12"
"Oceana","2","93","Michigan","5/29/20","81","12","26127","14.81"
"Ogemaw","0","29","Michigan","5/29/20","28","1","26129","3.57"
"Osceola","0","14","Michigan","5/29/20","13","1","26133","7.69"
"Oscoda","0","8","Michigan","5/29/20","8","0","26135","0"
"Otsego","0","118","Michigan","5/29/20","118","0","26137","0"
"Ottawa","15","824","Michigan","5/29/20","720","104","26139","14.44"
"Out of MI","-2","32","Michigan","5/29/20","48","-16","80026","-33.33"
"Presque Isle","0","11","Michigan","5/29/20","11","0","26141","0"
"Roscommon","0","24","Michigan","5/29/20","23","1","26143","4.35"
"Saginaw","7","1042","Michigan","5/29/20","994","48","26145","4.83"
"Sanilac","0","42","Michigan","5/29/20","40","2","26151","5"
"Schoolcraft","0","4","Michigan","5/29/20","4","0","26153","0"
"Shiawassee","-1","260","Michigan","5/29/20","266","-6","26155","-2.26"
"St. Clair","3","509","Michigan","5/29/20","487","22","26147","4.52"
"St. Joseph","2","116","Michigan","5/29/20","100","16","26149","16"
"Tuscola","2","192","Michigan","5/29/20","180","12","26157","6.67"
"Van Buren","2","157","Michigan","5/29/20","141","16","26159","11.35"
"Washtenaw","9","1495","Michigan","5/29/20","1432","63","26161","4.4"
"Wayne","97","20883","Michigan","5/29/20","20205","678","26163","3.36"
"Wexford","0","13","Michigan","5/29/20","13","0","26165","0"
"Aitkin","0","7","Minnesota","5/29/20","4","3","27001","75"
"Anoka","40","1324","Minnesota","5/29/20","1044","280","27003","26.82"
"Becker","0","36","Minnesota","5/29/20","33","3","27005","9.09"
"Beltrami","1","14","Minnesota","5/29/20","10","4","27007","40"
"Benton","2","175","Minnesota","5/29/20","158","17","27009","10.76"
"Big Stone","0","4","Minnesota","5/29/20","3","1","27011","33.33"
"Blue Earth","4","137","Minnesota","5/29/20","108","29","27013","26.85"
"Brown","0","14","Minnesota","5/29/20","11","3","27015","27.27"
"Carlton","0","73","Minnesota","5/29/20","71","2","27017","2.82"
"Carver","8","201","Minnesota","5/29/20","146","55","27019","37.67"
"Cass","0","13","Minnesota","5/29/20","10","3","27021","30"
"Chippewa","1","49","Minnesota","5/29/20","39","10","27023","25.64"
"Chisago","3","60","Minnesota","5/29/20","41","19","27025","46.34"
"Clay","9","420","Minnesota","5/29/20","356","64","27027","17.98"
"Clearwater","0","3","Minnesota","5/29/20","2","1","27029","50"
"Cottonwood","1","69","Minnesota","5/29/20","61","8","27033","13.11"
"Crow Wing","3","64","Minnesota","5/29/20","42","22","27035","52.38"
"Dakota","38","1230","Minnesota","5/29/20","961","269","27037","27.99"
"Dodge","1","50","Minnesota","5/29/20","41","9","27039","21.95"
"Douglas","2","40","Minnesota","5/29/20","27","13","27041","48.15"
"Faribault","1","15","Minnesota","5/29/20","11","4","27043","36.36"
"Fillmore","0","17","Minnesota","5/29/20","17","0","27045","0"
"Freeborn","5","108","Minnesota","5/29/20","76","32","27047","42.11"
"Goodhue","3","62","Minnesota","5/29/20","43","19","27049","44.19"
"Grant","0","4","Minnesota","5/29/20","2","2","27051","100"
"Hennepin","226","7932","Minnesota","5/29/20","6350","1582","27053","24.91"
"Houston","0","2","Minnesota","5/29/20","2","0","27055","0"
"Hubbard","0","2","Minnesota","5/29/20","0","2","27057","1"
"Isanti","2","32","Minnesota","5/29/20","21","11","27059","52.38"
"Itasca","0","54","Minnesota","5/29/20","51","3","27061","5.88"
"Jackson","0","39","Minnesota","5/29/20","37","2","27063","5.41"
"Kanabec","0","11","Minnesota","5/29/20","11","0","27065","0"
"Kandiyohi","6","486","Minnesota","5/29/20","443","43","27067","9.71"
"Kittson","0","1","Minnesota","5/29/20","1","0","27069","0"
"Koochiching","0","7","Minnesota","5/29/20","4","3","27071","75"
"Lac qui Parle","0","3","Minnesota","5/29/20","3","0","27073","0"
"Lake","0","1","Minnesota","5/29/20","1","0","27075","0"
"Le Sueur","1","44","Minnesota","5/29/20","39","5","27079","12.82"
"Lincoln","0","5","Minnesota","5/29/20","4","1","27081","25"
"Lyon","2","43","Minnesota","5/29/20","29","14","27083","48.28"
"Mahnomen","0","6","Minnesota","5/29/20","5","1","27087","20"
"Marshall","0","10","Minnesota","5/29/20","8","2","27089","25"
"Martin","1","129","Minnesota","5/29/20","124","5","27091","4.03"
"McLeod","1","33","Minnesota","5/29/20","24","9","27085","37.5"
"Meeker","0","44","Minnesota","5/29/20","41","3","27093","7.32"
"Mille Lacs","1","19","Minnesota","5/29/20","15","4","27095","26.67"
"Morrison","2","45","Minnesota","5/29/20","34","11","27097","32.35"
"Mower","20","254","Minnesota","5/29/20","112","142","27099","126.79"
"Murray","0","37","Minnesota","5/29/20","34","3","27101","8.82"
"Nicollet","3","83","Minnesota","5/29/20","63","20","27103","31.75"
"Nobles","10","1503","Minnesota","5/29/20","1432","71","27105","4.96"
"Norman","0","12","Minnesota","5/29/20","11","1","27107","9.09"
"Olmsted","10","594","Minnesota","5/29/20","525","69","27109","13.14"
"Otter Tail","2","63","Minnesota","5/29/20","52","11","27111","21.15"
"Pennington","2","17","Minnesota","5/29/20","6","11","27113","183.33"
"Pine","1","89","Minnesota","5/29/20","84","5","27115","5.95"
"Pipestone","0","10","Minnesota","5/29/20","10","0","27117","0"
"Polk","0","60","Minnesota","5/29/20","57","3","27119","5.26"
"Pope","0","9","Minnesota","5/29/20","6","3","27121","50"
"Ramsey","110","2790","Minnesota","5/29/20","2018","772","27123","38.26"
"Red Lake","0","4","Minnesota","5/29/20","3","1","27125","33.33"
"Redwood","0","4","Minnesota","5/29/20","3","1","27127","33.33"
"Renville","0","5","Minnesota","5/29/20","5","0","27129","0"
"Rice","16","438","Minnesota","5/29/20","328","110","27131","33.54"
"Rock","0","22","Minnesota","5/29/20","20","2","27133","10"
"Roseau","0","2","Minnesota","5/29/20","1","1","27135","100"
"Scott","11","394","Minnesota","5/29/20","316","78","27139","24.68"
"Sherburne","5","226","Minnesota","5/29/20","193","33","27141","17.1"
"Sibley","1","16","Minnesota","5/29/20","12","4","27143","33.33"
"St. Louis","1","118","Minnesota","5/29/20","109","9","27137","8.26"
"Stearns","17","2001","Minnesota","5/29/20","1881","120","27145","6.38"
"Steele","2","151","Minnesota","5/29/20","134","17","27147","12.69"
"Stevens","0","2","Minnesota","5/29/20","0","2","27149","1"
"Swift","0","18","Minnesota","5/29/20","15","3","27151","20"
"Todd","23","302","Minnesota","5/29/20","140","162","27153","115.71"
"Traverse","0","3","Minnesota","5/29/20","3","0","27155","0"
"Wabasha","0","17","Minnesota","5/29/20","16","1","27157","6.25"
"Wadena","0","8","Minnesota","5/29/20","6","2","27159","33.33"
"Waseca","0","26","Minnesota","5/29/20","23","3","27161","13.04"
"Washington","21","598","Minnesota","5/29/20","453","145","27163","32.01"
"Watonwan","3","69","Minnesota","5/29/20","45","24","27165","53.33"
"Wilkin","0","11","Minnesota","5/29/20","11","0","27167","0"
"Winona","0","79","Minnesota","5/29/20","76","3","27169","3.95"
"Wright","11","287","Minnesota","5/29/20","213","74","27171","34.74"
"Yellow Medicine","0","6","Minnesota","5/29/20","5","1","27173","20"
"Adams","2","192","Mississippi","5/29/20","180","12","28001","6.67"
"Alcorn","0","16","Mississippi","5/29/20","15","1","28003","6.67"
"Amite","1","59","Mississippi","5/29/20","49","10","28005","20.41"
"Attala","3","287","Mississippi","5/29/20","269","18","28007","6.69"
"Benton","0","15","Mississippi","5/29/20","13","2","28009","15.38"
"Bolivar","3","156","Mississippi","5/29/20","134","22","28011","16.42"
"Calhoun","0","63","Mississippi","5/29/20","61","2","28013","3.28"
"Carroll","1","118","Mississippi","5/29/20","113","5","28015","4.42"
"Chickasaw","1","132","Mississippi","5/29/20","125","7","28017","5.6"
"Choctaw","1","39","Mississippi","5/29/20","29","10","28019","34.48"
"Claiborne","2","72","Mississippi","5/29/20","58","14","28021","24.14"
"Clarke","2","139","Mississippi","5/29/20","123","16","28023","13.01"
"Clay","2","111","Mississippi","5/29/20","95","16","28025","16.84"
"Coahoma","4","120","Mississippi","5/29/20","92","28","28027","30.43"
"Copiah","6","298","Mississippi","5/29/20","259","39","28029","15.06"
"Covington","5","159","Mississippi","5/29/20","125","34","28031","27.2"
"DeSoto","11","520","Mississippi","5/29/20","442","78","28033","17.65"
"Forrest","10","534","Mississippi","5/29/20","462","72","28035","15.58"
"Franklin","1","28","Mississippi","5/29/20","23","5","28037","21.74"
"George","0","21","Mississippi","5/29/20","19","2","28039","10.53"
"Greene","1","11","Mississippi","5/29/20","7","4","28041","57.14"
"Grenada","3","88","Mississippi","5/29/20","68","20","28043","29.41"
"Hancock","0","87","Mississippi","5/29/20","86","1","28045","1.16"
"Harrison","3","251","Mississippi","5/29/20","230","21","28047","9.13"
"Hinds","17","971","Mississippi","5/29/20","855","116","28049","13.57"
"Holmes","7","389","Mississippi","5/29/20","343","46","28051","13.41"
"Humphreys","1","59","Mississippi","5/29/20","50","9","28053","18"
"Itawamba","1","85","Mississippi","5/29/20","81","4","28057","4.94"
"Jackson","2","303","Mississippi","5/29/20","291","12","28059","4.12"
"Jasper","3","152","Mississippi","5/29/20","131","21","28061","16.03"
"Jefferson","0","41","Mississippi","5/29/20","40","1","28063","2.5"
"Jefferson Davis","1","77","Mississippi","5/29/20","69","8","28065","11.59"
"Jones","22","576","Mississippi","5/29/20","422","154","28067","36.49"
"Kemper","4","144","Mississippi","5/29/20","116","28","28069","24.14"
"Lafayette","2","130","Mississippi","5/29/20","116","14","28071","12.07"
"Lamar","3","235","Mississippi","5/29/20","215","20","28073","9.3"
"Lauderdale","12","730","Mississippi","5/29/20","647","83","28075","12.83"
"Lawrence","3","102","Mississippi","5/29/20","82","20","28077","24.39"
"Leake","5","409","Mississippi","5/29/20","373","36","28079","9.65"
"Lee","6","139","Mississippi","5/29/20","99","40","28081","40.4"
"Leflore","6","255","Mississippi","5/29/20","211","44","28083","20.85"
"Lincoln","3","250","Mississippi","5/29/20","231","19","28085","8.23"
"Lowndes","9","200","Mississippi","5/29/20","139","61","28087","43.88"
"Madison","13","709","Mississippi","5/29/20","618","91","28089","14.72"
"Marion","2","114","Mississippi","5/29/20","103","11","28091","10.68"
"Marshall","2","81","Mississippi","5/29/20","68","13","28093","19.12"
"Monroe","3","254","Mississippi","5/29/20","231","23","28095","9.96"
"Montgomery","1","81","Mississippi","5/29/20","77","4","28097","5.19"
"Neshoba","18","606","Mississippi","5/29/20","477","129","28099","27.04"
"Newton","7","263","Mississippi","5/29/20","214","49","28101","22.9"
"Noxubee","4","179","Mississippi","5/29/20","152","27","28103","17.76"
"Oktibbeha","15","233","Mississippi","5/29/20","126","107","28105","84.92"
"Panola","1","66","Mississippi","5/29/20","59","7","28107","11.86"
"Pearl River","1","207","Mississippi","5/29/20","203","4","28109","1.97"
"Perry","1","50","Mississippi","5/29/20","40","10","28111","25"
"Pike","2","203","Mississippi","5/29/20","190","13","28113","6.84"
"Pontotoc","0","29","Mississippi","5/29/20","26","3","28115","11.54"
"Prentiss","2","51","Mississippi","5/29/20","37","14","28117","37.84"
"Quitman","0","25","Mississippi","5/29/20","23","2","28119","8.7"
"Rankin","11","399","Mississippi","5/29/20","325","74","28121","22.77"
"Scott","9","640","Mississippi","5/29/20","578","62","28123","10.73"
"Sharkey","0","7","Mississippi","5/29/20","7","0","28125","0"
"Simpson","2","95","Mississippi","5/29/20","82","13","28127","15.85"
"Smith","3","148","Mississippi","5/29/20","127","21","28129","16.54"
"Stone","0","30","Mississippi","5/29/20","27","3","28131","11.11"
"Sunflower","1","79","Mississippi","5/29/20","73","6","28133","8.22"
"Tallahatchie","0","26","Mississippi","5/29/20","23","3","28135","13.04"
"Tate","3","81","Mississippi","5/29/20","59","22","28137","37.29"
"Tippah","0","71","Mississippi","5/29/20","69","2","28139","2.9"
"Tishomingo","1","30","Mississippi","5/29/20","22","8","28141","36.36"
"Tunica","1","53","Mississippi","5/29/20","47","6","28143","12.77"
"Union","2","81","Mississippi","5/29/20","68","13","28145","19.12"
"Walthall","1","54","Mississippi","5/29/20","50","4","28147","8"
"Warren","3","163","Mississippi","5/29/20","144","19","28149","13.19"
"Washington","3","166","Mississippi","5/29/20","143","23","28151","16.08"
"Wayne","14","171","Mississippi","5/29/20","72","99","28153","137.5"
"Webster","5","64","Mississippi","5/29/20","27","37","28155","137.04"
"Wilkinson","1","86","Mississippi","5/29/20","81","5","28157","6.17"
"Winston","2","109","Mississippi","5/29/20","92","17","28159","18.48"
"Yalobusha","1","87","Mississippi","5/29/20","79","8","28161","10.13"
"Yazoo","6","239","Mississippi","5/29/20","198","41","28163","20.71"
"Adair","2","50","Missouri","5/29/20","38","12","29001","31.58"
"Andrew","1","30","Missouri","5/29/20","20","10","29003","50"
"Atchison","0","3","Missouri","5/29/20","3","0","29005","0"
"Audrain","7","73","Missouri","5/29/20","27","46","29007","170.37"
"Barry","0","9","Missouri","5/29/20","8","1","29009","12.5"
"Bates","0","7","Missouri","5/29/20","7","0","29013","0"
"Benton","0","10","Missouri","5/29/20","10","0","29015","0"
"Bollinger","0","6","Missouri","5/29/20","6","0","29017","0"
"Boone","5","144","Missouri","5/29/20","111","33","29019","29.73"
"Buchanan","13","687","Missouri","5/29/20","599","88","29021","14.69"
"Butler","1","32","Missouri","5/29/20","28","4","29023","14.29"
"Caldwell","0","5","Missouri","5/29/20","5","0","29025","0"
"Callaway","1","27","Missouri","5/29/20","23","4","29027","17.39"
"Camden","0","38","Missouri","5/29/20","36","2","29029","5.56"
"Cape Girardeau","2","73","Missouri","5/29/20","57","16","29031","28.07"
"Carroll","0","8","Missouri","5/29/20","7","1","29033","14.29"
"Carter","0","5","Missouri","5/29/20","4","1","29035","25"
"Cass","1","85","Missouri","5/29/20","77","8","29037","10.39"
"Cedar","0","9","Missouri","5/29/20","9","0","29039","0"
"Chariton","0","6","Missouri","5/29/20","6","0","29041","0"
"Christian","0","21","Missouri","5/29/20","21","0","29043","0"
"Clark","0","1","Missouri","5/29/20","1","0","29045","0"
"Clay","5","167","Missouri","5/29/20","133","34","29047","25.56"
"Clinton","0","18","Missouri","5/29/20","18","0","29049","0"
"Cole","0","60","Missouri","5/29/20","58","2","29051","3.45"
"Cooper","0","9","Missouri","5/29/20","9","0","29053","0"
"Crawford","0","9","Missouri","5/29/20","9","0","29055","0"
"Dallas","0","3","Missouri","5/29/20","3","0","29059","0"
"Daviess","0","4","Missouri","5/29/20","4","0","29061","0"
"DeKalb","0","6","Missouri","5/29/20","5","1","29063","20"
"Dunklin","1","33","Missouri","5/29/20","25","8","29069","32"
"Franklin","0","140","Missouri","5/29/20","137","3","29071","2.19"
"Gasconade","0","2","Missouri","5/29/20","2","0","29073","0"
"Gentry","3","26","Missouri","5/29/20","6","20","29075","333.33"
"Greene","3","139","Missouri","5/29/20","117","22","29077","18.8"
"Harrison","0","9","Missouri","5/29/20","8","1","29081","12.5"
"Henry","0","11","Missouri","5/29/20","9","2","29083","22.22"
"Holt","0","1","Missouri","5/29/20","1","0","29087","0"
"Howard","0","3","Missouri","5/29/20","3","0","29089","0"
"Howell","0","6","Missouri","5/29/20","5","1","29091","20"
"Iron","0","2","Missouri","5/29/20","2","0","29093","0"
"Jackson","11","560","Missouri","5/29/20","485","75","29095","15.46"
"Jasper","1","36","Missouri","5/29/20","32","4","29097","12.5"
"Jefferson","2","349","Missouri","5/29/20","334","15","29099","4.49"
"Johnson","1","76","Missouri","5/29/20","72","4","29101","5.56"
"Kansas City","21","1117","Missouri","5/29/20","967","150","00000","15.51"
"Laclede","0","3","Missouri","5/29/20","3","0","29105","0"
"Lafayette","1","73","Missouri","5/29/20","69","4","29107","5.8"
"Lawrence","0","8","Missouri","5/29/20","8","0","29109","0"
"Lewis","0","7","Missouri","5/29/20","7","0","29111","0"
"Lincoln","0","109","Missouri","5/29/20","106","3","29113","2.83"
"Linn","0","6","Missouri","5/29/20","5","1","29115","20"
"Livingston","0","3","Missouri","5/29/20","3","0","29117","0"
"Macon","0","4","Missouri","5/29/20","2","2","29121","100"
"Madison","0","3","Missouri","5/29/20","3","0","29123","0"
"Maries","0","2","Missouri","5/29/20","2","0","29125","0"
"Marion","0","5","Missouri","5/29/20","5","0","29127","0"
"McDonald","1","20","Missouri","5/29/20","15","5","29119","33.33"
"Miller","0","4","Missouri","5/29/20","4","0","29131","0"
"Mississippi","0","56","Missouri","5/29/20","53","3","29133","5.66"
"Moniteau","0","46","Missouri","5/29/20","44","2","29135","4.55"
"Montgomery","0","9","Missouri","5/29/20","7","2","29139","28.57"
"Morgan","0","9","Missouri","5/29/20","8","1","29141","12.5"
"New Madrid","1","20","Missouri","5/29/20","15","5","29143","33.33"
"Newton","0","16","Missouri","5/29/20","16","0","29145","0"
"Nodaway","1","12","Missouri","5/29/20","8","4","29147","50"
"Oregon","0","2","Missouri","5/29/20","2","0","29149","0"
"Osage","0","5","Missouri","5/29/20","5","0","29151","0"
"Pemiscot","1","76","Missouri","5/29/20","72","4","29155","5.56"
"Perry","1","55","Missouri","5/29/20","48","7","29157","14.58"
"Pettis","1","78","Missouri","5/29/20","70","8","29159","11.43"
"Phelps","0","4","Missouri","5/29/20","4","0","29161","0"
"Pike","0","17","Missouri","5/29/20","14","3","29163","21.43"
"Platte","1","70","Missouri","5/29/20","63","7","29165","11.11"
"Polk","0","3","Missouri","5/29/20","2","1","29167","50"
"Pulaski","0","34","Missouri","5/29/20","33","1","29169","3.03"
"Ralls","0","3","Missouri","5/29/20","2","1","29173","50"
"Randolph","0","9","Missouri","5/29/20","8","1","29175","12.5"
"Ray","1","19","Missouri","5/29/20","15","4","29177","26.67"
"Reynolds","0","2","Missouri","5/29/20","2","0","29179","0"
"Ripley","0","7","Missouri","5/29/20","7","0","29181","0"
"Saline","1","269","Missouri","5/29/20","262","7","29195","2.67"
"Scotland","0","4","Missouri","5/29/20","4","0","29199","0"
"Scott","1","100","Missouri","5/29/20","91","9","29201","9.89"
"Shelby","0","1","Missouri","5/29/20","1","0","29205","0"
"St. Charles","7","768","Missouri","5/29/20","722","46","29183","6.37"
"St. Clair","0","3","Missouri","5/29/20","3","0","29185","0"
"St. Francois","0","34","Missouri","5/29/20","33","1","29187","3.03"
"St. Louis","51","4980","Missouri","5/29/20","4621","359","29189","7.77"
"St. Louis City","22","1916","Missouri","5/29/20","1763","153","29510","8.68"
"Ste. Genevieve","0","11","Missouri","5/29/20","8","3","29186","37.5"
"Stoddard","2","78","Missouri","5/29/20","67","11","29207","16.42"
"Stone","0","4","Missouri","5/29/20","4","0","29209","0"
"Sullivan","2","55","Missouri","5/29/20","39","16","29211","41.03"
"Taney","0","14","Missouri","5/29/20","14","0","29213","0"
"Texas","0","1","Missouri","5/29/20","0","1","29215","1"
"Vernon","0","9","Missouri","5/29/20","7","2","29217","28.57"
"Warren","0","28","Missouri","5/29/20","28","0","29219","0"
"Washington","0","11","Missouri","5/29/20","10","1","29221","10"
"Webster","0","17","Missouri","5/29/20","17","0","29225","0"
"Worth","0","4","Missouri","5/29/20","3","1","29227","33.33"
"Wright","0","11","Missouri","5/29/20","11","0","29229","0"
"Beaverhead","0","1","Montana","5/29/20","1","0","30001","0"
"Big Horn","1","18","Montana","5/29/20","8","10","30003","125"
"Broadwater","0","4","Montana","5/29/20","4","0","30007","0"
"Carbon","0","6","Montana","5/29/20","6","0","30009","0"
"Cascade","0","17","Montana","5/29/20","17","0","30013","0"
"Deer Lodge","0","3","Montana","5/29/20","3","0","30023","0"
"Flathead","0","37","Montana","5/29/20","37","0","30029","0"
"Gallatin","0","150","Montana","5/29/20","149","1","30031","0.67"
"Glacier","0","6","Montana","5/29/20","6","0","30035","0"
"Golden Valley","0","3","Montana","5/29/20","3","0","30037","0"
"Hill","0","1","Montana","5/29/20","1","0","30041","0"
"Jefferson","0","3","Montana","5/29/20","3","0","30043","0"
"Lake","0","5","Montana","5/29/20","5","0","30047","0"
"Lewis and Clark","0","16","Montana","5/29/20","16","0","30049","0"
"Liberty","0","1","Montana","5/29/20","1","0","30051","0"
"Lincoln","0","7","Montana","5/29/20","7","0","30053","0"
"Madison","0","8","Montana","5/29/20","8","0","30057","0"
"Meagher","0","1","Montana","5/29/20","1","0","30059","0"
"Missoula","0","40","Montana","5/29/20","39","1","30063","2.56"
"Musselshell","0","1","Montana","5/29/20","1","0","30065","0"
"Park","0","8","Montana","5/29/20","8","0","30067","0"
"Pondera","0","2","Montana","5/29/20","2","0","30073","0"
"Ravalli","0","13","Montana","5/29/20","13","0","30081","0"
"Richland","0","3","Montana","5/29/20","3","0","30083","0"
"Roosevelt","0","7","Montana","5/29/20","7","0","30085","0"
"Silver Bow","0","11","Montana","5/29/20","11","0","30093","0"
"Stillwater","0","1","Montana","5/29/20","1","0","30095","0"
"Toole","0","29","Montana","5/29/20","29","0","30101","0"
"Wheatland","0","1","Montana","5/29/20","1","0","30107","0"
"Yellowstone","0","90","Montana","5/29/20","88","2","30111","2.27"
"Adams","1","268","Nebraska","5/29/20","258","10","31001","3.88"
"Antelope","0","8","Nebraska","5/29/20","7","1","31003","14.29"
"Boone","0","5","Nebraska","5/29/20","3","2","31011","66.67"
"Box Butte","0","2","Nebraska","5/29/20","1","1","31013","100"
"Buffalo","2","153","Nebraska","5/29/20","137","16","31019","11.68"
"Burt","0","9","Nebraska","5/29/20","8","1","31021","12.5"
"Butler","0","47","Nebraska","5/29/20","44","3","31023","6.82"
"Cass","3","46","Nebraska","5/29/20","28","18","31025","64.29"
"Cedar","0","7","Nebraska","5/29/20","7","0","31027","0"
"Chase","0","1","Nebraska","5/29/20","0","1","31029","1"
"Cherry","0","1","Nebraska","5/29/20","1","0","31031","0"
"Cheyenne","0","9","Nebraska","5/29/20","9","0","31033","0"
"Clay","0","24","Nebraska","5/29/20","22","2","31035","9.09"
"Colfax","5","612","Nebraska","5/29/20","580","32","31037","5.52"
"Cuming","1","31","Nebraska","5/29/20","26","5","31039","19.23"
"Custer","0","31","Nebraska","5/29/20","30","1","31041","3.33"
"Dakota","12","1650","Nebraska","5/29/20","1568","82","31043","5.23"
"Dawes","0","1","Nebraska","5/29/20","1","0","31045","0"
"Dawson","3","833","Nebraska","5/29/20","814","19","31047","2.33"
"Dixon","0","26","Nebraska","5/29/20","24","2","31051","8.33"
"Dodge","18","439","Nebraska","5/29/20","314","125","31053","39.81"
"Douglas","153","3955","Nebraska","5/29/20","2881","1074","31055","37.28"
"Fillmore","0","5","Nebraska","5/29/20","5","0","31059","0"
"Franklin","0","6","Nebraska","5/29/20","6","0","31061","0"
"Frontier","0","1","Nebraska","5/29/20","1","0","31063","0"
"Furnas","0","8","Nebraska","5/29/20","6","2","31065","33.33"
"Gage","0","45","Nebraska","5/29/20","44","1","31067","2.27"
"Garfield","0","1","Nebraska","5/29/20","0","1","31071","1"
"Gosper","0","13","Nebraska","5/29/20","13","0","31073","0"
"Greeley","0","2","Nebraska","5/29/20","2","0","31077","0"
"Hall","4","1484","Nebraska","5/29/20","1458","26","31079","1.78"
"Hamilton","0","54","Nebraska","5/29/20","52","2","31081","3.85"
"Harlan","0","0","Nebraska","5/29/20","1","-1","31083","-100"
"Hitchcock","0","1","Nebraska","5/29/20","1","0","31087","0"
"Holt","0","1","Nebraska","5/29/20","1","0","31089","0"
"Howard","1","42","Nebraska","5/29/20","38","4","31093","10.53"
"Jefferson","0","6","Nebraska","5/29/20","6","0","31095","0"
"Johnson","0","7","Nebraska","5/29/20","7","0","31097","0"
"Kearney","0","11","Nebraska","5/29/20","11","0","31099","0"
"Keith","0","2","Nebraska","5/29/20","2","0","31101","0"
"Kimball","0","8","Nebraska","5/29/20","8","0","31105","0"
"Knox","0","10","Nebraska","5/29/20","8","2","31107","25"
"Lancaster","25","1176","Nebraska","5/29/20","1002","174","31109","17.37"
"Lincoln","0","47","Nebraska","5/29/20","46","1","31111","2.17"
"Madison","3","312","Nebraska","5/29/20","294","18","31119","6.12"
"Merrick","0","33","Nebraska","5/29/20","32","1","31121","3.12"
"Morrill","0","11","Nebraska","5/29/20","10","1","31123","10"
"Nance","0","4","Nebraska","5/29/20","5","-1","31125","-20"
"Nemaha","0","3","Nebraska","5/29/20","3","0","31127","0"
"Nuckolls","0","1","Nebraska","5/29/20","1","0","31129","0"
"Otoe","0","7","Nebraska","5/29/20","6","1","31131","16.67"
"Phelps","1","20","Nebraska","5/29/20","16","4","31137","25"
"Pierce","0","5","Nebraska","5/29/20","2","3","31139","150"
"Platte","6","560","Nebraska","5/29/20","516","44","31141","8.53"
"Polk","0","11","Nebraska","5/29/20","9","2","31143","22.22"
"Red Willow","0","5","Nebraska","5/29/20","5","0","31145","0"
"Richardson","0","1","Nebraska","5/29/20","1","0","31147","0"
"Saline","5","498","Nebraska","5/29/20","465","33","31151","7.1"
"Sarpy","23","578","Nebraska","5/29/20","419","159","31153","37.95"
"Saunders","1","34","Nebraska","5/29/20","25","9","31155","36"
"Scotts Bluff","4","88","Nebraska","5/29/20","58","30","31157","51.72"
"Seward","0","27","Nebraska","5/29/20","27","0","31159","0"
"Sherman","0","4","Nebraska","5/29/20","2","2","31163","100"
"Stanton","1","20","Nebraska","5/29/20","15","5","31167","33.33"
"Thayer","0","1","Nebraska","5/29/20","0","1","31169","1"
"Thomas","0","1","Nebraska","5/29/20","1","0","31171","0"
"Thurston","2","41","Nebraska","5/29/20","24","17","31173","70.83"
"Valley","0","4","Nebraska","5/29/20","3","1","31175","33.33"
"Washington","0","29","Nebraska","5/29/20","26","3","31177","11.54"
"Wayne","1","14","Nebraska","5/29/20","7","7","31179","100"
"Webster","0","5","Nebraska","5/29/20","5","0","31181","0"
"York","0","36","Nebraska","5/29/20","35","1","31185","2.86"
"Carson City","2","95","Nevada","5/29/20","83","12","32510","14.46"
"Churchill","0","7","Nevada","5/29/20","6","1","32001","16.67"
"Clark","92","6457","Nevada","5/29/20","5815","642","32003","11.04"
"Douglas","1","30","Nevada","5/29/20","26","4","32005","15.38"
"Elko","0","24","Nevada","5/29/20","21","3","32007","14.29"
"Humboldt","0","78","Nevada","5/29/20","78","0","32013","0"
"Lander","0","20","Nevada","5/29/20","19","1","32015","5.26"
"Lincoln","0","2","Nevada","5/29/20","2","0","32017","0"
"Lyon","1","61","Nevada","5/29/20","51","10","32019","19.61"
"Mineral","0","4","Nevada","5/29/20","4","0","32021","0"
"Nye","0","62","Nevada","5/29/20","59","3","32023","5.08"
"Storey","0","1","Nevada","5/29/20","1","0","32029","0"
"Washoe","25","1531","Nevada","5/29/20","1356","175","32031","12.91"
"White Pine","0","4","Nevada","5/29/20","4","0","32033","0"
"Belknap","1","58","New Hampshire","5/29/20","54","4","33001","7.41"
"Carroll","0","46","New Hampshire","5/29/20","46","0","33003","0"
"Cheshire","1","57","New Hampshire","5/29/20","51","6","33005","11.76"
"Coos","0","5","New Hampshire","5/29/20","4","1","33007","25"
"Grafton","1","74","New Hampshire","5/29/20","68","6","33009","8.82"
"Hillsborough","48","2342","New Hampshire","5/29/20","2004","338","33011","16.87"
"Merrimack","4","334","New Hampshire","5/29/20","307","27","33013","8.79"
"Rockingham","12","1284","New Hampshire","5/29/20","1199","85","33015","7.09"
"Strafford","3","267","New Hampshire","5/29/20","248","19","33017","7.66"
"Sullivan","0","19","New Hampshire","5/29/20","16","3","33019","18.75"
"Atlantic","34","2154","New Jersey","5/29/20","1919","235","34001","12.25"
"Bergen","81","18223","New Jersey","5/29/20","17653","570","34003","3.23"
"Burlington","43","4519","New Jersey","5/29/20","4217","302","34005","7.16"
"Camden","61","6350","New Jersey","5/29/20","5923","427","34007","7.21"
"Cape May","9","611","New Jersey","5/29/20","545","66","34009","12.11"
"Cumberland","41","2209","New Jersey","5/29/20","1921","288","34011","14.99"
"Essex","78","17561","New Jersey","5/29/20","17014","547","34013","3.21"
"Gloucester","24","2198","New Jersey","5/29/20","2031","167","34015","8.22"
"Hudson","6","18919","New Jersey","5/29/20","18880","39","34017","0.21"
"Hunterdon","6","981","New Jersey","5/29/20","938","43","34019","4.58"
"Mercer","69","6775","New Jersey","5/29/20","6295","480","34021","7.63"
"Middlesex","81","15734","New Jersey","5/29/20","15165","569","34023","3.75"
"Monmouth","58","8100","New Jersey","5/29/20","7695","405","34025","5.26"
"Morris","28","6367","New Jersey","5/29/20","6171","196","34027","3.18"
"Ocean","49","8627","New Jersey","5/29/20","8285","342","34029","4.13"
"Passaic","63","16045","New Jersey","5/29/20","15604","441","34031","2.83"
"Salem","11","602","New Jersey","5/29/20","523","79","34033","15.11"
"Somerset","19","4552","New Jersey","5/29/20","4416","136","34035","3.08"
"Sussex","4","1106","New Jersey","5/29/20","1075","31","34037","2.88"
"Union","60","15610","New Jersey","5/29/20","15191","419","34039","2.76"
"Warren","5","1153","New Jersey","5/29/20","1118","35","34041","3.13"
"Bernalillo","19","1445","New Mexico","5/29/20","1313","132","35001","10.05"
"Catron","0","2","New Mexico","5/29/20","2","0","35003","0"
"Chaves","1","44","New Mexico","5/29/20","35","9","35005","25.71"
"Cibola","2","137","New Mexico","5/29/20","122","15","35006","12.3"
"Colfax","0","5","New Mexico","5/29/20","5","0","35007","0"
"Curry","1","52","New Mexico","5/29/20","45","7","35009","15.56"
"Dona Ana","11","449","New Mexico","5/29/20","370","79","35013","21.35"
"Eddy","0","20","New Mexico","5/29/20","17","3","35015","17.65"
"Grant","0","15","New Mexico","5/29/20","16","-1","35017","-6.25"
"Guadalupe","0","20","New Mexico","5/29/20","19","1","35019","5.26"
"Harding","0","1","New Mexico","5/29/20","1","0","35021","0"
"Hidalgo","0","1","New Mexico","5/29/20","1","0","35023","0"
"Lea","1","26","New Mexico","5/29/20","21","5","35025","23.81"
"Lincoln","0","2","New Mexico","5/29/20","3","-1","35027","-33.33"
"Los Alamos","0","6","New Mexico","5/29/20","6","0","35028","0"
"Luna","0","8","New Mexico","5/29/20","8","0","35029","0"
"McKinley","37","2348","New Mexico","5/29/20","2086","262","35031","12.56"
"Otero","1","22","New Mexico","5/29/20","12","10","35035","83.33"
"Quay","0","5","New Mexico","5/29/20","5","0","35037","0"
"Rio Arriba","1","43","New Mexico","5/29/20","36","7","35039","19.44"
"Roosevelt","1","37","New Mexico","5/29/20","31","6","35041","19.35"
"San Juan","29","1692","New Mexico","5/29/20","1490","202","35045","13.56"
"San Miguel","1","15","New Mexico","5/29/20","10","5","35047","50"
"Sandoval","4","559","New Mexico","5/29/20","529","30","35043","5.67"
"Santa Fe","1","137","New Mexico","5/29/20","129","8","35049","6.2"
"Sierra","0","1","New Mexico","5/29/20","1","0","35051","0"
"Socorro","0","50","New Mexico","5/29/20","49","1","35053","2.04"
"Taos","0","25","New Mexico","5/29/20","22","3","35055","13.64"
"Torrance","2","33","New Mexico","5/29/20","19","14","35057","73.68"
"Union","0","4","New Mexico","5/29/20","3","1","35059","33.33"
"Valencia","1","74","New Mexico","5/29/20","70","4","35061","5.71"
"Albany","11","1834","New York","5/29/20","1756","78","36001","4.44"
"Allegany","0","45","New York","5/29/20","44","1","36003","2.27"
"Broome","13","557","New York","5/29/20","468","89","36007","19.02"
"Cattaraugus","2","86","New York","5/29/20","74","12","36009","16.22"
"Cayuga","2","89","New York","5/29/20","73","16","36011","21.92"
"Chautauqua","3","82","New York","5/29/20","63","19","36013","30.16"
"Chemung","0","137","New York","5/29/20","135","2","36015","1.48"
"Chenango","2","130","New York","5/29/20","118","12","36017","10.17"
"Clinton","0","95","New York","5/29/20","94","1","36019","1.06"
"Columbia","4","382","New York","5/29/20","356","26","36021","7.3"
"Cortland","0","39","New York","5/29/20","37","2","36023","5.41"
"Delaware","1","79","New York","5/29/20","72","7","36025","9.72"
"Dutchess","17","3887","New York","5/29/20","3767","120","36027","3.19"
"Erie","77","5935","New York","5/29/20","5397","538","36029","9.97"
"Essex","0","36","New York","5/29/20","36","0","36031","0"
"Franklin","0","21","New York","5/29/20","19","2","36033","10.53"
"Fulton","2","206","New York","5/29/20","189","17","36035","8.99"
"Genesee","1","199","New York","5/29/20","189","10","36037","5.29"
"Greene","3","237","New York","5/29/20","215","22","36039","10.23"
"Hamilton","0","5","New York","5/29/20","5","0","36041","0"
"Herkimer","2","107","New York","5/29/20","95","12","36043","12.63"
"Jefferson","0","74","New York","5/29/20","72","2","36045","2.78"
"Lewis","0","20","New York","5/29/20","19","1","36049","5.26"
"Livingston","1","118","New York","5/29/20","114","4","36051","3.51"
"Madison","2","310","New York","5/29/20","297","13","36053","4.38"
"Monroe","37","2860","New York","5/29/20","2601","259","36055","9.96"
"Montgomery","1","84","New York","5/29/20","77","7","36057","9.09"
"Nassau","88","40226","New York","5/29/20","39608","618","36059","1.56"
"New York","788","201999","New York","5/29/20","196484","5515","36061","2.81"
"Niagara","16","1008","New York","5/29/20","897","111","36063","12.37"
"Oneida","23","988","New York","5/29/20","828","160","36065","19.32"
"Onondaga","38","2092","New York","5/29/20","1828","264","36067","14.44"
"Ontario","4","205","New York","5/29/20","180","25","36069","13.89"
"Orange","31","10361","New York","5/29/20","10142","219","36071","2.16"
"Orleans","6","216","New York","5/29/20","175","41","36073","23.43"
"Oswego","2","108","New York","5/29/20","96","12","36075","12.5"
"Otsego","1","71","New York","5/29/20","67","4","36077","5.97"
"Putnam","8","1241","New York","5/29/20","1187","54","36079","4.55"
"Rensselaer","3","478","New York","5/29/20","460","18","36083","3.91"
"Rockland","28","13100","New York","5/29/20","12905","195","36087","1.51"
"Saratoga","4","473","New York","5/29/20","448","25","36091","5.58"
"Schenectady","5","680","New York","5/29/20","645","35","36093","5.43"
"Schoharie","0","49","New York","5/29/20","49","0","36095","0"
"Schuyler","0","11","New York","5/29/20","11","0","36097","0"
"Seneca","0","57","New York","5/29/20","54","3","36099","5.56"
"St. Lawrence","1","202","New York","5/29/20","195","7","36089","3.59"
"Steuben","0","241","New York","5/29/20","240","1","36101","0.42"
"Suffolk","110","39445","New York","5/29/20","38672","773","36103","2"
"Sullivan","11","1364","New York","5/29/20","1287","77","36105","5.98"
"Tioga","1","126","New York","5/29/20","118","8","36107","6.78"
"Tompkins","1","157","New York","5/29/20","147","10","36109","6.8"
"Ulster","10","1663","New York","5/29/20","1595","68","36111","4.26"
"Warren","1","254","New York","5/29/20","246","8","36113","3.25"
"Washington","1","232","New York","5/29/20","224","8","36115","3.57"
"Wayne","1","113","New York","5/29/20","104","9","36117","8.65"
"Westchester","83","33349","New York","5/29/20","32767","582","36119","1.78"
"Wyoming","0","82","New York","5/29/20","79","3","36121","3.8"
"Yates","1","39","New York","5/29/20","34","5","36123","14.71"
"Alamance","11","342","North Carolina","5/29/20","268","74","37001","27.61"
"Alexander","1","30","North Carolina","5/29/20","23","7","37003","30.43"
"Alleghany","0","14","North Carolina","5/29/20","13","1","37005","7.69"
"Anson","1","64","North Carolina","5/29/20","55","9","37007","16.36"
"Ashe","1","36","North Carolina","5/29/20","32","4","37009","12.5"
"Avery","0","2","North Carolina","5/29/20","2","0","37011","0"
"Beaufort","0","36","North Carolina","5/29/20","35","1","37013","2.86"
"Bertie","2","119","North Carolina","5/29/20","108","11","37015","10.19"
"Bladen","1","95","North Carolina","5/29/20","91","4","37017","4.4"
"Brunswick","2","83","North Carolina","5/29/20","68","15","37019","22.06"
"Buncombe","9","310","North Carolina","5/29/20","246","64","37021","26.02"
"Burke","18","380","North Carolina","5/29/20","253","127","37023","50.2"
"Cabarrus","7","473","North Carolina","5/29/20","423","50","37025","11.82"
"Caldwell","3","127","North Carolina","5/29/20","104","23","37027","22.12"
"Camden","0","3","North Carolina","5/29/20","3","0","37029","0"
"Carteret","0","37","North Carolina","5/29/20","36","1","37031","2.78"
"Caswell","1","58","North Carolina","5/29/20","51","7","37033","13.73"
"Catawba","9","208","North Carolina","5/29/20","143","65","37035","45.45"
"Chatham","7","610","North Carolina","5/29/20","564","46","37037","8.16"
"Cherokee","0","30","North Carolina","5/29/20","30","0","37039","0"
"Chowan","0","17","North Carolina","5/29/20","15","2","37041","13.33"
"Clay","0","8","North Carolina","5/29/20","8","0","37043","0"
"Cleveland","2","79","North Carolina","5/29/20","63","16","37045","25.4"
"Columbus","6","330","North Carolina","5/29/20","289","41","37047","14.19"
"Craven","3","192","North Carolina","5/29/20","168","24","37049","14.29"
"Cumberland","13","662","North Carolina","5/29/20","569","93","37051","16.34"
"Currituck","1","15","North Carolina","5/29/20","11","4","37053","36.36"
"Dare","0","22","North Carolina","5/29/20","22","0","37055","0"
"Davidson","6","385","North Carolina","5/29/20","343","42","37057","12.24"
"Davie","4","87","North Carolina","5/29/20","62","25","37059","40.32"
"Duplin","29","750","North Carolina","5/29/20","545","205","37061","37.61"
"Durham","32","1441","North Carolina","5/29/20","1216","225","37063","18.5"
"Edgecombe","2","190","North Carolina","5/29/20","176","14","37065","7.95"
"Forsyth","48","1207","North Carolina","5/29/20","869","338","37067","38.9"
"Franklin","3","157","North Carolina","5/29/20","138","19","37069","13.77"
"Gaston","2","261","North Carolina","5/29/20","247","14","37071","5.67"
"Gates","2","25","North Carolina","5/29/20","14","11","37073","78.57"
"Graham","0","2","North Carolina","5/29/20","2","0","37075","0"
"Granville","9","287","North Carolina","5/29/20","226","61","37077","26.99"
"Greene","2","70","North Carolina","5/29/20","58","12","37079","20.69"
"Guilford","31","1195","North Carolina","5/29/20","977","218","37081","22.31"
"Halifax","3","167","North Carolina","5/29/20","147","20","37083","13.61"
"Harnett","4","285","North Carolina","5/29/20","259","26","37085","10.04"
"Haywood","1","47","North Carolina","5/29/20","39","8","37087","20.51"
"Henderson","4","334","North Carolina","5/29/20","306","28","37089","9.15"
"Hertford","4","89","North Carolina","5/29/20","61","28","37091","45.9"
"Hoke","8","232","North Carolina","5/29/20","175","57","37093","32.57"
"Hyde","0","1","North Carolina","5/29/20","1","0","37095","0"
"Iredell","5","251","North Carolina","5/29/20","213","38","37097","17.84"
"Jackson","1","33","North Carolina","5/29/20","27","6","37099","22.22"
"Johnston","16","428","North Carolina","5/29/20","314","114","37101","36.31"
"Jones","0","28","North Carolina","5/29/20","26","2","37103","7.69"
"Lee","10","428","North Carolina","5/29/20","359","69","37105","19.22"
"Lenoir","4","209","North Carolina","5/29/20","179","30","37107","16.76"
"Lincoln","2","67","North Carolina","5/29/20","56","11","37109","19.64"
"Macon","6","47","North Carolina","5/29/20","7","40","37113","571.43"
"Madison","0","4","North Carolina","5/29/20","4","0","37115","0"
"Martin","2","65","North Carolina","5/29/20","48","17","37117","35.42"
"McDowell","2","53","North Carolina","5/29/20","38","15","37111","39.47"
"Mecklenburg","119","3837","North Carolina","5/29/20","3001","836","37119","27.86"
"Mitchell","0","12","North Carolina","5/29/20","9","3","37121","33.33"
"Montgomery","5","113","North Carolina","5/29/20","78","35","37123","44.87"
"Moore","3","220","North Carolina","5/29/20","198","22","37125","11.11"
"Nash","4","193","North Carolina","5/29/20","166","27","37127","16.27"
"New Hanover","6","193","North Carolina","5/29/20","152","41","37129","26.97"
"Northampton","3","156","North Carolina","5/29/20","137","19","37131","13.87"
"Onslow","2","100","North Carolina","5/29/20","87","13","37133","14.94"
"Orange","5","326","North Carolina","5/29/20","291","35","37135","12.03"
"Pamlico","0","10","North Carolina","5/29/20","10","0","37137","0"
"Pasquotank","1","104","North Carolina","5/29/20","95","9","37139","9.47"
"Pender","2","76","North Carolina","5/29/20","64","12","37141","18.75"
"Perquimans","0","24","North Carolina","5/29/20","23","1","37143","4.35"
"Person","2","45","North Carolina","5/29/20","34","11","37145","32.35"
"Pitt","6","286","North Carolina","5/29/20","246","40","37147","16.26"
"Polk","0","35","North Carolina","5/29/20","35","0","37149","0"
"Randolph","15","651","North Carolina","5/29/20","543","108","37151","19.89"
"Richmond","4","162","North Carolina","5/29/20","132","30","37153","22.73"
"Robeson","20","786","North Carolina","5/29/20","646","140","37155","21.67"
"Rockingham","4","86","North Carolina","5/29/20","59","27","37157","45.76"
"Rowan","5","629","North Carolina","5/29/20","597","32","37159","5.36"
"Rutherford","2","174","North Carolina","5/29/20","161","13","37161","8.07"
"Sampson","12","429","North Carolina","5/29/20","345","84","37163","24.35"
"Scotland","3","84","North Carolina","5/29/20","60","24","37165","40"
"Stanly","3","57","North Carolina","5/29/20","37","20","37167","54.05"
"Stokes","3","65","North Carolina","5/29/20","42","23","37169","54.76"
"Surry","11","197","North Carolina","5/29/20","122","75","37171","61.48"
"Swain","0","11","North Carolina","5/29/20","10","1","37173","10"
"Transylvania","0","12","North Carolina","5/29/20","9","3","37175","33.33"
"Tyrrell","0","4","North Carolina","5/29/20","4","0","37177","0"
"Union","9","439","North Carolina","5/29/20","373","66","37179","17.69"
"Vance","12","300","North Carolina","5/29/20","215","85","37181","39.53"
"Wake","38","1661","North Carolina","5/29/20","1393","268","37183","19.24"
"Warren","1","58","North Carolina","5/29/20","48","10","37185","20.83"
"Washington","0","27","North Carolina","5/29/20","26","1","37187","3.85"
"Watauga","0","15","North Carolina","5/29/20","13","2","37189","15.38"
"Wayne","20","1088","North Carolina","5/29/20","949","139","37191","14.65"
"Wilkes","4","492","North Carolina","5/29/20","462","30","37193","6.49"
"Wilson","9","338","North Carolina","5/29/20","275","63","37195","22.91"
"Yadkin","6","169","North Carolina","5/29/20","128","41","37197","32.03"
"Yancey","1","14","North Carolina","5/29/20","10","4","37199","40"
"Barnes","0","4","North Dakota","5/29/20","4","0","38003","0"
"Benson","0","1","North Dakota","5/29/20","1","0","38005","0"
"Bottineau","0","2","North Dakota","5/29/20","2","0","38009","0"
"Bowman","0","1","North Dakota","5/29/20","1","0","38011","0"
"Burke","0","5","North Dakota","5/29/20","5","0","38013","0"
"Burleigh","0","126","North Dakota","5/29/20","128","-2","38015","-1.56"
"Cass","31","1661","North Dakota","5/29/20","1442","219","38017","15.19"
"Divide","0","1","North Dakota","5/29/20","1","0","38023","0"
"Dunn","0","12","North Dakota","5/29/20","12","0","38025","0"
"Eddy","-1","4","North Dakota","5/29/20","8","-4","38027","-50"
"Emmons","0","4","North Dakota","5/29/20","6","-2","38029","-33.33"
"Foster","0","1","North Dakota","5/29/20","1","0","38031","0"
"Grand Forks","2","331","North Dakota","5/29/20","320","11","38035","3.44"
"Grant","0","2","North Dakota","5/29/20","2","0","38037","0"
"Griggs","0","1","North Dakota","5/29/20","1","0","38039","0"
"McHenry","0","2","North Dakota","5/29/20","2","0","38049","0"
"McIntosh","0","1","North Dakota","5/29/20","1","0","38051","0"
"McKenzie","0","16","North Dakota","5/29/20","16","0","38053","0"
"McLean","0","7","North Dakota","5/29/20","7","0","38055","0"
"Mercer","0","5","North Dakota","5/29/20","5","0","38057","0"
"Morton","-1","59","North Dakota","5/29/20","64","-5","38059","-7.81"
"Mountrail","0","39","North Dakota","5/29/20","39","0","38061","0"
"Nelson","0","1","North Dakota","5/29/20","2","-1","38063","-50"
"Oliver","0","1","North Dakota","5/29/20","1","0","38065","0"
"Pembina","0","6","North Dakota","5/29/20","6","0","38067","0"
"Pierce","0","3","North Dakota","5/29/20","4","-1","38069","-25"
"Ramsey","0","8","North Dakota","5/29/20","9","-1","38071","-11.11"
"Ransom","0","8","North Dakota","5/29/20","7","1","38073","14.29"
"Renville","0","1","North Dakota","5/29/20","1","0","38075","0"
"Richland","1","21","North Dakota","5/29/20","15","6","38077","40"
"Rolette","0","6","North Dakota","5/29/20","4","2","38079","50"
"Sargent","0","3","North Dakota","5/29/20","3","0","38081","0"
"Sioux","0","2","North Dakota","5/29/20","2","0","38085","0"
"Slope","0","3","North Dakota","5/29/20","3","0","38087","0"
"Stark","0","61","North Dakota","5/29/20","61","0","38089","0"
"Steele","0","1","North Dakota","5/29/20","1","0","38091","0"
"Stutsman","1","22","North Dakota","5/29/20","18","4","38093","22.22"
"Traill","-1","11","North Dakota","5/29/20","20","-9","38097","-45"
"Walsh","0","13","North Dakota","5/29/20","11","2","38099","18.18"
"Ward","-2","37","North Dakota","5/29/20","54","-17","38101","-31.48"
"Wells","0","3","North Dakota","5/29/20","2","1","38103","50"
"Williams","0","24","North Dakota","5/29/20","25","-1","38105","-4"
"","0","22","Northern Mariana Islands","5/29/20","22","0",,"0"
"Adams","0","9","Ohio","5/29/20","8","1","39001","12.5"
"Allen","5","212","Ohio","5/29/20","178","34","39003","19.1"
"Ashland","0","20","Ohio","5/29/20","17","3","39005","17.65"
"Ashtabula","8","330","Ohio","5/29/20","272","58","39007","21.32"
"Athens","1","18","Ohio","5/29/20","13","5","39009","38.46"
"Auglaize","2","71","Ohio","5/29/20","56","15","39011","26.79"
"Belmont","6","419","Ohio","5/29/20","374","45","39013","12.03"
"Brown","1","28","Ohio","5/29/20","24","4","39015","16.67"
"Butler","18","862","Ohio","5/29/20","734","128","39017","17.44"
"Carroll","0","30","Ohio","5/29/20","28","2","39019","7.14"
"Champaign","0","27","Ohio","5/29/20","26","1","39021","3.85"
"Clark","10","252","Ohio","5/29/20","184","68","39023","36.96"
"Clermont","5","206","Ohio","5/29/20","170","36","39025","21.18"
"Clinton","0","43","Ohio","5/29/20","43","0","39027","0"
"Columbiana","38","739","Ohio","5/29/20","476","263","39029","55.25"
"Coshocton","2","38","Ohio","5/29/20","23","15","39031","65.22"
"Crawford","1","110","Ohio","5/29/20","104","6","39033","5.77"
"Cuyahoga","79","4318","Ohio","5/29/20","3762","556","39035","14.78"
"Darke","3","167","Ohio","5/29/20","146","21","39037","14.38"
"Defiance","0","33","Ohio","5/29/20","32","1","39039","3.12"
"Delaware","5","320","Ohio","5/29/20","282","38","39041","13.48"
"Erie","5","167","Ohio","5/29/20","133","34","39043","25.56"
"Fairfield","4","258","Ohio","5/29/20","229","29","39045","12.66"
"Fayette","1","40","Ohio","5/29/20","34","6","39047","17.65"
"Franklin","97","5674","Ohio","5/29/20","4996","678","39049","13.57"
"Fulton","1","39","Ohio","5/29/20","35","4","39051","11.43"
"Gallia","0","7","Ohio","5/29/20","7","0","39053","0"
"Geauga","4","277","Ohio","5/29/20","248","29","39055","11.69"
"Greene","2","101","Ohio","5/29/20","86","15","39057","17.44"
"Guernsey","1","34","Ohio","5/29/20","29","5","39059","17.24"
"Hamilton","46","2603","Ohio","5/29/20","2279","324","39061","14.22"
"Hancock","0","50","Ohio","5/29/20","47","3","39063","6.38"
"Hardin","1","45","Ohio","5/29/20","37","8","39065","21.62"
"Harrison","0","10","Ohio","5/29/20","10","0","39067","0"
"Henry","0","15","Ohio","5/29/20","13","2","39069","15.38"
"Highland","1","23","Ohio","5/29/20","16","7","39071","43.75"
"Hocking","1","69","Ohio","5/29/20","64","5","39073","7.81"
"Holmes","2","32","Ohio","5/29/20","20","12","39075","60"
"Huron","1","56","Ohio","5/29/20","48","8","39077","16.67"
"Jackson","0","13","Ohio","5/29/20","11","2","39079","18.18"
"Jefferson","1","67","Ohio","5/29/20","62","5","39081","8.06"
"Knox","0","24","Ohio","5/29/20","23","1","39083","4.35"
"Lake","7","302","Ohio","5/29/20","252","50","39085","19.84"
"Lawrence","0","30","Ohio","5/29/20","28","2","39087","7.14"
"Licking","4","230","Ohio","5/29/20","200","30","39089","15"
"Logan","1","37","Ohio","5/29/20","33","4","39091","12.12"
"Lorain","7","672","Ohio","5/29/20","626","46","39093","7.35"
"Lucas","19","2202","Ohio","5/29/20","2071","131","39095","6.33"
"Madison","3","152","Ohio","5/29/20","128","24","39097","18.75"
"Mahoning","16","1405","Ohio","5/29/20","1295","110","39099","8.49"
"Marion","11","2657","Ohio","5/29/20","2581","76","39101","2.94"
"Medina","10","328","Ohio","5/29/20","258","70","39103","27.13"
"Meigs","0","6","Ohio","5/29/20","5","1","39105","20"
"Mercer","5","203","Ohio","5/29/20","170","33","39107","19.41"
"Miami","3","355","Ohio","5/29/20","337","18","39109","5.34"
"Monroe","1","77","Ohio","5/29/20","71","6","39111","8.45"
"Montgomery","13","651","Ohio","5/29/20","561","90","39113","16.04"
"Morgan","0","5","Ohio","5/29/20","5","0","39115","0"
"Morrow","0","105","Ohio","5/29/20","103","2","39117","1.94"
"Muskingum","1","50","Ohio","5/29/20","43","7","39119","16.28"
"Noble","0","6","Ohio","5/29/20","5","1","39121","20"
"Ottawa","4","95","Ohio","5/29/20","66","29","39123","43.94"
"Paulding","0","14","Ohio","5/29/20","12","2","39125","16.67"
"Perry","0","18","Ohio","5/29/20","17","1","39127","5.88"
"Pickaway","2","2050","Ohio","5/29/20","2033","17","39129","0.84"
"Pike","0","6","Ohio","5/29/20","6","0","39131","0"
"Portage","2","322","Ohio","5/29/20","308","14","39133","4.55"
"Preble","1","35","Ohio","5/29/20","30","5","39135","16.67"
"Putnam","1","90","Ohio","5/29/20","84","6","39137","7.14"
"Richland","3","197","Ohio","5/29/20","178","19","39139","10.67"
"Ross","1","68","Ohio","5/29/20","61","7","39141","11.48"
"Sandusky","1","73","Ohio","5/29/20","63","10","39143","15.87"
"Scioto","0","15","Ohio","5/29/20","14","1","39145","7.14"
"Seneca","1","20","Ohio","5/29/20","16","4","39147","25"
"Shelby","1","40","Ohio","5/29/20","36","4","39149","11.11"
"Stark","9","716","Ohio","5/29/20","655","61","39151","9.31"
"Summit","28","1380","Ohio","5/29/20","1183","197","39153","16.65"
"Trumbull","8","562","Ohio","5/29/20","507","55","39155","10.85"
"Tuscarawas","5","339","Ohio","5/29/20","301","38","39157","12.62"
"Union","2","51","Ohio","5/29/20","40","11","39159","27.5"
"Van Wert","0","6","Ohio","5/29/20","5","1","39161","20"
"Vinton","0","19","Ohio","5/29/20","18","1","39163","5.56"
"Warren","7","359","Ohio","5/29/20","310","49","39165","15.81"
"Washington","0","118","Ohio","5/29/20","116","2","39167","1.72"
"Wayne","3","266","Ohio","5/29/20","242","24","39169","9.92"
"Williams","1","54","Ohio","5/29/20","48","6","39171","12.5"
"Wood","3","285","Ohio","5/29/20","261","24","39173","9.2"
"Wyandot","1","39","Ohio","5/29/20","33","6","39175","18.18"
"Adair","1","85","Oklahoma","5/29/20","79","6","40001","7.59"
"Alfalfa","0","1","Oklahoma","5/29/20","1","0","40003","0"
"Atoka","0","3","Oklahoma","5/29/20","1","2","40005","200"
"Beaver","0","24","Oklahoma","5/29/20","24","0","40007","0"
"Beckham","0","6","Oklahoma","5/29/20","6","0","40009","0"
"Blaine","0","6","Oklahoma","5/29/20","4","2","40011","50"
"Bryan","1","24","Oklahoma","5/29/20","19","5","40013","26.32"
"Caddo","3","155","Oklahoma","5/29/20","132","23","40015","17.42"
"Canadian","1","129","Oklahoma","5/29/20","123","6","40017","4.88"
"Carter","3","39","Oklahoma","5/29/20","21","18","40019","85.71"
"Cherokee","0","28","Oklahoma","5/29/20","28","0","40021","0"
"Choctaw","3","32","Oklahoma","5/29/20","14","18","40023","128.57"
"Cimarron","0","1","Oklahoma","5/29/20","1","0","40025","0"
"Cleveland","2","498","Oklahoma","5/29/20","481","17","40027","3.53"
"Coal","0","1","Oklahoma","5/29/20","1","0","40029","0"
"Comanche","6","279","Oklahoma","5/29/20","236","43","40031","18.22"
"Cotton","0","5","Oklahoma","5/29/20","5","0","40033","0"
"Craig","0","15","Oklahoma","5/29/20","15","0","40035","0"
"Creek","1","93","Oklahoma","5/29/20","88","5","40037","5.68"
"Custer","0","13","Oklahoma","5/29/20","12","1","40039","8.33"
"Delaware","0","100","Oklahoma","5/29/20","97","3","40041","3.09"
"Dewey","0","2","Oklahoma","5/29/20","3","-1","40043","-33.33"
"Garfield","0","26","Oklahoma","5/29/20","25","1","40047","4"
"Garvin","0","17","Oklahoma","5/29/20","15","2","40049","13.33"
"Grady","2","85","Oklahoma","5/29/20","72","13","40051","18.06"
"Grant","0","2","Oklahoma","5/29/20","2","0","40053","0"
"Greer","0","66","Oklahoma","5/29/20","66","0","40055","0"
"Harper","0","1","Oklahoma","5/29/20","1","0","40059","0"
"Haskell","0","6","Oklahoma","5/29/20","6","0","40061","0"
"Hughes","0","1","Oklahoma","5/29/20","0","1","40063","1"
"Jackson","0","24","Oklahoma","5/29/20","21","3","40065","14.29"
"Jefferson","0","3","Oklahoma","5/29/20","3","0","40067","0"
"Johnston","0","3","Oklahoma","5/29/20","3","0","40069","0"
"Kay","0","52","Oklahoma","5/29/20","51","1","40071","1.96"
"Kingfisher","0","11","Oklahoma","5/29/20","11","0","40073","0"
"Kiowa","0","6","Oklahoma","5/29/20","6","0","40075","0"
"Latimer","0","5","Oklahoma","5/29/20","5","0","40077","0"
"Le Flore","0","14","Oklahoma","5/29/20","13","1","40079","7.69"
"Lincoln","0","22","Oklahoma","5/29/20","21","1","40081","4.76"
"Logan","0","19","Oklahoma","5/29/20","18","1","40083","5.56"
"Love","1","15","Oklahoma","5/29/20","6","9","40085","150"
"Major","0","6","Oklahoma","5/29/20","6","0","40093","0"
"Marshall","0","8","Oklahoma","5/29/20","7","1","40095","14.29"
"Mayes","0","30","Oklahoma","5/29/20","29","1","40097","3.45"
"McClain","1","104","Oklahoma","5/29/20","95","9","40087","9.47"
"McCurtain","2","34","Oklahoma","5/29/20","18","16","40089","88.89"
"McIntosh","0","11","Oklahoma","5/29/20","11","0","40091","0"
"Murray","0","4","Oklahoma","5/29/20","2","2","40099","100"
"Muskogee","2","46","Oklahoma","5/29/20","34","12","40101","35.29"
"Noble","0","7","Oklahoma","5/29/20","7","0","40103","0"
"Nowata","0","23","Oklahoma","5/29/20","23","0","40105","0"
"Okfuskee","1","6","Oklahoma","5/29/20","2","4","40107","200"
"Oklahoma","11","1254","Oklahoma","5/29/20","1179","75","40109","6.36"
"Okmulgee","0","25","Oklahoma","5/29/20","22","3","40111","13.64"
"Osage","0","95","Oklahoma","5/29/20","93","2","40113","2.15"
"Ottawa","0","35","Oklahoma","5/29/20","35","0","40115","0"
"Pawnee","0","30","Oklahoma","5/29/20","29","1","40117","3.45"
"Payne","0","45","Oklahoma","5/29/20","45","0","40119","0"
"Pittsburg","0","40","Oklahoma","5/29/20","40","0","40121","0"
"Pontotoc","0","13","Oklahoma","5/29/20","11","2","40123","18.18"
"Pottawatomie","0","59","Oklahoma","5/29/20","56","3","40125","5.36"
"Pushmataha","0","2","Oklahoma","5/29/20","2","0","40127","0"
"Rogers","1","80","Oklahoma","5/29/20","73","7","40131","9.59"
"Seminole","1","26","Oklahoma","5/29/20","21","5","40133","23.81"
"Sequoyah","0","14","Oklahoma","5/29/20","14","0","40135","0"
"Stephens","0","37","Oklahoma","5/29/20","37","0","40137","0"
"Texas","8","908","Oklahoma","5/29/20","851","57","40139","6.7"
"Tillman","0","23","Oklahoma","5/29/20","22","1","40141","4.55"
"Tulsa","13","983","Oklahoma","5/29/20","890","93","40143","10.45"
"Wagoner","1","150","Oklahoma","5/29/20","143","7","40145","4.9"
"Washington","1","314","Oklahoma","5/29/20","309","5","40147","1.62"
"Washita","0","2","Oklahoma","5/29/20","1","1","40149","100"
"Woods","0","3","Oklahoma","5/29/20","3","0","40151","0"
"Woodward","0","4","Oklahoma","5/29/20","3","1","40153","33.33"
"Baker","0","1","Oregon","5/29/20","1","0","41001","0"
"Benton","0","55","Oregon","5/29/20","55","0","41003","0"
"Clackamas","2","305","Oregon","5/29/20","289","16","41005","5.54"
"Clatsop","0","45","Oregon","5/29/20","44","1","41007","2.27"
"Columbia","0","16","Oregon","5/29/20","16","0","41009","0"
"Coos","0","31","Oregon","5/29/20","31","0","41011","0"
"Crook","1","6","Oregon","5/29/20","1","5","41013","500"
"Curry","0","7","Oregon","5/29/20","6","1","41015","16.67"
"Deschutes","1","121","Oregon","5/29/20","116","5","41017","4.31"
"Douglas","0","26","Oregon","5/29/20","25","1","41019","4"
"Grant","0","1","Oregon","5/29/20","1","0","41023","0"
"Harney","0","1","Oregon","5/29/20","1","0","41025","0"
"Hood River","0","14","Oregon","5/29/20","12","2","41027","16.67"
"Jackson","1","65","Oregon","5/29/20","55","10","41029","18.18"
"Jefferson","0","28","Oregon","5/29/20","25","3","41031","12"
"Josephine","0","23","Oregon","5/29/20","25","-2","41033","-8"
"Klamath","0","42","Oregon","5/29/20","41","1","41035","2.44"
"Lake","0","2","Oregon","5/29/20","0","2","41037","1"
"Lane","0","68","Oregon","5/29/20","66","2","41039","3.03"
"Lincoln","1","12","Oregon","5/29/20","8","4","41041","50"
"Linn","0","115","Oregon","5/29/20","112","3","41043","2.68"
"Malheur","1","32","Oregon","5/29/20","28","4","41045","14.29"
"Marion","7","942","Oregon","5/29/20","890","52","41047","5.84"
"Morrow","0","12","Oregon","5/29/20","12","0","41049","0"
"Multnomah","12","1121","Oregon","5/29/20","1037","84","41051","8.1"
"Polk","0","98","Oregon","5/29/20","95","3","41053","3.16"
"Sherman","0","1","Oregon","5/29/20","1","0","41055","0"
"Tillamook","0","6","Oregon","5/29/20","6","0","41057","0"
"Umatilla","1","114","Oregon","5/29/20","108","6","41059","5.56"
"Union","0","6","Oregon","5/29/20","6","0","41061","0"
"Wallowa","0","2","Oregon","5/29/20","1","1","41063","100"
"Wasco","1","22","Oregon","5/29/20","18","4","41065","22.22"
"Washington","8","722","Oregon","5/29/20","669","53","41067","7.92"
"Yamhill","1","69","Oregon","5/29/20","63","6","41071","9.52"
"Adams","4","241","Pennsylvania","5/29/20","214","27","42001","12.62"
"Allegheny","19","1870","Pennsylvania","5/29/20","1739","131","42003","7.53"
"Armstrong","1","62","Pennsylvania","5/29/20","58","4","42005","6.9"
"Beaver","5","582","Pennsylvania","5/29/20","550","32","42007","5.82"
"Bedford","0","39","Pennsylvania","5/29/20","36","3","42009","8.33"
"Berks","21","3988","Pennsylvania","5/29/20","3838","150","42011","3.91"
"Blair","0","49","Pennsylvania","5/29/20","46","3","42013","6.52"
"Bradford","0","46","Pennsylvania","5/29/20","43","3","42015","6.98"
"Bucks","35","5012","Pennsylvania","5/29/20","4764","248","42017","5.21"
"Butler","3","227","Pennsylvania","5/29/20","209","18","42019","8.61"
"Cambria","0","57","Pennsylvania","5/29/20","55","2","42021","3.64"
"Cameron","0","2","Pennsylvania","5/29/20","2","0","42023","0"
"Carbon","1","234","Pennsylvania","5/29/20","224","10","42025","4.46"
"Centre","2","151","Pennsylvania","5/29/20","138","13","42027","9.42"
"Chester","41","2607","Pennsylvania","5/29/20","2320","287","42029","12.37"
"Clarion","0","26","Pennsylvania","5/29/20","25","1","42031","4"
"Clearfield","1","38","Pennsylvania","5/29/20","33","5","42033","15.15"
"Clinton","1","55","Pennsylvania","5/29/20","48","7","42035","14.58"
"Columbia","1","346","Pennsylvania","5/29/20","342","4","42037","1.17"
"Crawford","1","30","Pennsylvania","5/29/20","21","9","42039","42.86"
"Cumberland","7","621","Pennsylvania","5/29/20","572","49","42041","8.57"
"Dauphin","26","1231","Pennsylvania","5/29/20","1049","182","42043","17.35"
"Delaware","46","6379","Pennsylvania","5/29/20","6060","319","42045","5.26"
"Elk","0","6","Pennsylvania","5/29/20","6","0","42047","0"
"Erie","9","253","Pennsylvania","5/29/20","190","63","42049","33.16"
"Fayette","0","95","Pennsylvania","5/29/20","93","2","42051","2.15"
"Forest","0","7","Pennsylvania","5/29/20","7","0","42053","0"
"Franklin","9","762","Pennsylvania","5/29/20","697","65","42055","9.33"
"Fulton","0","15","Pennsylvania","5/29/20","14","1","42057","7.14"
"Greene","0","27","Pennsylvania","5/29/20","27","0","42059","0"
"Huntingdon","1","228","Pennsylvania","5/29/20","223","5","42061","2.24"
"Indiana","0","90","Pennsylvania","5/29/20","89","1","42063","1.12"
"Jefferson","0","7","Pennsylvania","5/29/20","7","0","42065","0"
"Juniata","0","95","Pennsylvania","5/29/20","94","1","42067","1.06"
"Lackawanna","11","1528","Pennsylvania","5/29/20","1451","77","42069","5.31"
"Lancaster","53","3105","Pennsylvania","5/29/20","2736","369","42071","13.49"
"Lawrence","0","76","Pennsylvania","5/29/20","73","3","42073","4.11"
"Lebanon","8","950","Pennsylvania","5/29/20","892","58","42075","6.5"
"Lehigh","18","3738","Pennsylvania","5/29/20","3613","125","42077","3.46"
"Luzerne","13","2711","Pennsylvania","5/29/20","2620","91","42079","3.47"
"Lycoming","1","162","Pennsylvania","5/29/20","155","7","42081","4.52"
"McKean","0","12","Pennsylvania","5/29/20","11","1","42083","9.09"
"Mercer","1","107","Pennsylvania","5/29/20","102","5","42085","4.9"
"Mifflin","0","58","Pennsylvania","5/29/20","57","1","42087","1.75"
"Monroe","3","1315","Pennsylvania","5/29/20","1295","20","42089","1.54"
"Montgomery","77","6906","Pennsylvania","5/29/20","6366","540","42091","8.48"
"Montour","0","50","Pennsylvania","5/29/20","51","-1","42093","-1.96"
"Northampton","29","3045","Pennsylvania","5/29/20","2842","203","42095","7.14"
"Northumberland","4","186","Pennsylvania","5/29/20","155","31","42097","20"
"Perry","2","56","Pennsylvania","5/29/20","43","13","42099","30.23"
"Philadelphia","199","22405","Pennsylvania","5/29/20","21009","1396","42101","6.64"
"Pike","0","476","Pennsylvania","5/29/20","475","1","42103","0.21"
"Potter","0","4","Pennsylvania","5/29/20","4","0","42105","0"
"Schuylkill","8","616","Pennsylvania","5/29/20","560","56","42107","10"
"Snyder","1","39","Pennsylvania","5/29/20","35","4","42109","11.43"
"Somerset","0","37","Pennsylvania","5/29/20","37","0","42111","0"
"Sullivan","0","3","Pennsylvania","5/29/20","2","1","42113","50"
"Susquehanna","2","109","Pennsylvania","5/29/20","93","16","42115","17.2"
"Tioga","0","17","Pennsylvania","5/29/20","16","1","42117","6.25"
"Union","-1","57","Pennsylvania","5/29/20","61","-4","42119","-6.56"
"Venango","0","8","Pennsylvania","5/29/20","8","0","42121","0"
"Warren","0","3","Pennsylvania","5/29/20","3","0","42123","0"
"Washington","1","139","Pennsylvania","5/29/20","134","5","42125","3.73"
"Wayne","1","119","Pennsylvania","5/29/20","115","4","42127","3.48"
"Westmoreland","1","444","Pennsylvania","5/29/20","436","8","42129","1.83"
"Wyoming","0","34","Pennsylvania","5/29/20","33","1","42131","3.03"
"York","14","991","Pennsylvania","5/29/20","895","96","42133","10.73"
"","88","3647","Puerto Rico","5/29/20","3030","617",,"20.36"
"Bristol","2","224","Rhode Island","5/29/20","209","15","44001","7.18"
"Kent","10","1052","Rhode Island","5/29/20","985","67","44003","6.8"
"Newport","5","244","Rhode Island","5/29/20","212","32","44005","15.09"
"Providence","105","11052","Rhode Island","5/29/20","10320","732","44007","7.09"
"Washington","2","499","Rhode Island","5/29/20","482","17","44009","3.53"
"Abbeville","0","39","South Carolina","5/29/20","36","3","45001","8.33"
"Aiken","4","191","South Carolina","5/29/20","166","25","45003","15.06"
"Allendale","0","34","South Carolina","5/29/20","34","0","45005","0"
"Anderson","2","234","South Carolina","5/29/20","219","15","45007","6.85"
"Bamberg","0","21","South Carolina","5/29/20","20","1","45009","5"
"Barnwell","0","44","South Carolina","5/29/20","41","3","45011","7.32"
"Beaufort","7","361","South Carolina","5/29/20","314","47","45013","14.97"
"Berkeley","2","228","South Carolina","5/29/20","211","17","45015","8.06"
"Calhoun","0","11","South Carolina","5/29/20","9","2","45017","22.22"
"Charleston","7","586","South Carolina","5/29/20","540","46","45019","8.52"
"Cherokee","1","34","South Carolina","5/29/20","26","8","45021","30.77"
"Chester","3","62","South Carolina","5/29/20","44","18","45023","40.91"
"Chesterfield","7","165","South Carolina","5/29/20","118","47","45025","39.83"
"Clarendon","1","296","South Carolina","5/29/20","289","7","45027","2.42"
"Colleton","4","92","South Carolina","5/29/20","66","26","45029","39.39"
"Darlington","5","276","South Carolina","5/29/20","242","34","45031","14.05"
"Dillon","1","156","South Carolina","5/29/20","146","10","45033","6.85"
"Dorchester","5","161","South Carolina","5/29/20","126","35","45035","27.78"
"Edgefield","1","51","South Carolina","5/29/20","47","4","45037","8.51"
"Fairfield","2","168","South Carolina","5/29/20","155","13","45039","8.39"
"Florence","9","637","South Carolina","5/29/20","574","63","45041","10.98"
"Georgetown","3","74","South Carolina","5/29/20","54","20","45043","37.04"
"Greenville","37","1461","South Carolina","5/29/20","1200","261","45045","21.75"
"Greenwood","7","128","South Carolina","5/29/20","79","49","45047","62.03"
"Hampton","1","36","South Carolina","5/29/20","31","5","45049","16.13"
"Horry","7","410","South Carolina","5/29/20","359","51","45051","14.21"
"Jasper","1","39","South Carolina","5/29/20","30","9","45053","30"
"Kershaw","5","324","South Carolina","5/29/20","289","35","45055","12.11"
"Lancaster","1","129","South Carolina","5/29/20","120","9","45057","7.5"
"Laurens","1","65","South Carolina","5/29/20","57","8","45059","14.04"
"Lee","4","212","South Carolina","5/29/20","181","31","45061","17.13"
"Lexington","9","597","South Carolina","5/29/20","537","60","45063","11.17"
"Marion","1","68","South Carolina","5/29/20","60","8","45067","13.33"
"Marlboro","8","149","South Carolina","5/29/20","91","58","45069","63.74"
"McCormick","0","8","South Carolina","5/29/20","8","0","45065","0"
"Newberry","2","55","South Carolina","5/29/20","44","11","45071","25"
"Oconee","1","50","South Carolina","5/29/20","42","8","45073","19.05"
"Orangeburg","7","168","South Carolina","5/29/20","122","46","45075","37.7"
"Pickens","4","138","South Carolina","5/29/20","110","28","45077","25.45"
"Richland","18","1461","South Carolina","5/29/20","1333","128","45079","9.6"
"Saluda","1","142","South Carolina","5/29/20","132","10","45081","7.58"
"Spartanburg","17","555","South Carolina","5/29/20","439","116","45083","26.42"
"Sumter","4","365","South Carolina","5/29/20","339","26","45085","7.67"
"Union","1","36","South Carolina","5/29/20","31","5","45087","16.13"
"Williamsburg","4","229","South Carolina","5/29/20","198","31","45089","15.66"
"York","8","385","South Carolina","5/29/20","329","56","45091","17.02"
"Aurora","0","23","South Dakota","5/29/20","20","3","46003","15"
"Beadle","18","222","South Dakota","5/29/20","98","124","46005","126.53"
"Bon Homme","0","8","South Dakota","5/29/20","5","3","46009","60"
"Brookings","0","16","South Dakota","5/29/20","14","2","46011","14.29"
"Brown","5","269","South Dakota","5/29/20","235","34","46013","14.47"
"Buffalo","1","12","South Dakota","5/29/20","7","5","46017","71.43"
"Charles Mix","1","16","South Dakota","5/29/20","11","5","46023","45.45"
"Clark","0","4","South Dakota","5/29/20","4","0","46025","0"
"Clay","0","15","South Dakota","5/29/20","15","0","46027","0"
"Codington","1","35","South Dakota","5/29/20","25","10","46029","40"
"Corson","0","4","South Dakota","5/29/20","4","0","46031","0"
"Davison","1","14","South Dakota","5/29/20","9","5","46035","55.56"
"Day","0","13","South Dakota","5/29/20","11","2","46037","18.18"
"Deuel","0","1","South Dakota","5/29/20","1","0","46039","0"
"Douglas","0","3","South Dakota","5/29/20","1","2","46043","200"
"Edmunds","0","1","South Dakota","5/29/20","0","1","46045","1"
"Fall River","0","4","South Dakota","5/29/20","4","0","46047","0"
"Faulk","0","1","South Dakota","5/29/20","1","0","46049","0"
"Grant","0","13","South Dakota","5/29/20","10","3","46051","30"
"Hamlin","0","4","South Dakota","5/29/20","3","1","46057","33.33"
"Hand","0","2","South Dakota","5/29/20","1","1","46059","100"
"Hughes","0","19","South Dakota","5/29/20","17","2","46065","11.76"
"Hutchinson","0","4","South Dakota","5/29/20","3","1","46067","33.33"
"Hyde","0","1","South Dakota","5/29/20","1","0","46069","0"
"Jackson","0","3","South Dakota","5/29/20","0","3","46071","1"
"Jerauld","3","34","South Dakota","5/29/20","16","18","46073","112.5"
"Kingsbury","0","1","South Dakota","5/29/20","0","1","46077","1"
"Lake","0","8","South Dakota","5/29/20","5","3","46079","60"
"Lawrence","0","11","South Dakota","5/29/20","9","2","46081","22.22"
"Lincoln","3","236","South Dakota","5/29/20","218","18","46083","8.26"
"Lyman","0","13","South Dakota","5/29/20","10","3","46085","30"
"Marshall","0","4","South Dakota","5/29/20","4","0","46091","0"
"McCook","0","5","South Dakota","5/29/20","5","0","46087","0"
"McPherson","0","1","South Dakota","5/29/20","1","0","46089","0"
"Meade","1","13","South Dakota","5/29/20","6","7","46093","116.67"
"Miner","0","1","South Dakota","5/29/20","1","0","46097","0"
"Minnehaha","17","3330","South Dakota","5/29/20","3211","119","46099","3.71"
"Moody","0","19","South Dakota","5/29/20","18","1","46101","5.56"
"Oglala Lakota","1","21","South Dakota","5/29/20","15","6","46102","40"
"Pennington","11","201","South Dakota","5/29/20","127","74","46103","58.27"
"Roberts","2","35","South Dakota","5/29/20","22","13","46109","59.09"
"Sanborn","1","12","South Dakota","5/29/20","8","4","46111","50"
"Spink","0","5","South Dakota","5/29/20","4","1","46115","25"
"Stanley","0","10","South Dakota","5/29/20","9","1","46117","11.11"
"Sully","0","1","South Dakota","5/29/20","1","0","46119","0"
"Todd","1","23","South Dakota","5/29/20","17","6","46121","35.29"
"Tripp","0","6","South Dakota","5/29/20","3","3","46123","100"
"Turner","0","24","South Dakota","5/29/20","22","2","46125","9.09"
"Union","2","88","South Dakota","5/29/20","73","15","46127","20.55"
"Walworth","0","5","South Dakota","5/29/20","5","0","46129","0"
"Yankton","1","51","South Dakota","5/29/20","45","6","46135","13.33"
"Ziebach","0","1","South Dakota","5/29/20","1","0","46137","0"
"Anderson","0","39","Tennessee","5/29/20","37","2","47001","5.41"
"Bedford","3","283","Tennessee","5/29/20","263","20","47003","7.6"
"Benton","0","7","Tennessee","5/29/20","7","0","47005","0"
"Bledsoe","0","608","Tennessee","5/29/20","607","1","47007","0.16"
"Blount","2","89","Tennessee","5/29/20","78","11","47009","14.1"
"Bradley","3","113","Tennessee","5/29/20","90","23","47011","25.56"
"Campbell","0","17","Tennessee","5/29/20","17","0","47013","0"
"Cannon","0","17","Tennessee","5/29/20","15","2","47015","13.33"
"Carroll","0","27","Tennessee","5/29/20","26","1","47017","3.85"
"Carter","0","19","Tennessee","5/29/20","19","0","47019","0"
"Cheatham","3","118","Tennessee","5/29/20","100","18","47021","18"
"Chester","0","12","Tennessee","5/29/20","12","0","47023","0"
"Claiborne","0","9","Tennessee","5/29/20","8","1","47025","12.5"
"Clay","0","7","Tennessee","5/29/20","6","1","47027","16.67"
"Cocke","0","20","Tennessee","5/29/20","20","0","47029","0"
"Coffee","1","70","Tennessee","5/29/20","64","6","47031","9.38"
"Crockett","0","16","Tennessee","5/29/20","14","2","47033","14.29"
"Cumberland","2","111","Tennessee","5/29/20","97","14","47035","14.43"
"Davidson","82","4968","Tennessee","5/29/20","4396","572","47037","13.01"
"Decatur","0","5","Tennessee","5/29/20","5","0","47039","0"
"DeKalb","1","37","Tennessee","5/29/20","32","5","47041","15.62"
"Dickson","1","110","Tennessee","5/29/20","101","9","47043","8.91"
"Dyer","1","50","Tennessee","5/29/20","46","4","47045","8.7"
"Fayette","2","112","Tennessee","5/29/20","100","12","47047","12"
"Fentress","0","12","Tennessee","5/29/20","9","3","47049","33.33"
"Franklin","1","51","Tennessee","5/29/20","45","6","47051","13.33"
"Gibson","0","62","Tennessee","5/29/20","60","2","47053","3.33"
"Giles","0","12","Tennessee","5/29/20","12","0","47055","0"
"Grainger","0","6","Tennessee","5/29/20","6","0","47057","0"
"Greene","0","49","Tennessee","5/29/20","47","2","47059","4.26"
"Grundy","0","32","Tennessee","5/29/20","31","1","47061","3.23"
"Hamblen","1","34","Tennessee","5/29/20","25","9","47063","36"
"Hamilton","41","753","Tennessee","5/29/20","468","285","47065","60.9"
"Hancock","0","1","Tennessee","5/29/20","1","0","47067","0"
"Hardeman","1","195","Tennessee","5/29/20","187","8","47069","4.28"
"Hardin","0","12","Tennessee","5/29/20","10","2","47071","20"
"Hawkins","0","32","Tennessee","5/29/20","31","1","47073","3.23"
"Haywood","0","30","Tennessee","5/29/20","29","1","47075","3.45"
"Henderson","0","15","Tennessee","5/29/20","12","3","47077","25"
"Henry","0","30","Tennessee","5/29/20","29","1","47079","3.45"
"Hickman","1","57","Tennessee","5/29/20","52","5","47081","9.62"
"Houston","0","8","Tennessee","5/29/20","7","1","47083","14.29"
"Humphreys","0","13","Tennessee","5/29/20","12","1","47085","8.33"
"Jackson","0","17","Tennessee","5/29/20","14","3","47087","21.43"
"Jefferson","0","28","Tennessee","5/29/20","27","1","47089","3.7"
"Johnson","0","16","Tennessee","5/29/20","15","1","47091","6.67"
"Knox","6","366","Tennessee","5/29/20","322","44","47093","13.66"
"Lake","1","413","Tennessee","5/29/20","406","7","47095","1.72"
"Lauderdale","1","56","Tennessee","5/29/20","51","5","47097","9.8"
"Lawrence","1","29","Tennessee","5/29/20","23","6","47099","26.09"
"Lewis","0","3","Tennessee","5/29/20","3","0","47101","0"
"Lincoln","0","25","Tennessee","5/29/20","26","-1","47103","-3.85"
"Loudon","2","142","Tennessee","5/29/20","130","12","47105","9.23"
"Macon","5","130","Tennessee","5/29/20","97","33","47111","34.02"
"Madison","2","175","Tennessee","5/29/20","163","12","47113","7.36"
"Marion","1","39","Tennessee","5/29/20","35","4","47115","11.43"
"Marshall","0","31","Tennessee","5/29/20","28","3","47117","10.71"
"Maury","1","88","Tennessee","5/29/20","78","10","47119","12.82"
"McMinn","2","136","Tennessee","5/29/20","124","12","47107","9.68"
"McNairy","0","12","Tennessee","5/29/20","12","0","47109","0"
"Meigs","1","26","Tennessee","5/29/20","22","4","47121","18.18"
"Monroe","1","61","Tennessee","5/29/20","57","4","47123","7.02"
"Montgomery","6","262","Tennessee","5/29/20","218","44","47125","20.18"
"Moore","0","3","Tennessee","5/29/20","3","0","47127","0"
"Morgan","0","17","Tennessee","5/29/20","17","0","47129","0"
"Obion","1","30","Tennessee","5/29/20","21","9","47131","42.86"
"Out of TN","6","379","Tennessee","5/29/20","339","40","80047","11.8"
"Overton","1","26","Tennessee","5/29/20","18","8","47133","44.44"
"Perry","1","17","Tennessee","5/29/20","13","4","47135","30.77"
"Pickett","0","3","Tennessee","5/29/20","2","1","47137","50"
"Polk","0","15","Tennessee","5/29/20","14","1","47139","7.14"
"Putnam","16","465","Tennessee","5/29/20","350","115","47141","32.86"
"Rhea","2","209","Tennessee","5/29/20","193","16","47143","8.29"
"Roane","1","16","Tennessee","5/29/20","10","6","47145","60"
"Robertson","16","449","Tennessee","5/29/20","335","114","47147","34.03"
"Rutherford","30","1162","Tennessee","5/29/20","950","212","47149","22.32"
"Scott","0","12","Tennessee","5/29/20","11","1","47151","9.09"
"Sequatchie","1","15","Tennessee","5/29/20","10","5","47153","50"
"Sevier","1","80","Tennessee","5/29/20","70","10","47155","14.29"
"Shelby","99","4823","Tennessee","5/29/20","4127","696","47157","16.86"
"Smith","0","32","Tennessee","5/29/20","29","3","47159","10.34"
"Stewart","0","11","Tennessee","5/29/20","8","3","47161","37.5"
"Sullivan","0","60","Tennessee","5/29/20","61","-1","47163","-1.64"
"Sumner","9","858","Tennessee","5/29/20","792","66","47165","8.33"
"Tipton","2","437","Tennessee","5/29/20","423","14","47167","3.31"
"Trousdale","0","1393","Tennessee","5/29/20","1390","3","47169","0.22"
"Unicoi","0","4","Tennessee","5/29/20","3","1","47171","33.33"
"Union","0","4","Tennessee","5/29/20","4","0","47173","0"
"Van Buren","0","4","Tennessee","5/29/20","4","0","47175","0"
"Warren","1","23","Tennessee","5/29/20","16","7","47177","43.75"
"Washington","1","75","Tennessee","5/29/20","68","7","47179","10.29"
"Wayne","0","63","Tennessee","5/29/20","63","0","47181","0"
"Weakley","0","26","Tennessee","5/29/20","26","0","47183","0"
"White","1","31","Tennessee","5/29/20","22","9","47185","40.91"
"Williamson","6","542","Tennessee","5/29/20","500","42","47187","8.4"
"Wilson","7","389","Tennessee","5/29/20","343","46","47189","13.41"
"Anderson","0","66","Texas","5/29/20","63","3","48001","4.76"
"Andrews","1","27","Texas","5/29/20","22","5","48003","22.73"
"Angelina","5","201","Texas","5/29/20","168","33","48005","19.64"
"Aransas","0","5","Texas","5/29/20","5","0","48007","0"
"Archer","0","1","Texas","5/29/20","1","0","48009","0"
"Armstrong","0","2","Texas","5/29/20","2","0","48011","0"
"Atascosa","0","35","Texas","5/29/20","35","0","48013","0"
"Austin","0","24","Texas","5/29/20","21","3","48015","14.29"
"Bailey","1","14","Texas","5/29/20","10","4","48017","40"
"Bandera","0","6","Texas","5/29/20","6","0","48019","0"
"Bastrop","5","196","Texas","5/29/20","161","35","48021","21.74"
"Bee","0","9","Texas","5/29/20","8","1","48025","12.5"
"Bell","8","335","Texas","5/29/20","282","53","48027","18.79"
"Bexar","30","2583","Texas","5/29/20","2371","212","48029","8.94"
"Blanco","0","8","Texas","5/29/20","7","1","48031","14.29"
"Bosque","0","6","Texas","5/29/20","6","0","48035","0"
"Bowie","2","189","Texas","5/29/20","176","13","48037","7.39"
"Brazoria","8","861","Texas","5/29/20","805","56","48039","6.96"
"Brazos","13","455","Texas","5/29/20","362","93","48041","25.69"
"Brewster","0","1","Texas","5/29/20","1","0","48043","0"
"Briscoe","0","1","Texas","5/29/20","1","0","48045","0"
"Brooks","0","1","Texas","5/29/20","1","0","48047","0"
"Brown","0","57","Texas","5/29/20","55","2","48049","3.64"
"Burleson","0","23","Texas","5/29/20","20","3","48051","15"
"Burnet","0","32","Texas","5/29/20","29","3","48053","10.34"
"Caldwell","2","57","Texas","5/29/20","41","16","48055","39.02"
"Calhoun","0","37","Texas","5/29/20","37","0","48057","0"
"Callahan","0","9","Texas","5/29/20","8","1","48059","12.5"
"Cameron","11","743","Texas","5/29/20","664","79","48061","11.9"
"Camp","6","74","Texas","5/29/20","32","42","48063","131.25"
"Carson","0","6","Texas","5/29/20","6","0","48065","0"
"Cass","1","29","Texas","5/29/20","21","8","48067","38.1"
"Castro","0","32","Texas","5/29/20","29","3","48069","10.34"
"Chambers","1","62","Texas","5/29/20","58","4","48071","6.9"
"Cherokee","0","44","Texas","5/29/20","44","0","48073","0"
"Childress","0","2","Texas","5/29/20","2","0","48075","0"
"Clay","0","3","Texas","5/29/20","3","0","48077","0"
"Cochran","0","1","Texas","5/29/20","1","0","48079","0"
"Coke","0","1","Texas","5/29/20","1","0","48081","0"
"Coleman","0","3","Texas","5/29/20","2","1","48083","50"
"Collin","18","1217","Texas","5/29/20","1090","127","48085","11.65"
"Collingsworth","0","5","Texas","5/29/20","4","1","48087","25"
"Colorado","0","22","Texas","5/29/20","19","3","48089","15.79"
"Comal","1","87","Texas","5/29/20","78","9","48091","11.54"
"Comanche","1","9","Texas","5/29/20","5","4","48093","80"
"Concho","0","1","Texas","5/29/20","1","0","48095","0"
"Cooke","0","13","Texas","5/29/20","13","0","48097","0"
"Coryell","0","227","Texas","5/29/20","226","1","48099","0.44"
"Cottle","0","4","Texas","5/29/20","4","0","48101","0"
"Crane","3","22","Texas","5/29/20","3","19","48103","633.33"
"Crosby","0","3","Texas","5/29/20","3","0","48107","0"
"Dallam","0","24","Texas","5/29/20","22","2","48111","9.09"
"Dallas","187","9787","Texas","5/29/20","8477","1310","48113","15.45"
"Dawson","0","40","Texas","5/29/20","39","1","48115","2.56"
"Deaf Smith","3","161","Texas","5/29/20","141","20","48117","14.18"
"Delta","0","1","Texas","5/29/20","1","0","48119","0"
"Denton","18","1285","Texas","5/29/20","1161","124","48121","10.68"
"DeWitt","0","17","Texas","5/29/20","17","0","48123","0"
"Dickens","0","1","Texas","5/29/20","1","0","48125","0"
"Dimmit","0","1","Texas","5/29/20","1","0","48127","0"
"Donley","0","26","Texas","5/29/20","26","0","48129","0"
"Duval","0","5","Texas","5/29/20","5","0","48131","0"
"Eastland","0","6","Texas","5/29/20","5","1","48133","20"
"Ector","3","152","Texas","5/29/20","130","22","48135","16.92"
"El Paso","75","2569","Texas","5/29/20","2046","523","48141","25.56"
"Ellis","6","305","Texas","5/29/20","266","39","48139","14.66"
"Erath","0","16","Texas","5/29/20","15","1","48143","6.67"
"Falls","0","6","Texas","5/29/20","6","0","48145","0"
"Fannin","1","37","Texas","5/29/20","29","8","48147","27.59"
"Fayette","0","34","Texas","5/29/20","31","3","48149","9.68"
"Fisher","0","2","Texas","5/29/20","2","0","48151","0"
"Floyd","0","8","Texas","5/29/20","5","3","48153","60"
"Fort Bend","16","1766","Texas","5/29/20","1652","114","48157","6.9"
"Franklin","1","13","Texas","5/29/20","8","5","48159","62.5"
"Freestone","0","10","Texas","5/29/20","7","3","48161","42.86"
"Frio","0","37","Texas","5/29/20","35","2","48163","5.71"
"Gaines","0","7","Texas","5/29/20","6","1","48165","16.67"
"Galveston","8","779","Texas","5/29/20","721","58","48167","8.04"
"Garza","0","5","Texas","5/29/20","4","1","48169","25"
"Gillespie","0","5","Texas","5/29/20","5","0","48171","0"
"Glasscock","0","1","Texas","5/29/20","1","0","48173","0"
"Goliad","0","7","Texas","5/29/20","7","0","48175","0"
"Gonzales","3","111","Texas","5/29/20","90","21","48177","23.33"
"Gray","0","96","Texas","5/29/20","95","1","48179","1.05"
"Grayson","7","316","Texas","5/29/20","268","48","48181","17.91"
"Gregg","3","201","Texas","5/29/20","180","21","48183","11.67"
"Grimes","3","113","Texas","5/29/20","91","22","48185","24.18"
"Guadalupe","1","126","Texas","5/29/20","116","10","48187","8.62"
"Hale","1","56","Texas","5/29/20","50","6","48189","12"
"Hall","0","2","Texas","5/29/20","1","1","48191","100"
"Hamilton","0","7","Texas","5/29/20","7","0","48193","0"
"Hansford","0","18","Texas","5/29/20","18","0","48195","0"
"Hardeman","0","1","Texas","5/29/20","0","1","48197","1"
"Hardin","2","137","Texas","5/29/20","121","16","48199","13.22"
"Harris","212","12009","Texas","5/29/20","10526","1483","48201","14.09"
"Harrison","3","239","Texas","5/29/20","217","22","48203","10.14"
"Hartley","0","11","Texas","5/29/20","11","0","48205","0"
"Haskell","0","2","Texas","5/29/20","2","0","48207","0"
"Hays","7","297","Texas","5/29/20","250","47","48209","18.8"
"Hemphill","0","1","Texas","5/29/20","1","0","48211","0"
"Henderson","1","57","Texas","5/29/20","51","6","48213","11.76"
"Hidalgo","11","548","Texas","5/29/20","472","76","48215","16.1"
"Hill","0","24","Texas","5/29/20","23","1","48217","4.35"
"Hockley","0","27","Texas","5/29/20","27","0","48219","0"
"Hood","0","26","Texas","5/29/20","23","3","48221","13.04"
"Hopkins","2","24","Texas","5/29/20","12","12","48223","100"
"Houston","0","84","Texas","5/29/20","81","3","48225","3.7"
"Howard","0","7","Texas","5/29/20","6","1","48227","16.67"
"Hudspeth","0","1","Texas","5/29/20","0","1","48229","1"
"Hunt","1","76","Texas","5/29/20","71","5","48231","7.04"
"Hutchinson","0","34","Texas","5/29/20","31","3","48233","9.68"
"Jack","0","4","Texas","5/29/20","4","0","48237","0"
"Jackson","0","18","Texas","5/29/20","16","2","48239","12.5"
"Jasper","0","28","Texas","5/29/20","26","2","48241","7.69"
"Jefferson","8","518","Texas","5/29/20","465","53","48245","11.4"
"Jim Hogg","0","4","Texas","5/29/20","4","0","48247","0"
"Jim Wells","0","9","Texas","5/29/20","9","0","48249","0"
"Johnson","3","165","Texas","5/29/20","144","21","48251","14.58"
"Jones","27","323","Texas","5/29/20","134","189","48253","141.04"
"Karnes","0","4","Texas","5/29/20","4","0","48255","0"
"Kaufman","4","203","Texas","5/29/20","173","30","48257","17.34"
"Kendall","1","28","Texas","5/29/20","24","4","48259","16.67"
"Kerr","1","17","Texas","5/29/20","11","6","48265","54.55"
"Kimble","0","1","Texas","5/29/20","1","0","48267","0"
"Kleberg","0","16","Texas","5/29/20","14","2","48273","14.29"
"Knox","0","1","Texas","5/29/20","1","0","48275","0"
"La Salle","0","4","Texas","5/29/20","4","0","48283","0"
"Lamar","1","136","Texas","5/29/20","126","10","48277","7.94"
"Lamb","1","16","Texas","5/29/20","11","5","48279","45.45"
"Lampasas","0","8","Texas","5/29/20","8","0","48281","0"
"Lavaca","0","11","Texas","5/29/20","8","3","48285","37.5"
"Lee","2","21","Texas","5/29/20","8","13","48287","162.5"
"Leon","0","10","Texas","5/29/20","9","1","48289","11.11"
"Liberty","0","81","Texas","5/29/20","81","0","48291","0"
"Limestone","1","23","Texas","5/29/20","18","5","48293","27.78"
"Lipscomb","0","2","Texas","5/29/20","2","0","48295","0"
"Live Oak","0","9","Texas","5/29/20","9","0","48297","0"
"Llano","0","3","Texas","5/29/20","3","0","48299","0"
"Lubbock","5","677","Texas","5/29/20","639","38","48303","5.95"
"Lynn","0","6","Texas","5/29/20","5","1","48305","20"
"Madison","0","8","Texas","5/29/20","8","0","48313","0"
"Marion","0","16","Texas","5/29/20","15","1","48315","6.67"
"Martin","0","3","Texas","5/29/20","3","0","48317","0"
"Mason","0","31","Texas","5/29/20","31","0","48319","0"
"Matagorda","0","70","Texas","5/29/20","67","3","48321","4.48"
"Maverick","3","116","Texas","5/29/20","98","18","48323","18.37"
"McCulloch","0","3","Texas","5/29/20","3","0","48307","0"
"McLennan","2","113","Texas","5/29/20","102","11","48309","10.78"
"Medina","1","69","Texas","5/29/20","64","5","48325","7.81"
"Midland","0","126","Texas","5/29/20","123","3","48329","2.44"
"Milam","0","28","Texas","5/29/20","27","1","48331","3.7"
"Mills","0","1","Texas","5/29/20","1","0","48333","0"
"Mitchell","0","1","Texas","5/29/20","1","0","48335","0"
"Montague","0","9","Texas","5/29/20","9","0","48337","0"
"Montgomery","9","954","Texas","5/29/20","888","66","48339","7.43"
"Moore","1","583","Texas","5/29/20","579","4","48341","0.69"
"Morris","2","27","Texas","5/29/20","15","12","48343","80"
"Motley","0","1","Texas","5/29/20","1","0","48345","0"
"Nacogdoches","4","271","Texas","5/29/20","244","27","48347","11.07"
"Navarro","1","49","Texas","5/29/20","40","9","48349","22.5"
"Newton","0","4","Texas","5/29/20","4","0","48351","0"
"Nolan","0","2","Texas","5/29/20","2","0","48353","0"
"Nueces","1","268","Texas","5/29/20","260","8","48355","3.08"
"Ochiltree","1","48","Texas","5/29/20","41","7","48357","17.07"
"Oldham","0","3","Texas","5/29/20","3","0","48359","0"
"Orange","1","96","Texas","5/29/20","89","7","48361","7.87"
"Palo Pinto","0","11","Texas","5/29/20","10","1","48363","10"
"Panola","1","196","Texas","5/29/20","188","8","48365","4.26"
"Parker","0","70","Texas","5/29/20","67","3","48367","4.48"
"Parmer","2","53","Texas","5/29/20","39","14","48369","35.9"
"Pecos","5","56","Texas","5/29/20","24","32","48371","133.33"
"Polk","0","54","Texas","5/29/20","52","2","48373","3.85"
"Potter","10","2266","Texas","5/29/20","2196","70","48375","3.19"
"Presidio","0","1","Texas","5/29/20","0","1","48377","1"
"Rains","0","3","Texas","5/29/20","3","0","48379","0"
"Randall","4","655","Texas","5/29/20","625","30","48381","4.8"
"Reagan","0","1","Texas","5/29/20","0","1","48383","1"
"Red River","1","50","Texas","5/29/20","42","8","48387","19.05"
"Reeves","0","7","Texas","5/29/20","7","0","48389","0"
"Refugio","0","3","Texas","5/29/20","3","0","48391","0"
"Roberts","0","2","Texas","5/29/20","2","0","48393","0"
"Robertson","0","7","Texas","5/29/20","7","0","48395","0"
"Rockwall","2","159","Texas","5/29/20","147","12","48397","8.16"
"Runnels","0","2","Texas","5/29/20","2","0","48399","0"
"Rusk","0","45","Texas","5/29/20","42","3","48401","7.14"
"Sabine","0","6","Texas","5/29/20","4","2","48403","50"
"San Augustine","0","31","Texas","5/29/20","28","3","48405","10.71"
"San Jacinto","0","14","Texas","5/29/20","13","1","48407","7.69"
"San Patricio","1","32","Texas","5/29/20","28","4","48409","14.29"
"San Saba","0","1","Texas","5/29/20","1","0","48411","0"
"Scurry","0","2","Texas","5/29/20","2","0","48415","0"
"Shackelford","0","1","Texas","5/29/20","1","0","48417","0"
"Shelby","1","189","Texas","5/29/20","180","9","48419","5"
"Sherman","0","23","Texas","5/29/20","23","0","48421","0"
"Smith","1","200","Texas","5/29/20","195","5","48423","2.56"
"Starr","1","27","Texas","5/29/20","23","4","48427","17.39"
"Stephens","0","4","Texas","5/29/20","2","2","48429","100"
"Swisher","0","18","Texas","5/29/20","15","3","48437","20"
"Tarrant","68","5190","Texas","5/29/20","4711","479","48439","10.17"
"Taylor","0","231","Texas","5/29/20","228","3","48441","1.32"
"Terry","0","13","Texas","5/29/20","13","0","48445","0"
"Titus","28","443","Texas","5/29/20","248","195","48449","78.63"
"Tom Green","0","93","Texas","5/29/20","90","3","48451","3.33"
"Travis","59","3057","Texas","5/29/20","2644","413","48453","15.62"
"Trinity","0","13","Texas","5/29/20","11","2","48455","18.18"
"Tyler","0","11","Texas","5/29/20","10","1","48457","10"
"Upshur","0","20","Texas","5/29/20","18","2","48459","11.11"
"Uvalde","0","6","Texas","5/29/20","6","0","48463","0"
"Val Verde","1","20","Texas","5/29/20","14","6","48465","42.86"
"Van Zandt","1","30","Texas","5/29/20","25","5","48467","20"
"Victoria","0","159","Texas","5/29/20","157","2","48469","1.27"
"Walker","62","869","Texas","5/29/20","436","433","48471","99.31"
"Waller","1","55","Texas","5/29/20","45","10","48473","22.22"
"Ward","0","1","Texas","5/29/20","0","1","48475","1"
"Washington","1","197","Texas","5/29/20","187","10","48477","5.35"
"Webb","4","524","Texas","5/29/20","498","26","48479","5.22"
"Wharton","2","57","Texas","5/29/20","45","12","48481","26.67"
"Wheeler","0","15","Texas","5/29/20","15","0","48483","0"
"Wichita","0","84","Texas","5/29/20","82","2","48485","2.44"
"Wilbarger","0","6","Texas","5/29/20","6","0","48487","0"
"Willacy","0","14","Texas","5/29/20","15","-1","48489","-6.67"
"Williamson","11","605","Texas","5/29/20","528","77","48491","14.58"
"Wilson","0","38","Texas","5/29/20","38","0","48493","0"
"Winkler","0","3","Texas","5/29/20","3","0","48495","0"
"Wise","0","45","Texas","5/29/20","42","3","48497","7.14"
"Wood","1","26","Texas","5/29/20","22","4","48499","18.18"
"Yoakum","0","3","Texas","5/29/20","3","0","48501","0"
"Young","0","4","Texas","5/29/20","4","0","48503","0"
"Zapata","0","8","Texas","5/29/20","8","0","48505","0"
"Zavala","0","11","Texas","5/29/20","11","0","48507","0"
"Bear River","8","156","Utah","5/29/20","98","58","00000","59.18"
"Central Utah","1","38","Utah","5/29/20","34","4","00000","11.76"
"Davis","7","447","Utah","5/29/20","401","46","49011","11.47"
"Salt Lake","98","4994","Utah","5/29/20","4308","686","49035","15.92"
"San Juan","5","286","Utah","5/29/20","254","32","49037","12.6"
"Southeast Utah","1","23","Utah","5/29/20","18","5","00000","27.78"
"Southwest Utah","15","386","Utah","5/29/20","281","105","00000","37.37"
"Summit","1","412","Utah","5/29/20","403","9","49043","2.23"
"Tooele","2","125","Utah","5/29/20","108","17","49045","15.74"
"TriCounty","0","18","Utah","5/29/20","21","-3","00000","-14.29"
"Utah","25","1826","Utah","5/29/20","1651","175","49049","10.6"
"Wasatch","5","265","Utah","5/29/20","228","37","49051","16.23"
"Weber-Morgan","5","288","Utah","5/29/20","252","36","00000","14.29"
"Addison","0","62","Vermont","5/29/20","62","0","50001","0"
"Bennington","0","63","Vermont","5/29/20","60","3","50003","5"
"Caledonia","0","15","Vermont","5/29/20","14","1","50005","7.14"
"Chittenden","1","448","Vermont","5/29/20","440","8","50007","1.82"
"Essex","0","3","Vermont","5/29/20","3","0","50009","0"
"Franklin","0","99","Vermont","5/29/20","99","0","50011","0"
"Grand Isle","0","7","Vermont","5/29/20","5","2","50013","40"
"Lamoille","0","29","Vermont","5/29/20","29","0","50015","0"
"Orange","0","8","Vermont","5/29/20","8","0","50017","0"
"Orleans","0","10","Vermont","5/29/20","9","1","50019","11.11"
"Rutland","1","55","Vermont","5/29/20","51","4","50021","7.84"
"Washington","0","39","Vermont","5/29/20","38","1","50023","2.63"
"Windham","0","81","Vermont","5/29/20","80","1","50025","1.25"
"Windsor","0","51","Vermont","5/29/20","49","2","50027","4.08"
"","0","69","Virgin Islands","5/29/20","69","0",,"0"
"Accomack","17","827","Virginia","5/29/20","711","116","51001","16.32"
"Albemarle","5","180","Virginia","5/29/20","142","38","51003","26.76"
"Alexandria","41","1941","Virginia","5/29/20","1657","284","51510","17.14"
"Alleghany","1","19","Virginia","5/29/20","10","9","51005","90"
"Amelia","0","25","Virginia","5/29/20","22","3","51007","13.64"
"Amherst","0","27","Virginia","5/29/20","25","2","51009","8"
"Appomattox","1","31","Virginia","5/29/20","26","5","51011","19.23"
"Arlington","42","2089","Virginia","5/29/20","1795","294","51013","16.38"
"Augusta","3","105","Virginia","5/29/20","86","19","51015","22.09"
"Bedford","1","47","Virginia","5/29/20","41","6","51019","14.63"
"Botetourt","0","32","Virginia","5/29/20","31","1","51023","3.23"
"Bristol","0","4","Virginia","5/29/20","4","0","51520","0"
"Brunswick","1","25","Virginia","5/29/20","21","4","51025","19.05"
"Buchanan","0","18","Virginia","5/29/20","18","0","51027","0"
"Buckingham","2","453","Virginia","5/29/20","439","14","51029","3.19"
"Buena Vista","0","13","Virginia","5/29/20","12","1","51530","8.33"
"Campbell","1","17","Virginia","5/29/20","13","4","51031","30.77"
"Caroline","2","58","Virginia","5/29/20","45","13","51033","28.89"
"Carroll","3","90","Virginia","5/29/20","66","24","51035","36.36"
"Charles City","0","27","Virginia","5/29/20","25","2","51036","8"
"Charlotte","1","23","Virginia","5/29/20","19","4","51037","21.05"
"Charlottesville","4","105","Virginia","5/29/20","74","31","51540","41.89"
"Chesapeake","11","494","Virginia","5/29/20","419","75","51550","17.9"
"Chesterfield","35","1400","Virginia","5/29/20","1152","248","51041","21.53"
"Clarke","1","25","Virginia","5/29/20","21","4","51043","19.05"
"Colonial Heights","0","86","Virginia","5/29/20","83","3","51570","3.61"
"Covington","0","3","Virginia","5/29/20","3","0","51580","0"
"Craig","0","5","Virginia","5/29/20","5","0","51045","0"
"Culpeper","16","666","Virginia","5/29/20","555","111","51047","20"
"Cumberland","1","35","Virginia","5/29/20","25","10","51049","40"
"Danville","1","51","Virginia","5/29/20","46","5","51590","10.87"
"Dinwiddie","3","71","Virginia","5/29/20","47","24","51053","51.06"
"Emporia","3","78","Virginia","5/29/20","60","18","51595","30"
"Essex","1","46","Virginia","5/29/20","36","10","51057","27.78"
"Fairfax","286","10738","Virginia","5/29/20","8734","2004","51059","22.94"
"Fairfax City","2","63","Virginia","5/29/20","51","12","51600","23.53"
"Falls Church","1","55","Virginia","5/29/20","46","9","51610","19.57"
"Fauquier","6","308","Virginia","5/29/20","267","41","51061","15.36"
"Floyd","0","6","Virginia","5/29/20","4","2","51063","50"
"Fluvanna","1","90","Virginia","5/29/20","84","6","51065","7.14"
"Franklin","1","35","Virginia","5/29/20","31","4","51067","12.9"
"Franklin City","1","42","Virginia","5/29/20","34","8","51620","23.53"
"Frederick","12","331","Virginia","5/29/20","249","82","51069","32.93"
"Fredericksburg","5","147","Virginia","5/29/20","109","38","51630","34.86"
"Galax","3","107","Virginia","5/29/20","85","22","51640","25.88"
"Giles","0","5","Virginia","5/29/20","5","0","51071","0"
"Gloucester","0","30","Virginia","5/29/20","30","0","51073","0"
"Goochland","1","95","Virginia","5/29/20","89","6","51075","6.74"
"Grayson","1","34","Virginia","5/29/20","24","10","51077","41.67"
"Greene","1","31","Virginia","5/29/20","21","10","51079","47.62"
"Greensville","2","69","Virginia","5/29/20","55","14","51081","25.45"
"Halifax","0","30","Virginia","5/29/20","29","1","51083","3.45"
"Hampton","3","192","Virginia","5/29/20","169","23","51650","13.61"
"Hanover","11","320","Virginia","5/29/20","246","74","51085","30.08"
"Harrisonburg","9","765","Virginia","5/29/20","704","61","51660","8.66"
"Henrico","43","1678","Virginia","5/29/20","1375","303","51087","22.04"
"Henry","6","99","Virginia","5/29/20","59","40","51089","67.8"
"Highland","0","3","Virginia","5/29/20","3","0","51091","0"
"Hopewell","3","85","Virginia","5/29/20","66","19","51670","28.79"
"Isle of Wight","1","127","Virginia","5/29/20","122","5","51093","4.1"
"James City","2","202","Virginia","5/29/20","191","11","51095","5.76"
"King and Queen","0","10","Virginia","5/29/20","7","3","51097","42.86"
"King George","2","62","Virginia","5/29/20","50","12","51099","24"
"King William","1","26","Virginia","5/29/20","19","7","51101","36.84"
"Lancaster","0","10","Virginia","5/29/20","10","0","51103","0"
"Lee","0","9","Virginia","5/29/20","9","0","51105","0"
"Lexington","0","7","Virginia","5/29/20","6","1","51678","16.67"
"Loudoun","89","2429","Virginia","5/29/20","1807","622","51107","34.42"
"Louisa","1","76","Virginia","5/29/20","67","9","51109","13.43"
"Lunenburg","1","12","Virginia","5/29/20","7","5","51111","71.43"
"Lynchburg","0","80","Virginia","5/29/20","77","3","51680","3.9"
"Madison","2","39","Virginia","5/29/20","27","12","51113","44.44"
"Manassas","34","1004","Virginia","5/29/20","764","240","51683","31.41"
"Manassas Park","8","287","Virginia","5/29/20","228","59","51685","25.88"
"Martinsville","1","31","Virginia","5/29/20","25","6","51690","24"
"Mathews","0","5","Virginia","5/29/20","5","0","51115","0"
"Mecklenburg","3","214","Virginia","5/29/20","192","22","51117","11.46"
"Middlesex","0","14","Virginia","5/29/20","12","2","51119","16.67"
"Montgomery","1","73","Virginia","5/29/20","67","6","51121","8.96"
"Nelson","0","16","Virginia","5/29/20","13","3","51125","23.08"
"New Kent","1","36","Virginia","5/29/20","26","10","51127","38.46"
"Newport News","5","257","Virginia","5/29/20","224","33","51700","14.73"
"Norfolk","12","470","Virginia","5/29/20","388","82","51710","21.13"
"Northampton","3","228","Virginia","5/29/20","206","22","51131","10.68"
"Northumberland","0","25","Virginia","5/29/20","22","3","51133","13.64"
"Norton","0","2","Virginia","5/29/20","2","0","51720","0"
"Nottoway","1","25","Virginia","5/29/20","19","6","51135","31.58"
"Orange","3","97","Virginia","5/29/20","73","24","51137","32.88"
"Page","6","214","Virginia","5/29/20","172","42","51139","24.42"
"Patrick","1","18","Virginia","5/29/20","12","6","51141","50"
"Petersburg","5","118","Virginia","5/29/20","84","34","51730","40.48"
"Pittsylvania","2","39","Virginia","5/29/20","27","12","51143","44.44"
"Poquoson","0","7","Virginia","5/29/20","7","0","51735","0"
"Portsmouth","6","294","Virginia","5/29/20","251","43","51740","17.13"
"Powhatan","1","32","Virginia","5/29/20","26","6","51145","23.08"
"Prince Edward","4","129","Virginia","5/29/20","104","25","51147","24.04"
"Prince George","9","121","Virginia","5/29/20","56","65","51149","116.07"
"Prince William","136","5270","Virginia","5/29/20","4315","955","51153","22.13"
"Pulaski","1","19","Virginia","5/29/20","10","9","51155","90"
"Radford","0","6","Virginia","5/29/20","4","2","51750","50"
"Rappahannock","0","13","Virginia","5/29/20","12","1","51157","8.33"
"Richmond","1","276","Virginia","5/29/20","267","9","51159","3.37"
"Richmond City","38","1202","Virginia","5/29/20","934","268","51760","28.69"
"Roanoke","2","102","Virginia","5/29/20","90","12","51161","13.33"
"Roanoke City","2","152","Virginia","5/29/20","140","12","51770","8.57"
"Rockbridge","0","16","Virginia","5/29/20","13","3","51163","23.08"
"Rockingham","9","505","Virginia","5/29/20","444","61","51165","13.74"
"Russell","0","8","Virginia","5/29/20","8","0","51167","0"
"Salem","0","34","Virginia","5/29/20","32","2","51775","6.25"
"Scott","0","7","Virginia","5/29/20","7","0","51169","0"
"Shenandoah","10","429","Virginia","5/29/20","358","71","51171","19.83"
"Smyth","0","15","Virginia","5/29/20","15","0","51173","0"
"Southampton","1","146","Virginia","5/29/20","137","9","51175","6.57"
"Spotsylvania","18","500","Virginia","5/29/20","373","127","51177","34.05"
"Stafford","18","681","Virginia","5/29/20","552","129","51179","23.37"
"Staunton","0","36","Virginia","5/29/20","34","2","51790","5.88"
"Suffolk","4","311","Virginia","5/29/20","283","28","51800","9.89"
"Surry","1","10","Virginia","5/29/20","6","4","51181","66.67"
"Sussex","7","151","Virginia","5/29/20","100","51","51183","51"
"Tazewell","0","7","Virginia","5/29/20","6","1","51185","16.67"
"Virginia Beach","13","680","Virginia","5/29/20","591","89","51810","15.06"
"Warren","5","146","Virginia","5/29/20","110","36","51187","32.73"
"Washington","0","51","Virginia","5/29/20","51","0","51191","0"
"Waynesboro","1","41","Virginia","5/29/20","36","5","51820","13.89"
"Westmoreland","3","63","Virginia","5/29/20","43","20","51193","46.51"
"Williamsburg","0","44","Virginia","5/29/20","43","1","51830","2.33"
"Winchester","8","176","Virginia","5/29/20","121","55","51840","45.45"
"Wise","0","24","Virginia","5/29/20","24","0","51195","0"
"Wythe","1","21","Virginia","5/29/20","17","4","51197","23.53"
"York","1","72","Virginia","5/29/20","67","5","51199","7.46"
"Adams","1","59","Washington","5/29/20","50","9","53001","18"
"Asotin","0","19","Washington","5/29/20","18","1","53003","5.56"
"Benton","12","757","Washington","5/29/20","674","83","53005","12.31"
"Chelan","6","244","Washington","5/29/20","204","40","53007","19.61"
"Clallam","0","25","Washington","5/29/20","25","0","53009","0"
"Clark","11","477","Washington","5/29/20","399","78","53011","19.55"
"Columbia","0","1","Washington","5/29/20","1","0","53013","0"
"Cowlitz","0","73","Washington","5/29/20","71","2","53015","2.82"
"Douglas","4","167","Washington","5/29/20","139","28","53017","20.14"
"Ferry","0","1","Washington","5/29/20","1","0","53019","0"
"Franklin","8","535","Washington","5/29/20","480","55","53021","11.46"
"Grant","2","202","Washington","5/29/20","189","13","53025","6.88"
"Grays Harbor","0","16","Washington","5/29/20","16","0","53027","0"
"Island","0","178","Washington","5/29/20","177","1","53029","0.56"
"Jefferson","0","30","Washington","5/29/20","30","0","53031","0"
"King","40","7949","Washington","5/29/20","7669","280","53033","3.65"
"Kitsap","0","161","Washington","5/29/20","160","1","53035","0.62"
"Kittitas","2","83","Washington","5/29/20","66","17","53037","25.76"
"Klickitat","0","24","Washington","5/29/20","24","0","53039","0"
"Lewis","0","35","Washington","5/29/20","35","0","53041","0"
"Lincoln","0","2","Washington","5/29/20","2","0","53043","0"
"Mason","0","35","Washington","5/29/20","34","1","53045","2.94"
"Okanogan","1","47","Washington","5/29/20","42","5","53047","11.9"
"Pacific","0","9","Washington","5/29/20","9","0","53049","0"
"Pend Oreille","0","3","Washington","5/29/20","2","1","53051","50"
"Pierce","26","1909","Washington","5/29/20","1728","181","53053","10.47"
"San Juan","0","15","Washington","5/29/20","15","0","53055","0"
"Skagit","1","430","Washington","5/29/20","426","4","53057","0.94"
"Skamania","0","3","Washington","5/29/20","3","0","53059","0"
"Snohomish","12","2945","Washington","5/29/20","2863","82","53061","2.86"
"Spokane","17","555","Washington","5/29/20","437","118","53063","27"
"Stevens","0","11","Washington","5/29/20","10","1","53065","10"
"Thurston","1","133","Washington","5/29/20","124","9","53067","7.26"
"Wahkiakum","0","4","Washington","5/29/20","4","0","53069","0"
"Walla Walla","0","108","Washington","5/29/20","106","2","53071","1.89"
"Whatcom","3","383","Washington","5/29/20","363","20","53073","5.51"
"Whitman","0","16","Washington","5/29/20","16","0","53075","0"
"Yakima","111","3369","Washington","5/29/20","2594","775","53077","29.88"
"Barbour","0","9","West Virginia","5/29/20","7","2","54001","28.57"
"Berkeley","6","301","West Virginia","5/29/20","256","45","54003","17.58"
"Boone","0","10","West Virginia","5/29/20","9","1","54005","11.11"
"Braxton","0","2","West Virginia","5/29/20","2","0","54007","0"
"Brooke","0","4","West Virginia","5/29/20","3","1","54009","33.33"
"Cabell","1","61","West Virginia","5/29/20","57","4","54011","7.02"
"Calhoun","0","2","West Virginia","5/29/20","2","0","54013","0"
"Clay","0","2","West Virginia","5/29/20","2","0","54015","0"
"Fayette","1","46","West Virginia","5/29/20","42","4","54019","9.52"
"Gilmer","0","10","West Virginia","5/29/20","9","1","54021","11.11"
"Grant","1","11","West Virginia","5/29/20","6","5","54023","83.33"
"Greenbrier","0","9","West Virginia","5/29/20","9","0","54025","0"
"Hampshire","2","29","West Virginia","5/29/20","13","16","54027","123.08"
"Hancock","0","17","West Virginia","5/29/20","15","2","54029","13.33"
"Hardy","0","38","West Virginia","5/29/20","35","3","54031","8.57"
"Harrison","0","41","West Virginia","5/29/20","38","3","54033","7.89"
"Jackson","0","135","West Virginia","5/29/20","135","0","54035","0"
"Jefferson","5","172","West Virginia","5/29/20","140","32","54037","22.86"
"Kanawha","1","220","West Virginia","5/29/20","212","8","54039","3.77"
"Lewis","0","7","West Virginia","5/29/20","5","2","54041","40"
"Lincoln","0","5","West Virginia","5/29/20","5","0","54043","0"
"Logan","0","17","West Virginia","5/29/20","16","1","54045","6.25"
"Marion","0","50","West Virginia","5/29/20","48","2","54049","4.17"
"Marshall","0","28","West Virginia","5/29/20","27","1","54051","3.7"
"Mason","0","15","West Virginia","5/29/20","15","0","54053","0"
"McDowell","0","6","West Virginia","5/29/20","6","0","54047","0"
"Mercer","0","13","West Virginia","5/29/20","13","0","54055","0"
"Mineral","1","45","West Virginia","5/29/20","36","9","54057","25"
"Mingo","1","7","West Virginia","5/29/20","3","4","54059","133.33"
"Monongalia","2","132","West Virginia","5/29/20","119","13","54061","10.92"
"Monroe","0","7","West Virginia","5/29/20","6","1","54063","16.67"
"Morgan","0","18","West Virginia","5/29/20","17","1","54065","5.88"
"Nicholas","0","8","West Virginia","5/29/20","10","-2","54067","-20"
"Ohio","0","41","West Virginia","5/29/20","38","3","54069","7.89"
"Pendleton","1","11","West Virginia","5/29/20","6","5","54071","83.33"
"Pleasants","0","4","West Virginia","5/29/20","3","1","54073","33.33"
"Pocahontas","-1","19","West Virginia","5/29/20","24","-5","54075","-20.83"
"Preston","1","22","West Virginia","5/29/20","15","7","54077","46.67"
"Putnam","1","35","West Virginia","5/29/20","31","4","54079","12.9"
"Raleigh","0","16","West Virginia","5/29/20","14","2","54081","14.29"
"Randolph","14","126","West Virginia","5/29/20","28","98","54083","350"
"Ritchie","0","1","West Virginia","5/29/20","1","0","54085","0"
"Roane","0","9","West Virginia","5/29/20","8","1","54087","12.5"
"Summers","0","1","West Virginia","5/29/20","1","0","54089","0"
"Taylor","0","8","West Virginia","5/29/20","8","0","54091","0"
"Tucker","0","4","West Virginia","5/29/20","4","0","54093","0"
"Tyler","0","3","West Virginia","5/29/20","3","0","54095","0"
"Upshur","0","7","West Virginia","5/29/20","6","1","54097","16.67"
"Wayne","0","98","West Virginia","5/29/20","97","1","54099","1.03"
"Wetzel","0","8","West Virginia","5/29/20","8","0","54103","0"
"Wirt","0","4","West Virginia","5/29/20","4","0","54105","0"
"Wood","1","54","West Virginia","5/29/20","48","6","54107","12.5"
"Wyoming","0","3","West Virginia","5/29/20","3","0","54109","0"
"Adams","0","4","Wisconsin","5/29/20","4","0","55001","0"
"Ashland","0","2","Wisconsin","5/29/20","2","0","55003","0"
"Barron","1","15","Wisconsin","5/29/20","11","4","55005","36.36"
"Bayfield","0","3","Wisconsin","5/29/20","3","0","55007","0"
"Brown","15","2308","Wisconsin","5/29/20","2204","104","55009","4.72"
"Buffalo","0","5","Wisconsin","5/29/20","5","0","55011","0"
"Burnett","0","1","Wisconsin","5/29/20","1","0","55013","0"
"Calumet","1","75","Wisconsin","5/29/20","67","8","55015","11.94"
"Chippewa","1","55","Wisconsin","5/29/20","46","9","55017","19.57"
"Clark","1","32","Wisconsin","5/29/20","28","4","55019","14.29"
"Columbia","1","43","Wisconsin","5/29/20","37","6","55021","16.22"
"Crawford","0","26","Wisconsin","5/29/20","25","1","55023","4"
"Dane","17","705","Wisconsin","5/29/20","587","118","55025","20.1"
"Dodge","6","180","Wisconsin","5/29/20","137","43","55027","31.39"
"Door","0","38","Wisconsin","5/29/20","35","3","55029","8.57"
"Douglas","0","19","Wisconsin","5/29/20","16","3","55031","18.75"
"Dunn","0","24","Wisconsin","5/29/20","21","3","55033","14.29"
"Eau Claire","3","107","Wisconsin","5/29/20","89","18","55035","20.22"
"Florence","0","2","Wisconsin","5/29/20","2","0","55037","0"
"Fond du Lac","6","194","Wisconsin","5/29/20","155","39","55039","25.16"
"Forest","2","28","Wisconsin","5/29/20","11","17","55041","154.55"
"Grant","2","94","Wisconsin","5/29/20","81","13","55043","16.05"
"Green","2","65","Wisconsin","5/29/20","49","16","55045","32.65"
"Green Lake","1","18","Wisconsin","5/29/20","13","5","55047","38.46"
"Iowa","1","15","Wisconsin","5/29/20","11","4","55049","36.36"
"Iron","0","2","Wisconsin","5/29/20","2","0","55051","0"
"Jackson","0","16","Wisconsin","5/29/20","15","1","55053","6.67"
"Jefferson","4","101","Wisconsin","5/29/20","75","26","55055","34.67"
"Juneau","0","23","Wisconsin","5/29/20","22","1","55057","4.55"
"Kenosha","26","1131","Wisconsin","5/29/20","948","183","55059","19.3"
"Kewaunee","0","34","Wisconsin","5/29/20","32","2","55061","6.25"
"La Crosse","1","53","Wisconsin","5/29/20","48","5","55063","10.42"
"Lafayette","1","27","Wisconsin","5/29/20","17","10","55065","58.82"
"Langlade","0","2","Wisconsin","5/29/20","1","1","55067","100"
"Lincoln","1","7","Wisconsin","5/29/20","3","4","55069","133.33"
"Manitowoc","1","36","Wisconsin","5/29/20","28","8","55071","28.57"
"Marathon","1","46","Wisconsin","5/29/20","36","10","55073","27.78"
"Marinette","0","33","Wisconsin","5/29/20","30","3","55075","10"
"Marquette","0","3","Wisconsin","5/29/20","3","0","55077","0"
"Menominee","0","3","Wisconsin","5/29/20","2","1","55078","50"
"Milwaukee","242","7429","Wisconsin","5/29/20","5735","1694","55079","29.54"
"Monroe","0","16","Wisconsin","5/29/20","16","0","55081","0"
"Oconto","0","35","Wisconsin","5/29/20","32","3","55083","9.38"
"Oneida","0","9","Wisconsin","5/29/20","7","2","55085","28.57"
"Outagamie","6","213","Wisconsin","5/29/20","174","39","55087","22.41"
"Ozaukee","4","159","Wisconsin","5/29/20","133","26","55089","19.55"
"Pepin","0","1","Wisconsin","5/29/20","1","0","55091","0"
"Pierce","2","45","Wisconsin","5/29/20","34","11","55093","32.35"
"Polk","1","18","Wisconsin","5/29/20","13","5","55095","38.46"
"Portage","0","11","Wisconsin","5/29/20","8","3","55097","37.5"
"Price","0","2","Wisconsin","5/29/20","2","0","55099","0"
"Racine","55","1652","Wisconsin","5/29/20","1269","383","55101","30.18"
"Richland","0","14","Wisconsin","5/29/20","14","0","55103","0"
"Rock","14","620","Wisconsin","5/29/20","520","100","55105","19.23"
"Rusk","0","5","Wisconsin","5/29/20","4","1","55107","25"
"Sauk","0","78","Wisconsin","5/29/20","77","1","55111","1.3"
"Sawyer","0","8","Wisconsin","5/29/20","7","1","55113","14.29"
"Shawano","1","45","Wisconsin","5/29/20","36","9","55115","25"
"Sheboygan","1","87","Wisconsin","5/29/20","78","9","55117","11.54"
"St. Croix","3","77","Wisconsin","5/29/20","58","19","55109","32.76"
"Taylor","0","2","Wisconsin","5/29/20","1","1","55119","100"
"Trempealeau","2","24","Wisconsin","5/29/20","13","11","55121","84.62"
"Vernon","1","21","Wisconsin","5/29/20","14","7","55123","50"
"Vilas","0","6","Wisconsin","5/29/20","6","0","55125","0"
"Walworth","7","379","Wisconsin","5/29/20","329","50","55127","15.2"
"Washburn","0","2","Wisconsin","5/29/20","2","0","55129","0"
"Washington","9","238","Wisconsin","5/29/20","178","60","55131","33.71"
"Waukesha","18","665","Wisconsin","5/29/20","537","128","55133","23.84"
"Waupaca","1","29","Wisconsin","5/29/20","20","9","55135","45"
"Waushara","0","8","Wisconsin","5/29/20","7","1","55137","14.29"
"Winnebago","9","224","Wisconsin","5/29/20","160","64","55139","40"
"Wood","0","10","Wisconsin","5/29/20","9","1","55141","11.11"
"Albany","2","25","Wyoming","5/29/20","10","15","56001","150"
"Big Horn","0","5","Wyoming","5/29/20","3","2","56003","66.67"
"Campbell","0","31","Wyoming","5/29/20","30","1","56005","3.33"
"Carbon","0","16","Wyoming","5/29/20","16","0","56007","0"
"Converse","0","24","Wyoming","5/29/20","24","0","56009","0"
"Crook","0","5","Wyoming","5/29/20","5","0","56011","0"
"Fremont","5","273","Wyoming","5/29/20","238","35","56013","14.71"
"Goshen","0","5","Wyoming","5/29/20","5","0","56015","0"
"Hot Springs","0","12","Wyoming","5/29/20","9","3","56017","33.33"
"Johnson","0","18","Wyoming","5/29/20","16","2","56019","12.5"
"Laramie","1","188","Wyoming","5/29/20","182","6","56021","3.3"
"Lincoln","0","15","Wyoming","5/29/20","15","0","56023","0"
"Natrona","1","76","Wyoming","5/29/20","68","8","56025","11.76"
"Niobrara","0","2","Wyoming","5/29/20","2","0","56027","0"
"Park","0","2","Wyoming","5/29/20","2","0","56029","0"
"Platte","0","1","Wyoming","5/29/20","1","0","56031","0"
"Sheridan","0","16","Wyoming","5/29/20","16","0","56033","0"
"Sublette","0","3","Wyoming","5/29/20","3","0","56035","0"
"Sweetwater","0","26","Wyoming","5/29/20","25","1","56037","4"
"Teton","0","100","Wyoming","5/29/20","100","0","56039","0"
"Uinta","0","12","Wyoming","5/29/20","13","-1","56041","-7.69"
"Washakie","2","35","Wyoming","5/29/20","20","15","56043","75"
"Weston","0","1","Wyoming","5/29/20","0","1","56045","1"
