"Locality","DailyAvgNewCasesPast7Days","TotalCases","State","Date","TotalCases7DaysAgo","NewCasesPast7Days","FIPS-Code","PercentIncreaseTotalCasesPast7Days"
"Autauga","7","149","Alabama","5/22/20","103","46","01001","44.66"
"Baldwin","4","271","Alabama","5/22/20","244","27","01003","11.07"
"Barbour","4","104","Alabama","5/22/20","79","25","01005","31.65"
"Bibb","1","55","Alabama","5/22/20","49","6","01007","12.24"
"Blount","1","49","Alabama","5/22/20","45","4","01009","8.89"
"Bullock","8","89","Alabama","5/22/20","32","57","01011","178.12"
"Butler","10","329","Alabama","5/22/20","258","71","01013","27.52"
"Calhoun","1","137","Alabama","5/22/20","129","8","01015","6.2"
"Chambers","1","330","Alabama","5/22/20","326","4","01017","1.23"
"Cherokee","1","33","Alabama","5/22/20","26","7","01019","26.92"
"Chilton","1","85","Alabama","5/22/20","75","10","01021","13.33"
"Choctaw","8","135","Alabama","5/22/20","81","54","01023","66.67"
"Clarke","3","92","Alabama","5/22/20","70","22","01025","31.43"
"Clay","0","27","Alabama","5/22/20","27","0","01027","0"
"Cleburne","0","13","Alabama","5/22/20","13","0","01029","0"
"Coffee","4","189","Alabama","5/22/20","162","27","01031","16.67"
"Colbert","5","117","Alabama","5/22/20","83","34","01033","40.96"
"Conecuh","1","24","Alabama","5/22/20","18","6","01035","33.33"
"Coosa","0","33","Alabama","5/22/20","34","-1","01037","-2.94"
"Covington","1","63","Alabama","5/22/20","56","7","01039","12.5"
"Crenshaw","0","53","Alabama","5/22/20","53","0","01041","0"
"Cullman","1","73","Alabama","5/22/20","68","5","01043","7.35"
"Dale","3","77","Alabama","5/22/20","57","20","01045","35.09"
"Dallas","6","182","Alabama","5/22/20","137","45","01047","32.85"
"DeKalb","3","209","Alabama","5/22/20","190","19","01049","10"
"Elmore","9","242","Alabama","5/22/20","178","64","01051","35.96"
"Escambia","0","39","Alabama","5/22/20","39","0","01053","0"
"Etowah","4","225","Alabama","5/22/20","199","26","01055","13.07"
"Fayette","0","11","Alabama","5/22/20","9","2","01057","22.22"
"Franklin","16","422","Alabama","5/22/20","309","113","01059","36.57"
"Geneva","1","28","Alabama","5/22/20","19","9","01061","47.37"
"Greene","1","88","Alabama","5/22/20","79","9","01063","11.39"
"Hale","6","119","Alabama","5/22/20","79","40","01065","50.63"
"Henry","2","50","Alabama","5/22/20","37","13","01067","35.14"
"Houston","4","156","Alabama","5/22/20","129","27","01069","20.93"
"Jackson","1","69","Alabama","5/22/20","61","8","01071","13.11"
"Jefferson","34","1498","Alabama","5/22/20","1258","240","01073","19.08"
"Lamar","0","17","Alabama","5/22/20","14","3","01075","21.43"
"Lauderdale","2","122","Alabama","5/22/20","110","12","01077","10.91"
"Lawrence","2","40","Alabama","5/22/20","29","11","01079","37.93"
"Lee","4","471","Alabama","5/22/20","444","27","01081","6.08"
"Limestone","1","72","Alabama","5/22/20","64","8","01083","12.5"
"Lowndes","7","172","Alabama","5/22/20","122","50","01085","40.98"
"Macon","0","58","Alabama","5/22/20","55","3","01087","5.45"
"Madison","2","286","Alabama","5/22/20","274","12","01089","4.38"
"Marengo","3","125","Alabama","5/22/20","101","24","01091","23.76"
"Marion","1","107","Alabama","5/22/20","101","6","01093","5.94"
"Marshall","4","642","Alabama","5/22/20","612","30","01095","4.9"
"Mobile","38","1916","Alabama","5/22/20","1653","263","01097","15.91"
"Monroe","1","23","Alabama","5/22/20","18","5","01099","27.78"
"Montgomery","44","1096","Alabama","5/22/20","787","309","01101","39.26"
"Morgan","5","144","Alabama","5/22/20","109","35","01103","32.11"
"Perry","1","28","Alabama","5/22/20","20","8","01105","40"
"Pickens","2","86","Alabama","5/22/20","73","13","01107","17.81"
"Pike","3","127","Alabama","5/22/20","105","22","01109","20.95"
"Randolph","1","123","Alabama","5/22/20","119","4","01111","3.36"
"Russell","3","120","Alabama","5/22/20","96","24","01113","25"
"Shelby","4","420","Alabama","5/22/20","391","29","01117","7.42"
"St. Clair","1","98","Alabama","5/22/20","88","10","01115","11.36"
"Sumter","7","172","Alabama","5/22/20","120","52","01119","43.33"
"Talladega","1","85","Alabama","5/22/20","75","10","01121","13.33"
"Tallapoosa","5","387","Alabama","5/22/20","351","36","01123","10.26"
"Tuscaloosa","19","464","Alabama","5/22/20","332","132","01125","39.76"
"Walker","9","179","Alabama","5/22/20","119","60","01127","50.42"
"Washington","0","63","Alabama","5/22/20","60","3","01129","5"
"Wilcox","3","110","Alabama","5/22/20","92","18","01131","19.57"
"Winston","3","52","Alabama","5/22/20","28","24","01133","85.71"
"Anchorage","1","206","Alaska","5/22/20","199","7","02020","3.52"
"Bethel","0","2","Alaska","5/22/20","1","1","02050","100"
"Fairbanks North Star","0","85","Alaska","5/22/20","84","1","02090","1.19"
"Juneau","0","31","Alaska","5/22/20","29","2","02110","6.9"
"Kenai Peninsula","0","26","Alaska","5/22/20","24","2","02122","8.33"
"Ketchikan Gateway","0","16","Alaska","5/22/20","16","0","02130","0"
"Kodiak Island","0","1","Alaska","5/22/20","1","0","02150","0"
"Matanuska-Susitna","0","22","Alaska","5/22/20","21","1","02170","4.76"
"Nome","0","2","Alaska","5/22/20","1","1","02180","100"
"Northwest Arctic","0","1","Alaska","5/22/20","0","1","02188","1"
"Petersburg","0","4","Alaska","5/22/20","4","0","02195","0"
"Prince of Wales-Hyder","0","2","Alaska","5/22/20","2","0","02198","0"
"Sitka","0","1","Alaska","5/22/20","1","0","02220","0"
"Southeast Fairbanks","0","3","Alaska","5/22/20","3","0","02240","0"
"Yukon-Koyukuk","0","1","Alaska","5/22/20","1","0","02290","0"
"Apache","30","1139","Arizona","5/22/20","927","212","04001","22.87"
"Cochise","2","56","Arizona","5/22/20","45","11","04003","24.44"
"Coconino","22","979","Arizona","5/22/20","823","156","04005","18.96"
"Gila","0","24","Arizona","5/22/20","22","2","04007","9.09"
"Graham","0","21","Arizona","5/22/20","21","0","04009","0"
"Greenlee","0","3","Arizona","5/22/20","2","1","04011","50"
"La Paz","2","48","Arizona","5/22/20","36","12","04012","33.33"
"Maricopa","161","7950","Arizona","5/22/20","6821","1129","04013","16.55"
"Mohave","7","288","Arizona","5/22/20","242","46","04015","19.01"
"Navajo","42","1470","Arizona","5/22/20","1177","293","04017","24.89"
"Pima","32","1974","Arizona","5/22/20","1750","224","04019","12.8"
"Pinal","11","749","Arizona","5/22/20","670","79","04021","11.79"
"Santa Cruz","9","131","Arizona","5/22/20","69","62","04023","89.86"
"Yavapai","4","284","Arizona","5/22/20","254","30","04025","11.81"
"Yuma","28","508","Arizona","5/22/20","310","198","04027","63.87"
"Arkansas","0","2","Arkansas","5/22/20","2","0","05001","0"
"Ashley","0","19","Arkansas","5/22/20","18","1","05003","5.56"
"Baxter","0","6","Arkansas","5/22/20","6","0","05005","0"
"Benton","10","212","Arkansas","5/22/20","139","73","05007","52.52"
"Boone","0","5","Arkansas","5/22/20","4","1","05009","25"
"Bradley","0","16","Arkansas","5/22/20","13","3","05011","23.08"
"Carroll","0","9","Arkansas","5/22/20","6","3","05015","50"
"Chicot","0","12","Arkansas","5/22/20","10","2","05017","20"
"Clark","0","36","Arkansas","5/22/20","35","1","05019","2.86"
"Clay","0","4","Arkansas","5/22/20","3","1","05021","33.33"
"Cleburne","0","73","Arkansas","5/22/20","72","1","05023","1.39"
"Cleveland","0","18","Arkansas","5/22/20","16","2","05025","12.5"
"Columbia","1","20","Arkansas","5/22/20","15","5","05027","33.33"
"Conway","0","14","Arkansas","5/22/20","14","0","05029","0"
"Craighead","6","174","Arkansas","5/22/20","130","44","05031","33.85"
"Crawford","0","12","Arkansas","5/22/20","9","3","05033","33.33"
"Crittenden","7","276","Arkansas","5/22/20","229","47","05035","20.52"
"Cross","1","42","Arkansas","5/22/20","35","7","05037","20"
"Dallas","0","1","Arkansas","5/22/20","1","0","05039","0"
"Desha","0","18","Arkansas","5/22/20","18","0","05041","0"
"Drew","0","19","Arkansas","5/22/20","19","0","05043","0"
"Faulkner","1","98","Arkansas","5/22/20","88","10","05045","11.36"
"Franklin","0","2","Arkansas","5/22/20","2","0","05047","0"
"Fulton","0","6","Arkansas","5/22/20","3","3","05049","100"
"Garland","1","132","Arkansas","5/22/20","127","5","05051","3.94"
"Grant","0","16","Arkansas","5/22/20","16","0","05053","0"
"Greene","3","42","Arkansas","5/22/20","24","18","05055","75"
"Hempstead","0","11","Arkansas","5/22/20","9","2","05057","22.22"
"Hot Spring","0","29","Arkansas","5/22/20","29","0","05059","0"
"Howard","0","15","Arkansas","5/22/20","14","1","05061","7.14"
"Independence","1","27","Arkansas","5/22/20","23","4","05063","17.39"
"Izard","0","14","Arkansas","5/22/20","13","1","05065","7.69"
"Jackson","0","1","Arkansas","5/22/20","1","0","05067","0"
"Jefferson","27","501","Arkansas","5/22/20","310","191","05069","61.61"
"Johnson","0","36","Arkansas","5/22/20","35","1","05071","2.86"
"Lafayette","0","9","Arkansas","5/22/20","9","0","05073","0"
"Lawrence","1","81","Arkansas","5/22/20","72","9","05075","12.5"
"Lee","0","13","Arkansas","5/22/20","10","3","05077","30"
"Lincoln","2","966","Arkansas","5/22/20","952","14","05079","1.47"
"Little River","0","1","Arkansas","5/22/20","0","1","05081","1"
"Logan","0","4","Arkansas","5/22/20","4","0","05083","0"
"Lonoke","0","46","Arkansas","5/22/20","45","1","05085","2.22"
"Madison","0","3","Arkansas","5/22/20","1","2","05087","200"
"Marion","0","1","Arkansas","5/22/20","1","0","05089","0"
"Miller","0","42","Arkansas","5/22/20","42","0","05091","0"
"Mississippi","2","70","Arkansas","5/22/20","58","12","05093","20.69"
"Monroe","0","5","Arkansas","5/22/20","5","0","05095","0"
"Montgomery","0","1","Arkansas","5/22/20","1","0","05097","0"
"Nevada","0","4","Arkansas","5/22/20","4","0","05099","0"
"Newton","0","3","Arkansas","5/22/20","3","0","05101","0"
"Ouachita","0","10","Arkansas","5/22/20","9","1","05103","11.11"
"Perry","0","12","Arkansas","5/22/20","12","0","05105","0"
"Phillips","0","7","Arkansas","5/22/20","4","3","05107","75"
"Pike","0","4","Arkansas","5/22/20","3","1","05109","33.33"
"Poinsett","1","31","Arkansas","5/22/20","25","6","05111","24"
"Polk","0","9","Arkansas","5/22/20","7","2","05113","28.57"
"Pope","6","100","Arkansas","5/22/20","61","39","05115","63.93"
"Prairie","0","2","Arkansas","5/22/20","2","0","05117","0"
"Pulaski","13","761","Arkansas","5/22/20","669","92","05119","13.75"
"Randolph","0","25","Arkansas","5/22/20","22","3","05121","13.64"
"Saline","0","83","Arkansas","5/22/20","80","3","05125","3.75"
"Scott","0","1","Arkansas","5/22/20","1","0","05127","0"
"Searcy","0","6","Arkansas","5/22/20","6","0","05129","0"
"Sebastian","0","18","Arkansas","5/22/20","15","3","05131","20"
"Sevier","5","62","Arkansas","5/22/20","25","37","05133","148"
"Sharp","1","42","Arkansas","5/22/20","37","5","05135","13.51"
"St. Francis","41","621","Arkansas","5/22/20","333","288","05123","86.49"
"Stone","0","8","Arkansas","5/22/20","8","0","05137","0"
"Union","6","144","Arkansas","5/22/20","105","39","05139","37.14"
"Van Buren","0","28","Arkansas","5/22/20","28","0","05141","0"
"Washington","12","213","Arkansas","5/22/20","131","82","05143","62.6"
"White","0","37","Arkansas","5/22/20","36","1","05145","2.78"
"Woodruff","0","1","Arkansas","5/22/20","1","0","05147","0"
"Yell","10","76","Arkansas","5/22/20","9","67","05149","744.44"
"Alameda","49","2708","California","5/22/20","2367","341","06001","14.41"
"Alpine","0","2","California","5/22/20","2","0","06003","0"
"Amador","0","10","California","5/22/20","9","1","06005","11.11"
"Butte","2","34","California","5/22/20","22","12","06007","54.55"
"Calaveras","0","13","California","5/22/20","13","0","06009","0"
"Colusa","0","5","California","5/22/20","3","2","06011","66.67"
"Contra Costa","23","1259","California","5/22/20","1100","159","06013","14.45"
"Del Norte","2","20","California","5/22/20","4","16","06015","400"
"El Dorado","0","67","California","5/22/20","64","3","06017","4.69"
"Fresno","43","1372","California","5/22/20","1074","298","06019","27.75"
"Glenn","0","12","California","5/22/20","9","3","06021","33.33"
"Humboldt","3","88","California","5/22/20","68","20","06023","29.41"
"Imperial","41","1076","California","5/22/20","786","290","06025","36.9"
"Inyo","0","19","California","5/22/20","19","0","06027","0"
"Kern","38","1695","California","5/22/20","1428","267","06029","18.7"
"Kings","19","488","California","5/22/20","358","130","06031","36.31"
"Lake","1","12","California","5/22/20","8","4","06033","50"
"Los Angeles","965","43070","California","5/22/20","36316","6754","06037","18.6"
"Madera","2","83","California","5/22/20","69","14","06039","20.29"
"Marin","10","352","California","5/22/20","279","73","06041","26.16"
"Mariposa","0","15","California","5/22/20","15","0","06043","0"
"Mendocino","1","21","California","5/22/20","13","8","06045","61.54"
"Merced","9","251","California","5/22/20","189","62","06047","32.8"
"Mono","0","34","California","5/22/20","33","1","06051","3.03"
"Monterey","6","362","California","5/22/20","317","45","06053","14.2"
"Napa","2","96","California","5/22/20","83","13","06055","15.66"
"Nevada","0","41","California","5/22/20","41","0","06057","0"
"Orange","117","4941","California","5/22/20","4125","816","06059","19.78"
"Placer","1","184","California","5/22/20","174","10","06061","5.75"
"Plumas","0","4","California","5/22/20","4","0","06063","0"
"Riverside","121","6464","California","5/22/20","5618","846","06065","15.06"
"Sacramento","9","1272","California","5/22/20","1211","61","06067","5.04"
"San Benito","1","66","California","5/22/20","59","7","06069","11.86"
"San Bernardino","119","4146","California","5/22/20","3311","835","06071","25.22"
"San Diego","132","6315","California","5/22/20","5391","924","06073","17.14"
"San Francisco","42","2320","California","5/22/20","2026","294","06075","14.51"
"San Joaquin","13","752","California","5/22/20","659","93","06077","14.11"
"San Luis Obispo","2","253","California","5/22/20","240","13","06079","5.42"
"San Mateo","30","1783","California","5/22/20","1575","208","06081","13.21"
"Santa Barbara","22","1540","California","5/22/20","1387","153","06083","11.03"
"Santa Clara","14","2492","California","5/22/20","2391","101","06085","4.22"
"Santa Cruz","5","186","California","5/22/20","149","37","06087","24.83"
"Shasta","0","34","California","5/22/20","33","1","06089","3.03"
"Sierra","0","1","California","5/22/20","0","1","06091","1"
"Siskiyou","0","6","California","5/22/20","5","1","06093","20"
"Solano","6","449","California","5/22/20","408","41","06095","10.05"
"Sonoma","13","444","California","5/22/20","351","93","06097","26.5"
"Stanislaus","11","611","California","5/22/20","537","74","06099","13.78"
"Sutter","0","40","California","5/22/20","37","3","06101","8.11"
"Tehama","0","3","California","5/22/20","1","2","06103","200"
"Trinity","0","1","California","5/22/20","1","0","06105","0"
"Tulare","43","1641","California","5/22/20","1338","303","06107","22.65"
"Tuolumne","0","2","California","5/22/20","2","0","06109","0"
"Ventura","17","883","California","5/22/20","764","119","06111","15.58"
"Yolo","1","186","California","5/22/20","182","4","06113","2.2"
"Yuba","0","28","California","5/22/20","25","3","06115","12"
"Adams","40","2802","Colorado","5/22/20","2520","282","08001","11.19"
"Alamosa","2","51","Colorado","5/22/20","38","13","08003","34.21"
"Arapahoe","56","3974","Colorado","5/22/20","3583","391","08005","10.91"
"Archuleta","0","8","Colorado","5/22/20","8","0","08007","0"
"Baca","0","12","Colorado","5/22/20","12","0","08009","0"
"Bent","0","2","Colorado","5/22/20","1","1","08011","100"
"Boulder","10","898","Colorado","5/22/20","825","73","08013","8.85"
"Broomfield","2","220","Colorado","5/22/20","207","13","08014","6.28"
"Chaffee","0","69","Colorado","5/22/20","69","0","08015","0"
"Cheyenne","0","5","Colorado","5/22/20","5","0","08017","0"
"Clear Creek","0","16","Colorado","5/22/20","15","1","08019","6.67"
"Conejos","0","1","Colorado","5/22/20","1","0","08021","0"
"Costilla","0","3","Colorado","5/22/20","4","-1","08023","-25"
"Crowley","1","44","Colorado","5/22/20","39","5","08025","12.82"
"Custer","0","2","Colorado","5/22/20","2","0","08027","0"
"Delta","1","61","Colorado","5/22/20","54","7","08029","12.96"
"Denver","86","5056","Colorado","5/22/20","4452","604","08031","13.57"
"Douglas","5","669","Colorado","5/22/20","632","37","08035","5.85"
"Eagle","2","577","Colorado","5/22/20","566","11","08037","1.94"
"El Paso","30","1460","Colorado","5/22/20","1251","209","08041","16.71"
"Elbert","1","48","Colorado","5/22/20","42","6","08039","14.29"
"Fremont","0","26","Colorado","5/22/20","25","1","08043","4"
"Garfield","1","120","Colorado","5/22/20","113","7","08045","6.19"
"Gilpin","0","3","Colorado","5/22/20","3","0","08047","0"
"Grand","0","5","Colorado","5/22/20","5","0","08049","0"
"Gunnison","-1","177","Colorado","5/22/20","182","-5","08051","-2.75"
"Hinsdale","0","3","Colorado","5/22/20","3","0","08053","0"
"Huerfano","0","3","Colorado","5/22/20","3","0","08055","0"
"Jefferson","32","1999","Colorado","5/22/20","1775","224","08059","12.62"
"Kit Carson","0","26","Colorado","5/22/20","26","0","08063","0"
"La Plata","1","73","Colorado","5/22/20","66","7","08067","10.61"
"Lake","0","27","Colorado","5/22/20","24","3","08065","12.5"
"Larimer","7","520","Colorado","5/22/20","472","48","08069","10.17"
"Las Animas","0","5","Colorado","5/22/20","4","1","08071","25"
"Lincoln","0","3","Colorado","5/22/20","3","0","08073","0"
"Logan","1","491","Colorado","5/22/20","483","8","08075","1.66"
"Mesa","0","50","Colorado","5/22/20","50","0","08077","0"
"Mineral","0","2","Colorado","5/22/20","2","0","08079","0"
"Moffat","0","6","Colorado","5/22/20","6","0","08081","0"
"Montezuma","1","35","Colorado","5/22/20","26","9","08083","34.62"
"Montrose","3","152","Colorado","5/22/20","131","21","08085","16.03"
"Morgan","7","591","Colorado","5/22/20","542","49","08087","9.04"
"Otero","0","14","Colorado","5/22/20","11","3","08089","27.27"
"Ouray","0","7","Colorado","5/22/20","7","0","08091","0"
"Park","1","21","Colorado","5/22/20","16","5","08093","31.25"
"Phillips","0","10","Colorado","5/22/20","10","0","08095","0"
"Pitkin","0","57","Colorado","5/22/20","56","1","08097","1.79"
"Prowers","0","11","Colorado","5/22/20","10","1","08099","10"
"Pueblo","5","233","Colorado","5/22/20","195","38","08101","19.49"
"Rio Blanco","0","1","Colorado","5/22/20","1","0","08103","0"
"Rio Grande","1","15","Colorado","5/22/20","7","8","08105","114.29"
"Routt","0","59","Colorado","5/22/20","59","0","08107","0"
"Saguache","1","23","Colorado","5/22/20","16","7","08109","43.75"
"San Juan","0","1","Colorado","5/22/20","1","0","08111","0"
"San Miguel","0","23","Colorado","5/22/20","22","1","08113","4.55"
"Summit","3","197","Colorado","5/22/20","178","19","08117","10.67"
"Teller","0","32","Colorado","5/22/20","31","1","08119","3.23"
"Washington","1","15","Colorado","5/22/20","9","6","08121","66.67"
"Weld","15","2367","Colorado","5/22/20","2260","107","08123","4.73"
"Yuma","0","12","Colorado","5/22/20","12","0","08125","0"
"Fairfield","126","14889","Connecticut","5/22/20","14009","880","09001","6.28"
"Hartford","191","9463","Connecticut","5/22/20","8126","1337","09003","16.45"
"Litchfield","11","1298","Connecticut","5/22/20","1218","80","09005","6.57"
"Middlesex","15","992","Connecticut","5/22/20","885","107","09007","12.09"
"New Haven","125","10756","Connecticut","5/22/20","9881","875","09009","8.86"
"New London","9","910","Connecticut","5/22/20","844","66","09011","7.82"
"Tolland","30","796","Connecticut","5/22/20","583","213","09013","36.54"
"Windham","7","348","Connecticut","5/22/20","301","47","09015","15.61"
"Kent","21","1296","Delaware","5/22/20","1146","150","10001","13.09"
"New Castle","73","3132","Delaware","5/22/20","2619","513","10003","19.59"
"Sussex","69","4048","Delaware","5/22/20","3565","483","10005","13.55"
"","0","49","Diamond Princess","5/22/20","49","0",,"0"
"District of Columbia","146","7893","District of Columbia","5/22/20","6871","1022","11001","14.87"
"Alachua","3","354","Florida","5/22/20","330","24","12001","7.27"
"Baker","0","26","Florida","5/22/20","26","0","12003","0"
"Bay","2","92","Florida","5/22/20","80","12","12005","15"
"Bradford","0","50","Florida","5/22/20","49","1","12007","2.04"
"Brevard","3","380","Florida","5/22/20","356","24","12009","6.74"
"Broward","64","6580","Florida","5/22/20","6133","447","12011","7.29"
"Calhoun","2","52","Florida","5/22/20","38","14","12013","36.84"
"Charlotte","6","412","Florida","5/22/20","367","45","12015","12.26"
"Citrus","1","118","Florida","5/22/20","110","8","12017","7.27"
"Clay","7","354","Florida","5/22/20","308","46","12019","14.94"
"Collier","35","1160","Florida","5/22/20","915","245","12021","26.78"
"Columbia","2","121","Florida","5/22/20","108","13","12023","12.04"
"DeSoto","5","97","Florida","5/22/20","61","36","12027","59.02"
"Dixie","2","33","Florida","5/22/20","22","11","12029","50"
"Duval","18","1376","Florida","5/22/20","1252","124","12031","9.9"
"Escambia","8","740","Florida","5/22/20","682","58","12033","8.5"
"Flagler","3","173","Florida","5/22/20","153","20","12035","13.07"
"Franklin","0","2","Florida","5/22/20","2","0","12037","0"
"Gadsden","10","252","Florida","5/22/20","180","72","12039","40"
"Gilchrist","0","10","Florida","5/22/20","7","3","12041","42.86"
"Glades","1","19","Florida","5/22/20","10","9","12043","90"
"Gulf","0","1","Florida","5/22/20","1","0","12045","0"
"Hamilton","2","159","Florida","5/22/20","144","15","12047","10.42"
"Hardee","3","60","Florida","5/22/20","39","21","12049","53.85"
"Hendry","10","250","Florida","5/22/20","180","70","12051","38.89"
"Hernando","1","110","Florida","5/22/20","105","5","12053","4.76"
"Highlands","1","111","Florida","5/22/20","103","8","12055","7.77"
"Hillsborough","32","1790","Florida","5/22/20","1568","222","12057","14.16"
"Holmes","1","16","Florida","5/22/20","11","5","12059","45.45"
"Indian River","1","112","Florida","5/22/20","104","8","12061","7.69"
"Jackson","13","219","Florida","5/22/20","125","94","12063","75.2"
"Jefferson","0","29","Florida","5/22/20","28","1","12065","3.57"
"Lafayette","0","7","Florida","5/22/20","5","2","12067","40"
"Lake","2","266","Florida","5/22/20","249","17","12069","6.83"
"Lee","40","1666","Florida","5/22/20","1385","281","12071","20.29"
"Leon","8","329","Florida","5/22/20","276","53","12073","19.2"
"Levy","0","27","Florida","5/22/20","24","3","12075","12.5"
"Liberty","1","204","Florida","5/22/20","199","5","12077","2.51"
"Madison","1","66","Florida","5/22/20","62","4","12079","6.45"
"Manatee","17","946","Florida","5/22/20","826","120","12081","14.53"
"Marion","2","233","Florida","5/22/20","218","15","12083","6.88"
"Martin","26","476","Florida","5/22/20","294","182","12085","61.9"
"Miami-Dade","216","16522","Florida","5/22/20","15011","1511","12086","10.07"
"Monroe","1","101","Florida","5/22/20","95","6","12087","6.32"
"Nassau","1","69","Florida","5/22/20","65","4","12089","6.15"
"Okaloosa","2","185","Florida","5/22/20","174","11","12091","6.32"
"Okeechobee","3","55","Florida","5/22/20","33","22","12093","66.67"
"Orange","18","1744","Florida","5/22/20","1615","129","12095","7.99"
"Osceola","5","644","Florida","5/22/20","608","36","12097","5.92"
"Palm Beach","97","5072","Florida","5/22/20","4391","681","12099","15.51"
"Pasco","4","338","Florida","5/22/20","313","25","12101","7.99"
"Pinellas","17","1116","Florida","5/22/20","997","119","12103","11.94"
"Polk","18","840","Florida","5/22/20","716","124","12105","17.32"
"Putnam","2","138","Florida","5/22/20","127","11","12107","8.66"
"Santa Rosa","3","202","Florida","5/22/20","182","20","12113","10.99"
"Sarasota","10","565","Florida","5/22/20","496","69","12115","13.91"
"Seminole","3","449","Florida","5/22/20","429","20","12117","4.66"
"St. Johns","1","236","Florida","5/22/20","231","5","12109","2.16"
"St. Lucie","7","363","Florida","5/22/20","313","50","12111","15.97"
"Sumter","0","252","Florida","5/22/20","250","2","12119","0.8"
"Suwannee","2","164","Florida","5/22/20","151","13","12121","8.61"
"Taylor","1","10","Florida","5/22/20","3","7","12123","233.33"
"Union","2","28","Florida","5/22/20","14","14","12125","100"
"Volusia","7","640","Florida","5/22/20","590","50","12127","8.47"
"Wakulla","0","32","Florida","5/22/20","31","1","12129","3.23"
"Walton","3","100","Florida","5/22/20","76","24","12131","31.58"
"Washington","1","24","Florida","5/22/20","14","10","12133","71.43"
"Appling","2","121","Georgia","5/22/20","108","13","13001","12.04"
"Atkinson","1","26","Georgia","5/22/20","20","6","13003","30"
"Bacon","2","73","Georgia","5/22/20","59","14","13005","23.73"
"Baker","0","32","Georgia","5/22/20","33","-1","13007","-3.03"
"Baldwin","7","329","Georgia","5/22/20","282","47","13009","16.67"
"Banks","4","73","Georgia","5/22/20","43","30","13011","69.77"
"Barrow","3","281","Georgia","5/22/20","258","23","13013","8.91"
"Bartow","6","427","Georgia","5/22/20","385","42","13015","10.91"
"Ben Hill","1","55","Georgia","5/22/20","45","10","13017","22.22"
"Berrien","2","34","Georgia","5/22/20","20","14","13019","70"
"Bibb","5","423","Georgia","5/22/20","391","32","13021","8.18"
"Bleckley","1","37","Georgia","5/22/20","33","4","13023","12.12"
"Brantley","2","48","Georgia","5/22/20","35","13","13025","37.14"
"Brooks","0","66","Georgia","5/22/20","64","2","13027","3.12"
"Bryan","1","68","Georgia","5/22/20","61","7","13029","11.48"
"Bulloch","1","49","Georgia","5/22/20","45","4","13031","8.89"
"Burke","1","120","Georgia","5/22/20","112","8","13033","7.14"
"Butts","1","206","Georgia","5/22/20","196","10","13035","5.1"
"Calhoun","0","123","Georgia","5/22/20","124","-1","13037","-0.81"
"Camden","1","53","Georgia","5/22/20","46","7","13039","15.22"
"Candler","0","12","Georgia","5/22/20","10","2","13043","20"
"Carroll","4","439","Georgia","5/22/20","408","31","13045","7.6"
"Catoosa","4","97","Georgia","5/22/20","71","26","13047","36.62"
"Charlton","0","28","Georgia","5/22/20","26","2","13049","7.69"
"Chatham","11","428","Georgia","5/22/20","353","75","13051","21.25"
"Chattahoochee","0","20","Georgia","5/22/20","19","1","13053","5.26"
"Chattooga","1","24","Georgia","5/22/20","15","9","13055","60"
"Cherokee","14","790","Georgia","5/22/20","695","95","13057","13.67"
"Clarke","3","219","Georgia","5/22/20","197","22","13059","11.17"
"Clay","1","34","Georgia","5/22/20","28","6","13061","21.43"
"Clayton","10","1071","Georgia","5/22/20","999","72","13063","7.21"
"Clinch","1","46","Georgia","5/22/20","40","6","13065","15"
"Cobb","37","2655","Georgia","5/22/20","2395","260","13067","10.86"
"Coffee","5","225","Georgia","5/22/20","192","33","13069","17.19"
"Colquitt","5","280","Georgia","5/22/20","245","35","13071","14.29"
"Columbia","3","223","Georgia","5/22/20","202","21","13073","10.4"
"Cook","2","44","Georgia","5/22/20","32","12","13075","37.5"
"Coweta","4","311","Georgia","5/22/20","282","29","13077","10.28"
"Crawford","1","24","Georgia","5/22/20","19","5","13079","26.32"
"Crisp","2","210","Georgia","5/22/20","193","17","13081","8.81"
"Dade","1","26","Georgia","5/22/20","20","6","13083","30"
"Dawson","2","101","Georgia","5/22/20","84","17","13085","20.24"
"Decatur","4","145","Georgia","5/22/20","116","29","13087","25"
"DeKalb","47","3080","Georgia","5/22/20","2751","329","13089","11.96"
"Dodge","1","48","Georgia","5/22/20","38","10","13091","26.32"
"Dooly","1","164","Georgia","5/22/20","155","9","13093","5.81"
"Dougherty","9","1723","Georgia","5/22/20","1662","61","13095","3.67"
"Douglas","6","478","Georgia","5/22/20","433","45","13097","10.39"
"Early","0","234","Georgia","5/22/20","233","1","13099","0.43"
"Echols","6","59","Georgia","5/22/20","15","44","13101","293.33"
"Effingham","3","61","Georgia","5/22/20","38","23","13103","60.53"
"Elbert","4","71","Georgia","5/22/20","46","25","13105","54.35"
"Emanuel","0","26","Georgia","5/22/20","25","1","13107","4"
"Evans","0","5","Georgia","5/22/20","4","1","13109","25"
"Fannin","0","39","Georgia","5/22/20","36","3","13111","8.33"
"Fayette","1","215","Georgia","5/22/20","205","10","13113","4.88"
"Floyd","7","224","Georgia","5/22/20","172","52","13115","30.23"
"Forsyth","7","444","Georgia","5/22/20","397","47","13117","11.84"
"Franklin","1","35","Georgia","5/22/20","31","4","13119","12.9"
"Fulton","33","3931","Georgia","5/22/20","3703","228","13121","6.16"
"Gilmer","3","126","Georgia","5/22/20","105","21","13123","20"
"Glascock","0","1","Georgia","5/22/20","1","0","13125","0"
"Glynn","1","83","Georgia","5/22/20","77","6","13127","7.79"
"Gordon","2","136","Georgia","5/22/20","125","11","13129","8.8"
"Grady","0","93","Georgia","5/22/20","90","3","13131","3.33"
"Greene","1","63","Georgia","5/22/20","57","6","13133","10.53"
"Gwinnett","52","2961","Georgia","5/22/20","2597","364","13135","14.02"
"Habersham","10","479","Georgia","5/22/20","411","68","13137","16.55"
"Hall","18","2269","Georgia","5/22/20","2140","129","13139","6.03"
"Hancock","4","175","Georgia","5/22/20","149","26","13141","17.45"
"Haralson","0","36","Georgia","5/22/20","34","2","13143","5.88"
"Harris","1","79","Georgia","5/22/20","75","4","13145","5.33"
"Hart","1","26","Georgia","5/22/20","19","7","13147","36.84"
"Heard","1","26","Georgia","5/22/20","17","9","13149","52.94"
"Henry","0","627","Georgia","5/22/20","628","-1","13151","-0.16"
"Houston","4","339","Georgia","5/22/20","314","25","13153","7.96"
"Irwin","0","23","Georgia","5/22/20","22","1","13155","4.55"
"Jackson","3","145","Georgia","5/22/20","127","18","13157","14.17"
"Jasper","1","31","Georgia","5/22/20","26","5","13159","19.23"
"Jeff Davis","1","31","Georgia","5/22/20","24","7","13161","29.17"
"Jefferson","1","26","Georgia","5/22/20","22","4","13163","18.18"
"Jenkins","0","18","Georgia","5/22/20","16","2","13165","12.5"
"Johnson","1","78","Georgia","5/22/20","71","7","13167","9.86"
"Jones","0","32","Georgia","5/22/20","30","2","13169","6.67"
"Lamar","1","50","Georgia","5/22/20","41","9","13171","21.95"
"Lanier","0","12","Georgia","5/22/20","12","0","13173","0"
"Laurens","1","96","Georgia","5/22/20","87","9","13175","10.34"
"Lee","0","342","Georgia","5/22/20","344","-2","13177","-0.58"
"Liberty","3","63","Georgia","5/22/20","45","18","13179","40"
"Lincoln","0","15","Georgia","5/22/20","12","3","13181","25"
"Long","1","12","Georgia","5/22/20","6","6","13183","100"
"Lowndes","4","232","Georgia","5/22/20","202","30","13185","14.85"
"Lumpkin","1","88","Georgia","5/22/20","82","6","13187","7.32"
"Macon","1","96","Georgia","5/22/20","90","6","13193","6.67"
"Madison","0","32","Georgia","5/22/20","29","3","13195","10.34"
"Marion","1","48","Georgia","5/22/20","39","9","13197","23.08"
"McDuffie","1","62","Georgia","5/22/20","53","9","13189","16.98"
"McIntosh","0","11","Georgia","5/22/20","9","2","13191","22.22"
"Meriwether","1","78","Georgia","5/22/20","73","5","13199","6.85"
"Miller","0","38","Georgia","5/22/20","38","0","13201","0"
"Mitchell","1","397","Georgia","5/22/20","388","9","13205","2.32"
"Monroe","10","114","Georgia","5/22/20","47","67","13207","142.55"
"Montgomery","0","8","Georgia","5/22/20","8","0","13209","0"
"Morgan","0","35","Georgia","5/22/20","33","2","13211","6.06"
"Murray","2","72","Georgia","5/22/20","59","13","13213","22.03"
"Muscogee","12","509","Georgia","5/22/20","424","85","13215","20.05"
"Newton","3","286","Georgia","5/22/20","262","24","13217","9.16"
"Oconee","3","103","Georgia","5/22/20","80","23","13219","28.75"
"Oglethorpe","0","58","Georgia","5/22/20","55","3","13221","5.45"
"Out of GA","31","1748","Georgia","5/22/20","1530","218","80013","14.25"
"Paulding","5","273","Georgia","5/22/20","240","33","13223","13.75"
"Peach","0","70","Georgia","5/22/20","71","-1","13225","-1.41"
"Pickens","1","41","Georgia","5/22/20","35","6","13227","17.14"
"Pierce","3","88","Georgia","5/22/20","69","19","13229","27.54"
"Pike","1","48","Georgia","5/22/20","44","4","13231","9.09"
"Polk","2","93","Georgia","5/22/20","78","15","13233","19.23"
"Pulaski","0","38","Georgia","5/22/20","36","2","13235","5.56"
"Putnam","3","84","Georgia","5/22/20","62","22","13237","35.48"
"Quitman","0","10","Georgia","5/22/20","8","2","13239","25"
"Rabun","0","15","Georgia","5/22/20","14","1","13241","7.14"
"Randolph","0","170","Georgia","5/22/20","169","1","13243","0.59"
"Richmond","5","523","Georgia","5/22/20","490","33","13245","6.73"
"Rockdale","1","257","Georgia","5/22/20","249","8","13247","3.21"
"Schley","0","16","Georgia","5/22/20","15","1","13249","6.67"
"Screven","1","25","Georgia","5/22/20","18","7","13251","38.89"
"Seminole","0","42","Georgia","5/22/20","40","2","13253","5"
"Spalding","2","250","Georgia","5/22/20","239","11","13255","4.6"
"Stephens","4","122","Georgia","5/22/20","97","25","13257","25.77"
"Stewart","0","40","Georgia","5/22/20","37","3","13259","8.11"
"Sumter","3","436","Georgia","5/22/20","413","23","13261","5.57"
"Talbot","1","34","Georgia","5/22/20","28","6","13263","21.43"
"Taliaferro","0","1","Georgia","5/22/20","1","0","13265","0"
"Tattnall","0","13","Georgia","5/22/20","11","2","13267","18.18"
"Taylor","0","21","Georgia","5/22/20","22","-1","13269","-4.55"
"Telfair","0","32","Georgia","5/22/20","29","3","13271","10.34"
"Terrell","1","209","Georgia","5/22/20","199","10","13273","5.03"
"Thomas","4","308","Georgia","5/22/20","281","27","13275","9.61"
"Tift","5","212","Georgia","5/22/20","175","37","13277","21.14"
"Toombs","1","50","Georgia","5/22/20","43","7","13279","16.28"
"Towns","0","22","Georgia","5/22/20","21","1","13281","4.76"
"Treutlen","0","8","Georgia","5/22/20","7","1","13283","14.29"
"Troup","6","238","Georgia","5/22/20","195","43","13285","22.05"
"Turner","2","92","Georgia","5/22/20","81","11","13287","13.58"
"Twiggs","0","11","Georgia","5/22/20","9","2","13289","22.22"
"Union","0","39","Georgia","5/22/20","36","3","13291","8.33"
"Upson","2","271","Georgia","5/22/20","257","14","13293","5.45"
"Walker","3","94","Georgia","5/22/20","74","20","13295","27.03"
"Walton","4","186","Georgia","5/22/20","158","28","13297","17.72"
"Ware","4","201","Georgia","5/22/20","170","31","13299","18.24"
"Warren","0","17","Georgia","5/22/20","16","1","13301","6.25"
"Washington","1","72","Georgia","5/22/20","63","9","13303","14.29"
"Wayne","0","15","Georgia","5/22/20","14","1","13305","7.14"
"Webster","0","11","Georgia","5/22/20","11","0","13307","0"
"Wheeler","0","9","Georgia","5/22/20","7","2","13309","28.57"
"White","0","92","Georgia","5/22/20","89","3","13311","3.37"
"Whitfield","10","249","Georgia","5/22/20","177","72","13313","40.68"
"Wilcox","0","98","Georgia","5/22/20","95","3","13315","3.16"
"Wilkes","1","32","Georgia","5/22/20","28","4","13317","14.29"
"Wilkinson","3","63","Georgia","5/22/20","42","21","13319","50"
"Worth","1","204","Georgia","5/22/20","195","9","13321","4.62"
"","0","103","Grand Princess","5/22/20","103","0",,"0"
"","2","165","Guam","5/22/20","154","11",,"7.14"
"Hawaii","1","81","Hawaii","5/22/20","76","5","15001","6.58"
"Honolulu","0","414","Hawaii","5/22/20","414","0","15003","0"
"Kauai","0","20","Hawaii","5/22/20","21","-1","15007","-4.76"
"Maui","0","117","Hawaii","5/22/20","117","0","15009","0"
"Out of HI","0","10","Hawaii","5/22/20","10","0","80015","0"
"Ada","5","794","Idaho","5/22/20","759","35","16001","4.61"
"Adams","0","3","Idaho","5/22/20","3","0","16003","0"
"Bannock","1","17","Idaho","5/22/20","13","4","16005","30.77"
"Bingham","0","6","Idaho","5/22/20","6","0","16011","0"
"Blaine","0","510","Idaho","5/22/20","507","3","16013","0.59"
"Bonner","0","4","Idaho","5/22/20","4","0","16017","0"
"Bonneville","0","32","Idaho","5/22/20","30","2","16019","6.67"
"Camas","0","1","Idaho","5/22/20","1","0","16025","0"
"Canyon","1","284","Idaho","5/22/20","276","8","16027","2.9"
"Caribou","0","1","Idaho","5/22/20","1","0","16029","0"
"Cassia","1","22","Idaho","5/22/20","16","6","16031","37.5"
"Custer","0","2","Idaho","5/22/20","2","0","16037","0"
"Elmore","0","31","Idaho","5/22/20","31","0","16039","0"
"Fremont","0","3","Idaho","5/22/20","3","0","16043","0"
"Gem","0","17","Idaho","5/22/20","16","1","16045","6.25"
"Gooding","2","35","Idaho","5/22/20","22","13","16047","59.09"
"Idaho","0","3","Idaho","5/22/20","3","0","16049","0"
"Jefferson","0","7","Idaho","5/22/20","5","2","16051","40"
"Jerome","7","137","Idaho","5/22/20","87","50","16053","57.47"
"Kootenai","0","66","Idaho","5/22/20","64","2","16055","3.12"
"Latah","0","7","Idaho","5/22/20","6","1","16057","16.67"
"Lemhi","0","1","Idaho","5/22/20","1","0","16059","0"
"Lincoln","0","30","Idaho","5/22/20","29","1","16063","3.45"
"Madison","0","20","Idaho","5/22/20","18","2","16065","11.11"
"Minidoka","2","26","Idaho","5/22/20","15","11","16067","73.33"
"Nez Perce","0","81","Idaho","5/22/20","79","2","16069","2.53"
"Owyhee","0","8","Idaho","5/22/20","8","0","16073","0"
"Payette","1","23","Idaho","5/22/20","19","4","16075","21.05"
"Power","0","3","Idaho","5/22/20","3","0","16077","0"
"Teton","0","11","Idaho","5/22/20","11","0","16081","0"
"Twin Falls","11","374","Idaho","5/22/20","298","76","16083","25.5"
"Valley","0","2","Idaho","5/22/20","2","0","16085","0"
"Washington","3","34","Idaho","5/22/20","13","21","16087","161.54"
"Adams","0","44","Illinois","5/22/20","42","2","17001","4.76"
"Alexander","0","8","Illinois","5/22/20","8","0","17003","0"
"Bond","0","10","Illinois","5/22/20","11","-1","17005","-9.09"
"Boone","13","368","Illinois","5/22/20","274","94","17007","34.31"
"Brown","0","10","Illinois","5/22/20","9","1","17009","11.11"
"Bureau","0","15","Illinois","5/22/20","15","0","17011","0"
"Calhoun","0","1","Illinois","5/22/20","1","0","17013","0"
"Carroll","0","13","Illinois","5/22/20","12","1","17015","8.33"
"Cass","0","67","Illinois","5/22/20","67","0","17017","0"
"Champaign","24","515","Illinois","5/22/20","344","171","17019","49.71"
"Christian","0","32","Illinois","5/22/20","30","2","17021","6.67"
"Clark","0","10","Illinois","5/22/20","9","1","17023","11.11"
"Clay","0","2","Illinois","5/22/20","2","0","17025","0"
"Clinton","2","173","Illinois","5/22/20","159","14","17027","8.81"
"Coles","4","95","Illinois","5/22/20","67","28","17029","41.79"
"Cook","1292","68949","Illinois","5/22/20","59905","9044","17031","15.1"
"Crawford","0","11","Illinois","5/22/20","11","0","17033","0"
"Cumberland","0","10","Illinois","5/22/20","8","2","17035","25"
"De Witt","0","4","Illinois","5/22/20","4","0","17039","0"
"DeKalb","10","299","Illinois","5/22/20","229","70","17037","30.57"
"Douglas","1","27","Illinois","5/22/20","22","5","17041","22.73"
"DuPage","159","6744","Illinois","5/22/20","5634","1110","17043","19.7"
"Edgar","0","0","Illinois","5/22/20","1","-1","17045","-100"
"Edwards","0","2","Illinois","5/22/20","2","0","17047","0"
"Effingham","0","6","Illinois","5/22/20","6","0","17049","0"
"Fayette","0","19","Illinois","5/22/20","19","0","17051","0"
"Ford","0","19","Illinois","5/22/20","16","3","17053","18.75"
"Franklin","0","11","Illinois","5/22/20","11","0","17055","0"
"Fulton","1","10","Illinois","5/22/20","6","4","17057","66.67"
"Gallatin","0","2","Illinois","5/22/20","2","0","17059","0"
"Greene","0","5","Illinois","5/22/20","4","1","17061","25"
"Grundy","2","84","Illinois","5/22/20","73","11","17063","15.07"
"Hamilton","0","2","Illinois","5/22/20","2","0","17065","0"
"Hancock","0","13","Illinois","5/22/20","12","1","17067","8.33"
"Hardin","0","1","Illinois","5/22/20","1","0","17069","0"
"Henderson","0","8","Illinois","5/22/20","7","1","17071","14.29"
"Henry","0","65","Illinois","5/22/20","64","1","17073","1.56"
"Iroquois","2","124","Illinois","5/22/20","111","13","17075","11.71"
"Jackson","3","197","Illinois","5/22/20","177","20","17077","11.3"
"Jasper","0","45","Illinois","5/22/20","45","0","17079","0"
"Jefferson","0","99","Illinois","5/22/20","98","1","17081","1.02"
"Jersey","0","20","Illinois","5/22/20","18","2","17083","11.11"
"Jo Daviess","1","24","Illinois","5/22/20","18","6","17085","33.33"
"Johnson","0","7","Illinois","5/22/20","7","0","17087","0"
"Kane","167","5327","Illinois","5/22/20","4159","1168","17089","28.08"
"Kankakee","15","753","Illinois","5/22/20","647","106","17091","16.38"
"Kendall","20","673","Illinois","5/22/20","531","142","17093","26.74"
"Knox","1","93","Illinois","5/22/20","84","9","17095","10.71"
"Lake","162","7291","Illinois","5/22/20","6157","1134","17097","18.42"
"LaSalle","2","130","Illinois","5/22/20","117","13","17099","11.11"
"Lawrence","0","4","Illinois","5/22/20","4","0","17101","0"
"Lee","0","75","Illinois","5/22/20","73","2","17103","2.74"
"Livingston","1","30","Illinois","5/22/20","25","5","17105","20"
"Logan","0","10","Illinois","5/22/20","10","0","17107","0"
"Macon","4","184","Illinois","5/22/20","159","25","17115","15.72"
"Macoupin","0","41","Illinois","5/22/20","41","0","17117","0"
"Madison","7","516","Illinois","5/22/20","464","52","17119","11.21"
"Marion","0","50","Illinois","5/22/20","47","3","17121","6.38"
"Marshall","0","5","Illinois","5/22/20","5","0","17123","0"
"Mason","0","16","Illinois","5/22/20","16","0","17125","0"
"Massac","0","7","Illinois","5/22/20","6","1","17127","16.67"
"McDonough","2","75","Illinois","5/22/20","58","17","17109","29.31"
"McHenry","29","1323","Illinois","5/22/20","1123","200","17111","17.81"
"McLean","9","195","Illinois","5/22/20","132","63","17113","47.73"
"Menard","0","17","Illinois","5/22/20","17","0","17129","0"
"Mercer","0","14","Illinois","5/22/20","14","0","17131","0"
"Monroe","1","91","Illinois","5/22/20","83","8","17133","9.64"
"Montgomery","0","38","Illinois","5/22/20","36","2","17135","5.56"
"Morgan","0","34","Illinois","5/22/20","35","-1","17137","-2.86"
"Moultrie","0","8","Illinois","5/22/20","7","1","17139","14.29"
"Ogle","3","185","Illinois","5/22/20","165","20","17141","12.12"
"Out of IL","4","112","Illinois","5/22/20","86","26","80017","30.23"
"Peoria","3","176","Illinois","5/22/20","156","20","17143","12.82"
"Perry","0","40","Illinois","5/22/20","38","2","17145","5.26"
"Piatt","0","9","Illinois","5/22/20","8","1","17147","12.5"
"Pike","0","1","Illinois","5/22/20","1","0","17149","0"
"Pope","0","1","Illinois","5/22/20","1","0","17151","0"
"Pulaski","0","40","Illinois","5/22/20","40","0","17153","0"
"Putnam","0","1","Illinois","5/22/20","0","1","17155","1"
"Randolph","2","251","Illinois","5/22/20","234","17","17157","7.26"
"Richland","0","3","Illinois","5/22/20","3","0","17159","0"
"Rock Island","8","617","Illinois","5/22/20","563","54","17161","9.59"
"Saline","0","6","Illinois","5/22/20","6","0","17165","0"
"Sangamon","4","325","Illinois","5/22/20","299","26","17167","8.7"
"Schuyler","0","9","Illinois","5/22/20","7","2","17169","28.57"
"Shelby","0","15","Illinois","5/22/20","12","3","17173","25"
"St. Clair","20","907","Illinois","5/22/20","765","142","17163","18.56"
"Stark","0","3","Illinois","5/22/20","1","2","17175","200"
"Stephenson","5","173","Illinois","5/22/20","135","38","17177","28.15"
"Tazewell","1","66","Illinois","5/22/20","62","4","17179","6.45"
"Union","3","136","Illinois","5/22/20","117","19","17181","16.24"
"Vermilion","1","39","Illinois","5/22/20","29","10","17183","34.48"
"Wabash","0","1","Illinois","5/22/20","1","0","17185","0"
"Warren","1","112","Illinois","5/22/20","105","7","17187","6.67"
"Washington","0","18","Illinois","5/22/20","17","1","17189","5.88"
"Wayne","0","9","Illinois","5/22/20","8","1","17191","12.5"
"White","0","2","Illinois","5/22/20","2","0","17193","0"
"Whiteside","3","131","Illinois","5/22/20","113","18","17195","15.93"
"Will","93","4929","Illinois","5/22/20","4277","652","17197","15.24"
"Williamson","0","54","Illinois","5/22/20","51","3","17199","5.88"
"Winnebago","56","1780","Illinois","5/22/20","1390","390","17201","28.06"
"Woodford","0","17","Illinois","5/22/20","14","3","17203","21.43"
"Adams","0","11","Indiana","5/22/20","9","2","18001","22.22"
"Allen","34","1191","Indiana","5/22/20","955","236","18003","24.71"
"Bartholomew","9","456","Indiana","5/22/20","394","62","18005","15.74"
"Benton","0","24","Indiana","5/22/20","21","3","18007","14.29"
"Blackford","1","18","Indiana","5/22/20","14","4","18009","28.57"
"Boone","4","278","Indiana","5/22/20","252","26","18011","10.32"
"Brown","1","33","Indiana","5/22/20","29","4","18013","13.79"
"Carroll","1","87","Indiana","5/22/20","77","10","18015","12.99"
"Cass","4","1578","Indiana","5/22/20","1551","27","18017","1.74"
"Clark","7","446","Indiana","5/22/20","399","47","18019","11.78"
"Clay","1","36","Indiana","5/22/20","28","8","18021","28.57"
"Clinton","11","194","Indiana","5/22/20","118","76","18023","64.41"
"Crawford","0","23","Indiana","5/22/20","22","1","18025","4.55"
"Daviess","2","73","Indiana","5/22/20","59","14","18027","23.73"
"Dearborn","1","161","Indiana","5/22/20","157","4","18029","2.55"
"Decatur","1","220","Indiana","5/22/20","216","4","18031","1.85"
"DeKalb","0","26","Indiana","5/22/20","25","1","18033","4"
"Delaware","11","328","Indiana","5/22/20","254","74","18035","29.13"
"Dubois","14","171","Indiana","5/22/20","70","101","18037","144.29"
"Elkhart","42","903","Indiana","5/22/20","609","294","18039","48.28"
"Fayette","1","50","Indiana","5/22/20","40","10","18041","25"
"Floyd","8","311","Indiana","5/22/20","254","57","18043","22.44"
"Fountain","0","17","Indiana","5/22/20","16","1","18045","6.25"
"Franklin","0","106","Indiana","5/22/20","107","-1","18047","-0.93"
"Fulton","1","46","Indiana","5/22/20","39","7","18049","17.95"
"Gibson","1","13","Indiana","5/22/20","9","4","18051","44.44"
"Grant","2","174","Indiana","5/22/20","157","17","18053","10.83"
"Greene","2","167","Indiana","5/22/20","154","13","18055","8.44"
"Hamilton","15","1084","Indiana","5/22/20","977","107","18057","10.95"
"Hancock","4","312","Indiana","5/22/20","282","30","18059","10.64"
"Harrison","2","179","Indiana","5/22/20","168","11","18061","6.55"
"Hendricks","12","1095","Indiana","5/22/20","1012","83","18063","8.2"
"Henry","7","153","Indiana","5/22/20","107","46","18065","42.99"
"Howard","11","339","Indiana","5/22/20","262","77","18067","29.39"
"Huntington","0","20","Indiana","5/22/20","19","1","18069","5.26"
"Jackson","5","351","Indiana","5/22/20","313","38","18071","12.14"
"Jasper","1","50","Indiana","5/22/20","42","8","18073","19.05"
"Jay","2","38","Indiana","5/22/20","25","13","18075","52"
"Jefferson","1","41","Indiana","5/22/20","35","6","18077","17.14"
"Jennings","2","125","Indiana","5/22/20","111","14","18079","12.61"
"Johnson","13","1052","Indiana","5/22/20","959","93","18081","9.7"
"Knox","0","23","Indiana","5/22/20","22","1","18083","4.55"
"Kosciusko","2","71","Indiana","5/22/20","55","16","18085","29.09"
"LaGrange","1","58","Indiana","5/22/20","48","10","18087","20.83"
"Lake","54","3128","Indiana","5/22/20","2747","381","18089","13.87"
"LaPorte","3","376","Indiana","5/22/20","352","24","18091","6.82"
"Lawrence","2","141","Indiana","5/22/20","127","14","18093","11.02"
"Madison","6","576","Indiana","5/22/20","535","41","18095","7.66"
"Marion","133","8928","Indiana","5/22/20","7995","933","18097","11.67"
"Marshall","2","54","Indiana","5/22/20","39","15","18099","38.46"
"Martin","0","8","Indiana","5/22/20","7","1","18101","14.29"
"Miami","1","134","Indiana","5/22/20","129","5","18103","3.88"
"Monroe","2","157","Indiana","5/22/20","144","13","18105","9.03"
"Montgomery","6","202","Indiana","5/22/20","160","42","18107","26.25"
"Morgan","2","253","Indiana","5/22/20","240","13","18109","5.42"
"Newton","0","72","Indiana","5/22/20","71","1","18111","1.41"
"Noble","3","167","Indiana","5/22/20","147","20","18113","13.61"
"Ohio","0","13","Indiana","5/22/20","11","2","18115","18.18"
"Orange","0","122","Indiana","5/22/20","120","2","18117","1.67"
"Owen","0","29","Indiana","5/22/20","27","2","18119","7.41"
"Parke","0","17","Indiana","5/22/20","17","0","18121","0"
"Perry","0","22","Indiana","5/22/20","19","3","18123","15.79"
"Pike","0","5","Indiana","5/22/20","3","2","18125","66.67"
"Porter","11","458","Indiana","5/22/20","381","77","18127","20.21"
"Posey","0","16","Indiana","5/22/20","16","0","18129","0"
"Pulaski","0","37","Indiana","5/22/20","34","3","18131","8.82"
"Putnam","5","127","Indiana","5/22/20","95","32","18133","33.68"
"Randolph","1","35","Indiana","5/22/20","29","6","18135","20.69"
"Ripley","1","110","Indiana","5/22/20","106","4","18137","3.77"
"Rush","1","44","Indiana","5/22/20","40","4","18139","10"
"Scott","2","106","Indiana","5/22/20","90","16","18143","17.78"
"Shelby","4","309","Indiana","5/22/20","278","31","18145","11.15"
"Spencer","1","14","Indiana","5/22/20","7","7","18147","100"
"St. Joseph","25","1097","Indiana","5/22/20","921","176","18141","19.11"
"Starke","1","30","Indiana","5/22/20","26","4","18149","15.38"
"Steuben","1","77","Indiana","5/22/20","67","10","18151","14.93"
"Sullivan","1","31","Indiana","5/22/20","25","6","18153","24"
"Switzerland","1","19","Indiana","5/22/20","15","4","18155","26.67"
"Tippecanoe","10","348","Indiana","5/22/20","281","67","18157","23.84"
"Tipton","0","21","Indiana","5/22/20","21","0","18159","0"
"Union","0","8","Indiana","5/22/20","8","0","18161","0"
"Vanderburgh","4","230","Indiana","5/22/20","201","29","18163","14.43"
"Vermillion","0","8","Indiana","5/22/20","7","1","18165","14.29"
"Vigo","4","131","Indiana","5/22/20","103","28","18167","27.18"
"Wabash","0","71","Indiana","5/22/20","69","2","18169","2.9"
"Warren","0","12","Indiana","5/22/20","12","0","18171","0"
"Warrick","2","158","Indiana","5/22/20","145","13","18173","8.97"
"Washington","0","52","Indiana","5/22/20","50","2","18175","4"
"Wayne","1","65","Indiana","5/22/20","60","5","18177","8.33"
"Wells","1","22","Indiana","5/22/20","15","7","18179","46.67"
"White","6","206","Indiana","5/22/20","164","42","18181","25.61"
"Whitley","0","31","Indiana","5/22/20","28","3","18183","10.71"
"Adair","0","6","Iowa","5/22/20","4","2","19001","50"
"Adams","1","4","Iowa","5/22/20","0","4","19003","1"
"Allamakee","0","118","Iowa","5/22/20","116","2","19005","1.72"
"Appanoose","0","8","Iowa","5/22/20","7","1","19007","14.29"
"Audubon","0","11","Iowa","5/22/20","11","0","19009","0"
"Benton","0","37","Iowa","5/22/20","37","0","19011","0"
"Black Hawk","16","1662","Iowa","5/22/20","1548","114","19013","7.36"
"Boone","2","52","Iowa","5/22/20","41","11","19015","26.83"
"Bremer","0","65","Iowa","5/22/20","63","2","19017","3.17"
"Buchanan","1","31","Iowa","5/22/20","26","5","19019","19.23"
"Buena Vista","8","140","Iowa","5/22/20","83","57","19021","68.67"
"Butler","0","15","Iowa","5/22/20","13","2","19023","15.38"
"Calhoun","0","2","Iowa","5/22/20","1","1","19025","100"
"Carroll","0","8","Iowa","5/22/20","8","0","19027","0"
"Cass","1","6","Iowa","5/22/20","1","5","19029","500"
"Cedar","0","44","Iowa","5/22/20","42","2","19031","4.76"
"Cerro Gordo","1","20","Iowa","5/22/20","15","5","19033","33.33"
"Cherokee","0","10","Iowa","5/22/20","8","2","19035","25"
"Chickasaw","0","8","Iowa","5/22/20","7","1","19037","14.29"
"Clarke","3","29","Iowa","5/22/20","11","18","19039","163.64"
"Clay","0","9","Iowa","5/22/20","10","-1","19041","-10"
"Clayton","0","30","Iowa","5/22/20","28","2","19043","7.14"
"Clinton","0","61","Iowa","5/22/20","60","1","19045","1.67"
"Crawford","16","445","Iowa","5/22/20","336","109","19047","32.44"
"Dallas","9","821","Iowa","5/22/20","757","64","19049","8.45"
"Davis","1","17","Iowa","5/22/20","13","4","19051","30.77"
"Delaware","0","14","Iowa","5/22/20","11","3","19055","27.27"
"Des Moines","2","52","Iowa","5/22/20","39","13","19057","33.33"
"Dickinson","0","8","Iowa","5/22/20","6","2","19059","33.33"
"Dubuque","8","307","Iowa","5/22/20","249","58","19061","23.29"
"Emmet","1","7","Iowa","5/22/20","1","6","19063","600"
"Fayette","0","26","Iowa","5/22/20","25","1","19065","4"
"Floyd","1","15","Iowa","5/22/20","10","5","19067","50"
"Franklin","0","7","Iowa","5/22/20","7","0","19069","0"
"Fremont","0","4","Iowa","5/22/20","3","1","19071","33.33"
"Greene","0","13","Iowa","5/22/20","13","0","19073","0"
"Grundy","0","20","Iowa","5/22/20","17","3","19075","17.65"
"Guthrie","1","42","Iowa","5/22/20","37","5","19077","13.51"
"Hamilton","1","15","Iowa","5/22/20","11","4","19079","36.36"
"Hancock","1","11","Iowa","5/22/20","3","8","19081","266.67"
"Hardin","0","13","Iowa","5/22/20","11","2","19083","18.18"
"Harrison","0","18","Iowa","5/22/20","17","1","19085","5.88"
"Henry","2","56","Iowa","5/22/20","44","12","19087","27.27"
"Howard","0","12","Iowa","5/22/20","12","0","19089","0"
"Humboldt","0","10","Iowa","5/22/20","7","3","19091","42.86"
"Ida","1","8","Iowa","5/22/20","4","4","19093","100"
"Iowa","1","35","Iowa","5/22/20","27","8","19095","29.63"
"Jackson","0","9","Iowa","5/22/20","8","1","19097","12.5"
"Jasper","1","250","Iowa","5/22/20","241","9","19099","3.73"
"Jefferson","1","14","Iowa","5/22/20","10","4","19101","40"
"Johnson","4","591","Iowa","5/22/20","565","26","19103","4.6"
"Jones","0","36","Iowa","5/22/20","36","0","19105","0"
"Keokuk","1","13","Iowa","5/22/20","9","4","19107","44.44"
"Kossuth","1","7","Iowa","5/22/20","2","5","19109","250"
"Lee","0","20","Iowa","5/22/20","18","2","19111","11.11"
"Linn","5","916","Iowa","5/22/20","882","34","19113","3.85"
"Louisa","3","327","Iowa","5/22/20","304","23","19115","7.57"
"Lucas","1","4","Iowa","5/22/20","0","4","19117","1"
"Lyon","0","19","Iowa","5/22/20","16","3","19119","18.75"
"Madison","1","21","Iowa","5/22/20","14","7","19121","50"
"Mahaska","4","48","Iowa","5/22/20","22","26","19123","118.18"
"Marion","1","28","Iowa","5/22/20","19","9","19125","47.37"
"Marshall","12","852","Iowa","5/22/20","771","81","19127","10.51"
"Mills","1","14","Iowa","5/22/20","9","5","19129","55.56"
"Mitchell","0","4","Iowa","5/22/20","4","0","19131","0"
"Monona","1","19","Iowa","5/22/20","15","4","19133","26.67"
"Monroe","2","29","Iowa","5/22/20","18","11","19135","61.11"
"Montgomery","0","5","Iowa","5/22/20","5","0","19137","0"
"Muscatine","3","540","Iowa","5/22/20","519","21","19139","4.05"
"O'Brien","1","24","Iowa","5/22/20","20","4","19141","20"
"Osceola","1","30","Iowa","5/22/20","25","5","19143","20"
"Page","0","10","Iowa","5/22/20","10","0","19145","0"
"Palo Alto","0","3","Iowa","5/22/20","1","2","19147","200"
"Plymouth","3","101","Iowa","5/22/20","78","23","19149","29.49"
"Pocahontas","0","3","Iowa","5/22/20","3","0","19151","0"
"Polk","107","3518","Iowa","5/22/20","2767","751","19153","27.14"
"Pottawattamie","6","196","Iowa","5/22/20","151","45","19155","29.8"
"Poweshiek","1","87","Iowa","5/22/20","83","4","19157","4.82"
"Ringgold","0","2","Iowa","5/22/20","0","2","19159","1"
"Sac","1","8","Iowa","5/22/20","4","4","19161","100"
"Scott","5","329","Iowa","5/22/20","297","32","19163","10.77"
"Shelby","1","28","Iowa","5/22/20","20","8","19165","40"
"Sioux","9","188","Iowa","5/22/20","126","62","19167","49.21"
"Story","2","88","Iowa","5/22/20","73","15","19169","20.55"
"Tama","5","383","Iowa","5/22/20","350","33","19171","9.43"
"Taylor","1","6","Iowa","5/22/20","1","5","19173","500"
"Union","1","5","Iowa","5/22/20","1","4","19175","400"
"Van Buren","0","8","Iowa","5/22/20","8","0","19177","0"
"Wapello","16","462","Iowa","5/22/20","350","112","19179","32"
"Warren","5","97","Iowa","5/22/20","63","34","19181","53.97"
"Washington","2","178","Iowa","5/22/20","163","15","19183","9.2"
"Wayne","0","1","Iowa","5/22/20","1","0","19185","0"
"Webster","2","25","Iowa","5/22/20","13","12","19187","92.31"
"Winnebago","1","10","Iowa","5/22/20","6","4","19189","66.67"
"Winneshiek","0","21","Iowa","5/22/20","18","3","19191","16.67"
"Woodbury","51","2469","Iowa","5/22/20","2111","358","19193","16.96"
"Worth","0","3","Iowa","5/22/20","2","1","19195","50"
"Wright","11","85","Iowa","5/22/20","7","78","19197","1114.29"
"Allen","0","1","Kansas","5/22/20","0","1","20001","1"
"Anderson","0","1","Kansas","5/22/20","1","0","20003","0"
"Atchison","0","18","Kansas","5/22/20","15","3","20005","20"
"Barber","0","1","Kansas","5/22/20","1","0","20007","0"
"Barton","1","36","Kansas","5/22/20","30","6","20009","20"
"Bourbon","0","7","Kansas","5/22/20","6","1","20011","16.67"
"Brown","0","5","Kansas","5/22/20","3","2","20013","66.67"
"Butler","1","24","Kansas","5/22/20","18","6","20015","33.33"
"Chase","0","3","Kansas","5/22/20","3","0","20017","0"
"Chautauqua","0","4","Kansas","5/22/20","4","0","20019","0"
"Cherokee","0","9","Kansas","5/22/20","8","1","20021","12.5"
"Cheyenne","0","2","Kansas","5/22/20","2","0","20023","0"
"Clark","2","31","Kansas","5/22/20","20","11","20025","55"
"Clay","0","5","Kansas","5/22/20","4","1","20027","25"
"Cloud","0","4","Kansas","5/22/20","4","0","20029","0"
"Coffey","0","50","Kansas","5/22/20","50","0","20031","0"
"Comanche","0","1","Kansas","5/22/20","0","1","20033","1"
"Cowley","0","4","Kansas","5/22/20","4","0","20035","0"
"Crawford","0","8","Kansas","5/22/20","8","0","20037","0"
"Dickinson","0","4","Kansas","5/22/20","2","2","20041","100"
"Doniphan","0","12","Kansas","5/22/20","9","3","20043","33.33"
"Douglas","1","63","Kansas","5/22/20","59","4","20045","6.78"
"Edwards","0","5","Kansas","5/22/20","4","1","20047","25"
"Ellis","0","8","Kansas","5/22/20","8","0","20051","0"
"Ellsworth","0","2","Kansas","5/22/20","2","0","20053","0"
"Finney","26","1418","Kansas","5/22/20","1234","184","20055","14.91"
"Ford","37","1555","Kansas","5/22/20","1296","259","20057","19.98"
"Franklin","0","32","Kansas","5/22/20","32","0","20059","0"
"Geary","0","16","Kansas","5/22/20","14","2","20061","14.29"
"Gove","0","1","Kansas","5/22/20","1","0","20063","0"
"Grant","1","18","Kansas","5/22/20","13","5","20067","38.46"
"Gray","1","21","Kansas","5/22/20","12","9","20069","75"
"Greenwood","0","3","Kansas","5/22/20","3","0","20073","0"
"Hamilton","0","10","Kansas","5/22/20","9","1","20075","11.11"
"Harper","0","1","Kansas","5/22/20","1","0","20077","0"
"Harvey","0","11","Kansas","5/22/20","10","1","20079","10"
"Haskell","0","17","Kansas","5/22/20","16","1","20081","6.25"
"Hodgeman","0","1","Kansas","5/22/20","0","1","20083","1"
"Jackson","9","84","Kansas","5/22/20","23","61","20085","265.22"
"Jefferson","0","21","Kansas","5/22/20","19","2","20087","10.53"
"Jewell","0","4","Kansas","5/22/20","4","0","20089","0"
"Johnson","7","684","Kansas","5/22/20","638","46","20091","7.21"
"Kearny","1","40","Kansas","5/22/20","36","4","20093","11.11"
"Kiowa","0","2","Kansas","5/22/20","2","0","20097","0"
"Labette","0","22","Kansas","5/22/20","22","0","20099","0"
"Lane","0","1","Kansas","5/22/20","0","1","20101","1"
"Leavenworth","16","1067","Kansas","5/22/20","958","109","20103","11.38"
"Linn","0","7","Kansas","5/22/20","6","1","20107","16.67"
"Lyon","3","328","Kansas","5/22/20","310","18","20111","5.81"
"Marion","0","5","Kansas","5/22/20","5","0","20115","0"
"McPherson","0","27","Kansas","5/22/20","26","1","20113","3.85"
"Meade","0","24","Kansas","5/22/20","22","2","20119","9.09"
"Miami","0","6","Kansas","5/22/20","6","0","20121","0"
"Mitchell","0","3","Kansas","5/22/20","3","0","20123","0"
"Montgomery","0","20","Kansas","5/22/20","20","0","20125","0"
"Morris","0","3","Kansas","5/22/20","3","0","20127","0"
"Morton","0","4","Kansas","5/22/20","4","0","20129","0"
"Nemaha","1","9","Kansas","5/22/20","1","8","20131","800"
"Neosho","0","2","Kansas","5/22/20","2","0","20133","0"
"Ness","0","1","Kansas","5/22/20","0","1","20135","1"
"Norton","0","2","Kansas","5/22/20","2","0","20137","0"
"Osage","0","7","Kansas","5/22/20","6","1","20139","16.67"
"Osborne","0","2","Kansas","5/22/20","2","0","20141","0"
"Ottawa","0","4","Kansas","5/22/20","4","0","20143","0"
"Phillips","0","2","Kansas","5/22/20","2","0","20147","0"
"Pottawatomie","0","22","Kansas","5/22/20","19","3","20149","15.79"
"Pratt","0","1","Kansas","5/22/20","1","0","20151","0"
"Reno","0","43","Kansas","5/22/20","41","2","20155","4.88"
"Republic","0","4","Kansas","5/22/20","4","0","20157","0"
"Rice","0","4","Kansas","5/22/20","4","0","20159","0"
"Riley","0","61","Kansas","5/22/20","60","1","20161","1.67"
"Rooks","0","6","Kansas","5/22/20","6","0","20163","0"
"Saline","0","24","Kansas","5/22/20","23","1","20169","4.35"
"Scott","1","13","Kansas","5/22/20","8","5","20171","62.5"
"Sedgwick","2","545","Kansas","5/22/20","530","15","20173","2.83"
"Seward","9","821","Kansas","5/22/20","758","63","20175","8.31"
"Shawnee","9","247","Kansas","5/22/20","184","63","20177","34.24"
"Sheridan","0","2","Kansas","5/22/20","2","0","20179","0"
"Sherman","0","6","Kansas","5/22/20","5","1","20181","20"
"Smith","0","2","Kansas","5/22/20","2","0","20183","0"
"Stafford","0","1","Kansas","5/22/20","1","0","20185","0"
"Stanton","0","9","Kansas","5/22/20","9","0","20187","0"
"Stevens","0","26","Kansas","5/22/20","26","0","20189","0"
"Sumner","0","6","Kansas","5/22/20","6","0","20191","0"
"Trego","0","1","Kansas","5/22/20","0","1","20195","1"
"Wabaunsee","0","29","Kansas","5/22/20","28","1","20197","3.57"
"Wichita","0","0","Kansas","5/22/20","1","-1","20203","-100"
"Wilson","0","1","Kansas","5/22/20","1","0","20205","0"
"Woodson","0","6","Kansas","5/22/20","6","0","20207","0"
"Wyandotte","15","1236","Kansas","5/22/20","1129","107","20209","9.48"
"Adair","1","96","Kentucky","5/22/20","92","4","21001","4.35"
"Allen","1","44","Kentucky","5/22/20","37","7","21003","18.92"
"Anderson","1","15","Kentucky","5/22/20","10","5","21005","50"
"Ballard","0","9","Kentucky","5/22/20","10","-1","21007","-10"
"Barren","1","40","Kentucky","5/22/20","34","6","21009","17.65"
"Bath","0","8","Kentucky","5/22/20","7","1","21011","14.29"
"Bell","0","1","Kentucky","5/22/20","0","1","21013","1"
"Boone","13","379","Kentucky","5/22/20","285","94","21015","32.98"
"Bourbon","0","9","Kentucky","5/22/20","8","1","21017","12.5"
"Boyd","0","39","Kentucky","5/22/20","38","1","21019","2.63"
"Boyle","0","20","Kentucky","5/22/20","18","2","21021","11.11"
"Bracken","0","11","Kentucky","5/22/20","9","2","21023","22.22"
"Breathitt","0","2","Kentucky","5/22/20","2","0","21025","0"
"Breckinridge","0","16","Kentucky","5/22/20","14","2","21027","14.29"
"Bullitt","1","101","Kentucky","5/22/20","92","9","21029","9.78"
"Butler","1","219","Kentucky","5/22/20","212","7","21031","3.3"
"Caldwell","0","12","Kentucky","5/22/20","12","0","21033","0"
"Calloway","1","49","Kentucky","5/22/20","43","6","21035","13.95"
"Campbell","2","144","Kentucky","5/22/20","129","15","21037","11.63"
"Carlisle","0","5","Kentucky","5/22/20","3","2","21039","66.67"
"Carroll","1","6","Kentucky","5/22/20","2","4","21041","200"
"Carter","0","9","Kentucky","5/22/20","8","1","21043","12.5"
"Casey","0","2","Kentucky","5/22/20","2","0","21045","0"
"Christian","1","101","Kentucky","5/22/20","95","6","21047","6.32"
"Clark","2","37","Kentucky","5/22/20","20","17","21049","85"
"Clay","0","3","Kentucky","5/22/20","2","1","21051","50"
"Clinton","0","3","Kentucky","5/22/20","3","0","21053","0"
"Crittenden","0","5","Kentucky","5/22/20","4","1","21055","25"
"Cumberland","0","5","Kentucky","5/22/20","5","0","21057","0"
"Daviess","2","300","Kentucky","5/22/20","287","13","21059","4.53"
"Edmonson","1","53","Kentucky","5/22/20","49","4","21061","8.16"
"Elliott","0","1","Kentucky","5/22/20","0","1","21063","1"
"Fayette","10","603","Kentucky","5/22/20","530","73","21067","13.77"
"Fleming","0","2","Kentucky","5/22/20","1","1","21069","100"
"Floyd","0","16","Kentucky","5/22/20","16","0","21071","0"
"Franklin","1","24","Kentucky","5/22/20","18","6","21073","33.33"
"Fulton","0","3","Kentucky","5/22/20","1","2","21075","200"
"Gallatin","0","5","Kentucky","5/22/20","2","3","21077","150"
"Garrard","0","4","Kentucky","5/22/20","4","0","21079","0"
"Grant","1","36","Kentucky","5/22/20","32","4","21081","12.5"
"Graves","0","152","Kentucky","5/22/20","152","0","21083","0"
"Grayson","2","120","Kentucky","5/22/20","103","17","21085","16.5"
"Green","0","1","Kentucky","5/22/20","1","0","21087","0"
"Greenup","0","13","Kentucky","5/22/20","13","0","21089","0"
"Hancock","0","6","Kentucky","5/22/20","7","-1","21091","-14.29"
"Hardin","3","90","Kentucky","5/22/20","71","19","21093","26.76"
"Harlan","0","1","Kentucky","5/22/20","1","0","21095","0"
"Harrison","0","18","Kentucky","5/22/20","19","-1","21097","-5.26"
"Hart","0","17","Kentucky","5/22/20","15","2","21099","13.33"
"Henderson","1","93","Kentucky","5/22/20","85","8","21101","9.41"
"Henry","0","14","Kentucky","5/22/20","12","2","21103","16.67"
"Hickman","0","5","Kentucky","5/22/20","5","0","21105","0"
"Hopkins","0","218","Kentucky","5/22/20","215","3","21107","1.4"
"Jackson","0","60","Kentucky","5/22/20","57","3","21109","5.26"
"Jefferson","36","2021","Kentucky","5/22/20","1772","249","21111","14.05"
"Jessamine","0","50","Kentucky","5/22/20","50","0","21113","0"
"Johnson","0","5","Kentucky","5/22/20","5","0","21115","0"
"Kenton","12","520","Kentucky","5/22/20","437","83","21117","18.99"
"Knott","0","4","Kentucky","5/22/20","4","0","21119","0"
"Knox","0","8","Kentucky","5/22/20","7","1","21121","14.29"
"Larue","0","6","Kentucky","5/22/20","6","0","21123","0"
"Laurel","0","21","Kentucky","5/22/20","21","0","21125","0"
"Lawrence","0","1","Kentucky","5/22/20","2","-1","21127","-50"
"Leslie","0","6","Kentucky","5/22/20","5","1","21131","20"
"Letcher","0","4","Kentucky","5/22/20","5","-1","21133","-20"
"Lewis","0","7","Kentucky","5/22/20","8","-1","21135","-12.5"
"Lincoln","0","8","Kentucky","5/22/20","7","1","21137","14.29"
"Livingston","0","8","Kentucky","5/22/20","7","1","21139","14.29"
"Logan","5","113","Kentucky","5/22/20","80","33","21141","41.25"
"Lyon","0","14","Kentucky","5/22/20","14","0","21143","0"
"Madison","0","45","Kentucky","5/22/20","42","3","21151","7.14"
"Magoffin","0","1","Kentucky","5/22/20","0","1","21153","1"
"Marion","0","18","Kentucky","5/22/20","17","1","21155","5.88"
"Marshall","0","37","Kentucky","5/22/20","35","2","21157","5.71"
"Martin","0","3","Kentucky","5/22/20","3","0","21159","0"
"Mason","0","8","Kentucky","5/22/20","8","0","21161","0"
"McCracken","1","85","Kentucky","5/22/20","80","5","21145","6.25"
"McCreary","0","13","Kentucky","5/22/20","13","0","21147","0"
"McLean","0","19","Kentucky","5/22/20","18","1","21149","5.56"
"Meade","0","21","Kentucky","5/22/20","18","3","21163","16.67"
"Menifee","1","8","Kentucky","5/22/20","3","5","21165","166.67"
"Mercer","0","12","Kentucky","5/22/20","12","0","21167","0"
"Metcalfe","0","4","Kentucky","5/22/20","3","1","21169","33.33"
"Monroe","0","7","Kentucky","5/22/20","6","1","21171","16.67"
"Montgomery","0","17","Kentucky","5/22/20","16","1","21173","6.25"
"Morgan","0","1","Kentucky","5/22/20","1","0","21175","0"
"Muhlenberg","1","468","Kentucky","5/22/20","464","4","21177","0.86"
"Nelson","1","36","Kentucky","5/22/20","32","4","21179","12.5"
"Nicholas","0","1","Kentucky","5/22/20","1","0","21181","0"
"Ohio","1","117","Kentucky","5/22/20","108","9","21183","8.33"
"Oldham","1","60","Kentucky","5/22/20","50","10","21185","20"
"Owen","0","1","Kentucky","5/22/20","1","0","21187","0"
"Owsley","0","2","Kentucky","5/22/20","2","0","21189","0"
"Pendleton","0","7","Kentucky","5/22/20","6","1","21191","16.67"
"Perry","0","19","Kentucky","5/22/20","19","0","21193","0"
"Pike","1","28","Kentucky","5/22/20","23","5","21195","21.74"
"Powell","0","1","Kentucky","5/22/20","1","0","21197","0"
"Pulaski","1","53","Kentucky","5/22/20","47","6","21199","12.77"
"Rockcastle","0","13","Kentucky","5/22/20","12","1","21203","8.33"
"Rowan","0","7","Kentucky","5/22/20","6","1","21205","16.67"
"Russell","0","22","Kentucky","5/22/20","19","3","21207","15.79"
"Scott","0","34","Kentucky","5/22/20","34","0","21209","0"
"Shelby","3","89","Kentucky","5/22/20","65","24","21211","36.92"
"Simpson","1","44","Kentucky","5/22/20","35","9","21213","25.71"
"Spencer","0","16","Kentucky","5/22/20","16","0","21215","0"
"Taylor","0","10","Kentucky","5/22/20","9","1","21217","11.11"
"Todd","0","16","Kentucky","5/22/20","17","-1","21219","-5.88"
"Trigg","0","9","Kentucky","5/22/20","9","0","21221","0"
"Trimble","0","5","Kentucky","5/22/20","3","2","21223","66.67"
"Union","0","10","Kentucky","5/22/20","10","0","21225","0"
"Warren","22","906","Kentucky","5/22/20","751","155","21227","20.64"
"Washington","0","5","Kentucky","5/22/20","5","0","21229","0"
"Wayne","0","8","Kentucky","5/22/20","8","0","21231","0"
"Webster","0","32","Kentucky","5/22/20","32","0","21233","0"
"Whitley","0","13","Kentucky","5/22/20","12","1","21235","8.33"
"Wolfe","0","1","Kentucky","5/22/20","0","1","21237","1"
"Woodford","1","25","Kentucky","5/22/20","19","6","21239","31.58"
"Acadia","14","289","Louisiana","5/22/20","189","100","22001","52.91"
"Allen","13","182","Louisiana","5/22/20","94","88","22003","93.62"
"Ascension","5","785","Louisiana","5/22/20","749","36","22005","4.81"
"Assumption","0","238","Louisiana","5/22/20","235","3","22007","1.28"
"Avoyelles","3","101","Louisiana","5/22/20","80","21","22009","26.25"
"Beauregard","1","56","Louisiana","5/22/20","50","6","22011","12"
"Bienville","8","136","Louisiana","5/22/20","83","53","22013","63.86"
"Bossier","6","380","Louisiana","5/22/20","336","44","22015","13.1"
"Caddo","64","2293","Louisiana","5/22/20","1846","447","22017","24.21"
"Calcasieu","8","567","Louisiana","5/22/20","513","54","22019","10.53"
"Caldwell","0","51","Louisiana","5/22/20","48","3","22021","6.25"
"Cameron","0","3","Louisiana","5/22/20","3","0","22023","0"
"Catahoula","1","112","Louisiana","5/22/20","103","9","22025","8.74"
"Claiborne","0","58","Louisiana","5/22/20","59","-1","22027","-1.69"
"Concordia","2","69","Louisiana","5/22/20","55","14","22029","25.45"
"De Soto","2","236","Louisiana","5/22/20","225","11","22031","4.89"
"East Baton Rouge","60","3370","Louisiana","5/22/20","2953","417","22033","14.12"
"East Carroll","5","62","Louisiana","5/22/20","26","36","22035","138.46"
"East Feliciana","2","184","Louisiana","5/22/20","172","12","22037","6.98"
"Evangeline","2","87","Louisiana","5/22/20","74","13","22039","17.57"
"Franklin","3","287","Louisiana","5/22/20","266","21","22041","7.89"
"Grant","1","26","Louisiana","5/22/20","20","6","22043","30"
"Iberia","5","388","Louisiana","5/22/20","352","36","22045","10.23"
"Iberville","0","541","Louisiana","5/22/20","543","-2","22047","-0.37"
"Jackson","2","82","Louisiana","5/22/20","69","13","22049","18.84"
"Jefferson","48","7232","Louisiana","5/22/20","6897","335","22051","4.86"
"Jefferson Davis","0","73","Louisiana","5/22/20","70","3","22053","4.29"
"Lafayette","13","637","Louisiana","5/22/20","543","94","22055","17.31"
"Lafourche","6","766","Louisiana","5/22/20","724","42","22057","5.8"
"LaSalle","1","45","Louisiana","5/22/20","36","9","22059","25"
"Lincoln","2","133","Louisiana","5/22/20","122","11","22061","9.02"
"Livingston","3","366","Louisiana","5/22/20","347","19","22063","5.48"
"Madison","4","54","Louisiana","5/22/20","24","30","22065","125"
"Morehouse","3","110","Louisiana","5/22/20","92","18","22067","19.57"
"Natchitoches","6","145","Louisiana","5/22/20","102","43","22069","42.16"
"Orleans","22","6944","Louisiana","5/22/20","6787","157","22071","2.31"
"Ouachita","21","1041","Louisiana","5/22/20","891","150","22073","16.84"
"Plaquemines","1","198","Louisiana","5/22/20","193","5","22075","2.59"
"Pointe Coupee","4","182","Louisiana","5/22/20","155","27","22077","17.42"
"Rapides","25","600","Louisiana","5/22/20","424","176","22079","41.51"
"Red River","1","46","Louisiana","5/22/20","40","6","22081","15"
"Richland","1","114","Louisiana","5/22/20","106","8","22083","7.55"
"Sabine","1","39","Louisiana","5/22/20","29","10","22085","34.48"
"St. Bernard","1","521","Louisiana","5/22/20","517","4","22087","0.77"
"St. Charles","2","622","Louisiana","5/22/20","606","16","22089","2.64"
"St. Helena","1","44","Louisiana","5/22/20","40","4","22091","10"
"St. James","1","289","Louisiana","5/22/20","284","5","22093","1.76"
"St. John the Baptist","1","838","Louisiana","5/22/20","830","8","22095","0.96"
"St. Landry","0","247","Louisiana","5/22/20","244","3","22097","1.23"
"St. Martin","1","288","Louisiana","5/22/20","278","10","22099","3.6"
"St. Mary","4","294","Louisiana","5/22/20","268","26","22101","9.7"
"St. Tammany","13","1609","Louisiana","5/22/20","1520","89","22103","5.86"
"Tangipahoa","9","767","Louisiana","5/22/20","707","60","22105","8.49"
"Tensas","1","10","Louisiana","5/22/20","6","4","22107","66.67"
"Terrebonne","9","623","Louisiana","5/22/20","557","66","22109","11.85"
"Union","7","287","Louisiana","5/22/20","238","49","22111","20.59"
"Vermilion","1","50","Louisiana","5/22/20","43","7","22113","16.28"
"Vernon","1","23","Louisiana","5/22/20","19","4","22115","21.05"
"Washington","4","383","Louisiana","5/22/20","357","26","22117","7.28"
"Webster","2","126","Louisiana","5/22/20","112","14","22119","12.5"
"West Baton Rouge","1","154","Louisiana","5/22/20","150","4","22121","2.67"
"West Carroll","3","33","Louisiana","5/22/20","11","22","22123","200"
"West Feliciana","1","194","Louisiana","5/22/20","184","10","22125","5.43"
"Winn","5","112","Louisiana","5/22/20","76","36","22127","47.37"
"Androscoggin","14","209","Maine","5/22/20","113","96","23001","84.96"
"Aroostook","0","8","Maine","5/22/20","7","1","23003","14.29"
"Cumberland","24","968","Maine","5/22/20","798","170","23005","21.3"
"Franklin","0","36","Maine","5/22/20","33","3","23007","9.09"
"Hancock","0","11","Maine","5/22/20","10","1","23009","10"
"Kennebec","1","124","Maine","5/22/20","116","8","23011","6.9"
"Knox","0","20","Maine","5/22/20","21","-1","23013","-4.76"
"Lincoln","0","18","Maine","5/22/20","16","2","23015","12.5"
"Oxford","0","19","Maine","5/22/20","17","2","23017","11.76"
"Penobscot","1","98","Maine","5/22/20","91","7","23019","7.69"
"Piscataquis","0","1","Maine","5/22/20","1","0","23021","0"
"Sagadahoc","0","28","Maine","5/22/20","26","2","23023","7.69"
"Somerset","0","21","Maine","5/22/20","19","2","23025","10.53"
"Waldo","0","51","Maine","5/22/20","50","1","23027","2"
"Washington","0","2","Maine","5/22/20","2","0","23029","0"
"York","7","331","Maine","5/22/20","281","50","23031","17.79"
"Allegany","2","168","Maryland","5/22/20","151","17","24001","11.26"
"Anne Arundel","65","3207","Maryland","5/22/20","2752","455","24003","16.53"
"Baltimore","110","5170","Maryland","5/22/20","4399","771","24005","17.53"
"Baltimore City","127","4492","Maryland","5/22/20","3606","886","24510","24.57"
"Calvert","9","291","Maryland","5/22/20","228","63","24009","27.63"
"Caroline","5","223","Maryland","5/22/20","190","33","24011","17.37"
"Carroll","17","755","Maryland","5/22/20","635","120","24013","18.9"
"Cecil","6","339","Maryland","5/22/20","300","39","24015","13"
"Charles","18","956","Maryland","5/22/20","829","127","24017","15.32"
"Dorchester","3","126","Maryland","5/22/20","107","19","24019","17.76"
"Frederick","37","1625","Maryland","5/22/20","1364","261","24021","19.13"
"Garrett","0","7","Maryland","5/22/20","6","1","24023","16.67"
"Harford","11","746","Maryland","5/22/20","671","75","24025","11.18"
"Howard","39","1586","Maryland","5/22/20","1313","273","24027","20.79"
"Kent","2","146","Maryland","5/22/20","131","15","24029","11.45"
"Montgomery","239","9432","Maryland","5/22/20","7759","1673","24031","21.56"
"Prince George's","327","13077","Maryland","5/22/20","10791","2286","24033","21.18"
"Queen Anne's","5","141","Maryland","5/22/20","108","33","24035","30.56"
"Somerset","2","71","Maryland","5/22/20","54","17","24039","31.48"
"St. Mary's","10","370","Maryland","5/22/20","299","71","24037","23.75"
"Talbot","1","73","Maryland","5/22/20","65","8","24041","12.31"
"Washington","10","389","Maryland","5/22/20","320","69","24043","21.56"
"Wicomico","11","854","Maryland","5/22/20","777","77","24045","9.91"
"Worcester","7","180","Maryland","5/22/20","131","49","24047","37.4"
"Barnstable","20","1346","Massachusetts","5/22/20","1208","138","25001","11.42"
"Berkshire","4","531","Massachusetts","5/22/20","505","26","25003","5.15"
"Bristol","113","6503","Massachusetts","5/22/20","5710","793","25005","13.89"
"Dukes and Nantucket","1","51","Massachusetts","5/22/20","43","8","00000","18.6"
"Essex","166","13580","Massachusetts","5/22/20","12419","1161","25009","9.35"
"Franklin","1","321","Massachusetts","5/22/20","314","7","25011","2.23"
"Hampden","79","5683","Massachusetts","5/22/20","5133","550","25013","10.71"
"Hampshire","11","840","Massachusetts","5/22/20","762","78","25015","10.24"
"Middlesex","222","20776","Massachusetts","5/22/20","19223","1553","25017","8.08"
"Norfolk","66","8148","Massachusetts","5/22/20","7685","463","25021","6.02"
"Plymouth","86","7704","Massachusetts","5/22/20","7105","599","25023","8.43"
"Suffolk","181","17680","Massachusetts","5/22/20","16415","1265","25025","7.71"
"Worcester","194","10301","Massachusetts","5/22/20","8944","1357","25027","15.17"
"Alcona","0","12","Michigan","5/22/20","9","3","26001","33.33"
"Allegan","4","231","Michigan","5/22/20","203","28","26005","13.79"
"Alpena","0","100","Michigan","5/22/20","97","3","26007","3.09"
"Antrim","0","12","Michigan","5/22/20","11","1","26009","9.09"
"Arenac","0","36","Michigan","5/22/20","33","3","26011","9.09"
"Baraga","0","1","Michigan","5/22/20","1","0","26013","0"
"Barry","1","73","Michigan","5/22/20","69","4","26015","5.8"
"Bay","6","305","Michigan","5/22/20","263","42","26017","15.97"
"Benzie","0","4","Michigan","5/22/20","4","0","26019","0"
"Berrien","13","699","Michigan","5/22/20","608","91","26021","14.97"
"Branch","1","107","Michigan","5/22/20","98","9","26023","9.18"
"Calhoun","7","371","Michigan","5/22/20","325","46","26025","14.15"
"Cass","3","84","Michigan","5/22/20","61","23","26027","37.7"
"Charlevoix","0","17","Michigan","5/22/20","14","3","26029","21.43"
"Cheboygan","0","26","Michigan","5/22/20","24","2","26031","8.33"
"Chippewa","0","3","Michigan","5/22/20","3","0","26033","0"
"Clare","0","18","Michigan","5/22/20","15","3","26035","20"
"Clinton","2","164","Michigan","5/22/20","151","13","26037","8.61"
"Crawford","0","62","Michigan","5/22/20","61","1","26039","1.64"
"Delta","1","20","Michigan","5/22/20","16","4","26041","25"
"Dickinson","0","5","Michigan","5/22/20","5","0","26043","0"
"Eaton","4","219","Michigan","5/22/20","192","27","26045","14.06"
"Emmet","0","25","Michigan","5/22/20","25","0","26047","0"
"Federal Correctional Institution (FCI)","1","125","Michigan","5/22/20","115","10","00000","8.7"
"Genesee","28","2326","Michigan","5/22/20","2127","199","26049","9.36"
"Gladwin","0","17","Michigan","5/22/20","17","0","26051","0"
"Gogebic","0","5","Michigan","5/22/20","4","1","26053","25"
"Grand Traverse","0","24","Michigan","5/22/20","24","0","26055","0"
"Gratiot","5","72","Michigan","5/22/20","40","32","26057","80"
"Hillsdale","1","174","Michigan","5/22/20","167","7","26059","4.19"
"Houghton","0","2","Michigan","5/22/20","2","0","26061","0"
"Huron","1","50","Michigan","5/22/20","45","5","26063","11.11"
"Ingham","8","716","Michigan","5/22/20","662","54","26065","8.16"
"Ionia","4","153","Michigan","5/22/20","127","26","26067","20.47"
"Iosco","3","91","Michigan","5/22/20","72","19","26069","26.39"
"Isabella","1","82","Michigan","5/22/20","77","5","26073","6.49"
"Jackson","2","451","Michigan","5/22/20","437","14","26075","3.2"
"Kalamazoo","15","824","Michigan","5/22/20","719","105","26077","14.6"
"Kalkaska","0","29","Michigan","5/22/20","28","1","26079","3.57"
"Kent","78","3442","Michigan","5/22/20","2897","545","26081","18.81"
"Lake","0","6","Michigan","5/22/20","3","3","26085","100"
"Lapeer","1","204","Michigan","5/22/20","196","8","26087","4.08"
"Leelanau","0","11","Michigan","5/22/20","10","1","26089","10"
"Lenawee","2","177","Michigan","5/22/20","164","13","26091","7.93"
"Livingston","3","476","Michigan","5/22/20","458","18","26093","3.93"
"Luce","0","3","Michigan","5/22/20","1","2","26095","200"
"Mackinac","0","6","Michigan","5/22/20","6","0","26097","0"
"Macomb","28","6572","Michigan","5/22/20","6377","195","26099","3.06"
"Manistee","0","12","Michigan","5/22/20","12","0","26101","0"
"Marquette","0","52","Michigan","5/22/20","51","1","26103","1.96"
"Mason","1","37","Michigan","5/22/20","29","8","26105","27.59"
"Mecosta","0","22","Michigan","5/22/20","21","1","26107","4.76"
"Menominee","0","8","Michigan","5/22/20","8","0","26109","0"
"Michigan Department of Corrections (MDOC)","152","3378","Michigan","5/22/20","2313","1065","00000","46.04"
"Midland","2","116","Michigan","5/22/20","102","14","26111","13.73"
"Missaukee","0","22","Michigan","5/22/20","22","0","26113","0"
"Monroe","7","501","Michigan","5/22/20","450","51","26115","11.33"
"Montcalm","2","68","Michigan","5/22/20","56","12","26117","21.43"
"Montmorency","0","5","Michigan","5/22/20","5","0","26119","0"
"Muskegon","16","564","Michigan","5/22/20","454","110","26121","24.23"
"Newaygo","5","80","Michigan","5/22/20","44","36","26123","81.82"
"Oakland","92","10109","Michigan","5/22/20","9464","645","26125","6.82"
"Oceana","4","81","Michigan","5/22/20","54","27","26127","50"
"Ogemaw","1","28","Michigan","5/22/20","22","6","26129","27.27"
"Osceola","0","13","Michigan","5/22/20","11","2","26133","18.18"
"Oscoda","0","8","Michigan","5/22/20","8","0","26135","0"
"Otsego","0","118","Michigan","5/22/20","117","1","26137","0.85"
"Ottawa","23","720","Michigan","5/22/20","556","164","26139","29.5"
"Out of MI","-7","48","Michigan","5/22/20","97","-49","80026","-50.52"
"Presque Isle","0","11","Michigan","5/22/20","11","0","26141","0"
"Roscommon","0","23","Michigan","5/22/20","23","0","26143","0"
"Saginaw","14","994","Michigan","5/22/20","895","99","26145","11.06"
"Sanilac","0","40","Michigan","5/22/20","39","1","26151","2.56"
"Schoolcraft","0","4","Michigan","5/22/20","4","0","26153","0"
"Shiawassee","4","266","Michigan","5/22/20","239","27","26155","11.3"
"St. Clair","4","487","Michigan","5/22/20","459","28","26147","6.1"
"St. Joseph","2","100","Michigan","5/22/20","84","16","26149","19.05"
"Tuscola","2","180","Michigan","5/22/20","169","11","26157","6.51"
"Van Buren","2","141","Michigan","5/22/20","126","15","26159","11.9"
"Washtenaw","8","1432","Michigan","5/22/20","1377","55","26161","3.99"
"Wayne","115","20205","Michigan","5/22/20","19397","808","26163","4.17"
"Wexford","0","13","Michigan","5/22/20","13","0","26165","0"
"Aitkin","0","4","Minnesota","5/22/20","2","2","27001","100"
"Anoka","45","1044","Minnesota","5/22/20","726","318","27003","43.8"
"Becker","0","33","Minnesota","5/22/20","31","2","27005","6.45"
"Beltrami","0","10","Minnesota","5/22/20","9","1","27007","11.11"
"Benton","6","158","Minnesota","5/22/20","117","41","27009","35.04"
"Big Stone","0","3","Minnesota","5/22/20","2","1","27011","50"
"Blue Earth","5","108","Minnesota","5/22/20","76","32","27013","42.11"
"Brown","0","11","Minnesota","5/22/20","10","1","27015","10"
"Carlton","1","71","Minnesota","5/22/20","66","5","27017","7.58"
"Carver","6","146","Minnesota","5/22/20","105","41","27019","39.05"
"Cass","0","10","Minnesota","5/22/20","8","2","27021","25"
"Chippewa","2","39","Minnesota","5/22/20","27","12","27023","44.44"
"Chisago","2","41","Minnesota","5/22/20","27","14","27025","51.85"
"Clay","11","356","Minnesota","5/22/20","279","77","27027","27.6"
"Clearwater","0","2","Minnesota","5/22/20","2","0","27029","0"
"Cottonwood","1","61","Minnesota","5/22/20","52","9","27033","17.31"
"Crow Wing","2","42","Minnesota","5/22/20","25","17","27035","68"
"Dakota","48","961","Minnesota","5/22/20","623","338","27037","54.25"
"Dodge","2","41","Minnesota","5/22/20","30","11","27039","36.67"
"Douglas","1","27","Minnesota","5/22/20","18","9","27041","50"
"Faribault","0","11","Minnesota","5/22/20","12","-1","27043","-8.33"
"Fillmore","0","17","Minnesota","5/22/20","17","0","27045","0"
"Freeborn","3","76","Minnesota","5/22/20","55","21","27047","38.18"
"Goodhue","2","43","Minnesota","5/22/20","29","14","27049","48.28"
"Grant","0","2","Minnesota","5/22/20","2","0","27051","0"
"Hennepin","239","6350","Minnesota","5/22/20","4674","1676","27053","35.86"
"Houston","0","2","Minnesota","5/22/20","2","0","27055","0"
"Isanti","1","21","Minnesota","5/22/20","16","5","27059","31.25"
"Itasca","1","51","Minnesota","5/22/20","42","9","27061","21.43"
"Jackson","0","37","Minnesota","5/22/20","34","3","27063","8.82"
"Kanabec","0","11","Minnesota","5/22/20","9","2","27065","22.22"
"Kandiyohi","7","443","Minnesota","5/22/20","394","49","27067","12.44"
"Kittson","0","1","Minnesota","5/22/20","1","0","27069","0"
"Koochiching","0","4","Minnesota","5/22/20","3","1","27071","33.33"
"Lac qui Parle","0","3","Minnesota","5/22/20","2","1","27073","50"
"Lake","0","1","Minnesota","5/22/20","1","0","27075","0"
"Le Sueur","1","39","Minnesota","5/22/20","33","6","27079","18.18"
"Lincoln","0","4","Minnesota","5/22/20","4","0","27081","0"
"Lyon","1","29","Minnesota","5/22/20","25","4","27083","16"
"Mahnomen","0","5","Minnesota","5/22/20","5","0","27087","0"
"Marshall","0","8","Minnesota","5/22/20","8","0","27089","0"
"Martin","1","124","Minnesota","5/22/20","114","10","27091","8.77"
"McLeod","1","24","Minnesota","5/22/20","15","9","27085","60"
"Meeker","2","41","Minnesota","5/22/20","24","17","27093","70.83"
"Mille Lacs","1","15","Minnesota","5/22/20","8","7","27095","87.5"
"Morrison","2","34","Minnesota","5/22/20","23","11","27097","47.83"
"Mower","8","112","Minnesota","5/22/20","54","58","27099","107.41"
"Murray","1","34","Minnesota","5/22/20","30","4","27101","13.33"
"Nicollet","5","63","Minnesota","5/22/20","28","35","27103","125"
"Nobles","13","1432","Minnesota","5/22/20","1342","90","27105","6.71"
"Norman","0","11","Minnesota","5/22/20","11","0","27107","0"
"Olmsted","15","525","Minnesota","5/22/20","417","108","27109","25.9"
"Otter Tail","2","52","Minnesota","5/22/20","35","17","27111","48.57"
"Pennington","1","6","Minnesota","5/22/20","1","5","27113","500"
"Pine","0","84","Minnesota","5/22/20","82","2","27115","2.44"
"Pipestone","0","10","Minnesota","5/22/20","9","1","27117","11.11"
"Polk","0","57","Minnesota","5/22/20","55","2","27119","3.64"
"Pope","0","6","Minnesota","5/22/20","5","1","27121","20"
"Ramsey","104","2018","Minnesota","5/22/20","1287","731","27123","56.8"
"Red Lake","0","3","Minnesota","5/22/20","2","1","27125","50"
"Redwood","0","3","Minnesota","5/22/20","3","0","27127","0"
"Renville","0","5","Minnesota","5/22/20","5","0","27129","0"
"Rice","19","328","Minnesota","5/22/20","197","131","27131","66.5"
"Rock","0","20","Minnesota","5/22/20","19","1","27133","5.26"
"Roseau","0","1","Minnesota","5/22/20","1","0","27135","0"
"Scott","16","316","Minnesota","5/22/20","207","109","27139","52.66"
"Sherburne","8","193","Minnesota","5/22/20","135","58","27141","42.96"
"Sibley","1","12","Minnesota","5/22/20","4","8","27143","200"
"St. Louis","1","109","Minnesota","5/22/20","100","9","27137","9"
"Stearns","34","1881","Minnesota","5/22/20","1641","240","27145","14.63"
"Steele","6","134","Minnesota","5/22/20","92","42","27147","45.65"
"Stevens","0","0","Minnesota","5/22/20","1","-1","27149","-100"
"Swift","1","15","Minnesota","5/22/20","11","4","27151","36.36"
"Todd","13","140","Minnesota","5/22/20","46","94","27153","204.35"
"Traverse","0","3","Minnesota","5/22/20","3","0","27155","0"
"Wabasha","0","16","Minnesota","5/22/20","16","0","27157","0"
"Wadena","0","6","Minnesota","5/22/20","4","2","27159","50"
"Waseca","1","23","Minnesota","5/22/20","19","4","27161","21.05"
"Washington","21","453","Minnesota","5/22/20","305","148","27163","48.52"
"Watonwan","2","45","Minnesota","5/22/20","33","12","27165","36.36"
"Wilkin","0","11","Minnesota","5/22/20","11","0","27167","0"
"Winona","0","76","Minnesota","5/22/20","75","1","27169","1.33"
"Wright","10","213","Minnesota","5/22/20","140","73","27171","52.14"
"Yellow Medicine","0","5","Minnesota","5/22/20","3","2","27173","66.67"
"Adams","2","180","Mississippi","5/22/20","166","14","28001","8.43"
"Alcorn","0","15","Mississippi","5/22/20","12","3","28003","25"
"Amite","1","49","Mississippi","5/22/20","41","8","28005","19.51"
"Attala","6","269","Mississippi","5/22/20","224","45","28007","20.09"
"Benton","0","13","Mississippi","5/22/20","13","0","28009","0"
"Bolivar","1","134","Mississippi","5/22/20","127","7","28011","5.51"
"Calhoun","0","61","Mississippi","5/22/20","58","3","28013","5.17"
"Carroll","1","113","Mississippi","5/22/20","109","4","28015","3.67"
"Chickasaw","2","125","Mississippi","5/22/20","114","11","28017","9.65"
"Choctaw","1","29","Mississippi","5/22/20","19","10","28019","52.63"
"Claiborne","1","58","Mississippi","5/22/20","48","10","28021","20.83"
"Clarke","4","123","Mississippi","5/22/20","97","26","28023","26.8"
"Clay","2","95","Mississippi","5/22/20","78","17","28025","21.79"
"Coahoma","2","92","Mississippi","5/22/20","75","17","28027","22.67"
"Copiah","10","259","Mississippi","5/22/20","190","69","28029","36.32"
"Covington","3","125","Mississippi","5/22/20","104","21","28031","20.19"
"DeSoto","10","442","Mississippi","5/22/20","369","73","28033","19.78"
"Forrest","12","462","Mississippi","5/22/20","380","82","28035","21.58"
"Franklin","1","23","Mississippi","5/22/20","19","4","28037","21.05"
"George","0","19","Mississippi","5/22/20","18","1","28039","5.56"
"Greene","0","7","Mississippi","5/22/20","7","0","28041","0"
"Grenada","1","68","Mississippi","5/22/20","58","10","28043","17.24"
"Hancock","1","86","Mississippi","5/22/20","78","8","28045","10.26"
"Harrison","2","230","Mississippi","5/22/20","214","16","28047","7.48"
"Hinds","16","855","Mississippi","5/22/20","745","110","28049","14.77"
"Holmes","9","343","Mississippi","5/22/20","278","65","28051","23.38"
"Humphreys","1","50","Mississippi","5/22/20","42","8","28053","19.05"
"Itawamba","1","81","Mississippi","5/22/20","75","6","28057","8"
"Jackson","1","291","Mississippi","5/22/20","283","8","28059","2.83"
"Jasper","3","131","Mississippi","5/22/20","110","21","28061","19.09"
"Jefferson","1","40","Mississippi","5/22/20","34","6","28063","17.65"
"Jefferson Davis","0","69","Mississippi","5/22/20","67","2","28065","2.99"
"Jones","17","422","Mississippi","5/22/20","304","118","28067","38.82"
"Kemper","2","116","Mississippi","5/22/20","100","16","28069","16"
"Lafayette","1","116","Mississippi","5/22/20","107","9","28071","8.41"
"Lamar","7","215","Mississippi","5/22/20","166","49","28073","29.52"
"Lauderdale","12","647","Mississippi","5/22/20","566","81","28075","14.31"
"Lawrence","1","82","Mississippi","5/22/20","74","8","28077","10.81"
"Leake","3","373","Mississippi","5/22/20","351","22","28079","6.27"
"Lee","2","99","Mississippi","5/22/20","85","14","28081","16.47"
"Leflore","2","211","Mississippi","5/22/20","199","12","28083","6.03"
"Lincoln","5","231","Mississippi","5/22/20","197","34","28085","17.26"
"Lowndes","4","139","Mississippi","5/22/20","108","31","28087","28.7"
"Madison","16","618","Mississippi","5/22/20","507","111","28089","21.89"
"Marion","2","103","Mississippi","5/22/20","86","17","28091","19.77"
"Marshall","0","68","Mississippi","5/22/20","65","3","28093","4.62"
"Monroe","2","231","Mississippi","5/22/20","215","16","28095","7.44"
"Montgomery","1","77","Mississippi","5/22/20","71","6","28097","8.45"
"Neshoba","15","477","Mississippi","5/22/20","369","108","28099","29.27"
"Newton","6","214","Mississippi","5/22/20","172","42","28101","24.42"
"Noxubee","3","152","Mississippi","5/22/20","132","20","28103","15.15"
"Oktibbeha","4","126","Mississippi","5/22/20","99","27","28105","27.27"
"Panola","2","59","Mississippi","5/22/20","47","12","28107","25.53"
"Pearl River","1","203","Mississippi","5/22/20","195","8","28109","4.1"
"Perry","1","40","Mississippi","5/22/20","36","4","28111","11.11"
"Pike","2","190","Mississippi","5/22/20","174","16","28113","9.2"
"Pontotoc","0","26","Mississippi","5/22/20","25","1","28115","4"
"Prentiss","0","37","Mississippi","5/22/20","36","1","28117","2.78"
"Quitman","0","23","Mississippi","5/22/20","20","3","28119","15"
"Rankin","7","325","Mississippi","5/22/20","276","49","28121","17.75"
"Scott","11","578","Mississippi","5/22/20","504","74","28123","14.68"
"Sharkey","0","7","Mississippi","5/22/20","5","2","28125","40"
"Simpson","1","82","Mississippi","5/22/20","75","7","28127","9.33"
"Smith","3","127","Mississippi","5/22/20","109","18","28129","16.51"
"Stone","0","27","Mississippi","5/22/20","24","3","28131","12.5"
"Sunflower","1","73","Mississippi","5/22/20","69","4","28133","5.8"
"Tallahatchie","1","23","Mississippi","5/22/20","18","5","28135","27.78"
"Tate","1","59","Mississippi","5/22/20","55","4","28137","7.27"
"Tippah","0","69","Mississippi","5/22/20","67","2","28139","2.99"
"Tishomingo","1","22","Mississippi","5/22/20","13","9","28141","69.23"
"Tunica","0","47","Mississippi","5/22/20","44","3","28143","6.82"
"Union","1","68","Mississippi","5/22/20","59","9","28145","15.25"
"Walthall","1","50","Mississippi","5/22/20","44","6","28147","13.64"
"Warren","2","144","Mississippi","5/22/20","129","15","28149","11.63"
"Washington","6","143","Mississippi","5/22/20","100","43","28151","43"
"Wayne","6","72","Mississippi","5/22/20","33","39","28153","118.18"
"Webster","1","27","Mississippi","5/22/20","22","5","28155","22.73"
"Wilkinson","0","81","Mississippi","5/22/20","78","3","28157","3.85"
"Winston","3","92","Mississippi","5/22/20","73","19","28159","26.03"
"Yalobusha","2","79","Mississippi","5/22/20","66","13","28161","19.7"
"Yazoo","3","198","Mississippi","5/22/20","180","18","28163","10"
"Adair","3","38","Missouri","5/22/20","17","21","29001","123.53"
"Andrew","1","20","Missouri","5/22/20","14","6","29003","42.86"
"Atchison","0","3","Missouri","5/22/20","2","1","29005","50"
"Audrain","4","27","Missouri","5/22/20","2","25","29007","1250"
"Barry","0","8","Missouri","5/22/20","6","2","29009","33.33"
"Bates","0","7","Missouri","5/22/20","6","1","29013","16.67"
"Benton","0","10","Missouri","5/22/20","9","1","29015","11.11"
"Bollinger","0","6","Missouri","5/22/20","4","2","29017","50"
"Boone","2","111","Missouri","5/22/20","100","11","29019","11"
"Buchanan","14","599","Missouri","5/22/20","502","97","29021","19.32"
"Butler","0","28","Missouri","5/22/20","27","1","29023","3.7"
"Caldwell","0","5","Missouri","5/22/20","3","2","29025","66.67"
"Callaway","0","23","Missouri","5/22/20","23","0","29027","0"
"Camden","0","36","Missouri","5/22/20","36","0","29029","0"
"Cape Girardeau","1","57","Missouri","5/22/20","52","5","29031","9.62"
"Carroll","0","7","Missouri","5/22/20","7","0","29033","0"
"Carter","0","4","Missouri","5/22/20","3","1","29035","33.33"
"Cass","1","77","Missouri","5/22/20","72","5","29037","6.94"
"Cedar","0","9","Missouri","5/22/20","9","0","29039","0"
"Chariton","0","6","Missouri","5/22/20","6","0","29041","0"
"Christian","0","21","Missouri","5/22/20","21","0","29043","0"
"Clark","0","1","Missouri","5/22/20","1","0","29045","0"
"Clay","3","133","Missouri","5/22/20","111","22","29047","19.82"
"Clinton","1","18","Missouri","5/22/20","14","4","29049","28.57"
"Cole","0","58","Missouri","5/22/20","56","2","29051","3.57"
"Cooper","0","9","Missouri","5/22/20","9","0","29053","0"
"Crawford","0","9","Missouri","5/22/20","8","1","29055","12.5"
"Dallas","0","3","Missouri","5/22/20","2","1","29059","50"
"Daviess","0","4","Missouri","5/22/20","3","1","29061","33.33"
"DeKalb","0","5","Missouri","5/22/20","4","1","29063","25"
"Dunklin","0","25","Missouri","5/22/20","24","1","29069","4.17"
"Franklin","0","137","Missouri","5/22/20","134","3","29071","2.24"
"Gasconade","0","2","Missouri","5/22/20","2","0","29073","0"
"Gentry","1","6","Missouri","5/22/20","2","4","29075","200"
"Greene","2","117","Missouri","5/22/20","105","12","29077","11.43"
"Harrison","0","8","Missouri","5/22/20","7","1","29081","14.29"
"Henry","0","9","Missouri","5/22/20","9","0","29083","0"
"Holt","0","1","Missouri","5/22/20","1","0","29087","0"
"Howard","0","3","Missouri","5/22/20","3","0","29089","0"
"Howell","0","5","Missouri","5/22/20","5","0","29091","0"
"Iron","0","2","Missouri","5/22/20","2","0","29093","0"
"Jackson","9","485","Missouri","5/22/20","425","60","29095","14.12"
"Jasper","0","32","Missouri","5/22/20","29","3","29097","10.34"
"Jefferson","2","334","Missouri","5/22/20","318","16","29099","5.03"
"Johnson","0","72","Missouri","5/22/20","71","1","29101","1.41"
"Kansas City","17","967","Missouri","5/22/20","848","119","00000","14.03"
"Laclede","0","3","Missouri","5/22/20","3","0","29105","0"
"Lafayette","0","69","Missouri","5/22/20","68","1","29107","1.47"
"Lawrence","0","8","Missouri","5/22/20","7","1","29109","14.29"
"Lewis","0","7","Missouri","5/22/20","7","0","29111","0"
"Lincoln","0","106","Missouri","5/22/20","103","3","29113","2.91"
"Linn","0","5","Missouri","5/22/20","5","0","29115","0"
"Livingston","0","3","Missouri","5/22/20","3","0","29117","0"
"Macon","0","2","Missouri","5/22/20","2","0","29121","0"
"Madison","0","3","Missouri","5/22/20","3","0","29123","0"
"Maries","0","2","Missouri","5/22/20","2","0","29125","0"
"Marion","0","5","Missouri","5/22/20","5","0","29127","0"
"McDonald","1","15","Missouri","5/22/20","7","8","29119","114.29"
"Miller","0","4","Missouri","5/22/20","4","0","29131","0"
"Mississippi","1","53","Missouri","5/22/20","49","4","29133","8.16"
"Moniteau","0","44","Missouri","5/22/20","44","0","29135","0"
"Montgomery","0","7","Missouri","5/22/20","7","0","29139","0"
"Morgan","0","8","Missouri","5/22/20","7","1","29141","14.29"
"New Madrid","0","15","Missouri","5/22/20","13","2","29143","15.38"
"Newton","0","16","Missouri","5/22/20","13","3","29145","23.08"
"Nodaway","0","8","Missouri","5/22/20","5","3","29147","60"
"Oregon","0","2","Missouri","5/22/20","2","0","29149","0"
"Osage","0","5","Missouri","5/22/20","5","0","29151","0"
"Pemiscot","1","72","Missouri","5/22/20","68","4","29155","5.88"
"Perry","0","48","Missouri","5/22/20","46","2","29157","4.35"
"Pettis","0","70","Missouri","5/22/20","70","0","29159","0"
"Phelps","0","4","Missouri","5/22/20","2","2","29161","100"
"Pike","0","14","Missouri","5/22/20","14","0","29163","0"
"Platte","1","63","Missouri","5/22/20","54","9","29165","16.67"
"Polk","0","2","Missouri","5/22/20","1","1","29167","100"
"Pulaski","0","33","Missouri","5/22/20","36","-3","29169","-8.33"
"Ralls","0","2","Missouri","5/22/20","2","0","29173","0"
"Randolph","0","8","Missouri","5/22/20","8","0","29175","0"
"Ray","0","15","Missouri","5/22/20","12","3","29177","25"
"Reynolds","0","2","Missouri","5/22/20","2","0","29179","0"
"Ripley","0","7","Missouri","5/22/20","6","1","29181","16.67"
"Saline","3","262","Missouri","5/22/20","241","21","29195","8.71"
"Scotland","0","4","Missouri","5/22/20","4","0","29199","0"
"Scott","1","91","Missouri","5/22/20","85","6","29201","7.06"
"Shelby","0","1","Missouri","5/22/20","1","0","29205","0"
"St. Charles","5","722","Missouri","5/22/20","688","34","29183","4.94"
"St. Clair","0","3","Missouri","5/22/20","2","1","29185","50"
"St. Francois","0","33","Missouri","5/22/20","33","0","29187","0"
"St. Louis","49","4621","Missouri","5/22/20","4278","343","29189","8.02"
"St. Louis City","23","1763","Missouri","5/22/20","1602","161","29510","10.05"
"Ste. Genevieve","0","8","Missouri","5/22/20","8","0","29186","0"
"Stoddard","5","67","Missouri","5/22/20","34","33","29207","97.06"
"Stone","0","4","Missouri","5/22/20","3","1","29209","33.33"
"Sullivan","4","39","Missouri","5/22/20","13","26","29211","200"
"Taney","0","14","Missouri","5/22/20","12","2","29213","16.67"
"Vernon","0","7","Missouri","5/22/20","4","3","29217","75"
"Warren","0","28","Missouri","5/22/20","28","0","29219","0"
"Washington","0","10","Missouri","5/22/20","9","1","29221","11.11"
"Webster","0","17","Missouri","5/22/20","16","1","29225","6.25"
"Worth","0","3","Missouri","5/22/20","2","1","29227","50"
"Wright","0","11","Missouri","5/22/20","10","1","29229","10"
"Beaverhead","0","1","Montana","5/22/20","1","0","30001","0"
"Big Horn","0","8","Montana","5/22/20","8","0","30003","0"
"Broadwater","0","4","Montana","5/22/20","4","0","30007","0"
"Carbon","0","6","Montana","5/22/20","6","0","30009","0"
"Cascade","0","17","Montana","5/22/20","17","0","30013","0"
"Deer Lodge","0","3","Montana","5/22/20","3","0","30023","0"
"Flathead","0","37","Montana","5/22/20","37","0","30029","0"
"Gallatin","0","149","Montana","5/22/20","149","0","30031","0"
"Glacier","0","6","Montana","5/22/20","6","0","30035","0"
"Golden Valley","0","3","Montana","5/22/20","3","0","30037","0"
"Hill","0","1","Montana","5/22/20","1","0","30041","0"
"Jefferson","0","3","Montana","5/22/20","3","0","30043","0"
"Lake","0","5","Montana","5/22/20","5","0","30047","0"
"Lewis and Clark","0","16","Montana","5/22/20","16","0","30049","0"
"Liberty","0","1","Montana","5/22/20","1","0","30051","0"
"Lincoln","0","7","Montana","5/22/20","7","0","30053","0"
"Madison","0","8","Montana","5/22/20","8","0","30057","0"
"Meagher","0","1","Montana","5/22/20","1","0","30059","0"
"Missoula","0","39","Montana","5/22/20","39","0","30063","0"
"Musselshell","0","1","Montana","5/22/20","1","0","30065","0"
"Park","0","8","Montana","5/22/20","8","0","30067","0"
"Pondera","0","2","Montana","5/22/20","2","0","30073","0"
"Ravalli","1","13","Montana","5/22/20","5","8","30081","160"
"Richland","0","3","Montana","5/22/20","3","0","30083","0"
"Roosevelt","0","7","Montana","5/22/20","7","0","30085","0"
"Silver Bow","0","11","Montana","5/22/20","11","0","30093","0"
"Stillwater","0","1","Montana","5/22/20","1","0","30095","0"
"Toole","0","29","Montana","5/22/20","29","0","30101","0"
"Wheatland","0","1","Montana","5/22/20","1","0","30107","0"
"Yellowstone","1","88","Montana","5/22/20","83","5","30111","6.02"
"Adams","2","258","Nebraska","5/22/20","246","12","31001","4.88"
"Antelope","0","7","Nebraska","5/22/20","5","2","31003","40"
"Boone","0","3","Nebraska","5/22/20","3","0","31011","0"
"Box Butte","0","1","Nebraska","5/22/20","1","0","31013","0"
"Buffalo","0","137","Nebraska","5/22/20","134","3","31019","2.24"
"Burt","0","8","Nebraska","5/22/20","5","3","31021","60"
"Butler","2","44","Nebraska","5/22/20","28","16","31023","57.14"
"Cass","2","28","Nebraska","5/22/20","15","13","31025","86.67"
"Cedar","0","7","Nebraska","5/22/20","6","1","31027","16.67"
"Cherry","0","1","Nebraska","5/22/20","1","0","31031","0"
"Cheyenne","0","9","Nebraska","5/22/20","8","1","31033","12.5"
"Clay","1","22","Nebraska","5/22/20","15","7","31035","46.67"
"Colfax","14","580","Nebraska","5/22/20","481","99","31037","20.58"
"Cuming","1","26","Nebraska","5/22/20","16","10","31039","62.5"
"Custer","0","30","Nebraska","5/22/20","29","1","31041","3.45"
"Dakota","18","1568","Nebraska","5/22/20","1444","124","31043","8.59"
"Dawes","0","1","Nebraska","5/22/20","1","0","31045","0"
"Dawson","5","814","Nebraska","5/22/20","778","36","31047","4.63"
"Dixon","0","24","Nebraska","5/22/20","25","-1","31051","-4"
"Dodge","13","314","Nebraska","5/22/20","225","89","31053","39.56"
"Douglas","113","2881","Nebraska","5/22/20","2093","788","31055","37.65"
"Fillmore","0","5","Nebraska","5/22/20","4","1","31059","25"
"Franklin","0","6","Nebraska","5/22/20","5","1","31061","20"
"Frontier","0","1","Nebraska","5/22/20","1","0","31063","0"
"Furnas","0","6","Nebraska","5/22/20","5","1","31065","20"
"Gage","0","44","Nebraska","5/22/20","42","2","31067","4.76"
"Gosper","0","13","Nebraska","5/22/20","13","0","31073","0"
"Greeley","0","2","Nebraska","5/22/20","2","0","31077","0"
"Hall","7","1458","Nebraska","5/22/20","1409","49","31079","3.48"
"Hamilton","1","52","Nebraska","5/22/20","48","4","31081","8.33"
"Harlan","0","1","Nebraska","5/22/20","0","1","31083","1"
"Hitchcock","0","1","Nebraska","5/22/20","1","0","31087","0"
"Holt","0","1","Nebraska","5/22/20","1","0","31089","0"
"Howard","1","38","Nebraska","5/22/20","32","6","31093","18.75"
"Jefferson","0","6","Nebraska","5/22/20","5","1","31095","20"
"Johnson","0","7","Nebraska","5/22/20","6","1","31097","16.67"
"Kearney","0","11","Nebraska","5/22/20","10","1","31099","10"
"Keith","0","2","Nebraska","5/22/20","2","0","31101","0"
"Kimball","0","8","Nebraska","5/22/20","9","-1","31105","-11.11"
"Knox","0","8","Nebraska","5/22/20","8","0","31107","0"
"Lancaster","38","1002","Nebraska","5/22/20","733","269","31109","36.7"
"Lincoln","1","46","Nebraska","5/22/20","42","4","31111","9.52"
"Madison","4","294","Nebraska","5/22/20","264","30","31119","11.36"
"Merrick","1","32","Nebraska","5/22/20","28","4","31121","14.29"
"Morrill","0","10","Nebraska","5/22/20","10","0","31123","0"
"Nance","0","5","Nebraska","5/22/20","4","1","31125","25"
"Nemaha","0","3","Nebraska","5/22/20","2","1","31127","50"
"Nuckolls","0","1","Nebraska","5/22/20","0","1","31129","1"
"Otoe","0","6","Nebraska","5/22/20","5","1","31131","20"
"Phelps","0","16","Nebraska","5/22/20","13","3","31137","23.08"
"Pierce","0","2","Nebraska","5/22/20","1","1","31139","100"
"Platte","13","516","Nebraska","5/22/20","426","90","31141","21.13"
"Polk","0","9","Nebraska","5/22/20","9","0","31143","0"
"Red Willow","0","5","Nebraska","5/22/20","5","0","31145","0"
"Richardson","0","1","Nebraska","5/22/20","1","0","31147","0"
"Saline","9","465","Nebraska","5/22/20","403","62","31151","15.38"
"Sarpy","16","419","Nebraska","5/22/20","309","110","31153","35.6"
"Saunders","1","25","Nebraska","5/22/20","18","7","31155","38.89"
"Scotts Bluff","1","58","Nebraska","5/22/20","51","7","31157","13.73"
"Seward","1","27","Nebraska","5/22/20","23","4","31159","17.39"
"Sherman","0","2","Nebraska","5/22/20","2","0","31163","0"
"Stanton","0","15","Nebraska","5/22/20","15","0","31167","0"
"Thayer","0","0","Nebraska","5/22/20","1","-1","31169","-100"
"Thomas","0","1","Nebraska","5/22/20","1","0","31171","0"
"Thurston","1","24","Nebraska","5/22/20","18","6","31173","33.33"
"Valley","0","3","Nebraska","5/22/20","3","0","31175","0"
"Washington","0","26","Nebraska","5/22/20","24","2","31177","8.33"
"Wayne","0","7","Nebraska","5/22/20","4","3","31179","75"
"Webster","0","5","Nebraska","5/22/20","5","0","31181","0"
"York","1","35","Nebraska","5/22/20","28","7","31185","25"
"Carson City","3","83","Nevada","5/22/20","65","18","32510","27.69"
"Churchill","0","6","Nevada","5/22/20","5","1","32001","20"
"Clark","83","5815","Nevada","5/22/20","5235","580","32003","11.08"
"Douglas","0","26","Nevada","5/22/20","24","2","32005","8.33"
"Elko","0","21","Nevada","5/22/20","18","3","32007","16.67"
"Humboldt","1","78","Nevada","5/22/20","71","7","32013","9.86"
"Lander","0","19","Nevada","5/22/20","19","0","32015","0"
"Lincoln","0","2","Nevada","5/22/20","2","0","32017","0"
"Lyon","1","51","Nevada","5/22/20","47","4","32019","8.51"
"Mineral","0","4","Nevada","5/22/20","4","0","32021","0"
"Nye","1","59","Nevada","5/22/20","49","10","32023","20.41"
"Storey","0","1","Nevada","5/22/20","1","0","32029","0"
"Washoe","24","1356","Nevada","5/22/20","1190","166","32031","13.95"
"White Pine","0","4","Nevada","5/22/20","3","1","32033","33.33"
"Belknap","1","54","New Hampshire","5/22/20","50","4","33001","8"
"Carroll","1","46","New Hampshire","5/22/20","39","7","33003","17.95"
"Cheshire","1","51","New Hampshire","5/22/20","47","4","33005","8.51"
"Coos","0","4","New Hampshire","5/22/20","4","0","33007","0"
"Grafton","1","68","New Hampshire","5/22/20","61","7","33009","11.48"
"Hillsborough","46","2004","New Hampshire","5/22/20","1680","324","33011","19.29"
"Merrimack","7","307","New Hampshire","5/22/20","261","46","33013","17.62"
"Rockingham","23","1199","New Hampshire","5/22/20","1040","159","33015","15.29"
"Strafford","4","248","New Hampshire","5/22/20","221","27","33017","12.22"
"Sullivan","0","16","New Hampshire","5/22/20","16","0","33019","0"
"Atlantic","34","1919","New Jersey","5/22/20","1678","241","34001","14.36"
"Bergen","65","17653","New Jersey","5/22/20","17195","458","34003","2.66"
"Burlington","53","4217","New Jersey","5/22/20","3849","368","34005","9.56"
"Camden","95","5923","New Jersey","5/22/20","5255","668","34007","12.71"
"Cape May","8","545","New Jersey","5/22/20","487","58","34009","11.91"
"Cumberland","62","1921","New Jersey","5/22/20","1488","433","34011","29.1"
"Essex","130","17014","New Jersey","5/22/20","16103","911","34013","5.66"
"Gloucester","35","2031","New Jersey","5/22/20","1788","243","34015","13.59"
"Hudson","119","18880","New Jersey","5/22/20","18048","832","34017","4.61"
"Hunterdon","23","938","New Jersey","5/22/20","777","161","34019","20.72"
"Mercer","89","6295","New Jersey","5/22/20","5673","622","34021","10.96"
"Middlesex","105","15165","New Jersey","5/22/20","14429","736","34023","5.1"
"Monmouth","67","7695","New Jersey","5/22/20","7224","471","34025","6.52"
"Morris","26","6171","New Jersey","5/22/20","5990","181","34027","3.02"
"Ocean","65","8285","New Jersey","5/22/20","7829","456","34029","5.82"
"Passaic","96","15604","New Jersey","5/22/20","14930","674","34031","4.51"
"Salem","11","523","New Jersey","5/22/20","446","77","34033","17.26"
"Somerset","34","4416","New Jersey","5/22/20","4181","235","34035","5.62"
"Sussex","4","1075","New Jersey","5/22/20","1050","25","34037","2.38"
"Union","100","15191","New Jersey","5/22/20","14492","699","34039","4.82"
"Warren","7","1118","New Jersey","5/22/20","1072","46","34041","4.29"
"Bernalillo","19","1313","New Mexico","5/22/20","1180","133","35001","11.27"
"Catron","0","2","New Mexico","5/22/20","2","0","35003","0"
"Chaves","1","35","New Mexico","5/22/20","30","5","35005","16.67"
"Cibola","3","122","New Mexico","5/22/20","100","22","35006","22"
"Colfax","0","5","New Mexico","5/22/20","5","0","35007","0"
"Curry","1","45","New Mexico","5/22/20","36","9","35009","25"
"Dona Ana","14","370","New Mexico","5/22/20","270","100","35013","37.04"
"Eddy","0","17","New Mexico","5/22/20","17","0","35015","0"
"Grant","0","16","New Mexico","5/22/20","16","0","35017","0"
"Guadalupe","0","19","New Mexico","5/22/20","19","0","35019","0"
"Harding","0","1","New Mexico","5/22/20","1","0","35021","0"
"Hidalgo","0","1","New Mexico","5/22/20","0","1","35023","1"
"Lea","1","21","New Mexico","5/22/20","15","6","35025","40"
"Lincoln","0","3","New Mexico","5/22/20","2","1","35027","50"
"Los Alamos","0","6","New Mexico","5/22/20","6","0","35028","0"
"Luna","0","8","New Mexico","5/22/20","8","0","35029","0"
"McKinley","43","2086","New Mexico","5/22/20","1787","299","35031","16.73"
"Otero","1","12","New Mexico","5/22/20","8","4","35035","50"
"Quay","0","5","New Mexico","5/22/20","5","0","35037","0"
"Rio Arriba","1","36","New Mexico","5/22/20","30","6","35039","20"
"Roosevelt","2","31","New Mexico","5/22/20","14","17","35041","121.43"
"San Juan","31","1490","New Mexico","5/22/20","1274","216","35045","16.95"
"San Miguel","0","10","New Mexico","5/22/20","9","1","35047","11.11"
"Sandoval","7","529","New Mexico","5/22/20","483","46","35043","9.52"
"Santa Fe","2","129","New Mexico","5/22/20","114","15","35049","13.16"
"Sierra","0","1","New Mexico","5/22/20","1","0","35051","0"
"Socorro","0","49","New Mexico","5/22/20","49","0","35053","0"
"Taos","0","22","New Mexico","5/22/20","23","-1","35055","-4.35"
"Torrance","0","19","New Mexico","5/22/20","18","1","35057","5.56"
"Union","0","3","New Mexico","5/22/20","3","0","35059","0"
"Valencia","1","70","New Mexico","5/22/20","63","7","35061","11.11"
"Albany","31","1756","New York","5/22/20","1538","218","36001","14.17"
"Allegany","0","44","New York","5/22/20","44","0","36003","0"
"Broome","11","468","New York","5/22/20","390","78","36007","20"
"Cattaraugus","1","74","New York","5/22/20","64","10","36009","15.62"
"Cayuga","2","73","New York","5/22/20","61","12","36011","19.67"
"Chautauqua","3","63","New York","5/22/20","45","18","36013","40"
"Chemung","0","135","New York","5/22/20","133","2","36015","1.5"
"Chenango","1","118","New York","5/22/20","113","5","36017","4.42"
"Clinton","1","94","New York","5/22/20","85","9","36019","10.59"
"Columbia","3","356","New York","5/22/20","333","23","36021","6.91"
"Cortland","1","37","New York","5/22/20","33","4","36023","12.12"
"Delaware","1","72","New York","5/22/20","67","5","36025","7.46"
"Dutchess","38","3767","New York","5/22/20","3498","269","36027","7.69"
"Erie","88","5397","New York","5/22/20","4782","615","36029","12.86"
"Essex","1","36","New York","5/22/20","32","4","36031","12.5"
"Franklin","0","19","New York","5/22/20","17","2","36033","11.76"
"Fulton","6","189","New York","5/22/20","145","44","36035","30.34"
"Genesee","2","189","New York","5/22/20","175","14","36037","8"
"Greene","1","215","New York","5/22/20","209","6","36039","2.87"
"Hamilton","0","5","New York","5/22/20","5","0","36041","0"
"Herkimer","1","95","New York","5/22/20","87","8","36043","9.2"
"Jefferson","0","72","New York","5/22/20","71","1","36045","1.41"
"Lewis","1","19","New York","5/22/20","12","7","36049","58.33"
"Livingston","1","114","New York","5/22/20","106","8","36051","7.55"
"Madison","6","297","New York","5/22/20","256","41","36053","16.02"
"Monroe","73","2601","New York","5/22/20","2091","510","36055","24.39"
"Montgomery","1","77","New York","5/22/20","72","5","36057","6.94"
"Nassau","106","39608","New York","5/22/20","38864","744","36059","1.91"
"New York","875","196484","New York","5/22/20","190357","6127","36061","3.22"
"Niagara","22","897","New York","5/22/20","743","154","36063","20.73"
"Oneida","16","828","New York","5/22/20","713","115","36065","16.13"
"Onondaga","55","1828","New York","5/22/20","1440","388","36067","26.94"
"Ontario","7","180","New York","5/22/20","133","47","36069","35.34"
"Orange","45","10142","New York","5/22/20","9825","317","36071","3.23"
"Orleans","4","175","New York","5/22/20","147","28","36073","19.05"
"Oswego","2","96","New York","5/22/20","80","16","36075","20"
"Otsego","0","67","New York","5/22/20","67","0","36077","0"
"Putnam","9","1187","New York","5/22/20","1121","66","36079","5.89"
"Rensselaer","5","460","New York","5/22/20","428","32","36083","7.48"
"Rockland","38","12905","New York","5/22/20","12637","268","36087","2.12"
"Saratoga","4","448","New York","5/22/20","421","27","36091","6.41"
"Schenectady","6","645","New York","5/22/20","603","42","36093","6.97"
"Schoharie","0","49","New York","5/22/20","47","2","36095","4.26"
"Schuyler","0","11","New York","5/22/20","8","3","36097","37.5"
"Seneca","1","54","New York","5/22/20","49","5","36099","10.2"
"St. Lawrence","0","195","New York","5/22/20","192","3","36089","1.56"
"Steuben","1","240","New York","5/22/20","231","9","36101","3.9"
"Suffolk","136","38672","New York","5/22/20","37719","953","36103","2.53"
"Sullivan","14","1287","New York","5/22/20","1189","98","36105","8.24"
"Tioga","1","118","New York","5/22/20","110","8","36107","7.27"
"Tompkins","2","147","New York","5/22/20","136","11","36109","8.09"
"Ulster","12","1595","New York","5/22/20","1511","84","36111","5.56"
"Warren","3","246","New York","5/22/20","228","18","36113","7.89"
"Washington","1","224","New York","5/22/20","217","7","36115","3.23"
"Wayne","2","104","New York","5/22/20","91","13","36117","14.29"
"Westchester","118","32767","New York","5/22/20","31943","824","36119","2.58"
"Wyoming","0","79","New York","5/22/20","77","2","36121","2.6"
"Yates","2","34","New York","5/22/20","22","12","36123","54.55"
"Alamance","10","268","North Carolina","5/22/20","196","72","37001","36.73"
"Alexander","1","23","North Carolina","5/22/20","15","8","37003","53.33"
"Alleghany","0","13","North Carolina","5/22/20","10","3","37005","30"
"Anson","2","55","North Carolina","5/22/20","43","12","37007","27.91"
"Ashe","2","32","North Carolina","5/22/20","17","15","37009","88.24"
"Avery","0","2","North Carolina","5/22/20","0","2","37011","1"
"Beaufort","1","35","North Carolina","5/22/20","27","8","37013","29.63"
"Bertie","5","108","North Carolina","5/22/20","76","32","37015","42.11"
"Bladen","3","91","North Carolina","5/22/20","68","23","37017","33.82"
"Brunswick","2","68","North Carolina","5/22/20","51","17","37019","33.33"
"Buncombe","15","246","North Carolina","5/22/20","138","108","37021","78.26"
"Burke","11","253","North Carolina","5/22/20","175","78","37023","44.57"
"Cabarrus","7","423","North Carolina","5/22/20","371","52","37025","14.02"
"Caldwell","4","104","North Carolina","5/22/20","75","29","37027","38.67"
"Camden","0","3","North Carolina","5/22/20","2","1","37029","50"
"Carteret","0","36","North Carolina","5/22/20","36","0","37031","0"
"Caswell","1","51","North Carolina","5/22/20","43","8","37033","18.6"
"Catawba","7","143","North Carolina","5/22/20","96","47","37035","48.96"
"Chatham","10","564","North Carolina","5/22/20","495","69","37037","13.94"
"Cherokee","0","30","North Carolina","5/22/20","27","3","37039","11.11"
"Chowan","0","15","North Carolina","5/22/20","12","3","37041","25"
"Clay","0","8","North Carolina","5/22/20","8","0","37043","0"
"Cleveland","1","63","North Carolina","5/22/20","54","9","37045","16.67"
"Columbus","7","289","North Carolina","5/22/20","238","51","37047","21.43"
"Craven","12","168","North Carolina","5/22/20","81","87","37049","107.41"
"Cumberland","19","569","North Carolina","5/22/20","439","130","37051","29.61"
"Currituck","0","11","North Carolina","5/22/20","11","0","37053","0"
"Dare","0","22","North Carolina","5/22/20","21","1","37055","4.76"
"Davidson","10","343","North Carolina","5/22/20","270","73","37057","27.04"
"Davie","3","62","North Carolina","5/22/20","43","19","37059","44.19"
"Duplin","27","545","North Carolina","5/22/20","354","191","37061","53.95"
"Durham","35","1216","North Carolina","5/22/20","968","248","37063","25.62"
"Edgecombe","2","176","North Carolina","5/22/20","164","12","37065","7.32"
"Forsyth","36","869","North Carolina","5/22/20","616","253","37067","41.07"
"Franklin","2","138","North Carolina","5/22/20","121","17","37069","14.05"
"Gaston","7","247","North Carolina","5/22/20","201","46","37071","22.89"
"Gates","0","14","North Carolina","5/22/20","13","1","37073","7.69"
"Graham","0","2","North Carolina","5/22/20","2","0","37075","0"
"Granville","6","226","North Carolina","5/22/20","186","40","37077","21.51"
"Greene","3","58","North Carolina","5/22/20","40","18","37079","45"
"Guilford","30","977","North Carolina","5/22/20","767","210","37081","27.38"
"Halifax","6","147","North Carolina","5/22/20","107","40","37083","37.38"
"Harnett","3","259","North Carolina","5/22/20","237","22","37085","9.28"
"Haywood","3","39","North Carolina","5/22/20","21","18","37087","85.71"
"Henderson","5","306","North Carolina","5/22/20","274","32","37089","11.68"
"Hertford","1","61","North Carolina","5/22/20","51","10","37091","19.61"
"Hoke","5","175","North Carolina","5/22/20","140","35","37093","25"
"Hyde","0","1","North Carolina","5/22/20","1","0","37095","0"
"Iredell","6","213","North Carolina","5/22/20","170","43","37097","25.29"
"Jackson","1","27","North Carolina","5/22/20","23","4","37099","17.39"
"Johnston","12","314","North Carolina","5/22/20","233","81","37101","34.76"
"Jones","1","26","North Carolina","5/22/20","21","5","37103","23.81"
"Lee","8","359","North Carolina","5/22/20","305","54","37105","17.7"
"Lenoir","5","179","North Carolina","5/22/20","141","38","37107","26.95"
"Lincoln","2","56","North Carolina","5/22/20","44","12","37109","27.27"
"Macon","1","7","North Carolina","5/22/20","3","4","37113","133.33"
"Madison","0","4","North Carolina","5/22/20","1","3","37115","300"
"Martin","2","48","North Carolina","5/22/20","34","14","37117","41.18"
"McDowell","1","38","North Carolina","5/22/20","30","8","37111","26.67"
"Mecklenburg","88","3001","North Carolina","5/22/20","2385","616","37119","25.83"
"Mitchell","1","9","North Carolina","5/22/20","5","4","37121","80"
"Montgomery","4","78","North Carolina","5/22/20","48","30","37123","62.5"
"Moore","5","198","North Carolina","5/22/20","164","34","37125","20.73"
"Nash","2","166","North Carolina","5/22/20","149","17","37127","11.41"
"New Hanover","4","152","North Carolina","5/22/20","127","25","37129","19.69"
"Northampton","1","137","North Carolina","5/22/20","129","8","37131","6.2"
"Onslow","3","87","North Carolina","5/22/20","67","20","37133","29.85"
"Orange","4","291","North Carolina","5/22/20","266","25","37135","9.4"
"Pamlico","0","10","North Carolina","5/22/20","8","2","37137","25"
"Pasquotank","2","95","North Carolina","5/22/20","83","12","37139","14.46"
"Pender","3","64","North Carolina","5/22/20","43","21","37141","48.84"
"Perquimans","0","23","North Carolina","5/22/20","21","2","37143","9.52"
"Person","0","34","North Carolina","5/22/20","32","2","37145","6.25"
"Pitt","7","246","North Carolina","5/22/20","196","50","37147","25.51"
"Polk","0","35","North Carolina","5/22/20","32","3","37149","9.38"
"Randolph","17","543","North Carolina","5/22/20","422","121","37151","28.67"
"Richmond","4","132","North Carolina","5/22/20","104","28","37153","26.92"
"Robeson","18","646","North Carolina","5/22/20","519","127","37155","24.47"
"Rockingham","2","59","North Carolina","5/22/20","44","15","37157","34.09"
"Rowan","11","597","North Carolina","5/22/20","517","80","37159","15.47"
"Rutherford","1","161","North Carolina","5/22/20","153","8","37161","5.23"
"Sampson","18","345","North Carolina","5/22/20","219","126","37163","57.53"
"Scotland","2","60","North Carolina","5/22/20","48","12","37165","25"
"Stanly","1","37","North Carolina","5/22/20","32","5","37167","15.62"
"Stokes","3","42","North Carolina","5/22/20","23","19","37169","82.61"
"Surry","8","122","North Carolina","5/22/20","67","55","37171","82.09"
"Swain","1","10","North Carolina","5/22/20","6","4","37173","66.67"
"Transylvania","0","9","North Carolina","5/22/20","7","2","37175","28.57"
"Tyrrell","0","4","North Carolina","5/22/20","4","0","37177","0"
"Union","5","373","North Carolina","5/22/20","337","36","37179","10.68"
"Vance","3","215","North Carolina","5/22/20","195","20","37181","10.26"
"Wake","33","1393","North Carolina","5/22/20","1165","228","37183","19.57"
"Warren","3","48","North Carolina","5/22/20","26","22","37185","84.62"
"Washington","0","26","North Carolina","5/22/20","26","0","37187","0"
"Watauga","1","13","North Carolina","5/22/20","9","4","37189","44.44"
"Wayne","21","949","North Carolina","5/22/20","801","148","37191","18.48"
"Wilkes","25","462","North Carolina","5/22/20","287","175","37193","60.98"
"Wilson","8","275","North Carolina","5/22/20","222","53","37195","23.87"
"Yadkin","5","128","North Carolina","5/22/20","92","36","37197","39.13"
"Yancey","0","10","North Carolina","5/22/20","8","2","37199","25"
"Barnes","0","4","North Dakota","5/22/20","4","0","38003","0"
"Benson","0","1","North Dakota","5/22/20","1","0","38005","0"
"Bottineau","0","2","North Dakota","5/22/20","0","2","38009","1"
"Bowman","0","1","North Dakota","5/22/20","1","0","38011","0"
"Burke","0","5","North Dakota","5/22/20","5","0","38013","0"
"Burleigh","3","128","North Dakota","5/22/20","109","19","38015","17.43"
"Cass","59","1442","North Dakota","5/22/20","1032","410","38017","39.73"
"Divide","0","1","North Dakota","5/22/20","1","0","38023","0"
"Dunn","0","12","North Dakota","5/22/20","11","1","38025","9.09"
"Eddy","1","8","North Dakota","5/22/20","2","6","38027","300"
"Emmons","1","6","North Dakota","5/22/20","1","5","38029","500"
"Foster","0","1","North Dakota","5/22/20","1","0","38031","0"
"Grand Forks","2","320","North Dakota","5/22/20","307","13","38035","4.23"
"Grant","0","2","North Dakota","5/22/20","2","0","38037","0"
"Griggs","0","1","North Dakota","5/22/20","0","1","38039","1"
"McHenry","0","2","North Dakota","5/22/20","2","0","38049","0"
"McIntosh","0","1","North Dakota","5/22/20","1","0","38051","0"
"McKenzie","0","16","North Dakota","5/22/20","15","1","38053","6.67"
"McLean","0","7","North Dakota","5/22/20","5","2","38055","40"
"Mercer","0","5","North Dakota","5/22/20","4","1","38057","25"
"Morton","4","64","North Dakota","5/22/20","39","25","38059","64.1"
"Mountrail","0","39","North Dakota","5/22/20","38","1","38061","2.63"
"Nelson","0","2","North Dakota","5/22/20","1","1","38063","100"
"Oliver","0","1","North Dakota","5/22/20","1","0","38065","0"
"Pembina","0","6","North Dakota","5/22/20","6","0","38067","0"
"Pierce","0","4","North Dakota","5/22/20","3","1","38069","33.33"
"Ramsey","0","9","North Dakota","5/22/20","7","2","38071","28.57"
"Ransom","1","7","North Dakota","5/22/20","3","4","38073","133.33"
"Renville","0","1","North Dakota","5/22/20","1","0","38075","0"
"Richland","1","15","North Dakota","5/22/20","9","6","38077","66.67"
"Rolette","0","4","North Dakota","5/22/20","4","0","38079","0"
"Sargent","0","3","North Dakota","5/22/20","3","0","38081","0"
"Sioux","0","2","North Dakota","5/22/20","1","1","38085","100"
"Slope","0","3","North Dakota","5/22/20","3","0","38087","0"
"Stark","0","61","North Dakota","5/22/20","61","0","38089","0"
"Steele","0","1","North Dakota","5/22/20","0","1","38091","1"
"Stutsman","0","18","North Dakota","5/22/20","16","2","38093","12.5"
"Traill","3","20","North Dakota","5/22/20","1","19","38097","1900"
"Walsh","0","11","North Dakota","5/22/20","9","2","38099","22.22"
"Ward","4","54","North Dakota","5/22/20","28","26","38101","92.86"
"Wells","0","2","North Dakota","5/22/20","2","0","38103","0"
"Williams","1","25","North Dakota","5/22/20","21","4","38105","19.05"
"","0","22","Northern Mariana Islands","5/22/20","19","3",,"15.79"
"Adams","0","8","Ohio","5/22/20","8","0","39001","0"
"Allen","2","178","Ohio","5/22/20","164","14","39003","8.54"
"Ashland","0","17","Ohio","5/22/20","15","2","39005","13.33"
"Ashtabula","7","272","Ohio","5/22/20","223","49","39007","21.97"
"Athens","1","13","Ohio","5/22/20","8","5","39009","62.5"
"Auglaize","0","56","Ohio","5/22/20","54","2","39011","3.7"
"Belmont","11","374","Ohio","5/22/20","300","74","39013","24.67"
"Brown","0","24","Ohio","5/22/20","22","2","39015","9.09"
"Butler","25","734","Ohio","5/22/20","558","176","39017","31.54"
"Carroll","1","28","Ohio","5/22/20","24","4","39019","16.67"
"Champaign","1","26","Ohio","5/22/20","22","4","39021","18.18"
"Clark","8","184","Ohio","5/22/20","131","53","39023","40.46"
"Clermont","4","170","Ohio","5/22/20","144","26","39025","18.06"
"Clinton","1","43","Ohio","5/22/20","38","5","39027","13.16"
"Columbiana","11","476","Ohio","5/22/20","397","79","39029","19.9"
"Coshocton","0","23","Ohio","5/22/20","20","3","39031","15"
"Crawford","2","104","Ohio","5/22/20","92","12","39033","13.04"
"Cuyahoga","87","3762","Ohio","5/22/20","3156","606","39035","19.2"
"Darke","6","146","Ohio","5/22/20","102","44","39037","43.14"
"Defiance","1","32","Ohio","5/22/20","25","7","39039","28"
"Delaware","6","282","Ohio","5/22/20","241","41","39041","17.01"
"Erie","6","133","Ohio","5/22/20","88","45","39043","51.14"
"Fairfield","4","229","Ohio","5/22/20","203","26","39045","12.81"
"Fayette","1","34","Ohio","5/22/20","28","6","39047","21.43"
"Franklin","95","4996","Ohio","5/22/20","4330","666","39049","15.38"
"Fulton","0","35","Ohio","5/22/20","34","1","39051","2.94"
"Gallia","0","7","Ohio","5/22/20","6","1","39053","16.67"
"Geauga","5","248","Ohio","5/22/20","212","36","39055","16.98"
"Greene","2","86","Ohio","5/22/20","73","13","39057","17.81"
"Guernsey","1","29","Ohio","5/22/20","22","7","39059","31.82"
"Hamilton","45","2279","Ohio","5/22/20","1961","318","39061","16.22"
"Hancock","0","47","Ohio","5/22/20","44","3","39063","6.82"
"Hardin","1","37","Ohio","5/22/20","29","8","39065","27.59"
"Harrison","0","10","Ohio","5/22/20","9","1","39067","11.11"
"Henry","0","13","Ohio","5/22/20","10","3","39069","30"
"Highland","0","16","Ohio","5/22/20","14","2","39071","14.29"
"Hocking","5","64","Ohio","5/22/20","31","33","39073","106.45"
"Holmes","1","20","Ohio","5/22/20","10","10","39075","100"
"Huron","1","48","Ohio","5/22/20","39","9","39077","23.08"
"Jackson","0","11","Ohio","5/22/20","10","1","39079","10"
"Jefferson","0","62","Ohio","5/22/20","59","3","39081","5.08"
"Knox","0","23","Ohio","5/22/20","21","2","39083","9.52"
"Lake","5","252","Ohio","5/22/20","214","38","39085","17.76"
"Lawrence","0","28","Ohio","5/22/20","27","1","39087","3.7"
"Licking","3","200","Ohio","5/22/20","182","18","39089","9.89"
"Logan","1","33","Ohio","5/22/20","24","9","39091","37.5"
"Lorain","6","626","Ohio","5/22/20","585","41","39093","7.01"
"Lucas","21","2071","Ohio","5/22/20","1921","150","39095","7.81"
"Madison","5","128","Ohio","5/22/20","95","33","39097","34.74"
"Mahoning","16","1295","Ohio","5/22/20","1185","110","39099","9.28"
"Marion","21","2581","Ohio","5/22/20","2436","145","39101","5.95"
"Medina","7","258","Ohio","5/22/20","210","48","39103","22.86"
"Meigs","0","5","Ohio","5/22/20","3","2","39105","66.67"
"Mercer","8","170","Ohio","5/22/20","115","55","39107","47.83"
"Miami","2","337","Ohio","5/22/20","326","11","39109","3.37"
"Monroe","3","71","Ohio","5/22/20","53","18","39111","33.96"
"Montgomery","10","561","Ohio","5/22/20","489","72","39113","14.72"
"Morgan","0","5","Ohio","5/22/20","5","0","39115","0"
"Morrow","1","103","Ohio","5/22/20","97","6","39117","6.19"
"Muskingum","2","43","Ohio","5/22/20","31","12","39119","38.71"
"Noble","0","5","Ohio","5/22/20","5","0","39121","0"
"Ottawa","1","66","Ohio","5/22/20","57","9","39123","15.79"
"Paulding","0","12","Ohio","5/22/20","11","1","39125","9.09"
"Perry","0","17","Ohio","5/22/20","15","2","39127","13.33"
"Pickaway","4","2033","Ohio","5/22/20","2005","28","39129","1.4"
"Pike","0","6","Ohio","5/22/20","5","1","39131","20"
"Portage","3","308","Ohio","5/22/20","289","19","39133","6.57"
"Preble","0","30","Ohio","5/22/20","28","2","39135","7.14"
"Putnam","1","84","Ohio","5/22/20","80","4","39137","5"
"Richland","4","178","Ohio","5/22/20","150","28","39139","18.67"
"Ross","0","61","Ohio","5/22/20","58","3","39141","5.17"
"Sandusky","1","63","Ohio","5/22/20","56","7","39143","12.5"
"Scioto","0","14","Ohio","5/22/20","13","1","39145","7.69"
"Seneca","0","16","Ohio","5/22/20","15","1","39147","6.67"
"Shelby","0","36","Ohio","5/22/20","35","1","39149","2.86"
"Stark","15","655","Ohio","5/22/20","548","107","39151","19.53"
"Summit","28","1183","Ohio","5/22/20","989","194","39153","19.62"
"Trumbull","10","507","Ohio","5/22/20","440","67","39155","15.23"
"Tuscarawas","8","301","Ohio","5/22/20","246","55","39157","22.36"
"Union","1","40","Ohio","5/22/20","30","10","39159","33.33"
"Van Wert","0","5","Ohio","5/22/20","3","2","39161","66.67"
"Vinton","0","18","Ohio","5/22/20","16","2","39163","12.5"
"Warren","7","310","Ohio","5/22/20","259","51","39165","19.69"
"Washington","0","116","Ohio","5/22/20","116","0","39167","0"
"Wayne","6","242","Ohio","5/22/20","198","44","39169","22.22"
"Williams","0","48","Ohio","5/22/20","46","2","39171","4.35"
"Wood","3","261","Ohio","5/22/20","237","24","39173","10.13"
"Wyandot","1","33","Ohio","5/22/20","29","4","39175","13.79"
"Adair","1","79","Oklahoma","5/22/20","74","5","40001","6.76"
"Alfalfa","0","1","Oklahoma","5/22/20","1","0","40003","0"
"Atoka","0","1","Oklahoma","5/22/20","1","0","40005","0"
"Beaver","0","24","Oklahoma","5/22/20","22","2","40007","9.09"
"Beckham","0","6","Oklahoma","5/22/20","6","0","40009","0"
"Blaine","0","4","Oklahoma","5/22/20","2","2","40011","100"
"Bryan","1","19","Oklahoma","5/22/20","12","7","40013","58.33"
"Caddo","3","132","Oklahoma","5/22/20","111","21","40015","18.92"
"Canadian","1","123","Oklahoma","5/22/20","116","7","40017","6.03"
"Carter","2","21","Oklahoma","5/22/20","8","13","40019","162.5"
"Cherokee","0","28","Oklahoma","5/22/20","29","-1","40021","-3.45"
"Choctaw","2","14","Oklahoma","5/22/20","3","11","40023","366.67"
"Cimarron","0","1","Oklahoma","5/22/20","1","0","40025","0"
"Cleveland","3","481","Oklahoma","5/22/20","459","22","40027","4.79"
"Coal","0","1","Oklahoma","5/22/20","0","1","40029","1"
"Comanche","4","236","Oklahoma","5/22/20","205","31","40031","15.12"
"Cotton","0","5","Oklahoma","5/22/20","5","0","40033","0"
"Craig","0","15","Oklahoma","5/22/20","13","2","40035","15.38"
"Creek","1","88","Oklahoma","5/22/20","83","5","40037","6.02"
"Custer","0","12","Oklahoma","5/22/20","12","0","40039","0"
"Delaware","1","97","Oklahoma","5/22/20","93","4","40041","4.3"
"Dewey","0","3","Oklahoma","5/22/20","2","1","40043","50"
"Garfield","0","25","Oklahoma","5/22/20","23","2","40047","8.7"
"Garvin","0","15","Oklahoma","5/22/20","16","-1","40049","-6.25"
"Grady","2","72","Oklahoma","5/22/20","60","12","40051","20"
"Grant","0","2","Oklahoma","5/22/20","2","0","40053","0"
"Greer","0","66","Oklahoma","5/22/20","66","0","40055","0"
"Harper","0","1","Oklahoma","5/22/20","1","0","40059","0"
"Haskell","0","6","Oklahoma","5/22/20","5","1","40061","20"
"Jackson","0","21","Oklahoma","5/22/20","21","0","40065","0"
"Jefferson","0","3","Oklahoma","5/22/20","3","0","40067","0"
"Johnston","0","3","Oklahoma","5/22/20","3","0","40069","0"
"Kay","0","51","Oklahoma","5/22/20","49","2","40071","4.08"
"Kingfisher","0","11","Oklahoma","5/22/20","10","1","40073","10"
"Kiowa","0","6","Oklahoma","5/22/20","7","-1","40075","-14.29"
"Latimer","0","5","Oklahoma","5/22/20","5","0","40077","0"
"Le Flore","0","13","Oklahoma","5/22/20","13","0","40079","0"
"Lincoln","1","21","Oklahoma","5/22/20","17","4","40081","23.53"
"Logan","0","18","Oklahoma","5/22/20","18","0","40083","0"
"Love","0","6","Oklahoma","5/22/20","3","3","40085","100"
"Major","0","6","Oklahoma","5/22/20","6","0","40093","0"
"Marshall","0","7","Oklahoma","5/22/20","4","3","40095","75"
"Mayes","0","29","Oklahoma","5/22/20","27","2","40097","7.41"
"McClain","1","95","Oklahoma","5/22/20","86","9","40087","10.47"
"McCurtain","1","18","Oklahoma","5/22/20","9","9","40089","100"
"McIntosh","0","11","Oklahoma","5/22/20","8","3","40091","37.5"
"Murray","0","2","Oklahoma","5/22/20","2","0","40099","0"
"Muskogee","1","34","Oklahoma","5/22/20","29","5","40101","17.24"
"Noble","0","7","Oklahoma","5/22/20","7","0","40103","0"
"Nowata","0","23","Oklahoma","5/22/20","23","0","40105","0"
"Okfuskee","0","2","Oklahoma","5/22/20","2","0","40107","0"
"Oklahoma","21","1179","Oklahoma","5/22/20","1035","144","40109","13.91"
"Okmulgee","1","22","Oklahoma","5/22/20","16","6","40111","37.5"
"Osage","0","93","Oklahoma","5/22/20","91","2","40113","2.2"
"Ottawa","0","35","Oklahoma","5/22/20","35","0","40115","0"
"Pawnee","0","29","Oklahoma","5/22/20","29","0","40117","0"
"Payne","0","45","Oklahoma","5/22/20","44","1","40119","2.27"
"Pittsburg","0","40","Oklahoma","5/22/20","39","1","40121","2.56"
"Pontotoc","0","11","Oklahoma","5/22/20","10","1","40123","10"
"Pottawatomie","0","56","Oklahoma","5/22/20","55","1","40125","1.82"
"Pushmataha","0","2","Oklahoma","5/22/20","1","1","40127","100"
"Rogers","0","73","Oklahoma","5/22/20","72","1","40131","1.39"
"Seminole","0","21","Oklahoma","5/22/20","21","0","40133","0"
"Sequoyah","0","14","Oklahoma","5/22/20","14","0","40135","0"
"Stephens","2","37","Oklahoma","5/22/20","23","14","40137","60.87"
"Texas","35","851","Oklahoma","5/22/20","606","245","40139","40.43"
"Tillman","0","22","Oklahoma","5/22/20","21","1","40141","4.76"
"Tulsa","20","890","Oklahoma","5/22/20","752","138","40143","18.35"
"Wagoner","1","143","Oklahoma","5/22/20","133","10","40145","7.52"
"Washington","1","309","Oklahoma","5/22/20","301","8","40147","2.66"
"Washita","0","1","Oklahoma","5/22/20","1","0","40149","0"
"Woods","0","3","Oklahoma","5/22/20","3","0","40151","0"
"Woodward","0","3","Oklahoma","5/22/20","1","2","40153","200"
"Baker","0","1","Oregon","5/22/20","3","-2","41001","-66.67"
"Benton","1","55","Oregon","5/22/20","51","4","41003","7.84"
"Clackamas","2","289","Oregon","5/22/20","277","12","41005","4.33"
"Clatsop","1","44","Oregon","5/22/20","36","8","41007","22.22"
"Columbia","0","16","Oregon","5/22/20","16","0","41009","0"
"Coos","0","31","Oregon","5/22/20","30","1","41011","3.33"
"Crook","0","1","Oregon","5/22/20","1","0","41013","0"
"Curry","0","6","Oregon","5/22/20","4","2","41015","50"
"Deschutes","3","116","Oregon","5/22/20","94","22","41017","23.4"
"Douglas","0","25","Oregon","5/22/20","25","0","41019","0"
"Grant","0","1","Oregon","5/22/20","1","0","41023","0"
"Harney","0","1","Oregon","5/22/20","1","0","41025","0"
"Hood River","0","12","Oregon","5/22/20","14","-2","41027","-14.29"
"Jackson","1","55","Oregon","5/22/20","50","5","41029","10"
"Jefferson","0","25","Oregon","5/22/20","24","1","41031","4.17"
"Josephine","0","25","Oregon","5/22/20","25","0","41033","0"
"Klamath","0","41","Oregon","5/22/20","41","0","41035","0"
"Lane","1","66","Oregon","5/22/20","61","5","41039","8.2"
"Lincoln","0","8","Oregon","5/22/20","7","1","41041","14.29"
"Linn","0","112","Oregon","5/22/20","109","3","41043","2.75"
"Malheur","2","28","Oregon","5/22/20","17","11","41045","64.71"
"Marion","13","890","Oregon","5/22/20","797","93","41047","11.67"
"Morrow","0","12","Oregon","5/22/20","12","0","41049","0"
"Multnomah","11","1037","Oregon","5/22/20","957","80","41051","8.36"
"Polk","0","95","Oregon","5/22/20","92","3","41053","3.26"
"Sherman","0","1","Oregon","5/22/20","1","0","41055","0"
"Tillamook","0","6","Oregon","5/22/20","6","0","41057","0"
"Umatilla","2","108","Oregon","5/22/20","91","17","41059","18.68"
"Union","0","6","Oregon","5/22/20","5","1","41061","20"
"Wallowa","0","1","Oregon","5/22/20","2","-1","41063","-50"
"Wasco","0","18","Oregon","5/22/20","16","2","41065","12.5"
"Washington","7","669","Oregon","5/22/20","620","49","41067","7.9"
"Yamhill","1","63","Oregon","5/22/20","55","8","41071","14.55"
"Adams","4","214","Pennsylvania","5/22/20","183","31","42001","16.94"
"Allegheny","22","1739","Pennsylvania","5/22/20","1582","157","42003","9.92"
"Armstrong","0","58","Pennsylvania","5/22/20","57","1","42005","1.75"
"Beaver","5","550","Pennsylvania","5/22/20","516","34","42007","6.59"
"Bedford","1","36","Pennsylvania","5/22/20","30","6","42009","20"
"Berks","35","3838","Pennsylvania","5/22/20","3593","245","42011","6.82"
"Blair","2","46","Pennsylvania","5/22/20","32","14","42013","43.75"
"Bradford","0","43","Pennsylvania","5/22/20","41","2","42015","4.88"
"Bucks","63","4764","Pennsylvania","5/22/20","4325","439","42017","10.15"
"Butler","1","209","Pennsylvania","5/22/20","202","7","42019","3.47"
"Cambria","1","55","Pennsylvania","5/22/20","49","6","42021","12.24"
"Cameron","0","2","Pennsylvania","5/22/20","2","0","42023","0"
"Carbon","3","224","Pennsylvania","5/22/20","206","18","42025","8.74"
"Centre","1","138","Pennsylvania","5/22/20","129","9","42027","6.98"
"Chester","37","2320","Pennsylvania","5/22/20","2060","260","42029","12.62"
"Clarion","0","25","Pennsylvania","5/22/20","24","1","42031","4.17"
"Clearfield","0","33","Pennsylvania","5/22/20","33","0","42033","0"
"Clinton","1","48","Pennsylvania","5/22/20","43","5","42035","11.63"
"Columbia","1","342","Pennsylvania","5/22/20","334","8","42037","2.4"
"Crawford","0","21","Pennsylvania","5/22/20","21","0","42039","0"
"Cumberland","11","572","Pennsylvania","5/22/20","492","80","42041","16.26"
"Dauphin","20","1049","Pennsylvania","5/22/20","912","137","42043","15.02"
"Delaware","93","6060","Pennsylvania","5/22/20","5409","651","42045","12.04"
"Elk","0","6","Pennsylvania","5/22/20","6","0","42047","0"
"Erie","9","190","Pennsylvania","5/22/20","129","61","42049","47.29"
"Fayette","1","93","Pennsylvania","5/22/20","87","6","42051","6.9"
"Forest","0","7","Pennsylvania","5/22/20","7","0","42053","0"
"Franklin","17","697","Pennsylvania","5/22/20","580","117","42055","20.17"
"Fulton","0","14","Pennsylvania","5/22/20","11","3","42057","27.27"
"Greene","0","27","Pennsylvania","5/22/20","27","0","42059","0"
"Huntingdon","3","223","Pennsylvania","5/22/20","204","19","42061","9.31"
"Indiana","1","89","Pennsylvania","5/22/20","84","5","42063","5.95"
"Jefferson","0","7","Pennsylvania","5/22/20","7","0","42065","0"
"Juniata","0","94","Pennsylvania","5/22/20","94","0","42067","0"
"Lackawanna","25","1451","Pennsylvania","5/22/20","1273","178","42069","13.98"
"Lancaster","44","2736","Pennsylvania","5/22/20","2428","308","42071","12.69"
"Lawrence","0","73","Pennsylvania","5/22/20","72","1","42073","1.39"
"Lebanon","4","892","Pennsylvania","5/22/20","863","29","42075","3.36"
"Lehigh","31","3613","Pennsylvania","5/22/20","3396","217","42077","6.39"
"Luzerne","18","2620","Pennsylvania","5/22/20","2491","129","42079","5.18"
"Lycoming","2","155","Pennsylvania","5/22/20","141","14","42081","9.93"
"McKean","0","11","Pennsylvania","5/22/20","10","1","42083","10"
"Mercer","3","102","Pennsylvania","5/22/20","83","19","42085","22.89"
"Mifflin","0","57","Pennsylvania","5/22/20","57","0","42087","0"
"Monroe","8","1295","Pennsylvania","5/22/20","1242","53","42089","4.27"
"Montgomery","96","6366","Pennsylvania","5/22/20","5697","669","42091","11.74"
"Montour","0","51","Pennsylvania","5/22/20","50","1","42093","2"
"Northampton","35","2842","Pennsylvania","5/22/20","2600","242","42095","9.31"
"Northumberland","3","155","Pennsylvania","5/22/20","136","19","42097","13.97"
"Perry","1","43","Pennsylvania","5/22/20","36","7","42099","19.44"
"Philadelphia","237","21009","Pennsylvania","5/22/20","19349","1660","42101","8.58"
"Pike","2","475","Pennsylvania","5/22/20","458","17","42103","3.71"
"Potter","0","4","Pennsylvania","5/22/20","4","0","42105","0"
"Schuylkill","8","560","Pennsylvania","5/22/20","506","54","42107","10.67"
"Snyder","0","35","Pennsylvania","5/22/20","33","2","42109","6.06"
"Somerset","1","37","Pennsylvania","5/22/20","32","5","42111","15.62"
"Sullivan","0","2","Pennsylvania","5/22/20","2","0","42113","0"
"Susquehanna","2","93","Pennsylvania","5/22/20","82","11","42115","13.41"
"Tioga","0","16","Pennsylvania","5/22/20","16","0","42117","0"
"Union","2","61","Pennsylvania","5/22/20","44","17","42119","38.64"
"Venango","0","8","Pennsylvania","5/22/20","7","1","42121","14.29"
"Warren","0","3","Pennsylvania","5/22/20","2","1","42123","50"
"Washington","1","134","Pennsylvania","5/22/20","129","5","42125","3.88"
"Wayne","1","115","Pennsylvania","5/22/20","107","8","42127","7.48"
"Westmoreland","2","436","Pennsylvania","5/22/20","423","13","42129","3.07"
"Wyoming","1","33","Pennsylvania","5/22/20","28","5","42131","17.86"
"York","10","895","Pennsylvania","5/22/20","828","67","42133","8.09"
"","70","3030","Puerto Rico","5/22/20","2542","488",,"19.2"
"Bristol","5","209","Rhode Island","5/22/20","172","37","44001","21.51"
"Kent","15","985","Rhode Island","5/22/20","883","102","44003","11.55"
"Newport","2","212","Rhode Island","5/22/20","197","15","44005","7.61"
"Providence","173","10320","Rhode Island","5/22/20","9112","1208","44007","13.26"
"Washington","8","482","Rhode Island","5/22/20","425","57","44009","13.41"
"Abbeville","0","36","South Carolina","5/22/20","34","2","45001","5.88"
"Aiken","4","166","South Carolina","5/22/20","137","29","45003","21.17"
"Allendale","1","34","South Carolina","5/22/20","30","4","45005","13.33"
"Anderson","2","219","South Carolina","5/22/20","202","17","45007","8.42"
"Bamberg","1","20","South Carolina","5/22/20","16","4","45009","25"
"Barnwell","0","41","South Carolina","5/22/20","39","2","45011","5.13"
"Beaufort","4","314","South Carolina","5/22/20","288","26","45013","9.03"
"Berkeley","1","211","South Carolina","5/22/20","201","10","45015","4.98"
"Calhoun","0","9","South Carolina","5/22/20","9","0","45017","0"
"Charleston","6","540","South Carolina","5/22/20","501","39","45019","7.78"
"Cherokee","0","26","South Carolina","5/22/20","23","3","45021","13.04"
"Chester","1","44","South Carolina","5/22/20","40","4","45023","10"
"Chesterfield","4","118","South Carolina","5/22/20","93","25","45025","26.88"
"Clarendon","2","289","South Carolina","5/22/20","274","15","45027","5.47"
"Colleton","3","66","South Carolina","5/22/20","48","18","45029","37.5"
"Darlington","7","242","South Carolina","5/22/20","194","48","45031","24.74"
"Dillon","4","146","South Carolina","5/22/20","115","31","45033","26.96"
"Dorchester","2","126","South Carolina","5/22/20","110","16","45035","14.55"
"Edgefield","1","47","South Carolina","5/22/20","41","6","45037","14.63"
"Fairfield","7","155","South Carolina","5/22/20","108","47","45039","43.52"
"Florence","10","574","South Carolina","5/22/20","505","69","45041","13.66"
"Georgetown","0","54","South Carolina","5/22/20","51","3","45043","5.88"
"Greenville","26","1200","South Carolina","5/22/20","1021","179","45045","17.53"
"Greenwood","1","79","South Carolina","5/22/20","69","10","45047","14.49"
"Hampton","0","31","South Carolina","5/22/20","29","2","45049","6.9"
"Horry","11","359","South Carolina","5/22/20","283","76","45051","26.86"
"Jasper","1","30","South Carolina","5/22/20","25","5","45053","20"
"Kershaw","4","289","South Carolina","5/22/20","261","28","45055","10.73"
"Lancaster","1","120","South Carolina","5/22/20","110","10","45057","9.09"
"Laurens","0","57","South Carolina","5/22/20","57","0","45059","0"
"Lee","8","181","South Carolina","5/22/20","127","54","45061","42.52"
"Lexington","4","537","South Carolina","5/22/20","512","25","45063","4.88"
"Marion","2","60","South Carolina","5/22/20","48","12","45067","25"
"Marlboro","3","91","South Carolina","5/22/20","71","20","45069","28.17"
"McCormick","0","8","South Carolina","5/22/20","7","1","45065","14.29"
"Newberry","2","44","South Carolina","5/22/20","30","14","45071","46.67"
"Oconee","0","42","South Carolina","5/22/20","42","0","45073","0"
"Orangeburg","2","122","South Carolina","5/22/20","108","14","45075","12.96"
"Pickens","3","110","South Carolina","5/22/20","89","21","45077","23.6"
"Richland","20","1333","South Carolina","5/22/20","1196","137","45079","11.45"
"Saluda","5","132","South Carolina","5/22/20","98","34","45081","34.69"
"Spartanburg","9","439","South Carolina","5/22/20","376","63","45083","16.76"
"Sumter","4","339","South Carolina","5/22/20","313","26","45085","8.31"
"Union","0","31","South Carolina","5/22/20","31","0","45087","0"
"Williamsburg","5","198","South Carolina","5/22/20","165","33","45089","20"
"York","7","329","South Carolina","5/22/20","280","49","45091","17.5"
"Aurora","3","20","South Dakota","5/22/20","2","18","46003","900"
"Beadle","11","98","South Dakota","5/22/20","22","76","46005","345.45"
"Bon Homme","0","5","South Dakota","5/22/20","4","1","46009","25"
"Brookings","0","14","South Dakota","5/22/20","14","0","46011","0"
"Brown","9","235","South Dakota","5/22/20","173","62","46013","35.84"
"Buffalo","1","7","South Dakota","5/22/20","1","6","46017","600"
"Charles Mix","0","11","South Dakota","5/22/20","8","3","46023","37.5"
"Clark","0","4","South Dakota","5/22/20","4","0","46025","0"
"Clay","0","15","South Dakota","5/22/20","12","3","46027","25"
"Codington","1","25","South Dakota","5/22/20","16","9","46029","56.25"
"Corson","0","4","South Dakota","5/22/20","3","1","46031","33.33"
"Davison","0","9","South Dakota","5/22/20","9","0","46035","0"
"Day","0","11","South Dakota","5/22/20","10","1","46037","10"
"Deuel","0","1","South Dakota","5/22/20","1","0","46039","0"
"Douglas","0","1","South Dakota","5/22/20","1","0","46043","0"
"Fall River","0","4","South Dakota","5/22/20","2","2","46047","100"
"Faulk","0","1","South Dakota","5/22/20","1","0","46049","0"
"Grant","0","10","South Dakota","5/22/20","7","3","46051","42.86"
"Hamlin","0","3","South Dakota","5/22/20","2","1","46057","50"
"Hand","0","1","South Dakota","5/22/20","1","0","46059","0"
"Hughes","0","17","South Dakota","5/22/20","16","1","46065","6.25"
"Hutchinson","0","3","South Dakota","5/22/20","3","0","46067","0"
"Hyde","0","1","South Dakota","5/22/20","1","0","46069","0"
"Jerauld","1","16","South Dakota","5/22/20","6","10","46073","166.67"
"Lake","0","5","South Dakota","5/22/20","5","0","46079","0"
"Lawrence","0","9","South Dakota","5/22/20","9","0","46081","0"
"Lincoln","3","218","South Dakota","5/22/20","198","20","46083","10.1"
"Lyman","1","10","South Dakota","5/22/20","4","6","46085","150"
"Marshall","0","4","South Dakota","5/22/20","1","3","46091","300"
"McCook","0","5","South Dakota","5/22/20","5","0","46087","0"
"McPherson","0","1","South Dakota","5/22/20","1","0","46089","0"
"Meade","0","6","South Dakota","5/22/20","5","1","46093","20"
"Miner","0","1","South Dakota","5/22/20","1","0","46097","0"
"Minnehaha","16","3211","South Dakota","5/22/20","3101","110","46099","3.55"
"Moody","0","18","South Dakota","5/22/20","17","1","46101","5.88"
"Oglala Lakota","1","15","South Dakota","5/22/20","6","9","46102","150"
"Pennington","12","127","South Dakota","5/22/20","43","84","46103","195.35"
"Roberts","1","22","South Dakota","5/22/20","18","4","46109","22.22"
"Sanborn","1","8","South Dakota","5/22/20","4","4","46111","100"
"Spink","0","4","South Dakota","5/22/20","4","0","46115","0"
"Stanley","0","9","South Dakota","5/22/20","9","0","46117","0"
"Sully","0","1","South Dakota","5/22/20","1","0","46119","0"
"Todd","0","17","South Dakota","5/22/20","15","2","46121","13.33"
"Tripp","0","3","South Dakota","5/22/20","1","2","46123","200"
"Turner","0","22","South Dakota","5/22/20","19","3","46125","15.79"
"Union","2","73","South Dakota","5/22/20","57","16","46127","28.07"
"Walworth","0","5","South Dakota","5/22/20","5","0","46129","0"
"Yankton","1","45","South Dakota","5/22/20","38","7","46135","18.42"
"Ziebach","0","1","South Dakota","5/22/20","1","0","46137","0"
"Anderson","0","37","Tennessee","5/22/20","36","1","47001","2.78"
"Bedford","2","263","Tennessee","5/22/20","248","15","47003","6.05"
"Benton","0","7","Tennessee","5/22/20","6","1","47005","16.67"
"Bledsoe","0","607","Tennessee","5/22/20","605","2","47007","0.33"
"Blount","0","78","Tennessee","5/22/20","75","3","47009","4"
"Bradley","1","90","Tennessee","5/22/20","81","9","47011","11.11"
"Campbell","0","17","Tennessee","5/22/20","17","0","47013","0"
"Cannon","0","15","Tennessee","5/22/20","13","2","47015","15.38"
"Carroll","0","26","Tennessee","5/22/20","24","2","47017","8.33"
"Carter","0","19","Tennessee","5/22/20","19","0","47019","0"
"Cheatham","2","100","Tennessee","5/22/20","88","12","47021","13.64"
"Chester","0","12","Tennessee","5/22/20","12","0","47023","0"
"Claiborne","0","8","Tennessee","5/22/20","7","1","47025","14.29"
"Clay","0","6","Tennessee","5/22/20","6","0","47027","0"
"Cocke","0","20","Tennessee","5/22/20","20","0","47029","0"
"Coffee","1","64","Tennessee","5/22/20","60","4","47031","6.67"
"Crockett","0","14","Tennessee","5/22/20","13","1","47033","7.69"
"Cumberland","1","97","Tennessee","5/22/20","88","9","47035","10.23"
"Davidson","86","4396","Tennessee","5/22/20","3795","601","47037","15.84"
"Decatur","0","5","Tennessee","5/22/20","5","0","47039","0"
"DeKalb","1","32","Tennessee","5/22/20","28","4","47041","14.29"
"Dickson","2","101","Tennessee","5/22/20","90","11","47043","12.22"
"Dyer","0","46","Tennessee","5/22/20","44","2","47045","4.55"
"Fayette","2","100","Tennessee","5/22/20","88","12","47047","13.64"
"Fentress","0","9","Tennessee","5/22/20","6","3","47049","50"
"Franklin","0","45","Tennessee","5/22/20","43","2","47051","4.65"
"Gibson","0","60","Tennessee","5/22/20","57","3","47053","5.26"
"Giles","0","12","Tennessee","5/22/20","9","3","47055","33.33"
"Grainger","0","6","Tennessee","5/22/20","6","0","47057","0"
"Greene","0","47","Tennessee","5/22/20","46","1","47059","2.17"
"Grundy","0","31","Tennessee","5/22/20","30","1","47061","3.33"
"Hamblen","0","25","Tennessee","5/22/20","25","0","47063","0"
"Hamilton","19","468","Tennessee","5/22/20","332","136","47065","40.96"
"Hancock","0","1","Tennessee","5/22/20","0","1","47067","1"
"Hardeman","1","187","Tennessee","5/22/20","180","7","47069","3.89"
"Hardin","0","10","Tennessee","5/22/20","9","1","47071","11.11"
"Hawkins","0","31","Tennessee","5/22/20","32","-1","47073","-3.12"
"Haywood","0","29","Tennessee","5/22/20","29","0","47075","0"
"Henderson","0","12","Tennessee","5/22/20","11","1","47077","9.09"
"Henry","2","29","Tennessee","5/22/20","17","12","47079","70.59"
"Hickman","0","52","Tennessee","5/22/20","52","0","47081","0"
"Houston","0","7","Tennessee","5/22/20","6","1","47083","16.67"
"Humphreys","0","12","Tennessee","5/22/20","12","0","47085","0"
"Jackson","1","14","Tennessee","5/22/20","10","4","47087","40"
"Jefferson","0","27","Tennessee","5/22/20","26","1","47089","3.85"
"Johnson","0","15","Tennessee","5/22/20","15","0","47091","0"
"Knox","3","322","Tennessee","5/22/20","302","20","47093","6.62"
"Lake","1","406","Tennessee","5/22/20","401","5","47095","1.25"
"Lauderdale","1","51","Tennessee","5/22/20","43","8","47097","18.6"
"Lawrence","0","23","Tennessee","5/22/20","21","2","47099","9.52"
"Lewis","0","3","Tennessee","5/22/20","2","1","47101","50"
"Lincoln","1","26","Tennessee","5/22/20","16","10","47103","62.5"
"Loudon","12","130","Tennessee","5/22/20","48","82","47105","170.83"
"Macon","3","97","Tennessee","5/22/20","75","22","47111","29.33"
"Madison","0","163","Tennessee","5/22/20","160","3","47113","1.88"
"Marion","1","35","Tennessee","5/22/20","30","5","47115","16.67"
"Marshall","0","28","Tennessee","5/22/20","25","3","47117","12"
"Maury","3","78","Tennessee","5/22/20","60","18","47119","30"
"McMinn","0","124","Tennessee","5/22/20","123","1","47107","0.81"
"McNairy","0","12","Tennessee","5/22/20","12","0","47109","0"
"Meigs","0","22","Tennessee","5/22/20","22","0","47121","0"
"Monroe","3","57","Tennessee","5/22/20","38","19","47123","50"
"Montgomery","2","218","Tennessee","5/22/20","203","15","47125","7.39"
"Moore","0","3","Tennessee","5/22/20","3","0","47127","0"
"Morgan","1","17","Tennessee","5/22/20","12","5","47129","41.67"
"Obion","1","21","Tennessee","5/22/20","17","4","47131","23.53"
"Out of TN","0","339","Tennessee","5/22/20","340","-1","80047","-0.29"
"Overton","1","18","Tennessee","5/22/20","14","4","47133","28.57"
"Perry","0","13","Tennessee","5/22/20","13","0","47135","0"
"Pickett","0","2","Tennessee","5/22/20","1","1","47137","100"
"Polk","0","14","Tennessee","5/22/20","12","2","47139","16.67"
"Putnam","21","350","Tennessee","5/22/20","206","144","47141","69.9"
"Rhea","27","193","Tennessee","5/22/20","7","186","47143","2657.14"
"Roane","0","10","Tennessee","5/22/20","8","2","47145","25"
"Robertson","10","335","Tennessee","5/22/20","263","72","47147","27.38"
"Rutherford","19","950","Tennessee","5/22/20","814","136","47149","16.71"
"Scott","0","11","Tennessee","5/22/20","11","0","47151","0"
"Sequatchie","0","10","Tennessee","5/22/20","10","0","47153","0"
"Sevier","1","70","Tennessee","5/22/20","66","4","47155","6.06"
"Shelby","76","4127","Tennessee","5/22/20","3595","532","47157","14.8"
"Smith","1","29","Tennessee","5/22/20","24","5","47159","20.83"
"Stewart","0","8","Tennessee","5/22/20","7","1","47161","14.29"
"Sullivan","1","61","Tennessee","5/22/20","57","4","47163","7.02"
"Sumner","10","792","Tennessee","5/22/20","724","68","47165","9.39"
"Tipton","3","423","Tennessee","5/22/20","402","21","47167","5.22"
"Trousdale","1","1390","Tennessee","5/22/20","1382","8","47169","0.58"
"Unicoi","0","3","Tennessee","5/22/20","3","0","47171","0"
"Union","0","4","Tennessee","5/22/20","4","0","47173","0"
"Van Buren","0","4","Tennessee","5/22/20","3","1","47175","33.33"
"Warren","0","16","Tennessee","5/22/20","14","2","47177","14.29"
"Washington","0","68","Tennessee","5/22/20","66","2","47179","3.03"
"Wayne","0","63","Tennessee","5/22/20","61","2","47181","3.28"
"Weakley","0","26","Tennessee","5/22/20","24","2","47183","8.33"
"White","1","22","Tennessee","5/22/20","17","5","47185","29.41"
"Williamson","5","500","Tennessee","5/22/20","462","38","47187","8.23"
"Wilson","4","343","Tennessee","5/22/20","316","27","47189","8.54"
"Anderson","2","63","Texas","5/22/20","52","11","48001","21.15"
"Andrews","0","22","Texas","5/22/20","22","0","48003","0"
"Angelina","5","168","Texas","5/22/20","131","37","48005","28.24"
"Aransas","0","5","Texas","5/22/20","3","2","48007","66.67"
"Archer","0","1","Texas","5/22/20","1","0","48009","0"
"Armstrong","0","2","Texas","5/22/20","2","0","48011","0"
"Atascosa","1","35","Texas","5/22/20","30","5","48013","16.67"
"Austin","1","21","Texas","5/22/20","17","4","48015","23.53"
"Bailey","1","10","Texas","5/22/20","3","7","48017","233.33"
"Bandera","0","6","Texas","5/22/20","6","0","48019","0"
"Bastrop","5","161","Texas","5/22/20","128","33","48021","25.78"
"Bee","0","8","Texas","5/22/20","6","2","48025","33.33"
"Bell","6","282","Texas","5/22/20","242","40","48027","16.53"
"Bexar","56","2371","Texas","5/22/20","1976","395","48029","19.99"
"Blanco","0","7","Texas","5/22/20","6","1","48031","16.67"
"Bosque","0","6","Texas","5/22/20","6","0","48035","0"
"Bowie","8","176","Texas","5/22/20","122","54","48037","44.26"
"Brazoria","13","805","Texas","5/22/20","712","93","48039","13.06"
"Brazos","8","362","Texas","5/22/20","305","57","48041","18.69"
"Brewster","0","1","Texas","5/22/20","1","0","48043","0"
"Briscoe","0","1","Texas","5/22/20","1","0","48045","0"
"Brooks","0","1","Texas","5/22/20","1","0","48047","0"
"Brown","1","55","Texas","5/22/20","51","4","48049","7.84"
"Burleson","0","20","Texas","5/22/20","17","3","48051","17.65"
"Burnet","0","29","Texas","5/22/20","28","1","48053","3.57"
"Caldwell","1","41","Texas","5/22/20","35","6","48055","17.14"
"Calhoun","0","37","Texas","5/22/20","36","1","48057","2.78"
"Callahan","0","8","Texas","5/22/20","8","0","48059","0"
"Cameron","12","664","Texas","5/22/20","582","82","48061","14.09"
"Camp","2","32","Texas","5/22/20","16","16","48063","100"
"Carson","0","6","Texas","5/22/20","3","3","48065","100"
"Cass","0","21","Texas","5/22/20","21","0","48067","0"
"Castro","0","29","Texas","5/22/20","27","2","48069","7.41"
"Chambers","1","58","Texas","5/22/20","52","6","48071","11.54"
"Cherokee","2","44","Texas","5/22/20","31","13","48073","41.94"
"Childress","0","2","Texas","5/22/20","2","0","48075","0"
"Clay","0","3","Texas","5/22/20","3","0","48077","0"
"Cochran","0","1","Texas","5/22/20","1","0","48079","0"
"Coke","0","1","Texas","5/22/20","1","0","48081","0"
"Coleman","0","2","Texas","5/22/20","2","0","48083","0"
"Collin","14","1090","Texas","5/22/20","993","97","48085","9.77"
"Collingsworth","0","4","Texas","5/22/20","4","0","48087","0"
"Colorado","0","19","Texas","5/22/20","18","1","48089","5.56"
"Comal","1","78","Texas","5/22/20","68","10","48091","14.71"
"Comanche","0","5","Texas","5/22/20","3","2","48093","66.67"
"Concho","0","1","Texas","5/22/20","1","0","48095","0"
"Cooke","0","13","Texas","5/22/20","13","0","48097","0"
"Coryell","1","226","Texas","5/22/20","221","5","48099","2.26"
"Cottle","0","4","Texas","5/22/20","4","0","48101","0"
"Crane","0","3","Texas","5/22/20","2","1","48103","50"
"Crosby","0","3","Texas","5/22/20","2","1","48107","50"
"Dallam","0","22","Texas","5/22/20","21","1","48111","4.76"
"Dallas","206","8477","Texas","5/22/20","7036","1441","48113","20.48"
"Dawson","0","39","Texas","5/22/20","36","3","48115","8.33"
"Deaf Smith","3","141","Texas","5/22/20","119","22","48117","18.49"
"Delta","0","1","Texas","5/22/20","1","0","48119","0"
"Denton","21","1161","Texas","5/22/20","1016","145","48121","14.27"
"DeWitt","0","17","Texas","5/22/20","17","0","48123","0"
"Dickens","0","1","Texas","5/22/20","1","0","48125","0"
"Dimmit","0","1","Texas","5/22/20","1","0","48127","0"
"Donley","0","26","Texas","5/22/20","26","0","48129","0"
"Duval","0","5","Texas","5/22/20","5","0","48131","0"
"Eastland","0","5","Texas","5/22/20","4","1","48133","25"
"Ector","4","130","Texas","5/22/20","103","27","48135","26.21"
"El Paso","63","2046","Texas","5/22/20","1607","439","48141","27.32"
"Ellis","4","266","Texas","5/22/20","241","25","48139","10.37"
"Erath","0","15","Texas","5/22/20","15","0","48143","0"
"Falls","0","6","Texas","5/22/20","6","0","48145","0"
"Fannin","1","29","Texas","5/22/20","24","5","48147","20.83"
"Fayette","1","31","Texas","5/22/20","27","4","48149","14.81"
"Fisher","0","2","Texas","5/22/20","1","1","48151","100"
"Floyd","0","5","Texas","5/22/20","4","1","48153","25"
"Fort Bend","26","1652","Texas","5/22/20","1471","181","48157","12.3"
"Franklin","1","8","Texas","5/22/20","4","4","48159","100"
"Freestone","0","7","Texas","5/22/20","8","-1","48161","-12.5"
"Frio","0","35","Texas","5/22/20","34","1","48163","2.94"
"Gaines","0","6","Texas","5/22/20","5","1","48165","20"
"Galveston","4","721","Texas","5/22/20","693","28","48167","4.04"
"Garza","0","4","Texas","5/22/20","4","0","48169","0"
"Gillespie","0","5","Texas","5/22/20","4","1","48171","25"
"Glasscock","0","1","Texas","5/22/20","1","0","48173","0"
"Goliad","0","7","Texas","5/22/20","7","0","48175","0"
"Gonzales","2","90","Texas","5/22/20","73","17","48177","23.29"
"Gray","1","95","Texas","5/22/20","88","7","48179","7.95"
"Grayson","20","268","Texas","5/22/20","129","139","48181","107.75"
"Gregg","5","180","Texas","5/22/20","142","38","48183","26.76"
"Grimes","4","91","Texas","5/22/20","63","28","48185","44.44"
"Guadalupe","1","116","Texas","5/22/20","106","10","48187","9.43"
"Hale","1","50","Texas","5/22/20","42","8","48189","19.05"
"Hall","0","1","Texas","5/22/20","0","1","48191","1"
"Hamilton","0","7","Texas","5/22/20","7","0","48193","0"
"Hansford","0","18","Texas","5/22/20","15","3","48195","20"
"Hardin","1","121","Texas","5/22/20","116","5","48199","4.31"
"Harris","211","10526","Texas","5/22/20","9050","1476","48201","16.31"
"Harrison","2","217","Texas","5/22/20","200","17","48203","8.5"
"Hartley","0","11","Texas","5/22/20","9","2","48205","22.22"
"Haskell","0","2","Texas","5/22/20","1","1","48207","100"
"Hays","4","250","Texas","5/22/20","219","31","48209","14.16"
"Hemphill","0","1","Texas","5/22/20","1","0","48211","0"
"Henderson","0","51","Texas","5/22/20","48","3","48213","6.25"
"Hidalgo","8","472","Texas","5/22/20","417","55","48215","13.19"
"Hill","0","23","Texas","5/22/20","22","1","48217","4.55"
"Hockley","1","27","Texas","5/22/20","23","4","48219","17.39"
"Hood","0","23","Texas","5/22/20","22","1","48221","4.55"
"Hopkins","1","12","Texas","5/22/20","8","4","48223","50"
"Houston","1","81","Texas","5/22/20","74","7","48225","9.46"
"Howard","0","6","Texas","5/22/20","6","0","48227","0"
"Hunt","1","71","Texas","5/22/20","66","5","48231","7.58"
"Hutchinson","1","31","Texas","5/22/20","25","6","48233","24"
"Jack","0","4","Texas","5/22/20","4","0","48237","0"
"Jackson","0","16","Texas","5/22/20","15","1","48239","6.67"
"Jasper","0","26","Texas","5/22/20","23","3","48241","13.04"
"Jefferson","5","465","Texas","5/22/20","429","36","48245","8.39"
"Jim Hogg","0","4","Texas","5/22/20","3","1","48247","33.33"
"Jim Wells","0","9","Texas","5/22/20","7","2","48249","28.57"
"Johnson","4","144","Texas","5/22/20","119","25","48251","21.01"
"Jones","3","134","Texas","5/22/20","110","24","48253","21.82"
"Karnes","0","4","Texas","5/22/20","4","0","48255","0"
"Kaufman","4","173","Texas","5/22/20","143","30","48257","20.98"
"Kendall","1","24","Texas","5/22/20","20","4","48259","20"
"Kerr","0","11","Texas","5/22/20","10","1","48265","10"
"Kimble","0","1","Texas","5/22/20","1","0","48267","0"
"Kleberg","0","14","Texas","5/22/20","13","1","48273","7.69"
"Knox","0","1","Texas","5/22/20","1","0","48275","0"
"La Salle","0","4","Texas","5/22/20","4","0","48283","0"
"Lamar","2","126","Texas","5/22/20","111","15","48277","13.51"
"Lamb","0","11","Texas","5/22/20","10","1","48279","10"
"Lampasas","0","8","Texas","5/22/20","8","0","48281","0"
"Lavaca","0","8","Texas","5/22/20","7","1","48285","14.29"
"Lee","0","8","Texas","5/22/20","6","2","48287","33.33"
"Leon","0","9","Texas","5/22/20","9","0","48289","0"
"Liberty","1","81","Texas","5/22/20","72","9","48291","12.5"
"Limestone","0","18","Texas","5/22/20","15","3","48293","20"
"Lipscomb","0","2","Texas","5/22/20","2","0","48295","0"
"Live Oak","0","9","Texas","5/22/20","6","3","48297","50"
"Llano","0","3","Texas","5/22/20","3","0","48299","0"
"Lubbock","4","639","Texas","5/22/20","614","25","48303","4.07"
"Lynn","0","5","Texas","5/22/20","5","0","48305","0"
"Madison","0","8","Texas","5/22/20","6","2","48313","33.33"
"Marion","0","15","Texas","5/22/20","15","0","48315","0"
"Martin","0","3","Texas","5/22/20","3","0","48317","0"
"Mason","0","31","Texas","5/22/20","28","3","48319","10.71"
"Matagorda","0","67","Texas","5/22/20","65","2","48321","3.08"
"Maverick","3","98","Texas","5/22/20","74","24","48323","32.43"
"McCulloch","0","3","Texas","5/22/20","3","0","48307","0"
"McLennan","1","102","Texas","5/22/20","96","6","48309","6.25"
"Medina","2","64","Texas","5/22/20","48","16","48325","33.33"
"Midland","1","123","Texas","5/22/20","116","7","48329","6.03"
"Milam","1","27","Texas","5/22/20","23","4","48331","17.39"
"Mills","0","1","Texas","5/22/20","1","0","48333","0"
"Mitchell","0","1","Texas","5/22/20","1","0","48335","0"
"Montague","0","9","Texas","5/22/20","9","0","48337","0"
"Montgomery","13","888","Texas","5/22/20","798","90","48339","11.28"
"Moore","6","579","Texas","5/22/20","540","39","48341","7.22"
"Morris","1","15","Texas","5/22/20","10","5","48343","50"
"Motley","0","1","Texas","5/22/20","1","0","48345","0"
"Nacogdoches","2","244","Texas","5/22/20","229","15","48347","6.55"
"Navarro","0","40","Texas","5/22/20","38","2","48349","5.26"
"Newton","0","4","Texas","5/22/20","4","0","48351","0"
"Nolan","0","2","Texas","5/22/20","2","0","48353","0"
"Nueces","7","260","Texas","5/22/20","209","51","48355","24.4"
"Ochiltree","0","41","Texas","5/22/20","40","1","48357","2.5"
"Oldham","0","3","Texas","5/22/20","4","-1","48359","-25"
"Orange","0","89","Texas","5/22/20","87","2","48361","2.3"
"Palo Pinto","0","10","Texas","5/22/20","9","1","48363","11.11"
"Panola","2","188","Texas","5/22/20","175","13","48365","7.43"
"Parker","1","67","Texas","5/22/20","57","10","48367","17.54"
"Parmer","2","39","Texas","5/22/20","23","16","48369","69.57"
"Pecos","1","24","Texas","5/22/20","20","4","48371","20"
"Polk","1","52","Texas","5/22/20","47","5","48373","10.64"
"Potter","105","2196","Texas","5/22/20","1462","734","48375","50.21"
"Rains","0","3","Texas","5/22/20","2","1","48379","50"
"Randall","21","625","Texas","5/22/20","477","148","48381","31.03"
"Red River","1","42","Texas","5/22/20","35","7","48387","20"
"Reeves","0","7","Texas","5/22/20","7","0","48389","0"
"Refugio","0","3","Texas","5/22/20","3","0","48391","0"
"Roberts","0","2","Texas","5/22/20","2","0","48393","0"
"Robertson","0","7","Texas","5/22/20","6","1","48395","16.67"
"Rockwall","1","147","Texas","5/22/20","138","9","48397","6.52"
"Runnels","0","2","Texas","5/22/20","2","0","48399","0"
"Rusk","0","42","Texas","5/22/20","40","2","48401","5"
"Sabine","0","4","Texas","5/22/20","3","1","48403","33.33"
"San Augustine","1","28","Texas","5/22/20","22","6","48405","27.27"
"San Jacinto","0","13","Texas","5/22/20","12","1","48407","8.33"
"San Patricio","0","28","Texas","5/22/20","25","3","48409","12"
"San Saba","0","1","Texas","5/22/20","0","1","48411","1"
"Scurry","0","2","Texas","5/22/20","2","0","48415","0"
"Shackelford","0","1","Texas","5/22/20","1","0","48417","0"
"Shelby","1","180","Texas","5/22/20","172","8","48419","4.65"
"Sherman","0","23","Texas","5/22/20","23","0","48421","0"
"Smith","1","195","Texas","5/22/20","189","6","48423","3.17"
"Starr","1","23","Texas","5/22/20","16","7","48427","43.75"
"Stephens","0","2","Texas","5/22/20","2","0","48429","0"
"Swisher","0","15","Texas","5/22/20","14","1","48437","7.14"
"Tarrant","71","4711","Texas","5/22/20","4211","500","48439","11.87"
"Taylor","2","228","Texas","5/22/20","215","13","48441","6.05"
"Terry","0","13","Texas","5/22/20","12","1","48445","8.33"
"Titus","24","248","Texas","5/22/20","83","165","48449","198.8"
"Tom Green","1","90","Texas","5/22/20","86","4","48451","4.65"
"Travis","38","2644","Texas","5/22/20","2381","263","48453","11.05"
"Trinity","0","11","Texas","5/22/20","11","0","48455","0"
"Tyler","0","10","Texas","5/22/20","7","3","48457","42.86"
"Upshur","0","18","Texas","5/22/20","18","0","48459","0"
"Uvalde","0","6","Texas","5/22/20","6","0","48463","0"
"Val Verde","0","14","Texas","5/22/20","13","1","48465","7.69"
"Van Zandt","0","25","Texas","5/22/20","22","3","48467","13.64"
"Victoria","0","157","Texas","5/22/20","154","3","48469","1.95"
"Walker","9","436","Texas","5/22/20","374","62","48471","16.58"
"Waller","1","45","Texas","5/22/20","38","7","48473","18.42"
"Washington","1","187","Texas","5/22/20","179","8","48477","4.47"
"Webb","7","498","Texas","5/22/20","451","47","48479","10.42"
"Wharton","0","45","Texas","5/22/20","42","3","48481","7.14"
"Wheeler","0","15","Texas","5/22/20","14","1","48483","7.14"
"Wichita","1","82","Texas","5/22/20","78","4","48485","5.13"
"Wilbarger","0","6","Texas","5/22/20","5","1","48487","20"
"Willacy","0","15","Texas","5/22/20","14","1","48489","7.14"
"Williamson","11","528","Texas","5/22/20","451","77","48491","17.07"
"Wilson","0","38","Texas","5/22/20","36","2","48493","5.56"
"Winkler","0","3","Texas","5/22/20","3","0","48495","0"
"Wise","1","42","Texas","5/22/20","36","6","48497","16.67"
"Wood","1","22","Texas","5/22/20","17","5","48499","29.41"
"Yoakum","0","3","Texas","5/22/20","2","1","48501","50"
"Young","0","4","Texas","5/22/20","4","0","48503","0"
"Zapata","0","8","Texas","5/22/20","7","1","48505","14.29"
"Zavala","0","11","Texas","5/22/20","9","2","48507","22.22"
"Bear River","2","98","Utah","5/22/20","84","14","00000","16.67"
"Central Utah","1","34","Utah","5/22/20","29","5","00000","17.24"
"Davis","7","401","Utah","5/22/20","354","47","49011","13.28"
"Salt Lake","86","4308","Utah","5/22/20","3709","599","49035","16.15"
"San Juan","14","254","Utah","5/22/20","159","95","49037","59.75"
"Southeast Utah","1","18","Utah","5/22/20","13","5","00000","38.46"
"Southwest Utah","12","281","Utah","5/22/20","200","81","00000","40.5"
"Summit","1","403","Utah","5/22/20","396","7","49043","1.77"
"Tooele","3","108","Utah","5/22/20","86","22","49045","25.58"
"TriCounty","1","21","Utah","5/22/20","16","5","00000","31.25"
"Utah","28","1651","Utah","5/22/20","1455","196","49049","13.47"
"Wasatch","5","228","Utah","5/22/20","196","32","49051","16.33"
"Weber-Morgan","5","252","Utah","5/22/20","216","36","00000","16.67"
"Addison","0","62","Vermont","5/22/20","62","0","50001","0"
"Bennington","0","60","Vermont","5/22/20","60","0","50003","0"
"Caledonia","0","14","Vermont","5/22/20","14","0","50005","0"
"Chittenden","1","440","Vermont","5/22/20","433","7","50007","1.62"
"Essex","0","3","Vermont","5/22/20","2","1","50009","50"
"Franklin","0","99","Vermont","5/22/20","99","0","50011","0"
"Grand Isle","0","5","Vermont","5/22/20","4","1","50013","25"
"Lamoille","0","29","Vermont","5/22/20","27","2","50015","7.41"
"Orange","0","8","Vermont","5/22/20","8","0","50017","0"
"Orleans","0","9","Vermont","5/22/20","9","0","50019","0"
"Rutland","0","51","Vermont","5/22/20","49","2","50021","4.08"
"Washington","0","38","Vermont","5/22/20","38","0","50023","0"
"Windham","0","80","Vermont","5/22/20","77","3","50025","3.9"
"Windsor","0","49","Vermont","5/22/20","47","2","50027","4.26"
"","0","69","Virgin Islands","5/22/20","69","0",,"0"
"Accomack","9","711","Virginia","5/22/20","648","63","51001","9.72"
"Albemarle","1","142","Virginia","5/22/20","133","9","51003","6.77"
"Alexandria","37","1657","Virginia","5/22/20","1396","261","51510","18.7"
"Alleghany","1","10","Virginia","5/22/20","6","4","51005","66.67"
"Amelia","1","22","Virginia","5/22/20","17","5","51007","29.41"
"Amherst","0","25","Virginia","5/22/20","22","3","51009","13.64"
"Appomattox","0","26","Virginia","5/22/20","23","3","51011","13.04"
"Arlington","37","1795","Virginia","5/22/20","1534","261","51013","17.01"
"Augusta","2","86","Virginia","5/22/20","74","12","51015","16.22"
"Bedford","0","41","Virginia","5/22/20","40","1","51019","2.5"
"Botetourt","0","31","Virginia","5/22/20","30","1","51023","3.33"
"Bristol","0","4","Virginia","5/22/20","3","1","51520","33.33"
"Brunswick","0","21","Virginia","5/22/20","20","1","51025","5"
"Buchanan","0","18","Virginia","5/22/20","16","2","51027","12.5"
"Buckingham","10","439","Virginia","5/22/20","366","73","51029","19.95"
"Buena Vista","1","12","Virginia","5/22/20","8","4","51530","50"
"Campbell","0","13","Virginia","5/22/20","13","0","51031","0"
"Caroline","0","45","Virginia","5/22/20","42","3","51033","7.14"
"Carroll","3","66","Virginia","5/22/20","42","24","51035","57.14"
"Charles City","0","25","Virginia","5/22/20","22","3","51036","13.64"
"Charlotte","1","19","Virginia","5/22/20","11","8","51037","72.73"
"Charlottesville","0","74","Virginia","5/22/20","71","3","51540","4.23"
"Chesapeake","6","419","Virginia","5/22/20","379","40","51550","10.55"
"Chesterfield","29","1152","Virginia","5/22/20","946","206","51041","21.78"
"Clarke","1","21","Virginia","5/22/20","17","4","51043","23.53"
"Colonial Heights","1","83","Virginia","5/22/20","74","9","51570","12.16"
"Covington","0","3","Virginia","5/22/20","2","1","51580","50"
"Craig","0","5","Virginia","5/22/20","4","1","51045","25"
"Culpeper","30","555","Virginia","5/22/20","343","212","51047","61.81"
"Cumberland","1","25","Virginia","5/22/20","18","7","51049","38.89"
"Danville","0","46","Virginia","5/22/20","43","3","51590","6.98"
"Dinwiddie","2","47","Virginia","5/22/20","36","11","51053","30.56"
"Emporia","1","60","Virginia","5/22/20","50","10","51595","20"
"Essex","1","36","Virginia","5/22/20","30","6","51057","20"
"Fairfax","225","8734","Virginia","5/22/20","7159","1575","51059","22"
"Fairfax City","1","51","Virginia","5/22/20","46","5","51600","10.87"
"Falls Church","1","46","Virginia","5/22/20","40","6","51610","15"
"Fauquier","9","267","Virginia","5/22/20","205","62","51061","30.24"
"Floyd","0","4","Virginia","5/22/20","4","0","51063","0"
"Fluvanna","1","84","Virginia","5/22/20","79","5","51065","6.33"
"Franklin","0","31","Virginia","5/22/20","30","1","51067","3.33"
"Franklin City","1","34","Virginia","5/22/20","27","7","51620","25.93"
"Frederick","8","249","Virginia","5/22/20","195","54","51069","27.69"
"Fredericksburg","4","109","Virginia","5/22/20","82","27","51630","32.93"
"Galax","3","85","Virginia","5/22/20","66","19","51640","28.79"
"Giles","0","5","Virginia","5/22/20","5","0","51071","0"
"Gloucester","0","30","Virginia","5/22/20","28","2","51073","7.14"
"Goochland","0","89","Virginia","5/22/20","86","3","51075","3.49"
"Grayson","1","24","Virginia","5/22/20","19","5","51077","26.32"
"Greene","1","21","Virginia","5/22/20","16","5","51079","31.25"
"Greensville","1","55","Virginia","5/22/20","50","5","51081","10"
"Halifax","0","29","Virginia","5/22/20","27","2","51083","7.41"
"Hampton","2","169","Virginia","5/22/20","158","11","51650","6.96"
"Hanover","5","246","Virginia","5/22/20","208","38","51085","18.27"
"Harrisonburg","12","704","Virginia","5/22/20","620","84","51660","13.55"
"Henrico","25","1375","Virginia","5/22/20","1198","177","51087","14.77"
"Henry","4","59","Virginia","5/22/20","30","29","51089","96.67"
"Highland","0","3","Virginia","5/22/20","2","1","51091","50"
"Hopewell","2","66","Virginia","5/22/20","49","17","51670","34.69"
"Isle of Wight","1","122","Virginia","5/22/20","115","7","51093","6.09"
"James City","2","191","Virginia","5/22/20","179","12","51095","6.7"
"King and Queen","0","7","Virginia","5/22/20","7","0","51097","0"
"King George","1","50","Virginia","5/22/20","45","5","51099","11.11"
"King William","1","19","Virginia","5/22/20","13","6","51101","46.15"
"Lancaster","0","10","Virginia","5/22/20","7","3","51103","42.86"
"Lee","0","9","Virginia","5/22/20","10","-1","51105","-10"
"Lexington","0","6","Virginia","5/22/20","5","1","51678","20"
"Loudoun","62","1807","Virginia","5/22/20","1374","433","51107","31.51"
"Louisa","1","67","Virginia","5/22/20","59","8","51109","13.56"
"Lunenburg","0","7","Virginia","5/22/20","7","0","51111","0"
"Lynchburg","1","77","Virginia","5/22/20","73","4","51680","5.48"
"Madison","1","27","Virginia","5/22/20","23","4","51113","17.39"
"Manassas","33","764","Virginia","5/22/20","533","231","51683","43.34"
"Manassas Park","7","228","Virginia","5/22/20","176","52","51685","29.55"
"Martinsville","3","25","Virginia","5/22/20","3","22","51690","733.33"
"Mathews","0","5","Virginia","5/22/20","5","0","51115","0"
"Mecklenburg","6","192","Virginia","5/22/20","152","40","51117","26.32"
"Middlesex","0","12","Virginia","5/22/20","11","1","51119","9.09"
"Montgomery","0","67","Virginia","5/22/20","66","1","51121","1.52"
"Nelson","0","13","Virginia","5/22/20","12","1","51125","8.33"
"New Kent","0","26","Virginia","5/22/20","26","0","51127","0"
"Newport News","6","224","Virginia","5/22/20","184","40","51700","21.74"
"Norfolk","6","388","Virginia","5/22/20","349","39","51710","11.17"
"Northampton","2","206","Virginia","5/22/20","193","13","51131","6.74"
"Northumberland","1","22","Virginia","5/22/20","15","7","51133","46.67"
"Norton","0","2","Virginia","5/22/20","2","0","51720","0"
"Nottoway","0","19","Virginia","5/22/20","16","3","51135","18.75"
"Orange","3","73","Virginia","5/22/20","51","22","51137","43.14"
"Page","4","172","Virginia","5/22/20","145","27","51139","18.62"
"Patrick","1","12","Virginia","5/22/20","6","6","51141","100"
"Petersburg","4","84","Virginia","5/22/20","58","26","51730","44.83"
"Pittsylvania","1","27","Virginia","5/22/20","18","9","51143","50"
"Poquoson","0","7","Virginia","5/22/20","7","0","51735","0"
"Portsmouth","5","251","Virginia","5/22/20","219","32","51740","14.61"
"Powhatan","0","26","Virginia","5/22/20","23","3","51145","13.04"
"Prince Edward","5","104","Virginia","5/22/20","72","32","51147","44.44"
"Prince George","1","56","Virginia","5/22/20","49","7","51149","14.29"
"Prince William","128","4315","Virginia","5/22/20","3421","894","51153","26.13"
"Pulaski","0","10","Virginia","5/22/20","10","0","51155","0"
"Radford","0","4","Virginia","5/22/20","3","1","51750","33.33"
"Rappahannock","0","12","Virginia","5/22/20","11","1","51157","9.09"
"Richmond","9","267","Virginia","5/22/20","201","66","51159","32.84"
"Richmond City","38","934","Virginia","5/22/20","665","269","51760","40.45"
"Roanoke","1","90","Virginia","5/22/20","83","7","51161","8.43"
"Roanoke City","3","140","Virginia","5/22/20","120","20","51770","16.67"
"Rockbridge","0","13","Virginia","5/22/20","10","3","51163","30"
"Rockingham","8","444","Virginia","5/22/20","388","56","51165","14.43"
"Russell","0","8","Virginia","5/22/20","6","2","51167","33.33"
"Salem","0","32","Virginia","5/22/20","32","0","51775","0"
"Scott","0","7","Virginia","5/22/20","7","0","51169","0"
"Shenandoah","10","358","Virginia","5/22/20","285","73","51171","25.61"
"Smyth","0","15","Virginia","5/22/20","15","0","51173","0"
"Southampton","0","137","Virginia","5/22/20","135","2","51175","1.48"
"Spotsylvania","12","373","Virginia","5/22/20","291","82","51177","28.18"
"Stafford","16","552","Virginia","5/22/20","442","110","51179","24.89"
"Staunton","0","34","Virginia","5/22/20","34","0","51790","0"
"Suffolk","4","283","Virginia","5/22/20","255","28","51800","10.98"
"Surry","0","6","Virginia","5/22/20","6","0","51181","0"
"Sussex","5","100","Virginia","5/22/20","67","33","51183","49.25"
"Tazewell","0","6","Virginia","5/22/20","6","0","51185","0"
"Virginia Beach","8","591","Virginia","5/22/20","535","56","51810","10.47"
"Warren","2","110","Virginia","5/22/20","94","16","51187","17.02"
"Washington","0","51","Virginia","5/22/20","49","2","51191","4.08"
"Waynesboro","2","36","Virginia","5/22/20","22","14","51820","63.64"
"Westmoreland","0","43","Virginia","5/22/20","42","1","51193","2.38"
"Williamsburg","0","43","Virginia","5/22/20","42","1","51830","2.38"
"Winchester","6","121","Virginia","5/22/20","79","42","51840","53.16"
"Wise","0","24","Virginia","5/22/20","23","1","51195","4.35"
"Wythe","0","17","Virginia","5/22/20","15","2","51197","13.33"
"York","1","67","Virginia","5/22/20","62","5","51199","8.06"
"Adams","0","50","Washington","5/22/20","50","0","53001","0"
"Asotin","0","18","Washington","5/22/20","18","0","53003","0"
"Benton","8","674","Washington","5/22/20","615","59","53005","9.59"
"Chelan","5","204","Washington","5/22/20","170","34","53007","20"
"Clallam","1","25","Washington","5/22/20","21","4","53009","19.05"
"Clark","2","399","Washington","5/22/20","382","17","53011","4.45"
"Columbia","0","1","Washington","5/22/20","1","0","53013","0"
"Cowlitz","0","71","Washington","5/22/20","68","3","53015","4.41"
"Douglas","2","139","Washington","5/22/20","124","15","53017","12.1"
"Ferry","0","1","Washington","5/22/20","1","0","53019","0"
"Franklin","7","480","Washington","5/22/20","433","47","53021","10.85"
"Grant","1","189","Washington","5/22/20","185","4","53025","2.16"
"Grays Harbor","0","16","Washington","5/22/20","14","2","53027","14.29"
"Island","0","177","Washington","5/22/20","176","1","53029","0.57"
"Jefferson","0","30","Washington","5/22/20","29","1","53031","3.45"
"King","49","7669","Washington","5/22/20","7325","344","53033","4.7"
"Kitsap","0","160","Washington","5/22/20","157","3","53035","1.91"
"Kittitas","3","66","Washington","5/22/20","47","19","53037","40.43"
"Klickitat","0","24","Washington","5/22/20","22","2","53039","9.09"
"Lewis","0","35","Washington","5/22/20","32","3","53041","9.38"
"Lincoln","0","2","Washington","5/22/20","2","0","53043","0"
"Mason","1","34","Washington","5/22/20","30","4","53045","13.33"
"Okanogan","1","42","Washington","5/22/20","35","7","53047","20"
"Pacific","0","9","Washington","5/22/20","9","0","53049","0"
"Pend Oreille","0","2","Washington","5/22/20","2","0","53051","0"
"Pierce","13","1728","Washington","5/22/20","1636","92","53053","5.62"
"San Juan","0","15","Washington","5/22/20","15","0","53055","0"
"Skagit","0","426","Washington","5/22/20","423","3","53057","0.71"
"Skamania","0","3","Washington","5/22/20","3","0","53059","0"
"Snohomish","15","2863","Washington","5/22/20","2756","107","53061","3.88"
"Spokane","6","437","Washington","5/22/20","393","44","53063","11.2"
"Stevens","0","10","Washington","5/22/20","9","1","53065","11.11"
"Thurston","0","124","Washington","5/22/20","122","2","53067","1.64"
"Wahkiakum","0","4","Washington","5/22/20","4","0","53069","0"
"Walla Walla","0","106","Washington","5/22/20","105","1","53071","0.95"
"Whatcom","3","363","Washington","5/22/20","344","19","53073","5.52"
"Whitman","0","16","Washington","5/22/20","16","0","53075","0"
"Yakima","77","2594","Washington","5/22/20","2052","542","53077","26.41"
"Barbour","0","7","West Virginia","5/22/20","7","0","54001","0"
"Berkeley","7","256","West Virginia","5/22/20","205","51","54003","24.88"
"Boone","0","9","West Virginia","5/22/20","9","0","54005","0"
"Braxton","0","2","West Virginia","5/22/20","2","0","54007","0"
"Brooke","0","3","West Virginia","5/22/20","3","0","54009","0"
"Cabell","0","57","West Virginia","5/22/20","55","2","54011","3.64"
"Calhoun","0","2","West Virginia","5/22/20","0","2","54013","1"
"Clay","0","2","West Virginia","5/22/20","2","0","54015","0"
"Fayette","1","42","West Virginia","5/22/20","38","4","54019","10.53"
"Gilmer","0","9","West Virginia","5/22/20","8","1","54021","12.5"
"Grant","0","6","West Virginia","5/22/20","6","0","54023","0"
"Greenbrier","0","9","West Virginia","5/22/20","8","1","54025","12.5"
"Hampshire","0","13","West Virginia","5/22/20","12","1","54027","8.33"
"Hancock","0","15","West Virginia","5/22/20","12","3","54029","25"
"Hardy","1","35","West Virginia","5/22/20","25","10","54031","40"
"Harrison","1","38","West Virginia","5/22/20","34","4","54033","11.76"
"Jackson","0","135","West Virginia","5/22/20","137","-2","54035","-1.46"
"Jefferson","6","140","West Virginia","5/22/20","97","43","54037","44.33"
"Kanawha","1","212","West Virginia","5/22/20","202","10","54039","4.95"
"Lewis","0","5","West Virginia","5/22/20","4","1","54041","25"
"Lincoln","0","5","West Virginia","5/22/20","5","0","54043","0"
"Logan","0","16","West Virginia","5/22/20","14","2","54045","14.29"
"Marion","0","48","West Virginia","5/22/20","46","2","54049","4.35"
"Marshall","1","27","West Virginia","5/22/20","23","4","54051","17.39"
"Mason","0","15","West Virginia","5/22/20","14","1","54053","7.14"
"McDowell","0","6","West Virginia","5/22/20","6","0","54047","0"
"Mercer","0","13","West Virginia","5/22/20","12","1","54055","8.33"
"Mineral","1","36","West Virginia","5/22/20","26","10","54057","38.46"
"Mingo","0","3","West Virginia","5/22/20","3","0","54059","0"
"Monongalia","1","119","West Virginia","5/22/20","114","5","54061","4.39"
"Monroe","0","6","West Virginia","5/22/20","6","0","54063","0"
"Morgan","0","17","West Virginia","5/22/20","17","0","54065","0"
"Nicholas","0","10","West Virginia","5/22/20","9","1","54067","11.11"
"Ohio","0","38","West Virginia","5/22/20","37","1","54069","2.7"
"Pendleton","0","6","West Virginia","5/22/20","5","1","54071","20"
"Pleasants","0","3","West Virginia","5/22/20","2","1","54073","50"
"Pocahontas","3","24","West Virginia","5/22/20","2","22","54075","1100"
"Preston","0","15","West Virginia","5/22/20","15","0","54077","0"
"Putnam","0","31","West Virginia","5/22/20","29","2","54079","6.9"
"Raleigh","1","14","West Virginia","5/22/20","10","4","54081","40"
"Randolph","3","28","West Virginia","5/22/20","5","23","54083","460"
"Ritchie","0","1","West Virginia","5/22/20","1","0","54085","0"
"Roane","0","8","West Virginia","5/22/20","8","0","54087","0"
"Summers","0","1","West Virginia","5/22/20","1","0","54089","0"
"Taylor","0","8","West Virginia","5/22/20","8","0","54091","0"
"Tucker","0","4","West Virginia","5/22/20","4","0","54093","0"
"Tyler","0","3","West Virginia","5/22/20","3","0","54095","0"
"Upshur","0","6","West Virginia","5/22/20","6","0","54097","0"
"Wayne","0","97","West Virginia","5/22/20","95","2","54099","2.11"
"Wetzel","0","8","West Virginia","5/22/20","6","2","54103","33.33"
"Wirt","0","4","West Virginia","5/22/20","3","1","54105","33.33"
"Wood","0","48","West Virginia","5/22/20","45","3","54107","6.67"
"Wyoming","0","3","West Virginia","5/22/20","1","2","54109","200"
"Adams","0","4","Wisconsin","5/22/20","4","0","55001","0"
"Ashland","0","2","Wisconsin","5/22/20","2","0","55003","0"
"Barron","0","11","Wisconsin","5/22/20","11","0","55005","0"
"Bayfield","0","3","Wisconsin","5/22/20","3","0","55007","0"
"Brown","24","2204","Wisconsin","5/22/20","2034","170","55009","8.36"
"Buffalo","0","5","Wisconsin","5/22/20","5","0","55011","0"
"Burnett","0","1","Wisconsin","5/22/20","1","0","55013","0"
"Calumet","2","67","Wisconsin","5/22/20","55","12","55015","21.82"
"Chippewa","1","46","Wisconsin","5/22/20","37","9","55017","24.32"
"Clark","0","28","Wisconsin","5/22/20","25","3","55019","12"
"Columbia","0","37","Wisconsin","5/22/20","34","3","55021","8.82"
"Crawford","1","25","Wisconsin","5/22/20","20","5","55023","25"
"Dane","11","587","Wisconsin","5/22/20","507","80","55025","15.78"
"Dodge","7","137","Wisconsin","5/22/20","87","50","55027","57.47"
"Door","1","35","Wisconsin","5/22/20","29","6","55029","20.69"
"Douglas","1","16","Wisconsin","5/22/20","12","4","55031","33.33"
"Dunn","0","21","Wisconsin","5/22/20","20","1","55033","5"
"Eau Claire","3","89","Wisconsin","5/22/20","65","24","55035","36.92"
"Florence","0","2","Wisconsin","5/22/20","2","0","55037","0"
"Fond du Lac","5","155","Wisconsin","5/22/20","119","36","55039","30.25"
"Forest","1","11","Wisconsin","5/22/20","5","6","55041","120"
"Grant","1","81","Wisconsin","5/22/20","72","9","55043","12.5"
"Green","1","49","Wisconsin","5/22/20","39","10","55045","25.64"
"Green Lake","0","13","Wisconsin","5/22/20","10","3","55047","30"
"Iowa","0","11","Wisconsin","5/22/20","11","0","55049","0"
"Iron","0","2","Wisconsin","5/22/20","2","0","55051","0"
"Jackson","0","15","Wisconsin","5/22/20","15","0","55053","0"
"Jefferson","2","75","Wisconsin","5/22/20","58","17","55055","29.31"
"Juneau","0","22","Wisconsin","5/22/20","21","1","55057","4.76"
"Kenosha","24","948","Wisconsin","5/22/20","780","168","55059","21.54"
"Kewaunee","0","32","Wisconsin","5/22/20","30","2","55061","6.67"
"La Crosse","1","48","Wisconsin","5/22/20","42","6","55063","14.29"
"Lafayette","0","17","Wisconsin","5/22/20","16","1","55065","6.25"
"Langlade","0","1","Wisconsin","5/22/20","0","1","55067","1"
"Lincoln","0","3","Wisconsin","5/22/20","2","1","55069","50"
"Manitowoc","1","28","Wisconsin","5/22/20","21","7","55071","33.33"
"Marathon","1","36","Wisconsin","5/22/20","31","5","55073","16.13"
"Marinette","1","30","Wisconsin","5/22/20","21","9","55075","42.86"
"Marquette","0","3","Wisconsin","5/22/20","3","0","55077","0"
"Menominee","0","2","Wisconsin","5/22/20","2","0","55078","0"
"Milwaukee","171","5735","Wisconsin","5/22/20","4535","1200","55079","26.46"
"Monroe","0","16","Wisconsin","5/22/20","15","1","55081","6.67"
"Oconto","0","32","Wisconsin","5/22/20","30","2","55083","6.67"
"Oneida","0","7","Wisconsin","5/22/20","7","0","55085","0"
"Outagamie","7","174","Wisconsin","5/22/20","128","46","55087","35.94"
"Ozaukee","2","133","Wisconsin","5/22/20","119","14","55089","11.76"
"Pepin","0","1","Wisconsin","5/22/20","1","0","55091","0"
"Pierce","3","34","Wisconsin","5/22/20","16","18","55093","112.5"
"Polk","1","13","Wisconsin","5/22/20","6","7","55095","116.67"
"Portage","0","8","Wisconsin","5/22/20","7","1","55097","14.29"
"Price","0","2","Wisconsin","5/22/20","1","1","55099","100"
"Racine","50","1269","Wisconsin","5/22/20","920","349","55101","37.93"
"Richland","0","14","Wisconsin","5/22/20","13","1","55103","7.69"
"Rock","16","520","Wisconsin","5/22/20","406","114","55105","28.08"
"Rusk","0","4","Wisconsin","5/22/20","4","0","55107","0"
"Sauk","0","77","Wisconsin","5/22/20","76","1","55111","1.32"
"Sawyer","0","7","Wisconsin","5/22/20","4","3","55113","75"
"Shawano","1","36","Wisconsin","5/22/20","29","7","55115","24.14"
"Sheboygan","1","78","Wisconsin","5/22/20","68","10","55117","14.71"
"St. Croix","3","58","Wisconsin","5/22/20","37","21","55109","56.76"
"Taylor","0","1","Wisconsin","5/22/20","0","1","55119","1"
"Trempealeau","1","13","Wisconsin","5/22/20","7","6","55121","85.71"
"Vernon","1","14","Wisconsin","5/22/20","8","6","55123","75"
"Vilas","0","6","Wisconsin","5/22/20","4","2","55125","50"
"Walworth","9","329","Wisconsin","5/22/20","269","60","55127","22.3"
"Washburn","0","2","Wisconsin","5/22/20","1","1","55129","100"
"Washington","7","178","Wisconsin","5/22/20","129","49","55131","37.98"
"Waukesha","12","537","Wisconsin","5/22/20","454","83","55133","18.28"
"Waupaca","1","20","Wisconsin","5/22/20","16","4","55135","25"
"Waushara","0","7","Wisconsin","5/22/20","5","2","55137","40"
"Winnebago","7","160","Wisconsin","5/22/20","112","48","55139","42.86"
"Wood","1","9","Wisconsin","5/22/20","5","4","55141","80"
"Albany","0","10","Wyoming","5/22/20","8","2","56001","25"
"Big Horn","0","3","Wyoming","5/22/20","3","0","56003","0"
"Campbell","0","30","Wyoming","5/22/20","29","1","56005","3.45"
"Carbon","1","16","Wyoming","5/22/20","8","8","56007","100"
"Converse","0","24","Wyoming","5/22/20","23","1","56009","4.35"
"Crook","0","5","Wyoming","5/22/20","5","0","56011","0"
"Fremont","3","238","Wyoming","5/22/20","214","24","56013","11.21"
"Goshen","0","5","Wyoming","5/22/20","5","0","56015","0"
"Hot Springs","1","9","Wyoming","5/22/20","3","6","56017","200"
"Johnson","0","16","Wyoming","5/22/20","15","1","56019","6.67"
"Laramie","1","182","Wyoming","5/22/20","178","4","56021","2.25"
"Lincoln","0","15","Wyoming","5/22/20","14","1","56023","7.14"
"Natrona","3","68","Wyoming","5/22/20","50","18","56025","36"
"Niobrara","0","2","Wyoming","5/22/20","2","0","56027","0"
"Park","0","2","Wyoming","5/22/20","1","1","56029","100"
"Platte","0","1","Wyoming","5/22/20","0","1","56031","1"
"Sheridan","0","16","Wyoming","5/22/20","16","0","56033","0"
"Sublette","0","3","Wyoming","5/22/20","3","0","56035","0"
"Sweetwater","0","25","Wyoming","5/22/20","22","3","56037","13.64"
"Teton","0","100","Wyoming","5/22/20","99","1","56039","1.01"
"Uinta","1","13","Wyoming","5/22/20","9","4","56041","44.44"
"Washakie","2","20","Wyoming","5/22/20","9","11","56043","122.22"
