"Locality","DailyAvgNewCasesPast7Days","TotalCases","State","Date","TotalCases7DaysAgo","NewCasesPast7Days","FIPS-Code","PercentIncreaseTotalCasesPast7Days"
"Autauga","9","221","Alabama","5/31/20","159","62","01001","38.99"
"Baldwin","2","290","Alabama","5/31/20","274","16","01003","5.84"
"Barbour","8","167","Alabama","5/31/20","110","57","01005","51.82"
"Bibb","2","75","Alabama","5/31/20","59","16","01007","27.12"
"Blount","2","62","Alabama","5/31/20","49","13","01009","26.53"
"Bullock","14","209","Alabama","5/31/20","111","98","01011","88.29"
"Butler","10","411","Alabama","5/31/20","344","67","01013","19.48"
"Calhoun","3","160","Alabama","5/31/20","141","19","01015","13.48"
"Chambers","3","355","Alabama","5/31/20","336","19","01017","5.65"
"Cherokee","1","37","Alabama","5/31/20","33","4","01019","12.12"
"Chilton","2","101","Alabama","5/31/20","87","14","01021","16.09"
"Choctaw","2","153","Alabama","5/31/20","141","12","01023","8.51"
"Clarke","6","144","Alabama","5/31/20","102","42","01025","41.18"
"Clay","0","27","Alabama","5/31/20","27","0","01027","0"
"Cleburne","0","15","Alabama","5/31/20","13","2","01029","15.38"
"Coffee","5","236","Alabama","5/31/20","200","36","01031","18"
"Colbert","7","184","Alabama","5/31/20","136","48","01033","35.29"
"Conecuh","2","41","Alabama","5/31/20","25","16","01035","64"
"Coosa","1","40","Alabama","5/31/20","33","7","01037","21.21"
"Covington","2","80","Alabama","5/31/20","65","15","01039","23.08"
"Crenshaw","2","75","Alabama","5/31/20","58","17","01041","29.31"
"Cullman","10","143","Alabama","5/31/20","76","67","01043","88.16"
"Dale","5","115","Alabama","5/31/20","83","32","01045","38.55"
"Dallas","11","272","Alabama","5/31/20","197","75","01047","38.07"
"DeKalb","4","248","Alabama","5/31/20","221","27","01049","12.22"
"Elmore","13","354","Alabama","5/31/20","263","91","01051","34.6"
"Escambia","3","63","Alabama","5/31/20","43","20","01053","46.51"
"Etowah","3","257","Alabama","5/31/20","236","21","01055","8.9"
"Fayette","1","16","Alabama","5/31/20","11","5","01057","45.45"
"Franklin","16","556","Alabama","5/31/20","447","109","01059","24.38"
"Geneva","1","43","Alabama","5/31/20","33","10","01061","30.3"
"Greene","1","94","Alabama","5/31/20","89","5","01063","5.62"
"Hale","6","173","Alabama","5/31/20","129","44","01065","34.11"
"Henry","3","80","Alabama","5/31/20","56","24","01067","42.86"
"Houston","8","220","Alabama","5/31/20","164","56","01069","34.15"
"Jackson","1","78","Alabama","5/31/20","69","9","01071","13.04"
"Jefferson","32","1837","Alabama","5/31/20","1614","223","01073","13.82"
"Lamar","1","26","Alabama","5/31/20","20","6","01075","30"
"Lauderdale","5","164","Alabama","5/31/20","128","36","01077","28.12"
"Lawrence","1","50","Alabama","5/31/20","42","8","01079","19.05"
"Lee","7","548","Alabama","5/31/20","498","50","01081","10.04"
"Limestone","5","106","Alabama","5/31/20","74","32","01083","43.24"
"Lowndes","9","246","Alabama","5/31/20","186","60","01085","32.26"
"Macon","3","82","Alabama","5/31/20","60","22","01087","36.67"
"Madison","6","339","Alabama","5/31/20","296","43","01089","14.53"
"Marengo","5","170","Alabama","5/31/20","133","37","01091","27.82"
"Marion","1","122","Alabama","5/31/20","113","9","01093","7.96"
"Marshall","6","693","Alabama","5/31/20","649","44","01095","6.78"
"Mobile","35","2239","Alabama","5/31/20","1996","243","01097","12.17"
"Monroe","2","40","Alabama","5/31/20","28","12","01099","42.86"
"Montgomery","75","1710","Alabama","5/31/20","1186","524","01101","44.18"
"Morgan","17","280","Alabama","5/31/20","162","118","01103","72.84"
"Perry","1","39","Alabama","5/31/20","31","8","01105","25.81"
"Pickens","3","116","Alabama","5/31/20","93","23","01107","24.73"
"Pike","10","203","Alabama","5/31/20","136","67","01109","49.26"
"Randolph","0","127","Alabama","5/31/20","125","2","01111","1.6"
"Russell","6","171","Alabama","5/31/20","128","43","01113","33.59"
"Shelby","12","517","Alabama","5/31/20","433","84","01117","19.4"
"St. Clair","3","123","Alabama","5/31/20","102","21","01115","20.59"
"Sumter","5","224","Alabama","5/31/20","191","33","01119","17.28"
"Talladega","3","113","Alabama","5/31/20","91","22","01121","24.18"
"Tallapoosa","4","427","Alabama","5/31/20","396","31","01123","7.83"
"Tuscaloosa","40","783","Alabama","5/31/20","505","278","01125","55.05"
"Walker","22","354","Alabama","5/31/20","198","156","01127","78.79"
"Washington","1","70","Alabama","5/31/20","64","6","01129","9.38"
"Wilcox","4","148","Alabama","5/31/20","118","30","01131","25.42"
"Winston","4","90","Alabama","5/31/20","62","28","01133","45.16"
"Anchorage","3","229","Alaska","5/31/20","206","23","02020","11.17"
"Bethel","0","3","Alaska","5/31/20","2","1","02050","50"
"Fairbanks North Star","0","85","Alaska","5/31/20","85","0","02090","0"
"Juneau","0","33","Alaska","5/31/20","31","2","02110","6.45"
"Kenai Peninsula","3","45","Alaska","5/31/20","26","19","02122","73.08"
"Ketchikan Gateway","0","16","Alaska","5/31/20","16","0","02130","0"
"Kodiak Island","0","1","Alaska","5/31/20","1","0","02150","0"
"Matanuska-Susitna","1","29","Alaska","5/31/20","24","5","02170","20.83"
"Nome","0","3","Alaska","5/31/20","3","0","02180","0"
"North Slope","0","1","Alaska","5/31/20","0","1","02185","1"
"Northwest Arctic","0","2","Alaska","5/31/20","2","0","02188","0"
"Petersburg","0","4","Alaska","5/31/20","4","0","02195","0"
"Prince of Wales-Hyder","0","2","Alaska","5/31/20","2","0","02198","0"
"Sitka","0","2","Alaska","5/31/20","1","1","02220","100"
"Southeast Fairbanks","0","3","Alaska","5/31/20","3","0","02240","0"
"Yukon-Koyukuk","0","1","Alaska","5/31/20","1","0","02290","0"
"Apache","48","1524","Arizona","5/31/20","1191","333","04001","27.96"
"Cochise","2","74","Arizona","5/31/20","59","15","04003","25.42"
"Coconino","19","1151","Arizona","5/31/20","1019","132","04005","12.95"
"Gila","1","31","Arizona","5/31/20","24","7","04007","29.17"
"Graham","2","32","Arizona","5/31/20","21","11","04009","52.38"
"Greenlee","0","6","Arizona","5/31/20","3","3","04011","100"
"La Paz","4","78","Arizona","5/31/20","50","28","04012","56"
"Maricopa","220","9815","Arizona","5/31/20","8277","1538","04013","18.58"
"Mohave","13","396","Arizona","5/31/20","304","92","04015","30.26"
"Navajo","49","1866","Arizona","5/31/20","1523","343","04017","22.52"
"Pima","49","2368","Arizona","5/31/20","2027","341","04019","16.82"
"Pinal","15","863","Arizona","5/31/20","755","108","04021","14.3"
"Santa Cruz","23","330","Arizona","5/31/20","169","161","04023","95.27"
"Yavapai","2","297","Arizona","5/31/20","285","12","04025","4.21"
"Yuma","62","1105","Arizona","5/31/20","670","435","04027","64.93"
"Arkansas","0","6","Arkansas","5/31/20","3","3","05001","100"
"Ashley","0","19","Arkansas","5/31/20","19","0","05003","0"
"Baxter","1","12","Arkansas","5/31/20","6","6","05005","100"
"Benton","42","578","Arkansas","5/31/20","284","294","05007","103.52"
"Boone","0","6","Arkansas","5/31/20","6","0","05009","0"
"Bradley","1","22","Arkansas","5/31/20","17","5","05011","29.41"
"Carroll","2","24","Arkansas","5/31/20","10","14","05015","140"
"Chicot","0","15","Arkansas","5/31/20","13","2","05017","15.38"
"Clark","0","39","Arkansas","5/31/20","36","3","05019","8.33"
"Clay","0","4","Arkansas","5/31/20","4","0","05021","0"
"Cleburne","0","73","Arkansas","5/31/20","73","0","05023","0"
"Cleveland","0","19","Arkansas","5/31/20","18","1","05025","5.56"
"Columbia","0","23","Arkansas","5/31/20","20","3","05027","15"
"Conway","0","14","Arkansas","5/31/20","14","0","05029","0"
"Craighead","5","220","Arkansas","5/31/20","185","35","05031","18.92"
"Crawford","2","29","Arkansas","5/31/20","13","16","05033","123.08"
"Crittenden","14","380","Arkansas","5/31/20","285","95","05035","33.33"
"Cross","1","52","Arkansas","5/31/20","42","10","05037","23.81"
"Dallas","0","1","Arkansas","5/31/20","1","0","05039","0"
"Desha","0","19","Arkansas","5/31/20","19","0","05041","0"
"Drew","0","20","Arkansas","5/31/20","19","1","05043","5.26"
"Faulkner","0","102","Arkansas","5/31/20","100","2","05045","2"
"Franklin","0","4","Arkansas","5/31/20","4","0","05047","0"
"Fulton","0","7","Arkansas","5/31/20","6","1","05049","16.67"
"Garland","0","136","Arkansas","5/31/20","133","3","05051","2.26"
"Grant","0","18","Arkansas","5/31/20","16","2","05053","12.5"
"Greene","3","64","Arkansas","5/31/20","45","19","05055","42.22"
"Hempstead","1","18","Arkansas","5/31/20","13","5","05057","38.46"
"Hot Spring","0","32","Arkansas","5/31/20","30","2","05059","6.67"
"Howard","1","21","Arkansas","5/31/20","16","5","05061","31.25"
"Independence","0","31","Arkansas","5/31/20","28","3","05063","10.71"
"Izard","0","16","Arkansas","5/31/20","15","1","05065","6.67"
"Jackson","0","3","Arkansas","5/31/20","1","2","05067","200"
"Jefferson","2","521","Arkansas","5/31/20","504","17","05069","3.37"
"Johnson","1","43","Arkansas","5/31/20","38","5","05071","13.16"
"Lafayette","0","9","Arkansas","5/31/20","9","0","05073","0"
"Lawrence","0","84","Arkansas","5/31/20","82","2","05075","2.44"
"Lee","1","20","Arkansas","5/31/20","15","5","05077","33.33"
"Lincoln","1","982","Arkansas","5/31/20","974","8","05079","0.82"
"Little River","1","6","Arkansas","5/31/20","2","4","05081","200"
"Logan","0","6","Arkansas","5/31/20","4","2","05083","50"
"Lonoke","0","48","Arkansas","5/31/20","46","2","05085","4.35"
"Madison","3","23","Arkansas","5/31/20","3","20","05087","666.67"
"Marion","0","2","Arkansas","5/31/20","1","1","05089","100"
"Miller","0","44","Arkansas","5/31/20","42","2","05091","4.76"
"Mississippi","1","75","Arkansas","5/31/20","70","5","05093","7.14"
"Monroe","0","5","Arkansas","5/31/20","5","0","05095","0"
"Montgomery","0","2","Arkansas","5/31/20","1","1","05097","100"
"Nevada","0","6","Arkansas","5/31/20","4","2","05099","50"
"Newton","0","3","Arkansas","5/31/20","3","0","05101","0"
"Ouachita","0","10","Arkansas","5/31/20","10","0","05103","0"
"Perry","0","14","Arkansas","5/31/20","13","1","05105","7.69"
"Phillips","2","21","Arkansas","5/31/20","9","12","05107","133.33"
"Pike","0","5","Arkansas","5/31/20","4","1","05109","25"
"Poinsett","0","33","Arkansas","5/31/20","31","2","05111","6.45"
"Polk","1","19","Arkansas","5/31/20","10","9","05113","90"
"Pope","5","148","Arkansas","5/31/20","113","35","05115","30.97"
"Prairie","0","2","Arkansas","5/31/20","2","0","05117","0"
"Pulaski","15","888","Arkansas","5/31/20","785","103","05119","13.12"
"Randolph","0","26","Arkansas","5/31/20","26","0","05121","0"
"Saline","2","112","Arkansas","5/31/20","97","15","05125","15.46"
"Scott","0","1","Arkansas","5/31/20","1","0","05127","0"
"Searcy","0","7","Arkansas","5/31/20","6","1","05129","16.67"
"Sebastian","3","40","Arkansas","5/31/20","19","21","05131","110.53"
"Sevier","18","210","Arkansas","5/31/20","84","126","05133","150"
"Sharp","1","46","Arkansas","5/31/20","42","4","05135","9.52"
"St. Francis","5","672","Arkansas","5/31/20","634","38","05123","5.99"
"Stone","0","9","Arkansas","5/31/20","8","1","05137","12.5"
"Union","2","173","Arkansas","5/31/20","157","16","05139","10.19"
"Van Buren","0","28","Arkansas","5/31/20","28","0","05141","0"
"Washington","36","509","Arkansas","5/31/20","259","250","05143","96.53"
"White","1","44","Arkansas","5/31/20","40","4","05145","10"
"Woodruff","0","1","Arkansas","5/31/20","1","0","05147","0"
"Yell","6","141","Arkansas","5/31/20","96","45","05149","46.88"
"Alameda","78","3390","California","5/31/20","2847","543","06001","19.07"
"Alpine","0","2","California","5/31/20","2","0","06003","0"
"Amador","1","19","California","5/31/20","10","9","06005","90"
"Butte","1","44","California","5/31/20","34","10","06007","29.41"
"Calaveras","0","15","California","5/31/20","13","2","06009","15.38"
"Colusa","0","5","California","5/31/20","5","0","06011","0"
"Contra Costa","18","1450","California","5/31/20","1321","129","06013","9.77"
"Del Norte","3","45","California","5/31/20","23","22","06015","95.65"
"El Dorado","2","90","California","5/31/20","74","16","06017","21.62"
"Fresno","42","1743","California","5/31/20","1448","295","06019","20.37"
"Glenn","1","16","California","5/31/20","12","4","06021","33.33"
"Humboldt","1","101","California","5/31/20","93","8","06023","8.6"
"Imperial","70","1634","California","5/31/20","1145","489","06025","42.71"
"Inyo","0","20","California","5/31/20","19","1","06027","5.26"
"Kern","61","2250","California","5/31/20","1824","426","06029","23.36"
"Kings","33","746","California","5/31/20","517","229","06031","44.29"
"Lake","1","21","California","5/31/20","12","9","06033","75"
"Lassen","0","5","California","5/31/20","2","3","06035","150"
"Los Angeles","1426","55001","California","5/31/20","45017","9984","06037","22.18"
"Madera","3","106","California","5/31/20","84","22","06039","26.19"
"Marin","14","483","California","5/31/20","388","95","06041","24.48"
"Mariposa","0","16","California","5/31/20","15","1","06043","6.67"
"Mendocino","1","30","California","5/31/20","21","9","06045","42.86"
"Merced","5","283","California","5/31/20","251","32","06047","12.75"
"Mono","0","37","California","5/31/20","34","3","06051","8.82"
"Monterey","19","530","California","5/31/20","395","135","06053","34.18"
"Napa","2","112","California","5/31/20","101","11","06055","10.89"
"Nevada","0","41","California","5/31/20","41","0","06057","0"
"Orange","132","6261","California","5/31/20","5336","925","06059","17.34"
"Placer","4","215","California","5/31/20","184","31","06061","16.85"
"Plumas","0","4","California","5/31/20","4","0","06063","0"
"Riverside","146","7486","California","5/31/20","6464","1022","06065","15.81"
"Sacramento","15","1400","California","5/31/20","1293","107","06067","8.28"
"San Benito","2","87","California","5/31/20","70","17","06069","24.29"
"San Bernardino","126","5246","California","5/31/20","4365","881","06071","20.18"
"San Diego","132","7481","California","5/31/20","6559","922","06073","14.06"
"San Francisco","32","2588","California","5/31/20","2367","221","06075","9.34"
"San Joaquin","15","858","California","5/31/20","752","106","06077","14.1"
"San Luis Obispo","2","269","California","5/31/20","258","11","06079","4.26"
"San Mateo","39","2104","California","5/31/20","1833","271","06081","14.78"
"Santa Barbara","14","1649","California","5/31/20","1551","98","06083","6.32"
"Santa Clara","23","2776","California","5/31/20","2617","159","06085","6.08"
"Santa Cruz","3","213","California","5/31/20","192","21","06087","10.94"
"Shasta","0","39","California","5/31/20","36","3","06089","8.33"
"Sierra","0","1","California","5/31/20","1","0","06091","0"
"Siskiyou","0","7","California","5/31/20","6","1","06093","16.67"
"Solano","9","517","California","5/31/20","455","62","06095","13.63"
"Sonoma","10","553","California","5/31/20","482","71","06097","14.73"
"Stanislaus","16","744","California","5/31/20","629","115","06099","18.28"
"Sutter","1","46","California","5/31/20","40","6","06101","15"
"Tehama","0","4","California","5/31/20","3","1","06103","33.33"
"Trinity","0","1","California","5/31/20","1","0","06105","0"
"Tulare","29","1844","California","5/31/20","1641","203","06107","12.37"
"Tuolumne","0","4","California","5/31/20","3","1","06109","33.33"
"Ventura","24","1078","California","5/31/20","912","166","06111","18.2"
"Yolo","3","211","California","5/31/20","190","21","06113","11.05"
"Yuba","0","30","California","5/31/20","28","2","06115","7.14"
"Adams","56","3258","Colorado","5/31/20","2869","389","08001","13.56"
"Alamosa","3","76","Colorado","5/31/20","58","18","08003","31.03"
"Arapahoe","51","4394","Colorado","5/31/20","4039","355","08005","8.79"
"Archuleta","0","8","Colorado","5/31/20","8","0","08007","0"
"Baca","0","12","Colorado","5/31/20","12","0","08009","0"
"Bent","0","2","Colorado","5/31/20","2","0","08011","0"
"Boulder","7","980","Colorado","5/31/20","928","52","08013","5.6"
"Broomfield","3","240","Colorado","5/31/20","220","20","08014","9.09"
"Chaffee","0","72","Colorado","5/31/20","70","2","08015","2.86"
"Cheyenne","0","5","Colorado","5/31/20","5","0","08017","0"
"Clear Creek","0","16","Colorado","5/31/20","16","0","08019","0"
"Conejos","0","2","Colorado","5/31/20","1","1","08021","100"
"Costilla","0","6","Colorado","5/31/20","3","3","08023","100"
"Crowley","0","64","Colorado","5/31/20","62","2","08025","3.23"
"Custer","0","2","Colorado","5/31/20","2","0","08027","0"
"Delta","0","69","Colorado","5/31/20","67","2","08029","2.99"
"Denver","86","5775","Colorado","5/31/20","5173","602","08031","11.64"
"Douglas","6","720","Colorado","5/31/20","675","45","08035","6.67"
"Eagle","1","587","Colorado","5/31/20","581","6","08037","1.03"
"El Paso","32","1732","Colorado","5/31/20","1505","227","08041","15.08"
"Elbert","1","53","Colorado","5/31/20","48","5","08039","10.42"
"Fremont","0","26","Colorado","5/31/20","26","0","08043","0"
"Garfield","3","139","Colorado","5/31/20","121","18","08045","14.88"
"Gilpin","0","3","Colorado","5/31/20","3","0","08047","0"
"Grand","1","14","Colorado","5/31/20","6","8","08049","133.33"
"Gunnison","0","177","Colorado","5/31/20","180","-3","08051","-1.67"
"Hinsdale","0","3","Colorado","5/31/20","3","0","08053","0"
"Huerfano","0","3","Colorado","5/31/20","3","0","08055","0"
"Jefferson","26","2221","Colorado","5/31/20","2040","181","08059","8.87"
"Kit Carson","0","26","Colorado","5/31/20","26","0","08063","0"
"La Plata","1","81","Colorado","5/31/20","77","4","08067","5.19"
"Lake","1","31","Colorado","5/31/20","27","4","08065","14.81"
"Larimer","7","583","Colorado","5/31/20","537","46","08069","8.57"
"Las Animas","0","5","Colorado","5/31/20","5","0","08071","0"
"Lincoln","0","3","Colorado","5/31/20","3","0","08073","0"
"Logan","5","614","Colorado","5/31/20","582","32","08075","5.5"
"Mesa","0","54","Colorado","5/31/20","55","-1","08077","-1.82"
"Mineral","0","2","Colorado","5/31/20","2","0","08079","0"
"Moffat","0","7","Colorado","5/31/20","6","1","08081","16.67"
"Montezuma","1","45","Colorado","5/31/20","35","10","08083","28.57"
"Montrose","2","172","Colorado","5/31/20","159","13","08085","8.18"
"Morgan","4","629","Colorado","5/31/20","604","25","08087","4.14"
"Otero","1","19","Colorado","5/31/20","14","5","08089","35.71"
"Ouray","0","8","Colorado","5/31/20","8","0","08091","0"
"Park","0","23","Colorado","5/31/20","23","0","08093","0"
"Phillips","0","13","Colorado","5/31/20","12","1","08095","8.33"
"Pitkin","0","58","Colorado","5/31/20","57","1","08097","1.75"
"Prowers","0","14","Colorado","5/31/20","12","2","08099","16.67"
"Pueblo","5","295","Colorado","5/31/20","263","32","08101","12.17"
"Rio Blanco","0","1","Colorado","5/31/20","1","0","08103","0"
"Rio Grande","2","33","Colorado","5/31/20","16","17","08105","106.25"
"Routt","0","62","Colorado","5/31/20","59","3","08107","5.08"
"Saguache","8","81","Colorado","5/31/20","25","56","08109","224"
"San Juan","0","1","Colorado","5/31/20","1","0","08111","0"
"San Miguel","0","23","Colorado","5/31/20","23","0","08113","0"
"Summit","3","226","Colorado","5/31/20","207","19","08117","9.18"
"Teller","0","32","Colorado","5/31/20","32","0","08119","0"
"Washington","1","41","Colorado","5/31/20","31","10","08121","32.26"
"Weld","12","2488","Colorado","5/31/20","2406","82","08123","3.41"
"Yuma","3","35","Colorado","5/31/20","15","20","08125","133.33"
"Fairfield","62","15549","Connecticut","5/31/20","15114","435","09001","2.88"
"Hartford","87","10296","Connecticut","5/31/20","9686","610","09003","6.3"
"Litchfield","9","1397","Connecticut","5/31/20","1331","66","09005","4.96"
"Middlesex","13","1104","Connecticut","5/31/20","1010","94","09007","9.31"
"New Haven","60","11323","Connecticut","5/31/20","10905","418","09009","3.83"
"New London","5","1078","Connecticut","5/31/20","1046","32","09011","3.06"
"Tolland","4","836","Connecticut","5/31/20","807","29","09013","3.59"
"Windham","4","384","Connecticut","5/31/20","359","25","09015","6.96"
"Kent","14","1436","Delaware","5/31/20","1340","96","10001","7.16"
"New Castle","64","3758","Delaware","5/31/20","3309","449","10003","13.57"
"Sussex","21","4253","Delaware","5/31/20","4103","150","10005","3.66"
"","0","49","Diamond Princess","5/31/20","49","0",,"0"
"District of Columbia","99","8801","District of Columbia","5/31/20","8110","691","11001","8.52"
"Alachua","3","380","Florida","5/31/20","361","19","12001","5.26"
"Baker","0","29","Florida","5/31/20","27","2","12003","7.41"
"Bay","0","98","Florida","5/31/20","95","3","12005","3.16"
"Bradford","0","51","Florida","5/31/20","51","0","12007","0"
"Brevard","4","422","Florida","5/31/20","394","28","12009","7.11"
"Broward","61","7123","Florida","5/31/20","6697","426","12011","6.36"
"Calhoun","2","63","Florida","5/31/20","52","11","12013","21.15"
"Charlotte","5","458","Florida","5/31/20","423","35","12015","8.27"
"Citrus","0","121","Florida","5/31/20","119","2","12017","1.68"
"Clay","4","382","Florida","5/31/20","357","25","12019","7"
"Collier","41","1539","Florida","5/31/20","1251","288","12021","23.02"
"Columbia","2","144","Florida","5/31/20","130","14","12023","10.77"
"DeSoto","10","182","Florida","5/31/20","115","67","12027","58.26"
"Dixie","1","51","Florida","5/31/20","41","10","12029","24.39"
"Duval","29","1644","Florida","5/31/20","1439","205","12031","14.25"
"Escambia","8","815","Florida","5/31/20","756","59","12033","7.8"
"Flagler","2","189","Florida","5/31/20","177","12","12035","6.78"
"Franklin","0","2","Florida","5/31/20","2","0","12037","0"
"Gadsden","3","273","Florida","5/31/20","255","18","12039","7.06"
"Gilchrist","0","12","Florida","5/31/20","11","1","12041","9.09"
"Glades","1","30","Florida","5/31/20","20","10","12043","50"
"Gulf","0","1","Florida","5/31/20","1","0","12045","0"
"Hamilton","6","233","Florida","5/31/20","194","39","12047","20.1"
"Hardee","3","99","Florida","5/31/20","77","22","12049","28.57"
"Hendry","19","415","Florida","5/31/20","281","134","12051","47.69"
"Hernando","1","115","Florida","5/31/20","109","6","12053","5.5"
"Highlands","2","129","Florida","5/31/20","113","16","12055","14.16"
"Hillsborough","45","2201","Florida","5/31/20","1883","318","12057","16.89"
"Holmes","1","19","Florida","5/31/20","14","5","12059","35.71"
"Indian River","2","130","Florida","5/31/20","116","14","12061","12.07"
"Jackson","3","251","Florida","5/31/20","230","21","12063","9.13"
"Jefferson","0","29","Florida","5/31/20","29","0","12065","0"
"Lafayette","0","8","Florida","5/31/20","8","0","12067","0"
"Lake","4","301","Florida","5/31/20","273","28","12069","10.26"
"Lee","30","1908","Florida","5/31/20","1699","209","12071","12.3"
"Leon","10","404","Florida","5/31/20","332","72","12073","21.69"
"Levy","1","32","Florida","5/31/20","27","5","12075","18.52"
"Liberty","1","213","Florida","5/31/20","206","7","12077","3.4"
"Madison","0","69","Florida","5/31/20","68","1","12079","1.47"
"Manatee","10","1045","Florida","5/31/20","975","70","12081","7.18"
"Marion","2","248","Florida","5/31/20","237","11","12083","4.64"
"Martin","22","651","Florida","5/31/20","494","157","12085","31.78"
"Miami-Dade","165","18000","Florida","5/31/20","16845","1155","12086","6.86"
"Monroe","0","108","Florida","5/31/20","108","0","12087","0"
"Nassau","1","76","Florida","5/31/20","70","6","12089","8.57"
"Okaloosa","4","223","Florida","5/31/20","193","30","12091","15.54"
"Okeechobee","3","83","Florida","5/31/20","60","23","12093","38.33"
"Orange","28","2002","Florida","5/31/20","1808","194","12095","10.73"
"Osceola","6","701","Florida","5/31/20","658","43","12097","6.53"
"Palm Beach","114","5996","Florida","5/31/20","5201","795","12099","15.29"
"Pasco","5","386","Florida","5/31/20","349","37","12101","10.6"
"Pinellas","18","1297","Florida","5/31/20","1173","124","12103","10.57"
"Polk","23","1027","Florida","5/31/20","869","158","12105","18.18"
"Putnam","2","152","Florida","5/31/20","140","12","12107","8.57"
"Santa Rosa","5","245","Florida","5/31/20","207","38","12113","18.36"
"Sarasota","7","635","Florida","5/31/20","586","49","12115","8.36"
"Seminole","4","490","Florida","5/31/20","459","31","12117","6.75"
"St. Johns","3","260","Florida","5/31/20","239","21","12109","8.79"
"St. Lucie","11","471","Florida","5/31/20","391","80","12111","20.46"
"Sumter","0","253","Florida","5/31/20","253","0","12119","0"
"Suwannee","0","167","Florida","5/31/20","165","2","12121","1.21"
"Taylor","1","22","Florida","5/31/20","12","10","12123","83.33"
"Union","0","32","Florida","5/31/20","30","2","12125","6.67"
"Volusia","10","736","Florida","5/31/20","663","73","12127","11.01"
"Wakulla","0","34","Florida","5/31/20","32","2","12129","6.25"
"Walton","2","117","Florida","5/31/20","106","11","12131","10.38"
"Washington","4","57","Florida","5/31/20","26","31","12133","119.23"
"Appling","4","159","Georgia","5/31/20","132","27","13001","20.45"
"Atkinson","3","48","Georgia","5/31/20","29","19","13003","65.52"
"Bacon","7","122","Georgia","5/31/20","75","47","13005","62.67"
"Baker","0","34","Georgia","5/31/20","33","1","13007","3.03"
"Baldwin","2","345","Georgia","5/31/20","331","14","13009","4.23"
"Banks","2","88","Georgia","5/31/20","73","15","13011","20.55"
"Barrow","6","326","Georgia","5/31/20","283","43","13013","15.19"
"Bartow","5","478","Georgia","5/31/20","443","35","13015","7.9"
"Ben Hill","2","74","Georgia","5/31/20","58","16","13017","27.59"
"Berrien","2","46","Georgia","5/31/20","34","12","13019","35.29"
"Bibb","3","453","Georgia","5/31/20","433","20","13021","4.62"
"Bleckley","1","45","Georgia","5/31/20","39","6","13023","15.38"
"Brantley","1","56","Georgia","5/31/20","51","5","13025","9.8"
"Brooks","0","68","Georgia","5/31/20","66","2","13027","3.03"
"Bryan","1","74","Georgia","5/31/20","70","4","13029","5.71"
"Bulloch","1","60","Georgia","5/31/20","52","8","13031","15.38"
"Burke","0","121","Georgia","5/31/20","121","0","13033","0"
"Butts","3","228","Georgia","5/31/20","209","19","13035","9.09"
"Calhoun","1","132","Georgia","5/31/20","126","6","13037","4.76"
"Camden","1","62","Georgia","5/31/20","56","6","13039","10.71"
"Candler","0","13","Georgia","5/31/20","13","0","13043","0"
"Carroll","11","525","Georgia","5/31/20","445","80","13045","17.98"
"Catoosa","5","133","Georgia","5/31/20","101","32","13047","31.68"
"Charlton","0","32","Georgia","5/31/20","29","3","13049","10.34"
"Chatham","8","501","Georgia","5/31/20","445","56","13051","12.58"
"Chattahoochee","4","54","Georgia","5/31/20","24","30","13053","125"
"Chattooga","0","24","Georgia","5/31/20","24","0","13055","0"
"Cherokee","14","909","Georgia","5/31/20","810","99","13057","12.22"
"Clarke","8","283","Georgia","5/31/20","224","59","13059","26.34"
"Clay","1","39","Georgia","5/31/20","35","4","13061","11.43"
"Clayton","15","1221","Georgia","5/31/20","1119","102","13063","9.12"
"Clinch","1","59","Georgia","5/31/20","49","10","13065","20.41"
"Cobb","46","3027","Georgia","5/31/20","2702","325","13067","12.03"
"Coffee","3","271","Georgia","5/31/20","248","23","13069","9.27"
"Colquitt","24","467","Georgia","5/31/20","296","171","13071","57.77"
"Columbia","4","248","Georgia","5/31/20","223","25","13073","11.21"
"Cook","0","48","Georgia","5/31/20","46","2","13075","4.35"
"Coweta","12","417","Georgia","5/31/20","331","86","13077","25.98"
"Crawford","0","28","Georgia","5/31/20","26","2","13079","7.69"
"Crisp","2","232","Georgia","5/31/20","221","11","13081","4.98"
"Dade","0","28","Georgia","5/31/20","27","1","13083","3.7"
"Dawson","1","109","Georgia","5/31/20","101","8","13085","7.92"
"Decatur","6","186","Georgia","5/31/20","146","40","13087","27.4"
"DeKalb","68","3734","Georgia","5/31/20","3257","477","13089","14.65"
"Dodge","0","51","Georgia","5/31/20","48","3","13091","6.25"
"Dooly","2","179","Georgia","5/31/20","168","11","13093","6.55"
"Dougherty","6","1770","Georgia","5/31/20","1727","43","13095","2.49"
"Douglas","8","543","Georgia","5/31/20","490","53","13097","10.82"
"Early","1","238","Georgia","5/31/20","234","4","13099","1.71"
"Echols","8","117","Georgia","5/31/20","61","56","13101","91.8"
"Effingham","2","74","Georgia","5/31/20","63","11","13103","17.46"
"Elbert","1","75","Georgia","5/31/20","71","4","13105","5.63"
"Emanuel","0","27","Georgia","5/31/20","26","1","13107","3.85"
"Evans","0","5","Georgia","5/31/20","5","0","13109","0"
"Fannin","1","44","Georgia","5/31/20","40","4","13111","10"
"Fayette","2","235","Georgia","5/31/20","220","15","13113","6.82"
"Floyd","5","265","Georgia","5/31/20","227","38","13115","16.74"
"Forsyth","9","512","Georgia","5/31/20","449","63","13117","14.03"
"Franklin","1","46","Georgia","5/31/20","36","10","13119","27.78"
"Fulton","67","4524","Georgia","5/31/20","4054","470","13121","11.59"
"Gilmer","3","153","Georgia","5/31/20","135","18","13123","13.33"
"Glascock","0","1","Georgia","5/31/20","1","0","13125","0"
"Glynn","4","115","Georgia","5/31/20","85","30","13127","35.29"
"Gordon","4","163","Georgia","5/31/20","138","25","13129","18.12"
"Grady","2","110","Georgia","5/31/20","93","17","13131","18.28"
"Greene","1","68","Georgia","5/31/20","64","4","13133","6.25"
"Gwinnett","103","3780","Georgia","5/31/20","3056","724","13135","23.69"
"Habersham","3","520","Georgia","5/31/20","500","20","13137","4"
"Hall","21","2467","Georgia","5/31/20","2322","145","13139","6.24"
"Hancock","1","195","Georgia","5/31/20","191","4","13141","2.09"
"Haralson","1","43","Georgia","5/31/20","36","7","13143","19.44"
"Harris","1","91","Georgia","5/31/20","83","8","13145","9.64"
"Hart","1","30","Georgia","5/31/20","26","4","13147","15.38"
"Heard","1","34","Georgia","5/31/20","26","8","13149","30.77"
"Henry","8","690","Georgia","5/31/20","632","58","13151","9.18"
"Houston","3","366","Georgia","5/31/20","343","23","13153","6.71"
"Irwin","1","28","Georgia","5/31/20","23","5","13155","21.74"
"Jackson","5","184","Georgia","5/31/20","147","37","13157","25.17"
"Jasper","1","36","Georgia","5/31/20","31","5","13159","16.13"
"Jeff Davis","1","37","Georgia","5/31/20","33","4","13161","12.12"
"Jefferson","2","43","Georgia","5/31/20","26","17","13163","65.38"
"Jenkins","0","19","Georgia","5/31/20","18","1","13165","5.56"
"Johnson","1","82","Georgia","5/31/20","76","6","13167","7.89"
"Jones","0","37","Georgia","5/31/20","34","3","13169","8.82"
"Lamar","2","67","Georgia","5/31/20","51","16","13171","31.37"
"Lanier","1","21","Georgia","5/31/20","12","9","13173","75"
"Laurens","1","106","Georgia","5/31/20","101","5","13175","4.95"
"Lee","3","361","Georgia","5/31/20","343","18","13177","5.25"
"Liberty","2","82","Georgia","5/31/20","65","17","13179","26.15"
"Lincoln","0","16","Georgia","5/31/20","15","1","13181","6.67"
"Long","1","16","Georgia","5/31/20","12","4","13183","33.33"
"Lowndes","8","302","Georgia","5/31/20","245","57","13185","23.27"
"Lumpkin","2","99","Georgia","5/31/20","88","11","13187","12.5"
"Macon","1","101","Georgia","5/31/20","95","6","13193","6.32"
"Madison","2","54","Georgia","5/31/20","38","16","13195","42.11"
"Marion","1","57","Georgia","5/31/20","49","8","13197","16.33"
"McDuffie","1","67","Georgia","5/31/20","62","5","13189","8.06"
"McIntosh","1","16","Georgia","5/31/20","12","4","13191","33.33"
"Meriwether","1","85","Georgia","5/31/20","78","7","13199","8.97"
"Miller","0","41","Georgia","5/31/20","38","3","13201","7.89"
"Mitchell","1","409","Georgia","5/31/20","399","10","13205","2.51"
"Monroe","0","120","Georgia","5/31/20","117","3","13207","2.56"
"Montgomery","0","9","Georgia","5/31/20","9","0","13209","0"
"Morgan","0","37","Georgia","5/31/20","36","1","13211","2.78"
"Murray","2","91","Georgia","5/31/20","78","13","13213","16.67"
"Muscogee","9","615","Georgia","5/31/20","550","65","13215","11.82"
"Newton","7","352","Georgia","5/31/20","304","48","13217","15.79"
"Oconee","2","116","Georgia","5/31/20","103","13","13219","12.62"
"Oglethorpe","0","61","Georgia","5/31/20","58","3","13221","5.17"
"Out of GA","14","2012","Georgia","5/31/20","1913","99","80013","5.18"
"Paulding","7","328","Georgia","5/31/20","277","51","13223","18.41"
"Peach","0","72","Georgia","5/31/20","70","2","13225","2.86"
"Pickens","1","48","Georgia","5/31/20","43","5","13227","11.63"
"Pierce","2","100","Georgia","5/31/20","89","11","13229","12.36"
"Pike","1","54","Georgia","5/31/20","49","5","13231","10.2"
"Polk","3","118","Georgia","5/31/20","95","23","13233","24.21"
"Pulaski","0","42","Georgia","5/31/20","39","3","13235","7.69"
"Putnam","0","90","Georgia","5/31/20","87","3","13237","3.45"
"Quitman","0","12","Georgia","5/31/20","11","1","13239","9.09"
"Rabun","1","20","Georgia","5/31/20","15","5","13241","33.33"
"Randolph","1","179","Georgia","5/31/20","170","9","13243","5.29"
"Richmond","10","595","Georgia","5/31/20","527","68","13245","12.9"
"Rockdale","3","285","Georgia","5/31/20","265","20","13247","7.55"
"Schley","0","16","Georgia","5/31/20","16","0","13249","0"
"Screven","3","51","Georgia","5/31/20","27","24","13251","88.89"
"Seminole","0","44","Georgia","5/31/20","42","2","13253","4.76"
"Spalding","3","275","Georgia","5/31/20","253","22","13255","8.7"
"Stephens","2","139","Georgia","5/31/20","122","17","13257","13.93"
"Stewart","1","52","Georgia","5/31/20","42","10","13259","23.81"
"Sumter","4","475","Georgia","5/31/20","445","30","13261","6.74"
"Talbot","0","38","Georgia","5/31/20","35","3","13263","8.57"
"Taliaferro","0","1","Georgia","5/31/20","1","0","13265","0"
"Tattnall","2","27","Georgia","5/31/20","15","12","13267","80"
"Taylor","0","22","Georgia","5/31/20","21","1","13269","4.76"
"Telfair","1","37","Georgia","5/31/20","32","5","13271","15.62"
"Terrell","0","213","Georgia","5/31/20","211","2","13273","0.95"
"Thomas","2","324","Georgia","5/31/20","311","13","13275","4.18"
"Tift","5","256","Georgia","5/31/20","219","37","13277","16.89"
"Toombs","1","56","Georgia","5/31/20","50","6","13279","12"
"Towns","0","24","Georgia","5/31/20","22","2","13281","9.09"
"Treutlen","0","10","Georgia","5/31/20","8","2","13283","25"
"Troup","9","313","Georgia","5/31/20","250","63","13285","25.2"
"Turner","3","118","Georgia","5/31/20","100","18","13287","18"
"Twiggs","1","17","Georgia","5/31/20","13","4","13289","30.77"
"Union","1","46","Georgia","5/31/20","39","7","13291","17.95"
"Upson","1","281","Georgia","5/31/20","273","8","13293","2.93"
"Walker","7","141","Georgia","5/31/20","94","47","13295","50"
"Walton","11","265","Georgia","5/31/20","189","76","13297","40.21"
"Ware","3","228","Georgia","5/31/20","209","19","13299","9.09"
"Warren","0","18","Georgia","5/31/20","17","1","13301","5.88"
"Washington","0","74","Georgia","5/31/20","74","0","13303","0"
"Wayne","0","19","Georgia","5/31/20","16","3","13305","18.75"
"Webster","0","13","Georgia","5/31/20","11","2","13307","18.18"
"Wheeler","1","13","Georgia","5/31/20","9","4","13309","44.44"
"White","1","101","Georgia","5/31/20","94","7","13311","7.45"
"Whitfield","14","374","Georgia","5/31/20","279","95","13313","34.05"
"Wilcox","2","111","Georgia","5/31/20","98","13","13315","13.27"
"Wilkes","0","33","Georgia","5/31/20","32","1","13317","3.12"
"Wilkinson","1","69","Georgia","5/31/20","65","4","13319","6.15"
"Worth","0","211","Georgia","5/31/20","209","2","13321","0.96"
"","0","103","Grand Princess","5/31/20","103","0",,"0"
"","1","172","Guam","5/31/20","166","6",,"3.61"
"Hawaii","0","81","Hawaii","5/31/20","81","0","15001","0"
"Honolulu","1","421","Hawaii","5/31/20","414","7","15003","1.69"
"Kauai","0","20","Hawaii","5/31/20","20","0","15007","0"
"Maui","0","120","Hawaii","5/31/20","118","2","15009","1.69"
"Out of HI","0","10","Hawaii","5/31/20","10","0","80015","0"
"Ada","2","812","Idaho","5/31/20","796","16","16001","2.01"
"Adams","0","3","Idaho","5/31/20","3","0","16003","0"
"Bannock","1","28","Idaho","5/31/20","18","10","16005","55.56"
"Benewah","1","8","Idaho","5/31/20","0","8","16009","1"
"Bingham","0","6","Idaho","5/31/20","6","0","16011","0"
"Blaine","0","512","Idaho","5/31/20","510","2","16013","0.39"
"Bonner","0","6","Idaho","5/31/20","4","2","16017","50"
"Bonneville","2","47","Idaho","5/31/20","32","15","16019","46.88"
"Camas","0","1","Idaho","5/31/20","1","0","16025","0"
"Canyon","3","303","Idaho","5/31/20","284","19","16027","6.69"
"Caribou","0","1","Idaho","5/31/20","1","0","16029","0"
"Cassia","5","63","Idaho","5/31/20","28","35","16031","125"
"Custer","0","2","Idaho","5/31/20","2","0","16037","0"
"Elmore","0","31","Idaho","5/31/20","31","0","16039","0"
"Franklin","0","2","Idaho","5/31/20","0","2","16041","1"
"Fremont","0","3","Idaho","5/31/20","3","0","16043","0"
"Gem","0","17","Idaho","5/31/20","17","0","16045","0"
"Gooding","1","47","Idaho","5/31/20","39","8","16047","20.51"
"Idaho","0","3","Idaho","5/31/20","3","0","16049","0"
"Jefferson","0","7","Idaho","5/31/20","7","0","16051","0"
"Jerome","3","169","Idaho","5/31/20","145","24","16053","16.55"
"Kootenai","0","68","Idaho","5/31/20","66","2","16055","3.03"
"Latah","0","7","Idaho","5/31/20","7","0","16057","0"
"Lemhi","0","1","Idaho","5/31/20","1","0","16059","0"
"Lincoln","0","33","Idaho","5/31/20","30","3","16063","10"
"Madison","0","21","Idaho","5/31/20","20","1","16065","5"
"Minidoka","3","50","Idaho","5/31/20","29","21","16067","72.41"
"Nez Perce","0","82","Idaho","5/31/20","81","1","16069","1.23"
"Owyhee","0","8","Idaho","5/31/20","8","0","16073","0"
"Payette","0","23","Idaho","5/31/20","23","0","16075","0"
"Power","0","5","Idaho","5/31/20","3","2","16077","66.67"
"Teton","0","11","Idaho","5/31/20","11","0","16081","0"
"Twin Falls","5","419","Idaho","5/31/20","381","38","16083","9.97"
"Valley","0","2","Idaho","5/31/20","2","0","16085","0"
"Washington","1","38","Idaho","5/31/20","34","4","16087","11.76"
"Adams","0","44","Illinois","5/31/20","44","0","17001","0"
"Alexander","0","8","Illinois","5/31/20","8","0","17003","0"
"Bond","0","12","Illinois","5/31/20","10","2","17005","20"
"Boone","8","452","Illinois","5/31/20","393","59","17007","15.01"
"Brown","0","10","Illinois","5/31/20","10","0","17009","0"
"Bureau","0","15","Illinois","5/31/20","15","0","17011","0"
"Calhoun","0","1","Illinois","5/31/20","1","0","17013","0"
"Carroll","0","15","Illinois","5/31/20","13","2","17015","15.38"
"Cass","1","73","Illinois","5/31/20","67","6","17017","8.96"
"Champaign","12","640","Illinois","5/31/20","556","84","17019","15.11"
"Christian","0","35","Illinois","5/31/20","33","2","17021","6.06"
"Clark","0","11","Illinois","5/31/20","10","1","17023","10"
"Clay","0","2","Illinois","5/31/20","2","0","17025","0"
"Clinton","1","186","Illinois","5/31/20","176","10","17027","5.68"
"Coles","2","127","Illinois","5/31/20","115","12","17029","10.43"
"Cook","845","77925","Illinois","5/31/20","72010","5915","17031","8.21"
"Crawford","0","11","Illinois","5/31/20","11","0","17033","0"
"Cumberland","0","10","Illinois","5/31/20","10","0","17035","0"
"De Witt","0","4","Illinois","5/31/20","4","0","17039","0"
"DeKalb","14","416","Illinois","5/31/20","319","97","17037","30.41"
"Douglas","0","28","Illinois","5/31/20","28","0","17041","0"
"DuPage","92","7707","Illinois","5/31/20","7060","647","17043","9.16"
"Edgar","0","1","Illinois","5/31/20","0","1","17045","1"
"Edwards","0","2","Illinois","5/31/20","2","0","17047","0"
"Effingham","0","7","Illinois","5/31/20","6","1","17049","16.67"
"Fayette","0","21","Illinois","5/31/20","20","1","17051","5"
"Ford","0","20","Illinois","5/31/20","20","0","17053","0"
"Franklin","0","12","Illinois","5/31/20","12","0","17055","0"
"Fulton","0","11","Illinois","5/31/20","11","0","17057","0"
"Gallatin","0","2","Illinois","5/31/20","2","0","17059","0"
"Greene","0","5","Illinois","5/31/20","5","0","17061","0"
"Grundy","1","98","Illinois","5/31/20","89","9","17063","10.11"
"Hamilton","0","2","Illinois","5/31/20","2","0","17065","0"
"Hancock","1","17","Illinois","5/31/20","13","4","17067","30.77"
"Hardin","0","1","Illinois","5/31/20","1","0","17069","0"
"Henderson","0","8","Illinois","5/31/20","8","0","17071","0"
"Henry","0","69","Illinois","5/31/20","66","3","17073","4.55"
"Iroquois","0","132","Illinois","5/31/20","130","2","17075","1.54"
"Jackson","10","286","Illinois","5/31/20","219","67","17077","30.59"
"Jasper","0","45","Illinois","5/31/20","45","0","17079","0"
"Jefferson","0","101","Illinois","5/31/20","101","0","17081","0"
"Jersey","1","24","Illinois","5/31/20","20","4","17083","20"
"Jo Daviess","1","32","Illinois","5/31/20","26","6","17085","23.08"
"Johnson","0","8","Illinois","5/31/20","7","1","17087","14.29"
"Kane","99","6338","Illinois","5/31/20","5645","693","17089","12.28"
"Kankakee","17","910","Illinois","5/31/20","791","119","17091","15.04"
"Kendall","13","798","Illinois","5/31/20","709","89","17093","12.55"
"Knox","1","100","Illinois","5/31/20","94","6","17095","6.38"
"Lake","102","8331","Illinois","5/31/20","7615","716","17097","9.4"
"LaSalle","2","153","Illinois","5/31/20","139","14","17099","10.07"
"Lawrence","0","4","Illinois","5/31/20","4","0","17101","0"
"Lee","1","81","Illinois","5/31/20","77","4","17103","5.19"
"Livingston","0","34","Illinois","5/31/20","31","3","17105","9.68"
"Logan","0","10","Illinois","5/31/20","10","0","17107","0"
"Macon","1","193","Illinois","5/31/20","187","6","17115","3.21"
"Macoupin","1","45","Illinois","5/31/20","41","4","17117","9.76"
"Madison","7","580","Illinois","5/31/20","533","47","17119","8.82"
"Marion","0","50","Illinois","5/31/20","50","0","17121","0"
"Marshall","0","5","Illinois","5/31/20","5","0","17123","0"
"Mason","0","18","Illinois","5/31/20","17","1","17125","5.88"
"Massac","0","7","Illinois","5/31/20","7","0","17127","0"
"McDonough","1","88","Illinois","5/31/20","80","8","17109","10"
"McHenry","24","1566","Illinois","5/31/20","1399","167","17111","11.94"
"McLean","2","220","Illinois","5/31/20","204","16","17113","7.84"
"Menard","0","20","Illinois","5/31/20","17","3","17129","17.65"
"Mercer","0","17","Illinois","5/31/20","14","3","17131","21.43"
"Monroe","1","95","Illinois","5/31/20","91","4","17133","4.4"
"Montgomery","0","39","Illinois","5/31/20","39","0","17135","0"
"Morgan","0","36","Illinois","5/31/20","34","2","17137","5.88"
"Moultrie","0","11","Illinois","5/31/20","9","2","17139","22.22"
"Ogle","2","206","Illinois","5/31/20","190","16","17141","8.42"
"Out of IL","-5","118","Illinois","5/31/20","150","-32","80017","-21.33"
"Peoria","8","233","Illinois","5/31/20","177","56","17143","31.64"
"Perry","0","41","Illinois","5/31/20","41","0","17145","0"
"Piatt","0","11","Illinois","5/31/20","11","0","17147","0"
"Pike","0","1","Illinois","5/31/20","1","0","17149","0"
"Pope","0","1","Illinois","5/31/20","1","0","17151","0"
"Pulaski","2","56","Illinois","5/31/20","40","16","17153","40"
"Putnam","0","1","Illinois","5/31/20","1","0","17155","0"
"Randolph","2","270","Illinois","5/31/20","258","12","17157","4.65"
"Richland","0","3","Illinois","5/31/20","3","0","17159","0"
"Rock Island","4","658","Illinois","5/31/20","631","27","17161","4.28"
"Saline","0","7","Illinois","5/31/20","6","1","17165","16.67"
"Sangamon","3","351","Illinois","5/31/20","329","22","17167","6.69"
"Schuyler","0","13","Illinois","5/31/20","10","3","17169","30"
"Shelby","0","16","Illinois","5/31/20","16","0","17173","0"
"St. Clair","24","1137","Illinois","5/31/20","966","171","17163","17.7"
"Stark","0","3","Illinois","5/31/20","3","0","17175","0"
"Stephenson","3","206","Illinois","5/31/20","187","19","17177","10.16"
"Tazewell","1","73","Illinois","5/31/20","67","6","17179","8.96"
"Union","2","154","Illinois","5/31/20","139","15","17181","10.79"
"Vermilion","0","40","Illinois","5/31/20","39","1","17183","2.56"
"Wabash","0","2","Illinois","5/31/20","1","1","17185","100"
"Warren","0","117","Illinois","5/31/20","114","3","17187","2.63"
"Washington","0","18","Illinois","5/31/20","18","0","17189","0"
"Wayne","0","9","Illinois","5/31/20","9","0","17191","0"
"White","0","2","Illinois","5/31/20","2","0","17193","0"
"Whiteside","1","140","Illinois","5/31/20","134","6","17195","4.48"
"Will","64","5566","Illinois","5/31/20","5117","449","17197","8.77"
"Williamson","2","67","Illinois","5/31/20","55","12","17199","21.82"
"Winnebago","47","2251","Illinois","5/31/20","1925","326","17201","16.94"
"Woodford","0","19","Illinois","5/31/20","17","2","17203","11.76"
"Adams","0","15","Indiana","5/31/20","12","3","18001","25"
"Allen","54","1618","Indiana","5/31/20","1240","378","18003","30.48"
"Bartholomew","5","511","Indiana","5/31/20","474","37","18005","7.81"
"Benton","1","30","Indiana","5/31/20","24","6","18007","25"
"Blackford","1","25","Indiana","5/31/20","20","5","18009","25"
"Boone","5","315","Indiana","5/31/20","281","34","18011","12.1"
"Brown","0","33","Indiana","5/31/20","33","0","18013","0"
"Carroll","0","93","Indiana","5/31/20","91","2","18015","2.2"
"Cass","1","1587","Indiana","5/31/20","1581","6","18017","0.38"
"Clark","7","504","Indiana","5/31/20","453","51","18019","11.26"
"Clay","2","51","Indiana","5/31/20","39","12","18021","30.77"
"Clinton","3","232","Indiana","5/31/20","208","24","18023","11.54"
"Crawford","0","24","Indiana","5/31/20","23","1","18025","4.35"
"Daviess","1","88","Indiana","5/31/20","81","7","18027","8.64"
"Dearborn","1","168","Indiana","5/31/20","162","6","18029","3.7"
"Decatur","0","224","Indiana","5/31/20","222","2","18031","0.9"
"DeKalb","1","37","Indiana","5/31/20","28","9","18033","32.14"
"Delaware","5","385","Indiana","5/31/20","349","36","18035","10.32"
"Dubois","3","199","Indiana","5/31/20","178","21","18037","11.8"
"Elkhart","47","1322","Indiana","5/31/20","991","331","18039","33.4"
"Fayette","2","77","Indiana","5/31/20","63","14","18041","22.22"
"Floyd","1","318","Indiana","5/31/20","312","6","18043","1.92"
"Fountain","1","21","Indiana","5/31/20","17","4","18045","23.53"
"Franklin","1","110","Indiana","5/31/20","106","4","18047","3.77"
"Fulton","0","49","Indiana","5/31/20","46","3","18049","6.52"
"Gibson","1","17","Indiana","5/31/20","13","4","18051","30.77"
"Grant","4","211","Indiana","5/31/20","181","30","18053","16.57"
"Greene","0","169","Indiana","5/31/20","167","2","18055","1.2"
"Hamilton","9","1159","Indiana","5/31/20","1096","63","18057","5.75"
"Hancock","3","338","Indiana","5/31/20","317","21","18059","6.62"
"Harrison","1","194","Indiana","5/31/20","184","10","18061","5.43"
"Hendricks","7","1169","Indiana","5/31/20","1117","52","18063","4.66"
"Henry","4","182","Indiana","5/31/20","156","26","18065","16.67"
"Howard","9","408","Indiana","5/31/20","345","63","18067","18.26"
"Huntington","1","28","Indiana","5/31/20","22","6","18069","27.27"
"Jackson","4","389","Indiana","5/31/20","359","30","18071","8.36"
"Jasper","2","67","Indiana","5/31/20","54","13","18073","24.07"
"Jay","1","52","Indiana","5/31/20","43","9","18075","20.93"
"Jefferson","1","45","Indiana","5/31/20","41","4","18077","9.76"
"Jennings","1","130","Indiana","5/31/20","126","4","18079","3.17"
"Johnson","4","1105","Indiana","5/31/20","1080","25","18081","2.31"
"Knox","1","28","Indiana","5/31/20","24","4","18083","16.67"
"Kosciusko","8","135","Indiana","5/31/20","78","57","18085","73.08"
"LaGrange","3","81","Indiana","5/31/20","60","21","18087","35"
"Lake","51","3616","Indiana","5/31/20","3260","356","18089","10.92"
"LaPorte","5","433","Indiana","5/31/20","399","34","18091","8.52"
"Lawrence","3","163","Indiana","5/31/20","142","21","18093","14.79"
"Madison","1","586","Indiana","5/31/20","580","6","18095","1.03"
"Marion","103","9853","Indiana","5/31/20","9132","721","18097","7.9"
"Marshall","6","108","Indiana","5/31/20","64","44","18099","68.75"
"Martin","0","11","Indiana","5/31/20","9","2","18101","22.22"
"Miami","0","140","Indiana","5/31/20","137","3","18103","2.19"
"Monroe","1","166","Indiana","5/31/20","158","8","18105","5.06"
"Montgomery","3","241","Indiana","5/31/20","221","20","18107","9.05"
"Morgan","3","277","Indiana","5/31/20","258","19","18109","7.36"
"Newton","1","78","Indiana","5/31/20","74","4","18111","5.41"
"Noble","7","232","Indiana","5/31/20","181","51","18113","28.18"
"Ohio","0","13","Indiana","5/31/20","13","0","18115","0"
"Orange","1","128","Indiana","5/31/20","124","4","18117","3.23"
"Owen","1","35","Indiana","5/31/20","31","4","18119","12.9"
"Parke","0","18","Indiana","5/31/20","17","1","18121","5.88"
"Perry","1","33","Indiana","5/31/20","23","10","18123","43.48"
"Pike","0","6","Indiana","5/31/20","6","0","18125","0"
"Porter","9","539","Indiana","5/31/20","473","66","18127","13.95"
"Posey","0","16","Indiana","5/31/20","17","-1","18129","-5.88"
"Pulaski","1","46","Indiana","5/31/20","39","7","18131","17.95"
"Putnam","1","137","Indiana","5/31/20","131","6","18133","4.58"
"Randolph","1","47","Indiana","5/31/20","38","9","18135","23.68"
"Ripley","0","109","Indiana","5/31/20","112","-3","18137","-2.68"
"Rush","0","47","Indiana","5/31/20","45","2","18139","4.44"
"Scott","1","120","Indiana","5/31/20","116","4","18143","3.45"
"Shelby","9","373","Indiana","5/31/20","312","61","18145","19.55"
"Spencer","1","20","Indiana","5/31/20","14","6","18147","42.86"
"St. Joseph","17","1274","Indiana","5/31/20","1155","119","18141","10.3"
"Starke","1","39","Indiana","5/31/20","31","8","18149","25.81"
"Steuben","1","83","Indiana","5/31/20","79","4","18151","5.06"
"Sullivan","1","36","Indiana","5/31/20","32","4","18153","12.5"
"Switzerland","0","20","Indiana","5/31/20","19","1","18155","5.26"
"Tippecanoe","5","402","Indiana","5/31/20","369","33","18157","8.94"
"Tipton","0","25","Indiana","5/31/20","22","3","18159","13.64"
"Union","0","9","Indiana","5/31/20","8","1","18161","12.5"
"Vanderburgh","5","274","Indiana","5/31/20","242","32","18163","13.22"
"Vermillion","0","10","Indiana","5/31/20","9","1","18165","11.11"
"Vigo","4","169","Indiana","5/31/20","141","28","18167","19.86"
"Wabash","1","78","Indiana","5/31/20","72","6","18169","8.33"
"Warren","0","12","Indiana","5/31/20","12","0","18171","0"
"Warrick","0","166","Indiana","5/31/20","164","2","18173","1.22"
"Washington","0","52","Indiana","5/31/20","52","0","18175","0"
"Wayne","2","82","Indiana","5/31/20","69","13","18177","18.84"
"Wells","1","32","Indiana","5/31/20","22","10","18179","45.45"
"White","2","235","Indiana","5/31/20","221","14","18181","6.33"
"Whitley","1","42","Indiana","5/31/20","34","8","18183","23.53"
"Adair","0","9","Iowa","5/31/20","8","1","19001","12.5"
"Adams","0","7","Iowa","5/31/20","5","2","19003","40"
"Allamakee","0","121","Iowa","5/31/20","118","3","19005","2.54"
"Appanoose","0","15","Iowa","5/31/20","12","3","19007","25"
"Audubon","0","12","Iowa","5/31/20","11","1","19009","9.09"
"Benton","1","43","Iowa","5/31/20","37","6","19011","16.22"
"Black Hawk","10","1746","Iowa","5/31/20","1676","70","19013","4.18"
"Boone","1","62","Iowa","5/31/20","54","8","19015","14.81"
"Bremer","0","70","Iowa","5/31/20","67","3","19017","4.48"
"Buchanan","0","33","Iowa","5/31/20","31","2","19019","6.45"
"Buena Vista","79","783","Iowa","5/31/20","231","552","19021","238.96"
"Butler","0","16","Iowa","5/31/20","15","1","19023","6.67"
"Calhoun","0","2","Iowa","5/31/20","2","0","19025","0"
"Carroll","0","10","Iowa","5/31/20","9","1","19027","11.11"
"Cass","0","12","Iowa","5/31/20","11","1","19029","9.09"
"Cedar","0","47","Iowa","5/31/20","45","2","19031","4.44"
"Cerro Gordo","1","29","Iowa","5/31/20","22","7","19033","31.82"
"Cherokee","2","28","Iowa","5/31/20","15","13","19035","86.67"
"Chickasaw","0","10","Iowa","5/31/20","8","2","19037","25"
"Clarke","3","55","Iowa","5/31/20","32","23","19039","71.88"
"Clay","1","16","Iowa","5/31/20","10","6","19041","60"
"Clayton","1","35","Iowa","5/31/20","30","5","19043","16.67"
"Clinton","0","61","Iowa","5/31/20","60","1","19045","1.67"
"Crawford","6","516","Iowa","5/31/20","477","39","19047","8.18"
"Dallas","8","904","Iowa","5/31/20","849","55","19049","6.48"
"Davis","0","22","Iowa","5/31/20","20","2","19051","10"
"Decatur","0","1","Iowa","5/31/20","0","1","19053","1"
"Delaware","0","15","Iowa","5/31/20","14","1","19055","7.14"
"Des Moines","1","63","Iowa","5/31/20","53","10","19057","18.87"
"Dickinson","2","21","Iowa","5/31/20","8","13","19059","162.5"
"Dubuque","4","344","Iowa","5/31/20","319","25","19061","7.84"
"Emmet","1","15","Iowa","5/31/20","7","8","19063","114.29"
"Fayette","0","27","Iowa","5/31/20","26","1","19065","3.85"
"Floyd","0","19","Iowa","5/31/20","18","1","19067","5.56"
"Franklin","1","13","Iowa","5/31/20","8","5","19069","62.5"
"Fremont","0","4","Iowa","5/31/20","4","0","19071","0"
"Greene","0","13","Iowa","5/31/20","13","0","19073","0"
"Grundy","0","20","Iowa","5/31/20","19","1","19075","5.26"
"Guthrie","1","50","Iowa","5/31/20","43","7","19077","16.28"
"Hamilton","2","37","Iowa","5/31/20","26","11","19079","42.31"
"Hancock","1","16","Iowa","5/31/20","12","4","19081","33.33"
"Hardin","1","17","Iowa","5/31/20","13","4","19083","30.77"
"Harrison","1","23","Iowa","5/31/20","19","4","19085","21.05"
"Henry","1","71","Iowa","5/31/20","61","10","19087","16.39"
"Howard","0","12","Iowa","5/31/20","12","0","19089","0"
"Humboldt","1","18","Iowa","5/31/20","13","5","19091","38.46"
"Ida","1","14","Iowa","5/31/20","10","4","19093","40"
"Iowa","0","33","Iowa","5/31/20","32","1","19095","3.12"
"Jackson","0","12","Iowa","5/31/20","11","1","19097","9.09"
"Jasper","1","260","Iowa","5/31/20","256","4","19099","1.56"
"Jefferson","2","27","Iowa","5/31/20","15","12","19101","80"
"Johnson","2","614","Iowa","5/31/20","598","16","19103","2.68"
"Jones","0","36","Iowa","5/31/20","36","0","19105","0"
"Keokuk","0","15","Iowa","5/31/20","13","2","19107","15.38"
"Kossuth","0","9","Iowa","5/31/20","7","2","19109","28.57"
"Lee","1","27","Iowa","5/31/20","22","5","19111","22.73"
"Linn","4","955","Iowa","5/31/20","927","28","19113","3.02"
"Louisa","1","344","Iowa","5/31/20","334","10","19115","2.99"
"Lucas","2","17","Iowa","5/31/20","6","11","19117","183.33"
"Lyon","1","24","Iowa","5/31/20","19","5","19119","26.32"
"Madison","1","28","Iowa","5/31/20","24","4","19121","16.67"
"Mahaska","6","94","Iowa","5/31/20","52","42","19123","80.77"
"Marion","0","32","Iowa","5/31/20","29","3","19125","10.34"
"Marshall","4","894","Iowa","5/31/20","866","28","19127","3.23"
"Mills","1","19","Iowa","5/31/20","14","5","19129","35.71"
"Mitchell","0","4","Iowa","5/31/20","4","0","19131","0"
"Monona","0","24","Iowa","5/31/20","23","1","19133","4.35"
"Monroe","1","38","Iowa","5/31/20","33","5","19135","15.15"
"Montgomery","0","7","Iowa","5/31/20","6","1","19137","16.67"
"Muscatine","2","557","Iowa","5/31/20","543","14","19139","2.58"
"O'Brien","1","31","Iowa","5/31/20","24","7","19141","29.17"
"Osceola","0","33","Iowa","5/31/20","32","1","19143","3.12"
"Page","0","13","Iowa","5/31/20","10","3","19145","30"
"Palo Alto","0","6","Iowa","5/31/20","3","3","19147","100"
"Plymouth","3","132","Iowa","5/31/20","108","24","19149","22.22"
"Pocahontas","1","12","Iowa","5/31/20","4","8","19151","200"
"Polk","73","4227","Iowa","5/31/20","3714","513","19153","13.81"
"Pottawattamie","8","263","Iowa","5/31/20","210","53","19155","25.24"
"Poweshiek","0","90","Iowa","5/31/20","88","2","19157","2.27"
"Ringgold","0","4","Iowa","5/31/20","4","0","19159","0"
"Sac","1","19","Iowa","5/31/20","13","6","19161","46.15"
"Scott","4","359","Iowa","5/31/20","331","28","19163","8.46"
"Shelby","1","37","Iowa","5/31/20","31","6","19165","19.35"
"Sioux","11","275","Iowa","5/31/20","199","76","19167","38.19"
"Story","3","115","Iowa","5/31/20","94","21","19169","22.34"
"Tama","2","403","Iowa","5/31/20","390","13","19171","3.33"
"Taylor","3","56","Iowa","5/31/20","37","19","19173","51.35"
"Union","0","8","Iowa","5/31/20","6","2","19175","33.33"
"Van Buren","0","9","Iowa","5/31/20","8","1","19177","12.5"
"Wapello","13","593","Iowa","5/31/20","500","93","19179","18.6"
"Warren","4","132","Iowa","5/31/20","106","26","19181","24.53"
"Washington","1","189","Iowa","5/31/20","179","10","19183","5.59"
"Wayne","0","1","Iowa","5/31/20","1","0","19185","0"
"Webster","2","40","Iowa","5/31/20","27","13","19187","48.15"
"Winnebago","0","11","Iowa","5/31/20","10","1","19189","10"
"Winneshiek","0","24","Iowa","5/31/20","21","3","19191","14.29"
"Woodbury","28","2750","Iowa","5/31/20","2555","195","19193","7.63"
"Worth","0","3","Iowa","5/31/20","3","0","19195","0"
"Wright","7","169","Iowa","5/31/20","117","52","19197","44.44"
"Allen","0","1","Kansas","5/31/20","1","0","20001","0"
"Anderson","0","1","Kansas","5/31/20","1","0","20003","0"
"Atchison","0","22","Kansas","5/31/20","19","3","20005","15.79"
"Barber","0","1","Kansas","5/31/20","1","0","20007","0"
"Barton","0","45","Kansas","5/31/20","45","0","20009","0"
"Bourbon","0","7","Kansas","5/31/20","7","0","20011","0"
"Brown","0","6","Kansas","5/31/20","6","0","20013","0"
"Butler","0","31","Kansas","5/31/20","28","3","20015","10.71"
"Chase","0","4","Kansas","5/31/20","4","0","20017","0"
"Chautauqua","0","4","Kansas","5/31/20","4","0","20019","0"
"Cherokee","0","10","Kansas","5/31/20","9","1","20021","11.11"
"Cheyenne","0","2","Kansas","5/31/20","2","0","20023","0"
"Clark","0","33","Kansas","5/31/20","31","2","20025","6.45"
"Clay","0","5","Kansas","5/31/20","5","0","20027","0"
"Cloud","0","5","Kansas","5/31/20","5","0","20029","0"
"Coffey","0","50","Kansas","5/31/20","50","0","20031","0"
"Comanche","0","2","Kansas","5/31/20","1","1","20033","100"
"Cowley","0","5","Kansas","5/31/20","4","1","20035","25"
"Crawford","0","8","Kansas","5/31/20","8","0","20037","0"
"Dickinson","0","3","Kansas","5/31/20","4","-1","20041","-25"
"Doniphan","0","15","Kansas","5/31/20","12","3","20043","25"
"Douglas","0","66","Kansas","5/31/20","63","3","20045","4.76"
"Edwards","0","5","Kansas","5/31/20","5","0","20047","0"
"Ellis","0","8","Kansas","5/31/20","8","0","20051","0"
"Ellsworth","0","2","Kansas","5/31/20","2","0","20053","0"
"Finney","9","1481","Kansas","5/31/20","1418","63","20055","4.44"
"Ford","26","1742","Kansas","5/31/20","1560","182","20057","11.67"
"Franklin","0","34","Kansas","5/31/20","32","2","20059","6.25"
"Geary","1","20","Kansas","5/31/20","16","4","20061","25"
"Gove","0","1","Kansas","5/31/20","1","0","20063","0"
"Grant","0","18","Kansas","5/31/20","18","0","20067","0"
"Gray","0","22","Kansas","5/31/20","21","1","20069","4.76"
"Greenwood","1","9","Kansas","5/31/20","3","6","20073","200"
"Hamilton","1","17","Kansas","5/31/20","10","7","20075","70"
"Harper","0","2","Kansas","5/31/20","1","1","20077","100"
"Harvey","0","11","Kansas","5/31/20","11","0","20079","0"
"Haskell","1","21","Kansas","5/31/20","17","4","20081","23.53"
"Hodgeman","1","5","Kansas","5/31/20","1","4","20083","400"
"Jackson","1","96","Kansas","5/31/20","92","4","20085","4.35"
"Jefferson","0","22","Kansas","5/31/20","21","1","20087","4.76"
"Jewell","0","4","Kansas","5/31/20","4","0","20089","0"
"Johnson","16","812","Kansas","5/31/20","698","114","20091","16.33"
"Kearny","1","45","Kansas","5/31/20","40","5","20093","12.5"
"Kiowa","0","2","Kansas","5/31/20","2","0","20097","0"
"Labette","0","22","Kansas","5/31/20","22","0","20099","0"
"Lane","0","3","Kansas","5/31/20","1","2","20101","200"
"Leavenworth","2","1082","Kansas","5/31/20","1067","15","20103","1.41"
"Linn","1","11","Kansas","5/31/20","7","4","20107","57.14"
"Lyon","4","354","Kansas","5/31/20","328","26","20111","7.93"
"Marion","0","5","Kansas","5/31/20","5","0","20115","0"
"McPherson","0","27","Kansas","5/31/20","27","0","20113","0"
"Meade","1","29","Kansas","5/31/20","24","5","20119","20.83"
"Miami","0","7","Kansas","5/31/20","6","1","20121","16.67"
"Mitchell","0","4","Kansas","5/31/20","3","1","20123","33.33"
"Montgomery","0","20","Kansas","5/31/20","20","0","20125","0"
"Morris","0","5","Kansas","5/31/20","4","1","20127","25"
"Morton","0","5","Kansas","5/31/20","4","1","20129","25"
"Nemaha","0","16","Kansas","5/31/20","13","3","20131","23.08"
"Neosho","0","2","Kansas","5/31/20","2","0","20133","0"
"Ness","0","1","Kansas","5/31/20","1","0","20135","0"
"Norton","0","2","Kansas","5/31/20","2","0","20137","0"
"Osage","0","7","Kansas","5/31/20","7","0","20139","0"
"Osborne","0","2","Kansas","5/31/20","2","0","20141","0"
"Ottawa","0","4","Kansas","5/31/20","4","0","20143","0"
"Phillips","0","2","Kansas","5/31/20","2","0","20147","0"
"Pottawatomie","0","25","Kansas","5/31/20","22","3","20149","13.64"
"Pratt","0","2","Kansas","5/31/20","1","1","20151","100"
"Reno","0","43","Kansas","5/31/20","43","0","20155","0"
"Republic","0","4","Kansas","5/31/20","4","0","20157","0"
"Rice","0","4","Kansas","5/31/20","4","0","20159","0"
"Riley","0","64","Kansas","5/31/20","61","3","20161","4.92"
"Rooks","0","6","Kansas","5/31/20","6","0","20163","0"
"Saline","0","25","Kansas","5/31/20","24","1","20169","4.17"
"Scott","0","14","Kansas","5/31/20","13","1","20171","7.69"
"Sedgwick","3","580","Kansas","5/31/20","556","24","20173","4.32"
"Seward","9","883","Kansas","5/31/20","821","62","20175","7.55"
"Shawnee","7","300","Kansas","5/31/20","254","46","20177","18.11"
"Sheridan","0","2","Kansas","5/31/20","2","0","20179","0"
"Sherman","0","7","Kansas","5/31/20","6","1","20181","16.67"
"Smith","0","2","Kansas","5/31/20","2","0","20183","0"
"Stafford","0","1","Kansas","5/31/20","1","0","20185","0"
"Stanton","0","9","Kansas","5/31/20","9","0","20187","0"
"Stevens","0","30","Kansas","5/31/20","27","3","20189","11.11"
"Sumner","0","8","Kansas","5/31/20","6","2","20191","33.33"
"Trego","0","1","Kansas","5/31/20","1","0","20195","0"
"Wabaunsee","0","31","Kansas","5/31/20","29","2","20197","6.9"
"Wilson","0","1","Kansas","5/31/20","1","0","20205","0"
"Woodson","0","6","Kansas","5/31/20","6","0","20207","0"
"Wyandotte","11","1337","Kansas","5/31/20","1263","74","20209","5.86"
"Adair","0","97","Kentucky","5/31/20","96","1","21001","1.04"
"Allen","3","70","Kentucky","5/31/20","47","23","21003","48.94"
"Anderson","0","18","Kentucky","5/31/20","15","3","21005","20"
"Ballard","0","12","Kentucky","5/31/20","9","3","21007","33.33"
"Barren","0","45","Kentucky","5/31/20","42","3","21009","7.14"
"Bath","0","9","Kentucky","5/31/20","8","1","21011","12.5"
"Bell","0","1","Kentucky","5/31/20","1","0","21013","0"
"Boone","7","436","Kentucky","5/31/20","387","49","21015","12.66"
"Bourbon","0","11","Kentucky","5/31/20","9","2","21017","22.22"
"Boyd","0","39","Kentucky","5/31/20","39","0","21019","0"
"Boyle","1","25","Kentucky","5/31/20","20","5","21021","25"
"Bracken","0","12","Kentucky","5/31/20","11","1","21023","9.09"
"Breathitt","0","3","Kentucky","5/31/20","3","0","21025","0"
"Breckinridge","0","17","Kentucky","5/31/20","16","1","21027","6.25"
"Bullitt","1","111","Kentucky","5/31/20","104","7","21029","6.73"
"Butler","1","228","Kentucky","5/31/20","218","10","21031","4.59"
"Caldwell","0","12","Kentucky","5/31/20","12","0","21033","0"
"Calloway","0","50","Kentucky","5/31/20","49","1","21035","2.04"
"Campbell","4","173","Kentucky","5/31/20","146","27","21037","18.49"
"Carlisle","0","5","Kentucky","5/31/20","5","0","21039","0"
"Carroll","1","12","Kentucky","5/31/20","7","5","21041","71.43"
"Carter","0","11","Kentucky","5/31/20","9","2","21043","22.22"
"Casey","0","3","Kentucky","5/31/20","2","1","21045","50"
"Christian","1","110","Kentucky","5/31/20","103","7","21047","6.8"
"Clark","1","41","Kentucky","5/31/20","37","4","21049","10.81"
"Clay","0","7","Kentucky","5/31/20","4","3","21051","75"
"Clinton","0","3","Kentucky","5/31/20","3","0","21053","0"
"Crittenden","0","6","Kentucky","5/31/20","5","1","21055","20"
"Cumberland","0","5","Kentucky","5/31/20","5","0","21057","0"
"Daviess","2","317","Kentucky","5/31/20","305","12","21059","3.93"
"Edmonson","0","56","Kentucky","5/31/20","54","2","21061","3.7"
"Elliott","0","1","Kentucky","5/31/20","1","0","21063","0"
"Fayette","14","714","Kentucky","5/31/20","619","95","21067","15.35"
"Fleming","0","3","Kentucky","5/31/20","2","1","21069","50"
"Floyd","0","16","Kentucky","5/31/20","16","0","21071","0"
"Franklin","2","38","Kentucky","5/31/20","24","14","21073","58.33"
"Fulton","1","7","Kentucky","5/31/20","3","4","21075","133.33"
"Gallatin","4","36","Kentucky","5/31/20","8","28","21077","350"
"Garrard","0","5","Kentucky","5/31/20","4","1","21079","25"
"Grant","1","42","Kentucky","5/31/20","36","6","21081","16.67"
"Graves","1","165","Kentucky","5/31/20","157","8","21083","5.1"
"Grayson","0","124","Kentucky","5/31/20","121","3","21085","2.48"
"Green","0","1","Kentucky","5/31/20","1","0","21087","0"
"Greenup","0","14","Kentucky","5/31/20","13","1","21089","7.69"
"Hancock","0","7","Kentucky","5/31/20","6","1","21091","16.67"
"Hardin","1","102","Kentucky","5/31/20","96","6","21093","6.25"
"Harlan","0","1","Kentucky","5/31/20","1","0","21095","0"
"Harrison","0","18","Kentucky","5/31/20","18","0","21097","0"
"Hart","0","22","Kentucky","5/31/20","20","2","21099","10"
"Henderson","2","110","Kentucky","5/31/20","95","15","21101","15.79"
"Henry","1","22","Kentucky","5/31/20","14","8","21103","57.14"
"Hickman","0","5","Kentucky","5/31/20","5","0","21105","0"
"Hopkins","0","221","Kentucky","5/31/20","218","3","21107","1.38"
"Jackson","0","61","Kentucky","5/31/20","60","1","21109","1.67"
"Jefferson","55","2437","Kentucky","5/31/20","2050","387","21111","18.88"
"Jessamine","2","62","Kentucky","5/31/20","51","11","21113","21.57"
"Johnson","0","5","Kentucky","5/31/20","5","0","21115","0"
"Kenton","8","585","Kentucky","5/31/20","527","58","21117","11.01"
"Knott","0","4","Kentucky","5/31/20","4","0","21119","0"
"Knox","0","8","Kentucky","5/31/20","8","0","21121","0"
"Larue","0","8","Kentucky","5/31/20","7","1","21123","14.29"
"Laurel","0","21","Kentucky","5/31/20","21","0","21125","0"
"Lawrence","0","2","Kentucky","5/31/20","1","1","21127","100"
"Lee","0","1","Kentucky","5/31/20","0","1","21129","1"
"Leslie","0","6","Kentucky","5/31/20","6","0","21131","0"
"Letcher","0","4","Kentucky","5/31/20","4","0","21133","0"
"Lewis","0","7","Kentucky","5/31/20","7","0","21135","0"
"Lincoln","0","8","Kentucky","5/31/20","8","0","21137","0"
"Livingston","0","9","Kentucky","5/31/20","8","1","21139","12.5"
"Logan","4","145","Kentucky","5/31/20","115","30","21141","26.09"
"Lyon","0","15","Kentucky","5/31/20","14","1","21143","7.14"
"Madison","1","55","Kentucky","5/31/20","45","10","21151","22.22"
"Magoffin","0","2","Kentucky","5/31/20","2","0","21153","0"
"Marion","0","21","Kentucky","5/31/20","18","3","21155","16.67"
"Marshall","0","38","Kentucky","5/31/20","37","1","21157","2.7"
"Martin","0","3","Kentucky","5/31/20","3","0","21159","0"
"Mason","0","9","Kentucky","5/31/20","8","1","21161","12.5"
"McCracken","1","95","Kentucky","5/31/20","87","8","21145","9.2"
"McCreary","0","13","Kentucky","5/31/20","13","0","21147","0"
"McLean","0","22","Kentucky","5/31/20","19","3","21149","15.79"
"Meade","0","22","Kentucky","5/31/20","21","1","21163","4.76"
"Menifee","0","10","Kentucky","5/31/20","8","2","21165","25"
"Mercer","0","13","Kentucky","5/31/20","12","1","21167","8.33"
"Metcalfe","0","6","Kentucky","5/31/20","4","2","21169","50"
"Monroe","0","17","Kentucky","5/31/20","14","3","21171","21.43"
"Montgomery","0","24","Kentucky","5/31/20","21","3","21173","14.29"
"Morgan","0","1","Kentucky","5/31/20","1","0","21175","0"
"Muhlenberg","2","483","Kentucky","5/31/20","471","12","21177","2.55"
"Nelson","1","41","Kentucky","5/31/20","35","6","21179","17.14"
"Nicholas","0","3","Kentucky","5/31/20","1","2","21181","200"
"Ohio","3","144","Kentucky","5/31/20","120","24","21183","20"
"Oldham","3","83","Kentucky","5/31/20","60","23","21185","38.33"
"Owen","0","2","Kentucky","5/31/20","1","1","21187","100"
"Owsley","0","2","Kentucky","5/31/20","2","0","21189","0"
"Pendleton","0","9","Kentucky","5/31/20","7","2","21191","28.57"
"Perry","0","19","Kentucky","5/31/20","19","0","21193","0"
"Pike","0","29","Kentucky","5/31/20","28","1","21195","3.57"
"Powell","0","1","Kentucky","5/31/20","1","0","21197","0"
"Pulaski","0","58","Kentucky","5/31/20","55","3","21199","5.45"
"Rockcastle","0","13","Kentucky","5/31/20","13","0","21203","0"
"Rowan","0","7","Kentucky","5/31/20","7","0","21205","0"
"Russell","0","24","Kentucky","5/31/20","22","2","21207","9.09"
"Scott","0","35","Kentucky","5/31/20","34","1","21209","2.94"
"Shelby","10","164","Kentucky","5/31/20","92","72","21211","78.26"
"Simpson","1","52","Kentucky","5/31/20","44","8","21213","18.18"
"Spencer","1","22","Kentucky","5/31/20","16","6","21215","37.5"
"Taylor","0","11","Kentucky","5/31/20","11","0","21217","0"
"Todd","0","17","Kentucky","5/31/20","16","1","21219","6.25"
"Trigg","0","10","Kentucky","5/31/20","9","1","21221","11.11"
"Trimble","0","6","Kentucky","5/31/20","5","1","21223","20"
"Union","0","11","Kentucky","5/31/20","10","1","21225","10"
"Warren","12","1007","Kentucky","5/31/20","920","87","21227","9.46"
"Washington","0","6","Kentucky","5/31/20","6","0","21229","0"
"Wayne","0","8","Kentucky","5/31/20","8","0","21231","0"
"Webster","0","32","Kentucky","5/31/20","32","0","21233","0"
"Whitley","0","13","Kentucky","5/31/20","13","0","21235","0"
"Wolfe","0","1","Kentucky","5/31/20","1","0","21237","0"
"Woodford","0","27","Kentucky","5/31/20","25","2","21239","8"
"Acadia","18","418","Louisiana","5/31/20","291","127","22001","43.64"
"Allen","0","184","Louisiana","5/31/20","182","2","22003","1.1"
"Ascension","5","820","Louisiana","5/31/20","786","34","22005","4.33"
"Assumption","2","252","Louisiana","5/31/20","238","14","22007","5.88"
"Avoyelles","3","128","Louisiana","5/31/20","104","24","22009","23.08"
"Beauregard","1","66","Louisiana","5/31/20","56","10","22011","17.86"
"Bienville","1","146","Louisiana","5/31/20","137","9","22013","6.57"
"Bossier","5","415","Louisiana","5/31/20","382","33","22015","8.64"
"Caddo","36","2562","Louisiana","5/31/20","2312","250","22017","10.81"
"Calcasieu","4","599","Louisiana","5/31/20","568","31","22019","5.46"
"Caldwell","0","54","Louisiana","5/31/20","52","2","22021","3.85"
"Cameron","0","6","Louisiana","5/31/20","3","3","22023","100"
"Catahoula","0","113","Louisiana","5/31/20","112","1","22025","0.89"
"Claiborne","1","66","Louisiana","5/31/20","61","5","22027","8.2"
"Concordia","3","87","Louisiana","5/31/20","69","18","22029","26.09"
"De Soto","1","247","Louisiana","5/31/20","237","10","22031","4.22"
"East Baton Rouge","33","3618","Louisiana","5/31/20","3386","232","22033","6.85"
"East Carroll","12","148","Louisiana","5/31/20","65","83","22035","127.69"
"East Feliciana","1","194","Louisiana","5/31/20","187","7","22037","3.74"
"Evangeline","-12","78","Louisiana","5/31/20","165","-87","22039","-52.73"
"Franklin","6","332","Louisiana","5/31/20","288","44","22041","15.28"
"Grant","0","28","Louisiana","5/31/20","26","2","22043","7.69"
"Iberia","3","408","Louisiana","5/31/20","388","20","22045","5.15"
"Iberville","3","567","Louisiana","5/31/20","546","21","22047","3.85"
"Jackson","3","106","Louisiana","5/31/20","83","23","22049","27.71"
"Jefferson","48","7584","Louisiana","5/31/20","7248","336","22051","4.64"
"Jefferson Davis","0","76","Louisiana","5/31/20","73","3","22053","4.11"
"Lafayette","16","768","Louisiana","5/31/20","659","109","22055","16.54"
"Lafourche","8","821","Louisiana","5/31/20","766","55","22057","7.18"
"LaSalle","1","51","Louisiana","5/31/20","45","6","22059","13.33"
"Lincoln","3","157","Louisiana","5/31/20","133","24","22061","18.05"
"Livingston","7","422","Louisiana","5/31/20","375","47","22063","12.53"
"Madison","6","97","Louisiana","5/31/20","55","42","22065","76.36"
"Morehouse","2","122","Louisiana","5/31/20","111","11","22067","9.91"
"Natchitoches","3","169","Louisiana","5/31/20","147","22","22069","14.97"
"Orleans","25","7127","Louisiana","5/31/20","6953","174","22071","2.5"
"Ouachita","29","1248","Louisiana","5/31/20","1045","203","22073","19.43"
"Plaquemines","2","211","Louisiana","5/31/20","200","11","22075","5.5"
"Pointe Coupee","2","197","Louisiana","5/31/20","182","15","22077","8.24"
"Rapides","26","790","Louisiana","5/31/20","606","184","22079","30.36"
"Red River","0","50","Louisiana","5/31/20","47","3","22081","6.38"
"Richland","3","135","Louisiana","5/31/20","114","21","22083","18.42"
"Sabine","1","46","Louisiana","5/31/20","40","6","22085","15"
"St. Bernard","2","536","Louisiana","5/31/20","521","15","22087","2.88"
"St. Charles","2","638","Louisiana","5/31/20","623","15","22089","2.41"
"St. Helena","1","51","Louisiana","5/31/20","44","7","22091","15.91"
"St. James","1","294","Louisiana","5/31/20","289","5","22093","1.73"
"St. John the Baptist","3","860","Louisiana","5/31/20","841","19","22095","2.26"
"St. Landry","1","257","Louisiana","5/31/20","247","10","22097","4.05"
"St. Martin","1","298","Louisiana","5/31/20","288","10","22099","3.47"
"St. Mary","3","319","Louisiana","5/31/20","295","24","22101","8.14"
"St. Tammany","19","1749","Louisiana","5/31/20","1618","131","22103","8.1"
"Tangipahoa","11","858","Louisiana","5/31/20","784","74","22105","9.44"
"Tensas","0","11","Louisiana","5/31/20","10","1","22107","10"
"Terrebonne","7","679","Louisiana","5/31/20","628","51","22109","8.12"
"Union","4","317","Louisiana","5/31/20","287","30","22111","10.45"
"Vermilion","0","53","Louisiana","5/31/20","50","3","22113","6"
"Vernon","0","26","Louisiana","5/31/20","23","3","22115","13.04"
"Washington","5","425","Louisiana","5/31/20","389","36","22117","9.25"
"Webster","2","147","Louisiana","5/31/20","136","11","22119","8.09"
"West Baton Rouge","2","166","Louisiana","5/31/20","154","12","22121","7.79"
"West Carroll","4","62","Louisiana","5/31/20","33","29","22123","87.88"
"West Feliciana","2","209","Louisiana","5/31/20","196","13","22125","6.63"
"Winn","7","164","Louisiana","5/31/20","112","52","22127","46.43"
"Androscoggin","9","298","Maine","5/31/20","233","65","23001","27.9"
"Aroostook","0","10","Maine","5/31/20","8","2","23003","25"
"Cumberland","20","1175","Maine","5/31/20","1032","143","23005","13.86"
"Franklin","0","36","Maine","5/31/20","36","0","23007","0"
"Hancock","0","11","Maine","5/31/20","11","0","23009","0"
"Kennebec","0","128","Maine","5/31/20","128","0","23011","0"
"Knox","0","20","Maine","5/31/20","20","0","23013","0"
"Lincoln","0","20","Maine","5/31/20","20","0","23015","0"
"Oxford","2","34","Maine","5/31/20","21","13","23017","61.9"
"Penobscot","0","100","Maine","5/31/20","98","2","23019","2.04"
"Piscataquis","0","1","Maine","5/31/20","1","0","23021","0"
"Sagadahoc","0","30","Maine","5/31/20","28","2","23023","7.14"
"Somerset","0","22","Maine","5/31/20","21","1","23025","4.76"
"Waldo","0","51","Maine","5/31/20","51","0","23027","0"
"Washington","0","2","Maine","5/31/20","2","0","23029","0"
"York","6","385","Maine","5/31/20","344","41","23031","11.92"
"Allegany","1","178","Maryland","5/31/20","170","8","24001","4.71"
"Anne Arundel","68","3785","Maryland","5/31/20","3307","478","24003","14.45"
"Baltimore","99","6065","Maryland","5/31/20","5373","692","24005","12.88"
"Baltimore City","126","5664","Maryland","5/31/20","4782","882","24510","18.44"
"Calvert","5","341","Maryland","5/31/20","304","37","24009","12.17"
"Caroline","3","259","Maryland","5/31/20","240","19","24011","7.92"
"Carroll","19","913","Maryland","5/31/20","783","130","24013","16.6"
"Cecil","4","371","Maryland","5/31/20","345","26","24015","7.54"
"Charles","17","1108","Maryland","5/31/20","989","119","24017","12.03"
"Dorchester","2","142","Maryland","5/31/20","127","15","24019","11.81"
"Frederick","31","1911","Maryland","5/31/20","1696","215","24021","12.68"
"Garrett","0","10","Maryland","5/31/20","7","3","24023","42.86"
"Harford","15","882","Maryland","5/31/20","780","102","24025","13.08"
"Howard","37","1928","Maryland","5/31/20","1667","261","24027","15.66"
"Kent","3","173","Maryland","5/31/20","152","21","24029","13.82"
"Montgomery","206","11361","Maryland","5/31/20","9922","1439","24031","14.5"
"Prince George's","243","15220","Maryland","5/31/20","13521","1699","24033","12.57"
"Queen Anne's","2","160","Maryland","5/31/20","146","14","24035","9.59"
"Somerset","0","73","Maryland","5/31/20","72","1","24039","1.39"
"St. Mary's","15","499","Maryland","5/31/20","393","106","24037","26.97"
"Talbot","3","99","Maryland","5/31/20","79","20","24041","25.32"
"Washington","9","469","Maryland","5/31/20","408","61","24043","14.95"
"Wicomico","12","953","Maryland","5/31/20","867","86","24045","9.92"
"Worcester","4","214","Maryland","5/31/20","183","31","24047","16.94"
"Barnstable","8","1420","Massachusetts","5/31/20","1363","57","25001","4.18"
"Berkshire","4","567","Massachusetts","5/31/20","541","26","25003","4.81"
"Bristol","83","7322","Massachusetts","5/31/20","6741","581","25005","8.62"
"Dukes and Nantucket","0","53","Massachusetts","5/31/20","52","1","00000","1.92"
"Essex","118","14658","Massachusetts","5/31/20","13833","825","25009","5.96"
"Franklin","1","335","Massachusetts","5/31/20","325","10","25011","3.08"
"Hampden","52","6165","Massachusetts","5/31/20","5804","361","25013","6.22"
"Hampshire","4","885","Massachusetts","5/31/20","858","27","25015","3.15"
"Middlesex","141","22150","Massachusetts","5/31/20","21162","988","25017","4.67"
"Norfolk","46","8568","Massachusetts","5/31/20","8249","319","25021","3.87"
"Plymouth","46","8171","Massachusetts","5/31/20","7850","321","25023","4.09"
"Suffolk","85","18533","Massachusetts","5/31/20","17937","596","25025","3.32"
"Worcester","94","11307","Massachusetts","5/31/20","10649","658","25027","6.18"
"Alcona","1","18","Michigan","5/31/20","14","4","26001","28.57"
"Allegan","2","255","Michigan","5/31/20","244","11","26005","4.51"
"Alpena","0","101","Michigan","5/31/20","102","-1","26007","-0.98"
"Antrim","0","13","Michigan","5/31/20","12","1","26009","8.33"
"Arenac","0","38","Michigan","5/31/20","36","2","26011","5.56"
"Baraga","0","1","Michigan","5/31/20","1","0","26013","0"
"Barry","1","80","Michigan","5/31/20","76","4","26015","5.26"
"Bay","4","346","Michigan","5/31/20","318","28","26017","8.81"
"Benzie","0","4","Michigan","5/31/20","4","0","26019","0"
"Berrien","7","761","Michigan","5/31/20","715","46","26021","6.43"
"Branch","3","133","Michigan","5/31/20","110","23","26023","20.91"
"Calhoun","5","416","Michigan","5/31/20","379","37","26025","9.76"
"Cass","1","96","Michigan","5/31/20","88","8","26027","9.09"
"Charlevoix","0","18","Michigan","5/31/20","17","1","26029","5.88"
"Cheboygan","0","26","Michigan","5/31/20","26","0","26031","0"
"Chippewa","0","3","Michigan","5/31/20","3","0","26033","0"
"Clare","0","20","Michigan","5/31/20","18","2","26035","11.11"
"Clinton","1","175","Michigan","5/31/20","169","6","26037","3.55"
"Crawford","0","62","Michigan","5/31/20","62","0","26039","0"
"Delta","0","20","Michigan","5/31/20","20","0","26041","0"
"Dickinson","0","5","Michigan","5/31/20","5","0","26043","0"
"Eaton","3","244","Michigan","5/31/20","225","19","26045","8.44"
"Emmet","0","26","Michigan","5/31/20","25","1","26047","4"
"Federal Correctional Institution (FCI)","2","146","Michigan","5/31/20","132","14","00000","10.61"
"Genesee","15","2459","Michigan","5/31/20","2351","108","26049","4.59"
"Gladwin","0","18","Michigan","5/31/20","18","0","26051","0"
"Gogebic","0","5","Michigan","5/31/20","5","0","26053","0"
"Grand Traverse","1","28","Michigan","5/31/20","24","4","26055","16.67"
"Gratiot","1","83","Michigan","5/31/20","78","5","26057","6.41"
"Hillsdale","0","176","Michigan","5/31/20","174","2","26059","1.15"
"Houghton","1","6","Michigan","5/31/20","2","4","26061","200"
"Huron","1","56","Michigan","5/31/20","50","6","26063","12"
"Ingham","6","775","Michigan","5/31/20","731","44","26065","6.02"
"Ionia","1","166","Michigan","5/31/20","161","5","26067","3.11"
"Iosco","2","109","Michigan","5/31/20","92","17","26069","18.48"
"Isabella","0","92","Michigan","5/31/20","89","3","26073","3.37"
"Jackson","2","470","Michigan","5/31/20","457","13","26075","2.84"
"Kalamazoo","7","894","Michigan","5/31/20","843","51","26077","6.05"
"Kalkaska","0","30","Michigan","5/31/20","30","0","26079","0"
"Kent","55","3953","Michigan","5/31/20","3571","382","26081","10.7"
"Lake","0","7","Michigan","5/31/20","6","1","26085","16.67"
"Lapeer","1","217","Michigan","5/31/20","213","4","26087","1.88"
"Leelanau","0","11","Michigan","5/31/20","11","0","26089","0"
"Lenawee","1","186","Michigan","5/31/20","179","7","26091","3.91"
"Livingston","2","493","Michigan","5/31/20","478","15","26093","3.14"
"Luce","0","3","Michigan","5/31/20","3","0","26095","0"
"Mackinac","0","8","Michigan","5/31/20","6","2","26097","33.33"
"Macomb","31","6842","Michigan","5/31/20","6628","214","26099","3.23"
"Manistee","0","12","Michigan","5/31/20","12","0","26101","0"
"Marquette","0","56","Michigan","5/31/20","54","2","26103","3.7"
"Mason","0","38","Michigan","5/31/20","37","1","26105","2.7"
"Mecosta","0","24","Michigan","5/31/20","22","2","26107","9.09"
"Menominee","0","8","Michigan","5/31/20","8","0","26109","0"
"Michigan Department of Corrections (MDOC)","90","4037","Michigan","5/31/20","3406","631","00000","18.53"
"Midland","1","121","Michigan","5/31/20","116","5","26111","4.31"
"Missaukee","0","22","Michigan","5/31/20","22","0","26113","0"
"Monroe","3","530","Michigan","5/31/20","508","22","26115","4.33"
"Montcalm","0","72","Michigan","5/31/20","71","1","26117","1.41"
"Montmorency","0","5","Michigan","5/31/20","5","0","26119","0"
"Muskegon","8","652","Michigan","5/31/20","594","58","26121","9.76"
"Newaygo","2","110","Michigan","5/31/20","94","16","26123","17.02"
"Oakland","77","10781","Michigan","5/31/20","10244","537","26125","5.24"
"Oceana","0","93","Michigan","5/31/20","90","3","26127","3.33"
"Ogemaw","0","29","Michigan","5/31/20","28","1","26129","3.57"
"Osceola","0","15","Michigan","5/31/20","13","2","26133","15.38"
"Oscoda","0","8","Michigan","5/31/20","8","0","26135","0"
"Otsego","0","120","Michigan","5/31/20","118","2","26137","1.69"
"Ottawa","11","840","Michigan","5/31/20","760","80","26139","10.53"
"Out of MI","-3","42","Michigan","5/31/20","63","-21","80026","-33.33"
"Presque Isle","0","11","Michigan","5/31/20","11","0","26141","0"
"Roscommon","0","24","Michigan","5/31/20","23","1","26143","4.35"
"Saginaw","7","1063","Michigan","5/31/20","1011","52","26145","5.14"
"Sanilac","0","42","Michigan","5/31/20","41","1","26151","2.44"
"Schoolcraft","0","4","Michigan","5/31/20","4","0","26153","0"
"Shiawassee","1","261","Michigan","5/31/20","254","7","26155","2.76"
"St. Clair","3","510","Michigan","5/31/20","491","19","26147","3.87"
"St. Joseph","3","123","Michigan","5/31/20","105","18","26149","17.14"
"Tuscola","0","190","Michigan","5/31/20","188","2","26157","1.06"
"Van Buren","3","165","Michigan","5/31/20","142","23","26159","16.2"
"Washtenaw","8","1513","Michigan","5/31/20","1454","59","26161","4.06"
"Wayne","100","21079","Michigan","5/31/20","20380","699","26163","3.43"
"Wexford","0","13","Michigan","5/31/20","13","0","26165","0"
"Aitkin","0","8","Minnesota","5/31/20","6","2","27001","33.33"
"Anoka","34","1399","Minnesota","5/31/20","1164","235","27003","20.19"
"Becker","1","40","Minnesota","5/31/20","32","8","27005","25"
"Beltrami","0","15","Minnesota","5/31/20","12","3","27007","25"
"Benton","2","177","Minnesota","5/31/20","166","11","27009","6.63"
"Big Stone","0","5","Minnesota","5/31/20","3","2","27011","66.67"
"Blue Earth","4","140","Minnesota","5/31/20","112","28","27013","25"
"Brown","1","16","Minnesota","5/31/20","11","5","27015","45.45"
"Carlton","0","73","Minnesota","5/31/20","73","0","27017","0"
"Carver","7","210","Minnesota","5/31/20","161","49","27019","30.43"
"Cass","0","14","Minnesota","5/31/20","11","3","27021","27.27"
"Chippewa","2","51","Minnesota","5/31/20","40","11","27023","27.5"
"Chisago","2","61","Minnesota","5/31/20","48","13","27025","27.08"
"Clay","8","423","Minnesota","5/31/20","366","57","27027","15.57"
"Clearwater","0","3","Minnesota","5/31/20","2","1","27029","50"
"Cottonwood","2","75","Minnesota","5/31/20","62","13","27033","20.97"
"Crow Wing","4","71","Minnesota","5/31/20","42","29","27035","69.05"
"Dakota","38","1327","Minnesota","5/31/20","1059","268","27037","25.31"
"Dodge","1","52","Minnesota","5/31/20","43","9","27039","20.93"
"Douglas","2","42","Minnesota","5/31/20","29","13","27041","44.83"
"Faribault","1","18","Minnesota","5/31/20","11","7","27043","63.64"
"Fillmore","0","17","Minnesota","5/31/20","17","0","27045","0"
"Freeborn","5","117","Minnesota","5/31/20","84","33","27047","39.29"
"Goodhue","2","66","Minnesota","5/31/20","52","14","27049","26.92"
"Grant","0","4","Minnesota","5/31/20","2","2","27051","100"
"Hennepin","211","8393","Minnesota","5/31/20","6918","1475","27053","21.32"
"Houston","0","2","Minnesota","5/31/20","2","0","27055","0"
"Hubbard","0","2","Minnesota","5/31/20","1","1","27057","100"
"Isanti","1","35","Minnesota","5/31/20","25","10","27059","40"
"Itasca","0","54","Minnesota","5/31/20","52","2","27061","3.85"
"Jackson","0","39","Minnesota","5/31/20","39","0","27063","0"
"Kanabec","0","11","Minnesota","5/31/20","11","0","27065","0"
"Kandiyohi","6","496","Minnesota","5/31/20","454","42","27067","9.25"
"Kittson","0","1","Minnesota","5/31/20","1","0","27069","0"
"Koochiching","0","8","Minnesota","5/31/20","5","3","27071","60"
"Lac qui Parle","0","3","Minnesota","5/31/20","3","0","27073","0"
"Lake","0","1","Minnesota","5/31/20","1","0","27075","0"
"Le Sueur","0","44","Minnesota","5/31/20","41","3","27079","7.32"
"Lincoln","0","5","Minnesota","5/31/20","5","0","27081","0"
"Lyon","4","56","Minnesota","5/31/20","31","25","27083","80.65"
"Mahnomen","0","6","Minnesota","5/31/20","5","1","27087","20"
"Marshall","1","12","Minnesota","5/31/20","8","4","27089","50"
"Martin","1","130","Minnesota","5/31/20","124","6","27091","4.84"
"McLeod","2","37","Minnesota","5/31/20","26","11","27085","42.31"
"Meeker","0","45","Minnesota","5/31/20","42","3","27093","7.14"
"Mille Lacs","0","19","Minnesota","5/31/20","16","3","27095","18.75"
"Morrison","1","46","Minnesota","5/31/20","38","8","27097","21.05"
"Mower","24","318","Minnesota","5/31/20","150","168","27099","112"
"Murray","1","39","Minnesota","5/31/20","35","4","27101","11.43"
"Nicollet","3","87","Minnesota","5/31/20","68","19","27103","27.94"
"Nobles","12","1539","Minnesota","5/31/20","1457","82","27105","5.63"
"Norman","0","13","Minnesota","5/31/20","11","2","27107","18.18"
"Olmsted","11","626","Minnesota","5/31/20","551","75","27109","13.61"
"Otter Tail","2","68","Minnesota","5/31/20","55","13","27111","23.64"
"Pennington","2","19","Minnesota","5/31/20","7","12","27113","171.43"
"Pine","1","89","Minnesota","5/31/20","85","4","27115","4.71"
"Pipestone","0","12","Minnesota","5/31/20","10","2","27117","20"
"Polk","0","61","Minnesota","5/31/20","58","3","27119","5.17"
"Pope","0","9","Minnesota","5/31/20","7","2","27121","28.57"
"Ramsey","100","3019","Minnesota","5/31/20","2316","703","27123","30.35"
"Red Lake","0","4","Minnesota","5/31/20","3","1","27125","33.33"
"Redwood","0","5","Minnesota","5/31/20","3","2","27127","66.67"
"Renville","0","5","Minnesota","5/31/20","5","0","27129","0"
"Rice","14","462","Minnesota","5/31/20","365","97","27131","26.58"
"Rock","0","22","Minnesota","5/31/20","21","1","27133","4.76"
"Roseau","0","2","Minnesota","5/31/20","1","1","27135","100"
"Scott","11","426","Minnesota","5/31/20","346","80","27139","23.12"
"Sherburne","5","243","Minnesota","5/31/20","208","35","27141","16.83"
"Sibley","1","16","Minnesota","5/31/20","12","4","27143","33.33"
"St. Louis","1","118","Minnesota","5/31/20","111","7","27137","6.31"
"Stearns","14","2021","Minnesota","5/31/20","1923","98","27145","5.1"
"Steele","3","158","Minnesota","5/31/20","140","18","27147","12.86"
"Stevens","0","1","Minnesota","5/31/20","0","1","27149","1"
"Swift","0","18","Minnesota","5/31/20","15","3","27151","20"
"Todd","17","316","Minnesota","5/31/20","197","119","27153","60.41"
"Traverse","0","3","Minnesota","5/31/20","3","0","27155","0"
"Wabasha","0","18","Minnesota","5/31/20","16","2","27157","12.5"
"Wadena","1","10","Minnesota","5/31/20","6","4","27159","66.67"
"Waseca","0","26","Minnesota","5/31/20","24","2","27161","8.33"
"Washington","19","636","Minnesota","5/31/20","506","130","27163","25.69"
"Watonwan","3","74","Minnesota","5/31/20","50","24","27165","48"
"Wilkin","0","11","Minnesota","5/31/20","11","0","27167","0"
"Winona","0","79","Minnesota","5/31/20","77","2","27169","2.6"
"Wright","10","313","Minnesota","5/31/20","240","73","27171","30.42"
"Yellow Medicine","0","6","Minnesota","5/31/20","5","1","27173","20"
"Adams","2","199","Mississippi","5/31/20","186","13","28001","6.99"
"Alcorn","0","17","Mississippi","5/31/20","15","2","28003","13.33"
"Amite","2","64","Mississippi","5/31/20","52","12","28005","23.08"
"Attala","4","298","Mississippi","5/31/20","270","28","28007","10.37"
"Benton","0","15","Mississippi","5/31/20","14","1","28009","7.14"
"Bolivar","3","162","Mississippi","5/31/20","140","22","28011","15.71"
"Calhoun","1","65","Mississippi","5/31/20","60","5","28013","8.33"
"Carroll","1","117","Mississippi","5/31/20","113","4","28015","3.54"
"Chickasaw","1","135","Mississippi","5/31/20","126","9","28017","7.14"
"Choctaw","2","43","Mississippi","5/31/20","29","14","28019","48.28"
"Claiborne","8","111","Mississippi","5/31/20","58","53","28021","91.38"
"Clarke","3","144","Mississippi","5/31/20","126","18","28023","14.29"
"Clay","2","112","Mississippi","5/31/20","99","13","28025","13.13"
"Coahoma","4","125","Mississippi","5/31/20","98","27","28027","27.55"
"Copiah","5","312","Mississippi","5/31/20","278","34","28029","12.23"
"Covington","5","165","Mississippi","5/31/20","127","38","28031","29.92"
"DeSoto","12","542","Mississippi","5/31/20","461","81","28033","17.57"
"Forrest","12","564","Mississippi","5/31/20","480","84","28035","17.5"
"Franklin","1","29","Mississippi","5/31/20","25","4","28037","16"
"George","1","25","Mississippi","5/31/20","19","6","28039","31.58"
"Greene","1","13","Mississippi","5/31/20","7","6","28041","85.71"
"Grenada","3","94","Mississippi","5/31/20","75","19","28043","25.33"
"Hancock","1","91","Mississippi","5/31/20","87","4","28045","4.6"
"Harrison","3","258","Mississippi","5/31/20","234","24","28047","10.26"
"Hinds","16","1006","Mississippi","5/31/20","893","113","28049","12.65"
"Holmes","9","429","Mississippi","5/31/20","365","64","28051","17.53"
"Humphreys","1","60","Mississippi","5/31/20","53","7","28053","13.21"
"Itawamba","0","87","Mississippi","5/31/20","85","2","28057","2.35"
"Jackson","2","308","Mississippi","5/31/20","296","12","28059","4.05"
"Jasper","3","163","Mississippi","5/31/20","139","24","28061","17.27"
"Jefferson","0","42","Mississippi","5/31/20","40","2","28063","5"
"Jefferson Davis","1","77","Mississippi","5/31/20","71","6","28065","8.45"
"Jones","23","629","Mississippi","5/31/20","467","162","28067","34.69"
"Kemper","3","144","Mississippi","5/31/20","125","19","28069","15.2"
"Lafayette","2","136","Mississippi","5/31/20","123","13","28071","10.57"
"Lamar","3","238","Mississippi","5/31/20","219","19","28073","8.68"
"Lauderdale","9","738","Mississippi","5/31/20","678","60","28075","8.85"
"Lawrence","2","102","Mississippi","5/31/20","90","12","28077","13.33"
"Leake","6","427","Mississippi","5/31/20","384","43","28079","11.2"
"Lee","7","153","Mississippi","5/31/20","104","49","28081","47.12"
"Leflore","3","264","Mississippi","5/31/20","240","24","28083","10"
"Lincoln","3","263","Mississippi","5/31/20","243","20","28085","8.23"
"Lowndes","7","211","Mississippi","5/31/20","160","51","28087","31.88"
"Madison","10","724","Mississippi","5/31/20","654","70","28089","10.7"
"Marion","1","115","Mississippi","5/31/20","108","7","28091","6.48"
"Marshall","2","83","Mississippi","5/31/20","69","14","28093","20.29"
"Monroe","2","257","Mississippi","5/31/20","242","15","28095","6.2"
"Montgomery","1","85","Mississippi","5/31/20","78","7","28097","8.97"
"Neshoba","19","646","Mississippi","5/31/20","512","134","28099","26.17"
"Newton","7","271","Mississippi","5/31/20","224","47","28101","20.98"
"Noxubee","4","186","Mississippi","5/31/20","158","28","28103","17.72"
"Oktibbeha","15","239","Mississippi","5/31/20","134","105","28105","78.36"
"Panola","1","71","Mississippi","5/31/20","62","9","28107","14.52"
"Pearl River","1","209","Mississippi","5/31/20","203","6","28109","2.96"
"Perry","1","50","Mississippi","5/31/20","46","4","28111","8.7"
"Pike","1","203","Mississippi","5/31/20","196","7","28113","3.57"
"Pontotoc","1","35","Mississippi","5/31/20","26","9","28115","34.62"
"Prentiss","2","53","Mississippi","5/31/20","38","15","28117","39.47"
"Quitman","1","33","Mississippi","5/31/20","24","9","28119","37.5"
"Rankin","13","439","Mississippi","5/31/20","349","90","28121","25.79"
"Scott","9","650","Mississippi","5/31/20","589","61","28123","10.36"
"Sharkey","0","7","Mississippi","5/31/20","7","0","28125","0"
"Simpson","2","101","Mississippi","5/31/20","85","16","28127","18.82"
"Smith","3","152","Mississippi","5/31/20","131","21","28129","16.03"
"Stone","0","30","Mississippi","5/31/20","30","0","28131","0"
"Sunflower","1","84","Mississippi","5/31/20","77","7","28133","9.09"
"Tallahatchie","0","27","Mississippi","5/31/20","24","3","28135","12.5"
"Tate","5","94","Mississippi","5/31/20","59","35","28137","59.32"
"Tippah","0","73","Mississippi","5/31/20","70","3","28139","4.29"
"Tishomingo","1","32","Mississippi","5/31/20","25","7","28141","28"
"Tunica","1","55","Mississippi","5/31/20","48","7","28143","14.58"
"Union","2","83","Mississippi","5/31/20","71","12","28145","16.9"
"Walthall","1","56","Mississippi","5/31/20","51","5","28147","9.8"
"Warren","3","173","Mississippi","5/31/20","150","23","28149","15.33"
"Washington","4","178","Mississippi","5/31/20","153","25","28151","16.34"
"Wayne","14","204","Mississippi","5/31/20","109","95","28153","87.16"
"Webster","6","69","Mississippi","5/31/20","27","42","28155","155.56"
"Wilkinson","1","88","Mississippi","5/31/20","82","6","28157","7.32"
"Winston","3","117","Mississippi","5/31/20","98","19","28159","19.39"
"Yalobusha","2","93","Mississippi","5/31/20","82","11","28161","13.41"
"Yazoo","9","281","Mississippi","5/31/20","215","66","28163","30.7"
"Adair","2","55","Missouri","5/31/20","41","14","29001","34.15"
"Andrew","1","30","Missouri","5/31/20","23","7","29003","30.43"
"Atchison","0","3","Missouri","5/31/20","3","0","29005","0"
"Audrain","4","82","Missouri","5/31/20","56","26","29007","46.43"
"Barry","0","9","Missouri","5/31/20","9","0","29009","0"
"Bates","0","7","Missouri","5/31/20","7","0","29013","0"
"Benton","0","11","Missouri","5/31/20","10","1","29015","10"
"Bollinger","0","6","Missouri","5/31/20","6","0","29017","0"
"Boone","5","152","Missouri","5/31/20","116","36","29019","31.03"
"Buchanan","11","692","Missouri","5/31/20","617","75","29021","12.16"
"Butler","1","35","Missouri","5/31/20","28","7","29023","25"
"Caldwell","0","5","Missouri","5/31/20","5","0","29025","0"
"Callaway","1","29","Missouri","5/31/20","24","5","29027","20.83"
"Camden","0","38","Missouri","5/31/20","38","0","29029","0"
"Cape Girardeau","2","73","Missouri","5/31/20","59","14","29031","23.73"
"Carroll","0","8","Missouri","5/31/20","7","1","29033","14.29"
"Carter","0","5","Missouri","5/31/20","5","0","29035","0"
"Cass","2","90","Missouri","5/31/20","79","11","29037","13.92"
"Cedar","0","9","Missouri","5/31/20","9","0","29039","0"
"Chariton","0","6","Missouri","5/31/20","6","0","29041","0"
"Christian","0","23","Missouri","5/31/20","21","2","29043","9.52"
"Clark","0","1","Missouri","5/31/20","1","0","29045","0"
"Clay","3","173","Missouri","5/31/20","149","24","29047","16.11"
"Clinton","0","18","Missouri","5/31/20","18","0","29049","0"
"Cole","0","60","Missouri","5/31/20","59","1","29051","1.69"
"Cooper","0","9","Missouri","5/31/20","9","0","29053","0"
"Crawford","0","9","Missouri","5/31/20","9","0","29055","0"
"Dallas","0","3","Missouri","5/31/20","3","0","29059","0"
"Daviess","0","4","Missouri","5/31/20","4","0","29061","0"
"DeKalb","0","6","Missouri","5/31/20","5","1","29063","20"
"Dunklin","1","38","Missouri","5/31/20","28","10","29069","35.71"
"Franklin","0","139","Missouri","5/31/20","138","1","29071","0.72"
"Gasconade","0","2","Missouri","5/31/20","2","0","29073","0"
"Gentry","2","31","Missouri","5/31/20","17","14","29075","82.35"
"Greene","4","151","Missouri","5/31/20","122","29","29077","23.77"
"Harrison","0","9","Missouri","5/31/20","8","1","29081","12.5"
"Henry","0","12","Missouri","5/31/20","10","2","29083","20"
"Holt","0","2","Missouri","5/31/20","1","1","29087","100"
"Howard","0","3","Missouri","5/31/20","3","0","29089","0"
"Howell","0","7","Missouri","5/31/20","5","2","29091","40"
"Iron","0","2","Missouri","5/31/20","2","0","29093","0"
"Jackson","11","596","Missouri","5/31/20","517","79","29095","15.28"
"Jasper","1","37","Missouri","5/31/20","32","5","29097","15.62"
"Jefferson","2","349","Missouri","5/31/20","337","12","29099","3.56"
"Johnson","1","76","Missouri","5/31/20","72","4","29101","5.56"
"Kansas City","23","1182","Missouri","5/31/20","1024","158","00000","15.43"
"Laclede","0","4","Missouri","5/31/20","3","1","29105","33.33"
"Lafayette","1","74","Missouri","5/31/20","69","5","29107","7.25"
"Lawrence","0","8","Missouri","5/31/20","8","0","29109","0"
"Lewis","0","7","Missouri","5/31/20","7","0","29111","0"
"Lincoln","0","109","Missouri","5/31/20","106","3","29113","2.83"
"Linn","0","9","Missouri","5/31/20","6","3","29115","50"
"Livingston","0","3","Missouri","5/31/20","3","0","29117","0"
"Macon","0","4","Missouri","5/31/20","2","2","29121","100"
"Madison","0","3","Missouri","5/31/20","3","0","29123","0"
"Maries","0","2","Missouri","5/31/20","2","0","29125","0"
"Marion","0","5","Missouri","5/31/20","5","0","29127","0"
"McDonald","0","20","Missouri","5/31/20","17","3","29119","17.65"
"Miller","0","4","Missouri","5/31/20","4","0","29131","0"
"Mississippi","1","58","Missouri","5/31/20","54","4","29133","7.41"
"Moniteau","0","47","Missouri","5/31/20","45","2","29135","4.44"
"Montgomery","0","9","Missouri","5/31/20","8","1","29139","12.5"
"Morgan","0","9","Missouri","5/31/20","8","1","29141","12.5"
"New Madrid","1","21","Missouri","5/31/20","17","4","29143","23.53"
"Newton","0","18","Missouri","5/31/20","16","2","29145","12.5"
"Nodaway","0","13","Missouri","5/31/20","12","1","29147","8.33"
"Oregon","0","2","Missouri","5/31/20","2","0","29149","0"
"Osage","0","5","Missouri","5/31/20","5","0","29151","0"
"Pemiscot","2","83","Missouri","5/31/20","72","11","29155","15.28"
"Perry","1","57","Missouri","5/31/20","49","8","29157","16.33"
"Pettis","1","78","Missouri","5/31/20","70","8","29159","11.43"
"Phelps","0","4","Missouri","5/31/20","4","0","29161","0"
"Pike","1","22","Missouri","5/31/20","14","8","29163","57.14"
"Platte","1","70","Missouri","5/31/20","65","5","29165","7.69"
"Polk","0","3","Missouri","5/31/20","3","0","29167","0"
"Pulaski","0","34","Missouri","5/31/20","33","1","29169","3.03"
"Ralls","0","5","Missouri","5/31/20","2","3","29173","150"
"Randolph","0","10","Missouri","5/31/20","9","1","29175","11.11"
"Ray","0","19","Missouri","5/31/20","16","3","29177","18.75"
"Reynolds","0","2","Missouri","5/31/20","2","0","29179","0"
"Ripley","0","7","Missouri","5/31/20","7","0","29181","0"
"Saline","0","269","Missouri","5/31/20","266","3","29195","1.13"
"Scotland","0","5","Missouri","5/31/20","4","1","29199","25"
"Scott","2","110","Missouri","5/31/20","93","17","29201","18.28"
"Shelby","0","1","Missouri","5/31/20","1","0","29205","0"
"St. Charles","6","780","Missouri","5/31/20","741","39","29183","5.26"
"St. Clair","0","3","Missouri","5/31/20","3","0","29185","0"
"St. Francois","0","35","Missouri","5/31/20","33","2","29187","6.06"
"St. Louis","46","5047","Missouri","5/31/20","4723","324","29189","6.86"
"St. Louis City","20","1955","Missouri","5/31/20","1815","140","29510","7.71"
"Ste. Genevieve","1","12","Missouri","5/31/20","8","4","29186","50"
"Stoddard","2","81","Missouri","5/31/20","70","11","29207","15.71"
"Stone","0","4","Missouri","5/31/20","4","0","29209","0"
"Sullivan","1","59","Missouri","5/31/20","49","10","29211","20.41"
"Taney","0","14","Missouri","5/31/20","14","0","29213","0"
"Texas","0","1","Missouri","5/31/20","0","1","29215","1"
"Vernon","0","9","Missouri","5/31/20","7","2","29217","28.57"
"Warren","0","28","Missouri","5/31/20","28","0","29219","0"
"Washington","0","11","Missouri","5/31/20","10","1","29221","10"
"Webster","0","17","Missouri","5/31/20","17","0","29225","0"
"Worth","0","4","Missouri","5/31/20","4","0","29227","0"
"Wright","0","11","Missouri","5/31/20","11","0","29229","0"
"Beaverhead","0","1","Montana","5/31/20","1","0","30001","0"
"Big Horn","3","29","Montana","5/31/20","8","21","30003","262.5"
"Broadwater","0","4","Montana","5/31/20","4","0","30007","0"
"Carbon","0","6","Montana","5/31/20","6","0","30009","0"
"Cascade","0","17","Montana","5/31/20","17","0","30013","0"
"Deer Lodge","0","3","Montana","5/31/20","3","0","30023","0"
"Flathead","0","37","Montana","5/31/20","37","0","30029","0"
"Gallatin","0","151","Montana","5/31/20","149","2","30031","1.34"
"Glacier","0","6","Montana","5/31/20","6","0","30035","0"
"Golden Valley","0","3","Montana","5/31/20","3","0","30037","0"
"Hill","0","1","Montana","5/31/20","1","0","30041","0"
"Jefferson","0","3","Montana","5/31/20","3","0","30043","0"
"Lake","0","5","Montana","5/31/20","5","0","30047","0"
"Lewis and Clark","0","16","Montana","5/31/20","16","0","30049","0"
"Liberty","0","1","Montana","5/31/20","1","0","30051","0"
"Lincoln","0","7","Montana","5/31/20","7","0","30053","0"
"Madison","0","8","Montana","5/31/20","8","0","30057","0"
"Meagher","0","1","Montana","5/31/20","1","0","30059","0"
"Missoula","0","40","Montana","5/31/20","39","1","30063","2.56"
"Musselshell","0","1","Montana","5/31/20","1","0","30065","0"
"Park","0","8","Montana","5/31/20","8","0","30067","0"
"Pondera","0","2","Montana","5/31/20","2","0","30073","0"
"Ravalli","0","14","Montana","5/31/20","13","1","30081","7.69"
"Richland","0","3","Montana","5/31/20","3","0","30083","0"
"Roosevelt","0","7","Montana","5/31/20","7","0","30085","0"
"Silver Bow","0","11","Montana","5/31/20","11","0","30093","0"
"Stillwater","0","1","Montana","5/31/20","1","0","30095","0"
"Toole","0","29","Montana","5/31/20","29","0","30101","0"
"Wheatland","0","1","Montana","5/31/20","1","0","30107","0"
"Yellowstone","2","99","Montana","5/31/20","88","11","30111","12.5"
"Adams","1","270","Nebraska","5/31/20","265","5","31001","1.89"
"Antelope","0","8","Nebraska","5/31/20","7","1","31003","14.29"
"Boone","0","6","Nebraska","5/31/20","3","3","31011","100"
"Box Butte","0","2","Nebraska","5/31/20","2","0","31013","0"
"Buffalo","2","157","Nebraska","5/31/20","142","15","31019","10.56"
"Burt","0","9","Nebraska","5/31/20","8","1","31021","12.5"
"Butler","0","48","Nebraska","5/31/20","45","3","31023","6.67"
"Cass","2","50","Nebraska","5/31/20","37","13","31025","35.14"
"Cedar","0","8","Nebraska","5/31/20","7","1","31027","14.29"
"Chase","0","1","Nebraska","5/31/20","1","0","31029","0"
"Cherry","0","1","Nebraska","5/31/20","1","0","31031","0"
"Cheyenne","0","9","Nebraska","5/31/20","9","0","31033","0"
"Clay","0","24","Nebraska","5/31/20","22","2","31035","9.09"
"Colfax","3","617","Nebraska","5/31/20","599","18","31037","3.01"
"Cuming","0","31","Nebraska","5/31/20","31","0","31039","0"
"Custer","0","31","Nebraska","5/31/20","31","0","31041","0"
"Dakota","12","1663","Nebraska","5/31/20","1582","81","31043","5.12"
"Dawes","0","1","Nebraska","5/31/20","1","0","31045","0"
"Dawson","3","838","Nebraska","5/31/20","820","18","31047","2.2"
"Dixon","0","27","Nebraska","5/31/20","25","2","31051","8"
"Dodge","16","465","Nebraska","5/31/20","355","110","31053","30.99"
"Douglas","158","4198","Nebraska","5/31/20","3094","1104","31055","35.68"
"Fillmore","0","6","Nebraska","5/31/20","5","1","31059","20"
"Franklin","0","6","Nebraska","5/31/20","6","0","31061","0"
"Frontier","0","1","Nebraska","5/31/20","1","0","31063","0"
"Furnas","0","9","Nebraska","5/31/20","7","2","31065","28.57"
"Gage","0","45","Nebraska","5/31/20","44","1","31067","2.27"
"Gosper","0","13","Nebraska","5/31/20","13","0","31073","0"
"Greeley","0","2","Nebraska","5/31/20","3","-1","31077","-33.33"
"Hall","6","1503","Nebraska","5/31/20","1464","39","31079","2.66"
"Hamilton","0","55","Nebraska","5/31/20","54","1","31081","1.85"
"Harlan","0","0","Nebraska","5/31/20","1","-1","31083","-100"
"Hitchcock","0","1","Nebraska","5/31/20","1","0","31087","0"
"Holt","0","1","Nebraska","5/31/20","1","0","31089","0"
"Howard","0","42","Nebraska","5/31/20","39","3","31093","7.69"
"Jefferson","0","6","Nebraska","5/31/20","6","0","31095","0"
"Johnson","0","6","Nebraska","5/31/20","7","-1","31097","-14.29"
"Kearney","0","11","Nebraska","5/31/20","11","0","31099","0"
"Keith","0","2","Nebraska","5/31/20","2","0","31101","0"
"Kimball","0","8","Nebraska","5/31/20","8","0","31105","0"
"Knox","0","10","Nebraska","5/31/20","8","2","31107","25"
"Lancaster","23","1205","Nebraska","5/31/20","1047","158","31109","15.09"
"Lincoln","0","48","Nebraska","5/31/20","47","1","31111","2.13"
"Madison","2","314","Nebraska","5/31/20","298","16","31119","5.37"
"Merrick","0","33","Nebraska","5/31/20","32","1","31121","3.12"
"Morrill","0","11","Nebraska","5/31/20","10","1","31123","10"
"Nance","0","4","Nebraska","5/31/20","5","-1","31125","-20"
"Nemaha","0","3","Nebraska","5/31/20","3","0","31127","0"
"Nuckolls","0","1","Nebraska","5/31/20","1","0","31129","0"
"Otoe","0","7","Nebraska","5/31/20","6","1","31131","16.67"
"Phelps","0","20","Nebraska","5/31/20","20","0","31137","0"
"Pierce","1","6","Nebraska","5/31/20","2","4","31139","200"
"Platte","8","577","Nebraska","5/31/20","523","54","31141","10.33"
"Polk","0","11","Nebraska","5/31/20","9","2","31143","22.22"
"Red Willow","0","5","Nebraska","5/31/20","5","0","31145","0"
"Richardson","0","1","Nebraska","5/31/20","1","0","31147","0"
"Saline","4","497","Nebraska","5/31/20","469","28","31151","5.97"
"Sarpy","25","620","Nebraska","5/31/20","448","172","31153","38.39"
"Saunders","1","36","Nebraska","5/31/20","27","9","31155","33.33"
"Scotts Bluff","5","102","Nebraska","5/31/20","67","35","31157","52.24"
"Seward","0","28","Nebraska","5/31/20","27","1","31159","3.7"
"Sherman","0","4","Nebraska","5/31/20","2","2","31163","100"
"Stanton","0","20","Nebraska","5/31/20","17","3","31167","17.65"
"Thayer","0","1","Nebraska","5/31/20","0","1","31169","1"
"Thomas","0","1","Nebraska","5/31/20","1","0","31171","0"
"Thurston","3","46","Nebraska","5/31/20","28","18","31173","64.29"
"Valley","0","4","Nebraska","5/31/20","3","1","31175","33.33"
"Washington","1","30","Nebraska","5/31/20","26","4","31177","15.38"
"Wayne","0","15","Nebraska","5/31/20","13","2","31179","15.38"
"Webster","0","5","Nebraska","5/31/20","5","0","31181","0"
"York","0","36","Nebraska","5/31/20","35","1","31185","2.86"
"Carson City","2","98","Nevada","5/31/20","86","12","32510","13.95"
"Churchill","0","7","Nevada","5/31/20","6","1","32001","16.67"
"Clark","74","6657","Nevada","5/31/20","6140","517","32003","8.42"
"Douglas","1","32","Nevada","5/31/20","27","5","32005","18.52"
"Elko","0","24","Nevada","5/31/20","22","2","32007","9.09"
"Humboldt","0","78","Nevada","5/31/20","78","0","32013","0"
"Lander","0","20","Nevada","5/31/20","19","1","32015","5.26"
"Lincoln","0","2","Nevada","5/31/20","2","0","32017","0"
"Lyon","1","62","Nevada","5/31/20","55","7","32019","12.73"
"Mineral","0","4","Nevada","5/31/20","4","0","32021","0"
"Nye","0","62","Nevada","5/31/20","59","3","32023","5.08"
"Storey","0","1","Nevada","5/31/20","1","0","32029","0"
"Washoe","28","1577","Nevada","5/31/20","1378","199","32031","14.44"
"White Pine","0","4","Nevada","5/31/20","4","0","32033","0"
"Belknap","1","60","New Hampshire","5/31/20","55","5","33001","9.09"
"Carroll","0","47","New Hampshire","5/31/20","46","1","33003","2.17"
"Cheshire","1","57","New Hampshire","5/31/20","52","5","33005","9.62"
"Coos","0","5","New Hampshire","5/31/20","4","1","33007","25"
"Grafton","1","76","New Hampshire","5/31/20","69","7","33009","10.14"
"Hillsborough","53","2464","New Hampshire","5/31/20","2095","369","33011","17.61"
"Merrimack","3","342","New Hampshire","5/31/20","320","22","33013","6.88"
"Rockingham","12","1306","New Hampshire","5/31/20","1223","83","33015","6.79"
"Strafford","2","269","New Hampshire","5/31/20","254","15","33017","5.91"
"Sullivan","0","19","New Hampshire","5/31/20","17","2","33019","11.76"
"Atlantic","36","2214","New Jersey","5/31/20","1961","253","34001","12.9"
"Bergen","67","18272","New Jersey","5/31/20","17804","468","34003","2.63"
"Burlington","46","4627","New Jersey","5/31/20","4308","319","34005","7.4"
"Camden","69","6510","New Jersey","5/31/20","6024","486","34007","8.07"
"Cape May","8","617","New Jersey","5/31/20","561","56","34009","9.98"
"Cumberland","50","2298","New Jersey","5/31/20","1947","351","34011","18.03"
"Essex","62","17649","New Jersey","5/31/20","17214","435","34013","2.53"
"Gloucester","24","2234","New Jersey","5/31/20","2066","168","34015","8.13"
"Hudson","-16","18767","New Jersey","5/31/20","18879","-112","34017","-0.59"
"Hunterdon","5","993","New Jersey","5/31/20","960","33","34019","3.44"
"Mercer","74","6933","New Jersey","5/31/20","6413","520","34021","8.11"
"Middlesex","81","15921","New Jersey","5/31/20","15351","570","34023","3.71"
"Monmouth","60","8219","New Jersey","5/31/20","7800","419","34025","5.37"
"Morris","37","6463","New Jersey","5/31/20","6207","256","34027","4.12"
"Ocean","54","8748","New Jersey","5/31/20","8372","376","34029","4.49"
"Passaic","69","16170","New Jersey","5/31/20","15686","484","34031","3.09"
"Salem","12","634","New Jersey","5/31/20","552","82","34033","14.86"
"Somerset","19","4583","New Jersey","5/31/20","4450","133","34035","2.99"
"Sussex","4","1110","New Jersey","5/31/20","1079","31","34037","2.87"
"Union","93","15821","New Jersey","5/31/20","15169","652","34039","4.3"
"Warren","5","1160","New Jersey","5/31/20","1125","35","34041","3.11"
"Bernalillo","20","1476","New Mexico","5/31/20","1337","139","35001","10.4"
"Catron","0","2","New Mexico","5/31/20","2","0","35003","0"
"Chaves","1","47","New Mexico","5/31/20","39","8","35005","20.51"
"Cibola","2","141","New Mexico","5/31/20","129","12","35006","9.3"
"Colfax","0","5","New Mexico","5/31/20","5","0","35007","0"
"Curry","1","52","New Mexico","5/31/20","46","6","35009","13.04"
"Dona Ana","8","466","New Mexico","5/31/20","407","59","35013","14.5"
"Eddy","1","22","New Mexico","5/31/20","18","4","35015","22.22"
"Grant","0","15","New Mexico","5/31/20","16","-1","35017","-6.25"
"Guadalupe","0","20","New Mexico","5/31/20","19","1","35019","5.26"
"Harding","0","1","New Mexico","5/31/20","1","0","35021","0"
"Hidalgo","0","1","New Mexico","5/31/20","1","0","35023","0"
"Lea","0","26","New Mexico","5/31/20","23","3","35025","13.04"
"Lincoln","0","2","New Mexico","5/31/20","3","-1","35027","-33.33"
"Los Alamos","0","6","New Mexico","5/31/20","6","0","35028","0"
"Luna","0","8","New Mexico","5/31/20","8","0","35029","0"
"McKinley","32","2415","New Mexico","5/31/20","2192","223","35031","10.17"
"Otero","1","22","New Mexico","5/31/20","14","8","35035","57.14"
"Quay","0","5","New Mexico","5/31/20","5","0","35037","0"
"Rio Arriba","1","47","New Mexico","5/31/20","37","10","35039","27.03"
"Roosevelt","1","40","New Mexico","5/31/20","34","6","35041","17.65"
"San Juan","25","1733","New Mexico","5/31/20","1558","175","35045","11.23"
"San Miguel","1","15","New Mexico","5/31/20","11","4","35047","36.36"
"Sandoval","4","568","New Mexico","5/31/20","543","25","35043","4.6"
"Santa Fe","1","142","New Mexico","5/31/20","132","10","35049","7.58"
"Sierra","0","1","New Mexico","5/31/20","1","0","35051","0"
"Socorro","0","50","New Mexico","5/31/20","49","1","35053","2.04"
"Taos","0","24","New Mexico","5/31/20","24","0","35055","0"
"Torrance","2","32","New Mexico","5/31/20","20","12","35057","60"
"Union","0","4","New Mexico","5/31/20","3","1","35059","33.33"
"Valencia","0","74","New Mexico","5/31/20","72","2","35061","2.78"
"Albany","11","1860","New York","5/31/20","1782","78","36001","4.38"
"Allegany","0","45","New York","5/31/20","44","1","36003","2.27"
"Broome","9","566","New York","5/31/20","501","65","36007","12.97"
"Cattaraugus","1","88","New York","5/31/20","78","10","36009","12.82"
"Cayuga","2","91","New York","5/31/20","77","14","36011","18.18"
"Chautauqua","1","84","New York","5/31/20","75","9","36013","12"
"Chemung","0","137","New York","5/31/20","136","1","36015","0.74"
"Chenango","2","133","New York","5/31/20","118","15","36017","12.71"
"Clinton","0","95","New York","5/31/20","95","0","36019","0"
"Columbia","3","387","New York","5/31/20","365","22","36021","6.03"
"Cortland","0","41","New York","5/31/20","39","2","36023","5.13"
"Delaware","0","79","New York","5/31/20","77","2","36025","2.6"
"Dutchess","15","3909","New York","5/31/20","3807","102","36027","2.68"
"Erie","63","6070","New York","5/31/20","5626","444","36029","7.89"
"Essex","0","37","New York","5/31/20","36","1","36031","2.78"
"Franklin","0","22","New York","5/31/20","20","2","36033","10"
"Fulton","2","208","New York","5/31/20","194","14","36035","7.22"
"Genesee","2","202","New York","5/31/20","191","11","36037","5.76"
"Greene","3","238","New York","5/31/20","220","18","36039","8.18"
"Hamilton","0","5","New York","5/31/20","5","0","36041","0"
"Herkimer","1","108","New York","5/31/20","101","7","36043","6.93"
"Jefferson","0","74","New York","5/31/20","72","2","36045","2.78"
"Lewis","0","20","New York","5/31/20","19","1","36049","5.26"
"Livingston","1","119","New York","5/31/20","114","5","36051","4.39"
"Madison","2","316","New York","5/31/20","301","15","36053","4.98"
"Monroe","35","2942","New York","5/31/20","2697","245","36055","9.08"
"Montgomery","2","91","New York","5/31/20","79","12","36057","15.19"
"Nassau","80","40396","New York","5/31/20","39837","559","36059","1.4"
"New York","740","203303","New York","5/31/20","198123","5180","36061","2.61"
"Niagara","14","1037","New York","5/31/20","941","96","36063","10.2"
"Oneida","21","1027","New York","5/31/20","878","149","36065","16.97"
"Onondaga","31","2170","New York","5/31/20","1953","217","36067","11.11"
"Ontario","3","207","New York","5/31/20","184","23","36069","12.5"
"Orange","26","10406","New York","5/31/20","10225","181","36071","1.77"
"Orleans","4","229","New York","5/31/20","202","27","36073","13.37"
"Oswego","1","109","New York","5/31/20","100","9","36075","9"
"Otsego","0","72","New York","5/31/20","69","3","36077","4.35"
"Putnam","6","1252","New York","5/31/20","1208","44","36079","3.64"
"Rensselaer","4","491","New York","5/31/20","463","28","36083","6.05"
"Rockland","27","13151","New York","5/31/20","12963","188","36087","1.45"
"Saratoga","3","480","New York","5/31/20","456","24","36091","5.26"
"Schenectady","4","689","New York","5/31/20","658","31","36093","4.71"
"Schoharie","0","50","New York","5/31/20","49","1","36095","2.04"
"Schuyler","0","11","New York","5/31/20","11","0","36097","0"
"Seneca","0","58","New York","5/31/20","55","3","36099","5.45"
"St. Lawrence","1","204","New York","5/31/20","197","7","36089","3.55"
"Steuben","0","241","New York","5/31/20","240","1","36101","0.42"
"Suffolk","97","39643","New York","5/31/20","38964","679","36103","1.74"
"Sullivan","11","1387","New York","5/31/20","1310","77","36105","5.88"
"Tioga","1","130","New York","5/31/20","122","8","36107","6.56"
"Tompkins","2","164","New York","5/31/20","151","13","36109","8.61"
"Ulster","10","1685","New York","5/31/20","1617","68","36111","4.21"
"Warren","1","255","New York","5/31/20","250","5","36113","2"
"Washington","1","235","New York","5/31/20","226","9","36115","3.98"
"Wayne","1","115","New York","5/31/20","108","7","36117","6.48"
"Westchester","73","33481","New York","5/31/20","32968","513","36119","1.56"
"Wyoming","1","86","New York","5/31/20","81","5","36121","6.17"
"Yates","0","39","New York","5/31/20","37","2","36123","5.41"
"Alamance","12","364","North Carolina","5/31/20","278","86","37001","30.94"
"Alexander","1","33","North Carolina","5/31/20","27","6","37003","22.22"
"Alleghany","0","16","North Carolina","5/31/20","13","3","37005","23.08"
"Anson","1","65","North Carolina","5/31/20","58","7","37007","12.07"
"Ashe","0","37","North Carolina","5/31/20","35","2","37009","5.71"
"Avery","0","2","North Carolina","5/31/20","2","0","37011","0"
"Beaufort","0","36","North Carolina","5/31/20","35","1","37013","2.86"
"Bertie","1","122","North Carolina","5/31/20","113","9","37015","7.96"
"Bladen","1","101","North Carolina","5/31/20","94","7","37017","7.45"
"Brunswick","2","85","North Carolina","5/31/20","74","11","37019","14.86"
"Buncombe","10","335","North Carolina","5/31/20","262","73","37021","27.86"
"Burke","21","425","North Carolina","5/31/20","278","147","37023","52.88"
"Cabarrus","9","500","North Carolina","5/31/20","438","62","37025","14.16"
"Caldwell","5","138","North Carolina","5/31/20","106","32","37027","30.19"
"Camden","0","3","North Carolina","5/31/20","3","0","37029","0"
"Carteret","0","37","North Carolina","5/31/20","36","1","37031","2.78"
"Caswell","1","61","North Carolina","5/31/20","54","7","37033","12.96"
"Catawba","10","217","North Carolina","5/31/20","148","69","37035","46.62"
"Chatham","8","634","North Carolina","5/31/20","578","56","37037","9.69"
"Cherokee","0","30","North Carolina","5/31/20","30","0","37039","0"
"Chowan","0","17","North Carolina","5/31/20","15","2","37041","13.33"
"Clay","0","8","North Carolina","5/31/20","8","0","37043","0"
"Cleveland","3","90","North Carolina","5/31/20","67","23","37045","34.33"
"Columbus","6","336","North Carolina","5/31/20","294","42","37047","14.29"
"Craven","3","207","North Carolina","5/31/20","189","18","37049","9.52"
"Cumberland","16","697","North Carolina","5/31/20","584","113","37051","19.35"
"Currituck","0","13","North Carolina","5/31/20","11","2","37053","18.18"
"Dare","0","22","North Carolina","5/31/20","22","0","37055","0"
"Davidson","9","413","North Carolina","5/31/20","352","61","37057","17.33"
"Davie","4","98","North Carolina","5/31/20","69","29","37059","42.03"
"Duplin","29","831","North Carolina","5/31/20","628","203","37061","32.32"
"Durham","50","1615","North Carolina","5/31/20","1262","353","37063","27.97"
"Edgecombe","1","200","North Carolina","5/31/20","190","10","37065","5.26"
"Forsyth","61","1347","North Carolina","5/31/20","920","427","37067","46.41"
"Franklin","3","159","North Carolina","5/31/20","141","18","37069","12.77"
"Gaston","6","286","North Carolina","5/31/20","247","39","37071","15.79"
"Gates","0","24","North Carolina","5/31/20","21","3","37073","14.29"
"Graham","0","2","North Carolina","5/31/20","2","0","37075","0"
"Granville","10","312","North Carolina","5/31/20","240","72","37077","30"
"Greene","2","78","North Carolina","5/31/20","65","13","37079","20"
"Guilford","31","1264","North Carolina","5/31/20","1049","215","37081","20.5"
"Halifax","5","180","North Carolina","5/31/20","148","32","37083","21.62"
"Harnett","2","288","North Carolina","5/31/20","272","16","37085","5.88"
"Haywood","1","47","North Carolina","5/31/20","39","8","37087","20.51"
"Henderson","4","345","North Carolina","5/31/20","316","29","37089","9.18"
"Hertford","8","120","North Carolina","5/31/20","66","54","37091","81.82"
"Hoke","7","240","North Carolina","5/31/20","192","48","37093","25"
"Hyde","0","1","North Carolina","5/31/20","1","0","37095","0"
"Iredell","4","259","North Carolina","5/31/20","228","31","37097","13.6"
"Jackson","1","33","North Carolina","5/31/20","27","6","37099","22.22"
"Johnston","18","456","North Carolina","5/31/20","331","125","37101","37.76"
"Jones","0","28","North Carolina","5/31/20","28","0","37103","0"
"Lee","13","455","North Carolina","5/31/20","364","91","37105","25"
"Lenoir","4","216","North Carolina","5/31/20","187","29","37107","15.51"
"Lincoln","2","69","North Carolina","5/31/20","58","11","37109","18.97"
"Macon","9","70","North Carolina","5/31/20","9","61","37113","677.78"
"Madison","0","4","North Carolina","5/31/20","4","0","37115","0"
"Martin","3","72","North Carolina","5/31/20","52","20","37117","38.46"
"McDowell","5","73","North Carolina","5/31/20","39","34","37111","87.18"
"Mecklenburg","146","4250","North Carolina","5/31/20","3231","1019","37119","31.54"
"Mitchell","1","14","North Carolina","5/31/20","9","5","37121","55.56"
"Montgomery","6","128","North Carolina","5/31/20","84","44","37123","52.38"
"Moore","4","224","North Carolina","5/31/20","198","26","37125","13.13"
"Nash","4","204","North Carolina","5/31/20","178","26","37127","14.61"
"New Hanover","6","195","North Carolina","5/31/20","153","42","37129","27.45"
"Northampton","3","156","North Carolina","5/31/20","138","18","37131","13.04"
"Onslow","2","110","North Carolina","5/31/20","97","13","37133","13.4"
"Orange","7","348","North Carolina","5/31/20","302","46","37135","15.23"
"Pamlico","0","10","North Carolina","5/31/20","10","0","37137","0"
"Pasquotank","1","105","North Carolina","5/31/20","96","9","37139","9.38"
"Pender","1","80","North Carolina","5/31/20","70","10","37141","14.29"
"Perquimans","0","24","North Carolina","5/31/20","23","1","37143","4.35"
"Person","2","48","North Carolina","5/31/20","37","11","37145","29.73"
"Pitt","7","304","North Carolina","5/31/20","257","47","37147","18.29"
"Polk","0","37","North Carolina","5/31/20","35","2","37149","5.71"
"Randolph","14","665","North Carolina","5/31/20","567","98","37151","17.28"
"Richmond","3","163","North Carolina","5/31/20","145","18","37153","12.41"
"Robeson","23","824","North Carolina","5/31/20","663","161","37155","24.28"
"Rockingham","4","94","North Carolina","5/31/20","69","25","37157","36.23"
"Rowan","7","654","North Carolina","5/31/20","605","49","37159","8.1"
"Rutherford","3","182","North Carolina","5/31/20","164","18","37161","10.98"
"Sampson","13","479","North Carolina","5/31/20","385","94","37163","24.42"
"Scotland","3","85","North Carolina","5/31/20","64","21","37165","32.81"
"Stanly","5","78","North Carolina","5/31/20","45","33","37167","73.33"
"Stokes","2","67","North Carolina","5/31/20","55","12","37169","21.82"
"Surry","8","214","North Carolina","5/31/20","158","56","37171","35.44"
"Swain","0","13","North Carolina","5/31/20","10","3","37173","30"
"Transylvania","0","13","North Carolina","5/31/20","11","2","37175","18.18"
"Tyrrell","0","4","North Carolina","5/31/20","4","0","37177","0"
"Union","7","442","North Carolina","5/31/20","394","48","37179","12.18"
"Vance","11","317","North Carolina","5/31/20","239","78","37181","32.64"
"Wake","43","1747","North Carolina","5/31/20","1448","299","37183","20.65"
"Warren","1","63","North Carolina","5/31/20","54","9","37185","16.67"
"Washington","0","29","North Carolina","5/31/20","26","3","37187","11.54"
"Watauga","1","23","North Carolina","5/31/20","13","10","37189","76.92"
"Wayne","20","1138","North Carolina","5/31/20","1000","138","37191","13.8"
"Wilkes","3","497","North Carolina","5/31/20","473","24","37193","5.07"
"Wilson","6","356","North Carolina","5/31/20","314","42","37195","13.38"
"Yadkin","6","171","North Carolina","5/31/20","132","39","37197","29.55"
"Yancey","1","14","North Carolina","5/31/20","10","4","37199","40"
"Barnes","0","4","North Dakota","5/31/20","4","0","38003","0"
"Benson","0","1","North Dakota","5/31/20","1","0","38005","0"
"Bottineau","0","2","North Dakota","5/31/20","2","0","38009","0"
"Bowman","0","1","North Dakota","5/31/20","1","0","38011","0"
"Burke","0","5","North Dakota","5/31/20","5","0","38013","0"
"Burleigh","0","128","North Dakota","5/31/20","131","-3","38015","-2.29"
"Cass","25","1705","North Dakota","5/31/20","1528","177","38017","11.58"
"Divide","0","1","North Dakota","5/31/20","1","0","38023","0"
"Dunn","0","12","North Dakota","5/31/20","12","0","38025","0"
"Eddy","0","4","North Dakota","5/31/20","7","-3","38027","-42.86"
"Emmons","0","4","North Dakota","5/31/20","6","-2","38029","-33.33"
"Foster","0","1","North Dakota","5/31/20","1","0","38031","0"
"Grand Forks","1","333","North Dakota","5/31/20","323","10","38035","3.1"
"Grant","0","2","North Dakota","5/31/20","2","0","38037","0"
"Griggs","0","1","North Dakota","5/31/20","1","0","38039","0"
"McHenry","0","2","North Dakota","5/31/20","2","0","38049","0"
"McIntosh","0","1","North Dakota","5/31/20","1","0","38051","0"
"McKenzie","0","17","North Dakota","5/31/20","16","1","38053","6.25"
"McLean","0","7","North Dakota","5/31/20","7","0","38055","0"
"Mercer","0","5","North Dakota","5/31/20","5","0","38057","0"
"Morton","-1","59","North Dakota","5/31/20","64","-5","38059","-7.81"
"Mountrail","0","39","North Dakota","5/31/20","39","0","38061","0"
"Nelson","0","1","North Dakota","5/31/20","2","-1","38063","-50"
"Oliver","0","1","North Dakota","5/31/20","1","0","38065","0"
"Pembina","0","6","North Dakota","5/31/20","6","0","38067","0"
"Pierce","0","3","North Dakota","5/31/20","4","-1","38069","-25"
"Ramsey","0","8","North Dakota","5/31/20","9","-1","38071","-11.11"
"Ransom","0","8","North Dakota","5/31/20","8","0","38073","0"
"Renville","0","3","North Dakota","5/31/20","1","2","38075","200"
"Richland","0","22","North Dakota","5/31/20","20","2","38077","10"
"Rolette","0","6","North Dakota","5/31/20","4","2","38079","50"
"Sargent","0","3","North Dakota","5/31/20","3","0","38081","0"
"Sioux","0","2","North Dakota","5/31/20","2","0","38085","0"
"Slope","0","3","North Dakota","5/31/20","3","0","38087","0"
"Stark","0","62","North Dakota","5/31/20","61","1","38089","1.64"
"Steele","0","1","North Dakota","5/31/20","1","0","38091","0"
"Stutsman","1","23","North Dakota","5/31/20","18","5","38093","27.78"
"Traill","-1","13","North Dakota","5/31/20","21","-8","38097","-38.1"
"Walsh","0","13","North Dakota","5/31/20","13","0","38099","0"
"Ward","-2","37","North Dakota","5/31/20","54","-17","38101","-31.48"
"Wells","0","3","North Dakota","5/31/20","3","0","38103","0"
"Williams","0","25","North Dakota","5/31/20","25","0","38105","0"
"","0","22","Northern Mariana Islands","5/31/20","22","0",,"0"
"Adams","0","10","Ohio","5/31/20","8","2","39001","25"
"Allen","3","212","Ohio","5/31/20","189","23","39003","12.17"
"Ashland","0","20","Ohio","5/31/20","17","3","39005","17.65"
"Ashtabula","9","339","Ohio","5/31/20","277","62","39007","22.38"
"Athens","1","18","Ohio","5/31/20","14","4","39009","28.57"
"Auglaize","2","73","Ohio","5/31/20","59","14","39011","23.73"
"Belmont","6","429","Ohio","5/31/20","384","45","39013","11.72"
"Brown","1","29","Ohio","5/31/20","24","5","39015","20.83"
"Butler","17","893","Ohio","5/31/20","776","117","39017","15.08"
"Carroll","0","31","Ohio","5/31/20","28","3","39019","10.71"
"Champaign","0","28","Ohio","5/31/20","26","2","39021","7.69"
"Clark","11","285","Ohio","5/31/20","206","79","39023","38.35"
"Clermont","4","211","Ohio","5/31/20","181","30","39025","16.57"
"Clinton","0","43","Ohio","5/31/20","43","0","39027","0"
"Columbiana","45","793","Ohio","5/31/20","478","315","39029","65.9"
"Coshocton","2","40","Ohio","5/31/20","24","16","39031","66.67"
"Crawford","1","114","Ohio","5/31/20","104","10","39033","9.62"
"Cuyahoga","74","4444","Ohio","5/31/20","3927","517","39035","13.17"
"Darke","3","170","Ohio","5/31/20","151","19","39037","12.58"
"Defiance","0","34","Ohio","5/31/20","32","2","39039","6.25"
"Delaware","6","337","Ohio","5/31/20","296","41","39041","13.85"
"Erie","2","172","Ohio","5/31/20","155","17","39043","10.97"
"Fairfield","4","267","Ohio","5/31/20","240","27","39045","11.25"
"Fayette","1","40","Ohio","5/31/20","34","6","39047","17.65"
"Franklin","96","5862","Ohio","5/31/20","5188","674","39049","12.99"
"Fulton","1","41","Ohio","5/31/20","36","5","39051","13.89"
"Gallia","0","8","Ohio","5/31/20","7","1","39053","14.29"
"Geauga","4","284","Ohio","5/31/20","256","28","39055","10.94"
"Greene","1","101","Ohio","5/31/20","93","8","39057","8.6"
"Guernsey","1","35","Ohio","5/31/20","31","4","39059","12.9"
"Hamilton","38","2672","Ohio","5/31/20","2403","269","39061","11.19"
"Hancock","0","50","Ohio","5/31/20","48","2","39063","4.17"
"Hardin","3","61","Ohio","5/31/20","40","21","39065","52.5"
"Harrison","0","10","Ohio","5/31/20","10","0","39067","0"
"Henry","0","15","Ohio","5/31/20","14","1","39069","7.14"
"Highland","1","25","Ohio","5/31/20","18","7","39071","38.89"
"Hocking","1","69","Ohio","5/31/20","65","4","39073","6.15"
"Holmes","2","39","Ohio","5/31/20","25","14","39075","56"
"Huron","1","58","Ohio","5/31/20","52","6","39077","11.54"
"Jackson","0","14","Ohio","5/31/20","11","3","39079","27.27"
"Jefferson","1","67","Ohio","5/31/20","62","5","39081","8.06"
"Knox","0","25","Ohio","5/31/20","23","2","39083","8.7"
"Lake","6","308","Ohio","5/31/20","267","41","39085","15.36"
"Lawrence","0","30","Ohio","5/31/20","28","2","39087","7.14"
"Licking","6","248","Ohio","5/31/20","204","44","39089","21.57"
"Logan","0","39","Ohio","5/31/20","37","2","39091","5.41"
"Lorain","7","687","Ohio","5/31/20","641","46","39093","7.18"
"Lucas","23","2267","Ohio","5/31/20","2107","160","39095","7.59"
"Madison","3","156","Ohio","5/31/20","133","23","39097","17.29"
"Mahoning","14","1431","Ohio","5/31/20","1334","97","39099","7.27"
"Marion","7","2666","Ohio","5/31/20","2617","49","39101","1.87"
"Medina","7","337","Ohio","5/31/20","288","49","39103","17.01"
"Meigs","0","6","Ohio","5/31/20","6","0","39105","0"
"Mercer","4","211","Ohio","5/31/20","184","27","39107","14.67"
"Miami","1","357","Ohio","5/31/20","348","9","39109","2.59"
"Monroe","1","78","Ohio","5/31/20","71","7","39111","9.86"
"Montgomery","10","663","Ohio","5/31/20","593","70","39113","11.8"
"Morgan","0","5","Ohio","5/31/20","5","0","39115","0"
"Morrow","0","107","Ohio","5/31/20","104","3","39117","2.88"
"Muskingum","1","52","Ohio","5/31/20","45","7","39119","15.56"
"Noble","0","6","Ohio","5/31/20","5","1","39121","20"
"Ottawa","1","99","Ohio","5/31/20","90","9","39123","10"
"Paulding","0","14","Ohio","5/31/20","13","1","39125","7.69"
"Perry","0","18","Ohio","5/31/20","18","0","39127","0"
"Pickaway","5","2074","Ohio","5/31/20","2042","32","39129","1.57"
"Pike","0","6","Ohio","5/31/20","6","0","39131","0"
"Portage","2","325","Ohio","5/31/20","310","15","39133","4.84"
"Preble","1","37","Ohio","5/31/20","31","6","39135","19.35"
"Putnam","1","92","Ohio","5/31/20","85","7","39137","8.24"
"Richland","2","200","Ohio","5/31/20","183","17","39139","9.29"
"Ross","1","71","Ohio","5/31/20","63","8","39141","12.7"
"Sandusky","2","79","Ohio","5/31/20","65","14","39143","21.54"
"Scioto","0","16","Ohio","5/31/20","15","1","39145","6.67"
"Seneca","0","20","Ohio","5/31/20","18","2","39147","11.11"
"Shelby","0","43","Ohio","5/31/20","40","3","39149","7.5"
"Stark","6","727","Ohio","5/31/20","682","45","39151","6.6"
"Summit","29","1420","Ohio","5/31/20","1220","200","39153","16.39"
"Trumbull","7","573","Ohio","5/31/20","525","48","39155","9.14"
"Tuscarawas","4","343","Ohio","5/31/20","312","31","39157","9.94"
"Union","1","52","Ohio","5/31/20","43","9","39159","20.93"
"Van Wert","0","6","Ohio","5/31/20","5","1","39161","20"
"Vinton","0","21","Ohio","5/31/20","19","2","39163","10.53"
"Warren","6","373","Ohio","5/31/20","328","45","39165","13.72"
"Washington","0","118","Ohio","5/31/20","117","1","39167","0.85"
"Wayne","4","274","Ohio","5/31/20","248","26","39169","10.48"
"Williams","1","55","Ohio","5/31/20","51","4","39171","7.84"
"Wood","3","294","Ohio","5/31/20","274","20","39173","7.3"
"Wyandot","1","41","Ohio","5/31/20","36","5","39175","13.89"
"Adair","1","87","Oklahoma","5/31/20","82","5","40001","6.1"
"Alfalfa","0","1","Oklahoma","5/31/20","1","0","40003","0"
"Atoka","0","3","Oklahoma","5/31/20","1","2","40005","200"
"Beaver","0","24","Oklahoma","5/31/20","24","0","40007","0"
"Beckham","0","6","Oklahoma","5/31/20","6","0","40009","0"
"Blaine","0","6","Oklahoma","5/31/20","4","2","40011","50"
"Bryan","1","26","Oklahoma","5/31/20","22","4","40013","18.18"
"Caddo","3","158","Oklahoma","5/31/20","136","22","40015","16.18"
"Canadian","1","132","Oklahoma","5/31/20","126","6","40017","4.76"
"Carter","3","41","Oklahoma","5/31/20","22","19","40019","86.36"
"Cherokee","0","29","Oklahoma","5/31/20","28","1","40021","3.57"
"Choctaw","3","39","Oklahoma","5/31/20","18","21","40023","116.67"
"Cimarron","0","1","Oklahoma","5/31/20","1","0","40025","0"
"Cleveland","2","500","Oklahoma","5/31/20","489","11","40027","2.25"
"Coal","0","1","Oklahoma","5/31/20","1","0","40029","0"
"Comanche","1","279","Oklahoma","5/31/20","270","9","40031","3.33"
"Cotton","0","5","Oklahoma","5/31/20","5","0","40033","0"
"Craig","0","15","Oklahoma","5/31/20","15","0","40035","0"
"Creek","1","94","Oklahoma","5/31/20","90","4","40037","4.44"
"Custer","1","16","Oklahoma","5/31/20","12","4","40039","33.33"
"Delaware","0","100","Oklahoma","5/31/20","99","1","40041","1.01"
"Dewey","0","2","Oklahoma","5/31/20","3","-1","40043","-33.33"
"Garfield","0","27","Oklahoma","5/31/20","26","1","40047","3.85"
"Garvin","0","17","Oklahoma","5/31/20","15","2","40049","13.33"
"Grady","2","92","Oklahoma","5/31/20","76","16","40051","21.05"
"Grant","0","2","Oklahoma","5/31/20","2","0","40053","0"
"Greer","0","66","Oklahoma","5/31/20","66","0","40055","0"
"Harper","0","1","Oklahoma","5/31/20","1","0","40059","0"
"Haskell","0","6","Oklahoma","5/31/20","6","0","40061","0"
"Hughes","0","1","Oklahoma","5/31/20","0","1","40063","1"
"Jackson","1","27","Oklahoma","5/31/20","21","6","40065","28.57"
"Jefferson","0","3","Oklahoma","5/31/20","3","0","40067","0"
"Johnston","0","3","Oklahoma","5/31/20","3","0","40069","0"
"Kay","0","53","Oklahoma","5/31/20","52","1","40071","1.92"
"Kingfisher","0","11","Oklahoma","5/31/20","11","0","40073","0"
"Kiowa","0","6","Oklahoma","5/31/20","6","0","40075","0"
"Latimer","0","5","Oklahoma","5/31/20","5","0","40077","0"
"Le Flore","0","14","Oklahoma","5/31/20","13","1","40079","7.69"
"Lincoln","0","22","Oklahoma","5/31/20","21","1","40081","4.76"
"Logan","0","19","Oklahoma","5/31/20","19","0","40083","0"
"Love","0","15","Oklahoma","5/31/20","14","1","40085","7.14"
"Major","0","6","Oklahoma","5/31/20","6","0","40093","0"
"Marshall","0","8","Oklahoma","5/31/20","7","1","40095","14.29"
"Mayes","0","30","Oklahoma","5/31/20","29","1","40097","3.45"
"McClain","1","104","Oklahoma","5/31/20","98","6","40087","6.12"
"McCurtain","1","35","Oklahoma","5/31/20","25","10","40089","40"
"McIntosh","0","11","Oklahoma","5/31/20","11","0","40091","0"
"Murray","0","4","Oklahoma","5/31/20","2","2","40099","100"
"Muskogee","2","48","Oklahoma","5/31/20","35","13","40101","37.14"
"Noble","0","7","Oklahoma","5/31/20","7","0","40103","0"
"Nowata","0","23","Oklahoma","5/31/20","23","0","40105","0"
"Okfuskee","0","4","Oklahoma","5/31/20","3","1","40107","33.33"
"Oklahoma","9","1263","Oklahoma","5/31/20","1203","60","40109","4.99"
"Okmulgee","0","26","Oklahoma","5/31/20","23","3","40111","13.04"
"Osage","0","95","Oklahoma","5/31/20","94","1","40113","1.06"
"Ottawa","0","35","Oklahoma","5/31/20","35","0","40115","0"
"Pawnee","0","31","Oklahoma","5/31/20","29","2","40117","6.9"
"Payne","0","45","Oklahoma","5/31/20","45","0","40119","0"
"Pittsburg","0","41","Oklahoma","5/31/20","40","1","40121","2.5"
"Pontotoc","0","13","Oklahoma","5/31/20","12","1","40123","8.33"
"Pottawatomie","0","59","Oklahoma","5/31/20","57","2","40125","3.51"
"Pushmataha","0","2","Oklahoma","5/31/20","2","0","40127","0"
"Rogers","0","81","Oklahoma","5/31/20","78","3","40131","3.85"
"Seminole","1","26","Oklahoma","5/31/20","22","4","40133","18.18"
"Sequoyah","0","15","Oklahoma","5/31/20","14","1","40135","7.14"
"Stephens","0","38","Oklahoma","5/31/20","37","1","40137","2.7"
"Texas","5","917","Oklahoma","5/31/20","881","36","40139","4.09"
"Tillman","0","23","Oklahoma","5/31/20","22","1","40141","4.55"
"Tulsa","12","998","Oklahoma","5/31/20","915","83","40143","9.07"
"Wagoner","0","149","Oklahoma","5/31/20","148","1","40145","0.68"
"Washington","1","316","Oklahoma","5/31/20","310","6","40147","1.94"
"Washita","0","2","Oklahoma","5/31/20","2","0","40149","0"
"Woods","0","3","Oklahoma","5/31/20","3","0","40151","0"
"Woodward","0","5","Oklahoma","5/31/20","4","1","40153","25"
"Baker","0","1","Oregon","5/31/20","1","0","41001","0"
"Benton","0","55","Oregon","5/31/20","55","0","41003","0"
"Clackamas","3","312","Oregon","5/31/20","290","22","41005","7.59"
"Clatsop","0","45","Oregon","5/31/20","45","0","41007","0"
"Columbia","0","16","Oregon","5/31/20","16","0","41009","0"
"Coos","0","31","Oregon","5/31/20","31","0","41011","0"
"Crook","0","6","Oregon","5/31/20","5","1","41013","20"
"Curry","0","7","Oregon","5/31/20","6","1","41015","16.67"
"Deschutes","1","125","Oregon","5/31/20","119","6","41017","5.04"
"Douglas","0","27","Oregon","5/31/20","25","2","41019","8"
"Grant","0","1","Oregon","5/31/20","1","0","41023","0"
"Harney","0","1","Oregon","5/31/20","1","0","41025","0"
"Hood River","1","18","Oregon","5/31/20","12","6","41027","50"
"Jackson","1","66","Oregon","5/31/20","57","9","41029","15.79"
"Jefferson","1","33","Oregon","5/31/20","25","8","41031","32"
"Josephine","0","23","Oregon","5/31/20","25","-2","41033","-8"
"Klamath","0","44","Oregon","5/31/20","41","3","41035","7.32"
"Lake","0","2","Oregon","5/31/20","0","2","41037","1"
"Lane","1","73","Oregon","5/31/20","67","6","41039","8.96"
"Lincoln","0","12","Oregon","5/31/20","9","3","41041","33.33"
"Linn","0","115","Oregon","5/31/20","116","-1","41043","-0.86"
"Malheur","1","32","Oregon","5/31/20","28","4","41045","14.29"
"Marion","8","960","Oregon","5/31/20","905","55","41047","6.08"
"Morrow","0","11","Oregon","5/31/20","12","-1","41049","-8.33"
"Multnomah","18","1165","Oregon","5/31/20","1040","125","41051","12.02"
"Polk","0","98","Oregon","5/31/20","96","2","41053","2.08"
"Sherman","0","1","Oregon","5/31/20","1","0","41055","0"
"Tillamook","0","6","Oregon","5/31/20","6","0","41057","0"
"Umatilla","1","116","Oregon","5/31/20","111","5","41059","4.5"
"Union","0","6","Oregon","5/31/20","6","0","41061","0"
"Wallowa","0","2","Oregon","5/31/20","2","0","41063","0"
"Wasco","1","24","Oregon","5/31/20","18","6","41065","33.33"
"Washington","7","739","Oregon","5/31/20","690","49","41067","7.1"
"Yamhill","1","70","Oregon","5/31/20","65","5","41071","7.69"
"Adams","4","251","Pennsylvania","5/31/20","226","25","42001","11.06"
"Allegheny","19","1911","Pennsylvania","5/31/20","1777","134","42003","7.54"
"Armstrong","1","62","Pennsylvania","5/31/20","58","4","42005","6.9"
"Beaver","5","590","Pennsylvania","5/31/20","554","36","42007","6.5"
"Bedford","0","39","Pennsylvania","5/31/20","37","2","42009","5.41"
"Berks","25","4061","Pennsylvania","5/31/20","3885","176","42011","4.53"
"Blair","1","50","Pennsylvania","5/31/20","46","4","42013","8.7"
"Bradford","0","46","Pennsylvania","5/31/20","44","2","42015","4.55"
"Bucks","31","5082","Pennsylvania","5/31/20","4867","215","42017","4.42"
"Butler","2","230","Pennsylvania","5/31/20","219","11","42019","5.02"
"Cambria","0","57","Pennsylvania","5/31/20","57","0","42021","0"
"Cameron","0","2","Pennsylvania","5/31/20","2","0","42023","0"
"Carbon","1","235","Pennsylvania","5/31/20","229","6","42025","2.62"
"Centre","1","153","Pennsylvania","5/31/20","146","7","42027","4.79"
"Chester","48","2729","Pennsylvania","5/31/20","2390","339","42029","14.18"
"Clarion","0","27","Pennsylvania","5/31/20","29","-2","42031","-6.9"
"Clearfield","1","39","Pennsylvania","5/31/20","34","5","42033","14.71"
"Clinton","1","56","Pennsylvania","5/31/20","50","6","42035","12"
"Columbia","1","348","Pennsylvania","5/31/20","344","4","42037","1.16"
"Crawford","1","29","Pennsylvania","5/31/20","22","7","42039","31.82"
"Cumberland","5","629","Pennsylvania","5/31/20","592","37","42041","6.25"
"Dauphin","25","1277","Pennsylvania","5/31/20","1099","178","42043","16.2"
"Delaware","40","6461","Pennsylvania","5/31/20","6179","282","42045","4.56"
"Elk","0","6","Pennsylvania","5/31/20","6","0","42047","0"
"Erie","10","279","Pennsylvania","5/31/20","209","70","42049","33.49"
"Fayette","0","95","Pennsylvania","5/31/20","94","1","42051","1.06"
"Forest","0","7","Pennsylvania","5/31/20","7","0","42053","0"
"Franklin","6","774","Pennsylvania","5/31/20","734","40","42055","5.45"
"Fulton","0","15","Pennsylvania","5/31/20","14","1","42057","7.14"
"Greene","0","27","Pennsylvania","5/31/20","27","0","42059","0"
"Huntingdon","0","230","Pennsylvania","5/31/20","228","2","42061","0.88"
"Indiana","0","91","Pennsylvania","5/31/20","89","2","42063","2.25"
"Jefferson","0","9","Pennsylvania","5/31/20","7","2","42065","28.57"
"Juniata","0","95","Pennsylvania","5/31/20","95","0","42067","0"
"Lackawanna","8","1547","Pennsylvania","5/31/20","1491","56","42069","3.76"
"Lancaster","44","3161","Pennsylvania","5/31/20","2854","307","42071","10.76"
"Lawrence","1","80","Pennsylvania","5/31/20","74","6","42073","8.11"
"Lebanon","9","969","Pennsylvania","5/31/20","909","60","42075","6.6"
"Lehigh","16","3765","Pennsylvania","5/31/20","3651","114","42077","3.12"
"Luzerne","13","2736","Pennsylvania","5/31/20","2645","91","42079","3.44"
"Lycoming","1","164","Pennsylvania","5/31/20","158","6","42081","3.8"
"McKean","0","12","Pennsylvania","5/31/20","11","1","42083","9.09"
"Mercer","0","107","Pennsylvania","5/31/20","104","3","42085","2.88"
"Mifflin","0","59","Pennsylvania","5/31/20","58","1","42087","1.72"
"Monroe","2","1319","Pennsylvania","5/31/20","1304","15","42089","1.15"
"Montgomery","77","7061","Pennsylvania","5/31/20","6525","536","42091","8.21"
"Montour","0","52","Pennsylvania","5/31/20","50","2","42093","4"
"Northampton","25","3083","Pennsylvania","5/31/20","2911","172","42095","5.91"
"Northumberland","3","192","Pennsylvania","5/31/20","170","22","42097","12.94"
"Perry","2","59","Pennsylvania","5/31/20","47","12","42099","25.53"
"Philadelphia","199","22629","Pennsylvania","5/31/20","21234","1395","42101","6.57"
"Pike","0","476","Pennsylvania","5/31/20","477","-1","42103","-0.21"
"Potter","0","4","Pennsylvania","5/31/20","4","0","42105","0"
"Schuylkill","7","631","Pennsylvania","5/31/20","585","46","42107","7.86"
"Snyder","1","45","Pennsylvania","5/31/20","38","7","42109","18.42"
"Somerset","0","38","Pennsylvania","5/31/20","37","1","42111","2.7"
"Sullivan","0","3","Pennsylvania","5/31/20","2","1","42113","50"
"Susquehanna","2","109","Pennsylvania","5/31/20","96","13","42115","13.54"
"Tioga","0","17","Pennsylvania","5/31/20","16","1","42117","6.25"
"Union","1","59","Pennsylvania","5/31/20","53","6","42119","11.32"
"Venango","0","9","Pennsylvania","5/31/20","8","1","42121","12.5"
"Warren","0","3","Pennsylvania","5/31/20","3","0","42123","0"
"Washington","0","139","Pennsylvania","5/31/20","138","1","42125","0.72"
"Wayne","0","119","Pennsylvania","5/31/20","117","2","42127","1.71"
"Westmoreland","1","449","Pennsylvania","5/31/20","440","9","42129","2.05"
"Wyoming","0","34","Pennsylvania","5/31/20","33","1","42131","3.03"
"York","12","1007","Pennsylvania","5/31/20","924","83","42133","8.98"
"","84","3776","Puerto Rico","5/31/20","3189","587",,"18.41"
"Bristol","2","224","Rhode Island","5/31/20","213","11","44001","5.16"
"Kent","6","1052","Rhode Island","5/31/20","1013","39","44003","3.85"
"Newport","2","244","Rhode Island","5/31/20","228","16","44005","7.02"
"Providence","64","11052","Rhode Island","5/31/20","10607","445","44007","4.2"
"Washington","2","499","Rhode Island","5/31/20","486","13","44009","2.67"
"Abbeville","1","42","South Carolina","5/31/20","35","7","45001","20"
"Aiken","3","197","South Carolina","5/31/20","173","24","45003","13.87"
"Allendale","0","35","South Carolina","5/31/20","34","1","45005","2.94"
"Anderson","3","239","South Carolina","5/31/20","218","21","45007","9.63"
"Bamberg","0","22","South Carolina","5/31/20","20","2","45009","10"
"Barnwell","0","46","South Carolina","5/31/20","43","3","45011","6.98"
"Beaufort","7","385","South Carolina","5/31/20","335","50","45013","14.93"
"Berkeley","3","233","South Carolina","5/31/20","215","18","45015","8.37"
"Calhoun","1","15","South Carolina","5/31/20","9","6","45017","66.67"
"Charleston","8","617","South Carolina","5/31/20","558","59","45019","10.57"
"Cherokee","1","39","South Carolina","5/31/20","29","10","45021","34.48"
"Chester","4","80","South Carolina","5/31/20","51","29","45023","56.86"
"Chesterfield","9","196","South Carolina","5/31/20","131","65","45025","49.62"
"Clarendon","1","301","South Carolina","5/31/20","293","8","45027","2.73"
"Colleton","4","105","South Carolina","5/31/20","75","30","45029","40"
"Darlington","7","295","South Carolina","5/31/20","246","49","45031","19.92"
"Dillon","3","165","South Carolina","5/31/20","147","18","45033","12.24"
"Dorchester","3","166","South Carolina","5/31/20","142","24","45035","16.9"
"Edgefield","0","51","South Carolina","5/31/20","48","3","45037","6.25"
"Fairfield","3","179","South Carolina","5/31/20","159","20","45039","12.58"
"Florence","7","655","South Carolina","5/31/20","603","52","45041","8.62"
"Georgetown","2","76","South Carolina","5/31/20","60","16","45043","26.67"
"Greenville","48","1619","South Carolina","5/31/20","1286","333","45045","25.89"
"Greenwood","9","142","South Carolina","5/31/20","82","60","45047","73.17"
"Hampton","0","37","South Carolina","5/31/20","34","3","45049","8.82"
"Horry","8","432","South Carolina","5/31/20","377","55","45051","14.59"
"Jasper","1","42","South Carolina","5/31/20","38","4","45053","10.53"
"Kershaw","5","332","South Carolina","5/31/20","300","32","45055","10.67"
"Lancaster","2","135","South Carolina","5/31/20","121","14","45057","11.57"
"Laurens","1","67","South Carolina","5/31/20","58","9","45059","15.52"
"Lee","4","218","South Carolina","5/31/20","191","27","45061","14.14"
"Lexington","13","645","South Carolina","5/31/20","553","92","45063","16.64"
"Marion","1","69","South Carolina","5/31/20","64","5","45067","7.81"
"Marlboro","9","171","South Carolina","5/31/20","111","60","45069","54.05"
"McCormick","0","9","South Carolina","5/31/20","8","1","45065","12.5"
"Newberry","2","63","South Carolina","5/31/20","46","17","45071","36.96"
"Oconee","0","50","South Carolina","5/31/20","47","3","45073","6.38"
"Orangeburg","7","189","South Carolina","5/31/20","139","50","45075","35.97"
"Pickens","5","158","South Carolina","5/31/20","120","38","45077","31.67"
"Richland","22","1518","South Carolina","5/31/20","1361","157","45079","11.54"
"Saluda","1","145","South Carolina","5/31/20","136","9","45081","6.62"
"Spartanburg","21","617","South Carolina","5/31/20","471","146","45083","31"
"Sumter","5","384","South Carolina","5/31/20","346","38","45085","10.98"
"Union","1","37","South Carolina","5/31/20","31","6","45087","19.35"
"Williamsburg","3","236","South Carolina","5/31/20","212","24","45089","11.32"
"York","10","407","South Carolina","5/31/20","340","67","45091","19.71"
"Aurora","1","26","South Dakota","5/31/20","22","4","46003","18.18"
"Beadle","19","261","South Dakota","5/31/20","131","130","46005","99.24"
"Bon Homme","0","8","South Dakota","5/31/20","8","0","46009","0"
"Brookings","0","16","South Dakota","5/31/20","15","1","46011","6.67"
"Brown","3","273","South Dakota","5/31/20","249","24","46013","9.64"
"Buffalo","1","17","South Dakota","5/31/20","9","8","46017","88.89"
"Charles Mix","1","17","South Dakota","5/31/20","13","4","46023","30.77"
"Clark","0","4","South Dakota","5/31/20","4","0","46025","0"
"Clay","0","15","South Dakota","5/31/20","15","0","46027","0"
"Codington","1","37","South Dakota","5/31/20","32","5","46029","15.62"
"Corson","0","4","South Dakota","5/31/20","4","0","46031","0"
"Davison","1","16","South Dakota","5/31/20","9","7","46035","77.78"
"Day","0","13","South Dakota","5/31/20","12","1","46037","8.33"
"Deuel","0","1","South Dakota","5/31/20","1","0","46039","0"
"Douglas","0","3","South Dakota","5/31/20","2","1","46043","50"
"Edmunds","0","1","South Dakota","5/31/20","0","1","46045","1"
"Fall River","0","4","South Dakota","5/31/20","4","0","46047","0"
"Faulk","0","1","South Dakota","5/31/20","1","0","46049","0"
"Grant","0","13","South Dakota","5/31/20","10","3","46051","30"
"Gregory","0","1","South Dakota","5/31/20","0","1","46053","1"
"Hamlin","0","4","South Dakota","5/31/20","4","0","46057","0"
"Hand","0","2","South Dakota","5/31/20","1","1","46059","100"
"Hughes","0","19","South Dakota","5/31/20","19","0","46065","0"
"Hutchinson","0","5","South Dakota","5/31/20","3","2","46067","66.67"
"Hyde","0","1","South Dakota","5/31/20","1","0","46069","0"
"Jackson","0","4","South Dakota","5/31/20","1","3","46071","300"
"Jerauld","1","35","South Dakota","5/31/20","28","7","46073","25"
"Kingsbury","0","1","South Dakota","5/31/20","0","1","46077","1"
"Lake","0","8","South Dakota","5/31/20","6","2","46079","33.33"
"Lawrence","0","11","South Dakota","5/31/20","9","2","46081","22.22"
"Lincoln","1","238","South Dakota","5/31/20","229","9","46083","3.93"
"Lyman","0","14","South Dakota","5/31/20","12","2","46085","16.67"
"Marshall","0","4","South Dakota","5/31/20","4","0","46091","0"
"McCook","0","6","South Dakota","5/31/20","5","1","46087","20"
"McPherson","0","1","South Dakota","5/31/20","1","0","46089","0"
"Meade","1","19","South Dakota","5/31/20","10","9","46093","90"
"Miner","0","1","South Dakota","5/31/20","1","0","46097","0"
"Minnehaha","13","3349","South Dakota","5/31/20","3260","89","46099","2.73"
"Moody","0","19","South Dakota","5/31/20","18","1","46101","5.56"
"Oglala Lakota","1","26","South Dakota","5/31/20","17","9","46102","52.94"
"Pennington","11","227","South Dakota","5/31/20","152","75","46103","49.34"
"Roberts","0","36","South Dakota","5/31/20","35","1","46109","2.86"
"Sanborn","0","13","South Dakota","5/31/20","10","3","46111","30"
"Spink","0","5","South Dakota","5/31/20","4","1","46115","25"
"Stanley","0","10","South Dakota","5/31/20","9","1","46117","11.11"
"Sully","0","1","South Dakota","5/31/20","1","0","46119","0"
"Todd","1","27","South Dakota","5/31/20","18","9","46121","50"
"Tripp","0","6","South Dakota","5/31/20","6","0","46123","0"
"Turner","0","24","South Dakota","5/31/20","22","2","46125","9.09"
"Union","1","89","South Dakota","5/31/20","79","10","46127","12.66"
"Walworth","0","5","South Dakota","5/31/20","5","0","46129","0"
"Yankton","0","51","South Dakota","5/31/20","51","0","46135","0"
"Ziebach","0","1","South Dakota","5/31/20","1","0","46137","0"
"Anderson","0","40","Tennessee","5/31/20","39","1","47001","2.56"
"Bedford","3","283","Tennessee","5/31/20","265","18","47003","6.79"
"Benton","0","7","Tennessee","5/31/20","7","0","47005","0"
"Bledsoe","0","607","Tennessee","5/31/20","607","0","47007","0"
"Blount","1","91","Tennessee","5/31/20","82","9","47009","10.98"
"Bradley","4","122","Tennessee","5/31/20","93","29","47011","31.18"
"Campbell","0","18","Tennessee","5/31/20","17","1","47013","5.88"
"Cannon","1","21","Tennessee","5/31/20","17","4","47015","23.53"
"Carroll","0","27","Tennessee","5/31/20","27","0","47017","0"
"Carter","0","19","Tennessee","5/31/20","19","0","47019","0"
"Cheatham","3","123","Tennessee","5/31/20","104","19","47021","18.27"
"Chester","0","12","Tennessee","5/31/20","12","0","47023","0"
"Claiborne","0","9","Tennessee","5/31/20","8","1","47025","12.5"
"Clay","0","7","Tennessee","5/31/20","7","0","47027","0"
"Cocke","0","20","Tennessee","5/31/20","20","0","47029","0"
"Coffee","1","73","Tennessee","5/31/20","65","8","47031","12.31"
"Crockett","0","16","Tennessee","5/31/20","15","1","47033","6.67"
"Cumberland","0","112","Tennessee","5/31/20","109","3","47035","2.75"
"Davidson","75","5040","Tennessee","5/31/20","4518","522","47037","11.55"
"Decatur","0","5","Tennessee","5/31/20","5","0","47039","0"
"DeKalb","1","37","Tennessee","5/31/20","33","4","47041","12.12"
"Dickson","1","109","Tennessee","5/31/20","101","8","47043","7.92"
"Dyer","0","50","Tennessee","5/31/20","48","2","47045","4.17"
"Fayette","1","115","Tennessee","5/31/20","107","8","47047","7.48"
"Fentress","0","12","Tennessee","5/31/20","10","2","47049","20"
"Franklin","1","53","Tennessee","5/31/20","46","7","47051","15.22"
"Gibson","0","63","Tennessee","5/31/20","61","2","47053","3.28"
"Giles","0","12","Tennessee","5/31/20","12","0","47055","0"
"Grainger","0","8","Tennessee","5/31/20","6","2","47057","33.33"
"Greene","0","50","Tennessee","5/31/20","48","2","47059","4.17"
"Grundy","0","31","Tennessee","5/31/20","31","0","47061","0"
"Hamblen","1","36","Tennessee","5/31/20","26","10","47063","38.46"
"Hamilton","35","794","Tennessee","5/31/20","552","242","47065","43.84"
"Hancock","0","1","Tennessee","5/31/20","1","0","47067","0"
"Hardeman","1","196","Tennessee","5/31/20","189","7","47069","3.7"
"Hardin","1","15","Tennessee","5/31/20","11","4","47071","36.36"
"Hawkins","0","33","Tennessee","5/31/20","31","2","47073","6.45"
"Haywood","0","31","Tennessee","5/31/20","29","2","47075","6.9"
"Henderson","0","15","Tennessee","5/31/20","12","3","47077","25"
"Henry","0","30","Tennessee","5/31/20","29","1","47079","3.45"
"Hickman","1","58","Tennessee","5/31/20","54","4","47081","7.41"
"Houston","0","8","Tennessee","5/31/20","7","1","47083","14.29"
"Humphreys","0","13","Tennessee","5/31/20","12","1","47085","8.33"
"Jackson","0","17","Tennessee","5/31/20","17","0","47087","0"
"Jefferson","0","28","Tennessee","5/31/20","27","1","47089","3.7"
"Johnson","0","16","Tennessee","5/31/20","15","1","47091","6.67"
"Knox","6","375","Tennessee","5/31/20","331","44","47093","13.29"
"Lake","1","414","Tennessee","5/31/20","409","5","47095","1.22"
"Lauderdale","1","56","Tennessee","5/31/20","51","5","47097","9.8"
"Lawrence","1","31","Tennessee","5/31/20","24","7","47099","29.17"
"Lewis","0","3","Tennessee","5/31/20","3","0","47101","0"
"Lincoln","0","25","Tennessee","5/31/20","26","-1","47103","-3.85"
"Loudon","2","143","Tennessee","5/31/20","132","11","47105","8.33"
"Macon","5","136","Tennessee","5/31/20","100","36","47111","36"
"Madison","1","175","Tennessee","5/31/20","165","10","47113","6.06"
"Marion","1","40","Tennessee","5/31/20","36","4","47115","11.11"
"Marshall","0","31","Tennessee","5/31/20","28","3","47117","10.71"
"Maury","2","89","Tennessee","5/31/20","78","11","47119","14.1"
"McMinn","1","141","Tennessee","5/31/20","134","7","47107","5.22"
"McNairy","0","12","Tennessee","5/31/20","12","0","47109","0"
"Meigs","0","26","Tennessee","5/31/20","25","1","47121","4"
"Monroe","1","62","Tennessee","5/31/20","57","5","47123","8.77"
"Montgomery","4","269","Tennessee","5/31/20","240","29","47125","12.08"
"Moore","0","3","Tennessee","5/31/20","3","0","47127","0"
"Morgan","0","17","Tennessee","5/31/20","17","0","47129","0"
"Obion","1","30","Tennessee","5/31/20","24","6","47131","25"
"Out of TN","11","418","Tennessee","5/31/20","339","79","80047","23.3"
"Overton","1","26","Tennessee","5/31/20","20","6","47133","30"
"Perry","1","21","Tennessee","5/31/20","13","8","47135","61.54"
"Pickett","0","3","Tennessee","5/31/20","3","0","47137","0"
"Polk","0","16","Tennessee","5/31/20","14","2","47139","14.29"
"Putnam","15","479","Tennessee","5/31/20","377","102","47141","27.06"
"Rhea","2","210","Tennessee","5/31/20","195","15","47143","7.69"
"Roane","0","16","Tennessee","5/31/20","15","1","47145","6.67"
"Robertson","13","465","Tennessee","5/31/20","371","94","47147","25.34"
"Rutherford","28","1196","Tennessee","5/31/20","998","198","47149","19.84"
"Scott","0","12","Tennessee","5/31/20","11","1","47151","9.09"
"Sequatchie","1","15","Tennessee","5/31/20","10","5","47153","50"
"Sevier","1","81","Tennessee","5/31/20","72","9","47155","12.5"
"Shelby","87","4943","Tennessee","5/31/20","4336","607","47157","14"
"Smith","1","34","Tennessee","5/31/20","30","4","47159","13.33"
"Stewart","0","11","Tennessee","5/31/20","9","2","47161","22.22"
"Sullivan","0","60","Tennessee","5/31/20","61","-1","47163","-1.64"
"Sumner","10","881","Tennessee","5/31/20","811","70","47165","8.63"
"Tipton","2","442","Tennessee","5/31/20","426","16","47167","3.76"
"Trousdale","0","1392","Tennessee","5/31/20","1393","-1","47169","-0.07"
"Unicoi","0","4","Tennessee","5/31/20","3","1","47171","33.33"
"Union","0","4","Tennessee","5/31/20","4","0","47173","0"
"Van Buren","0","4","Tennessee","5/31/20","4","0","47175","0"
"Warren","1","23","Tennessee","5/31/20","19","4","47177","21.05"
"Washington","0","75","Tennessee","5/31/20","73","2","47179","2.74"
"Wayne","0","64","Tennessee","5/31/20","63","1","47181","1.59"
"Weakley","0","26","Tennessee","5/31/20","26","0","47183","0"
"White","1","33","Tennessee","5/31/20","27","6","47185","22.22"
"Williamson","6","552","Tennessee","5/31/20","512","40","47187","7.81"
"Wilson","7","407","Tennessee","5/31/20","355","52","47189","14.65"
"Anderson","1","72","Texas","5/31/20","66","6","48001","9.09"
"Andrews","0","27","Texas","5/31/20","24","3","48003","12.5"
"Angelina","4","205","Texas","5/31/20","175","30","48005","17.14"
"Aransas","0","5","Texas","5/31/20","5","0","48007","0"
"Archer","0","1","Texas","5/31/20","1","0","48009","0"
"Armstrong","0","3","Texas","5/31/20","2","1","48011","50"
"Atascosa","0","37","Texas","5/31/20","35","2","48013","5.71"
"Austin","1","26","Texas","5/31/20","22","4","48015","18.18"
"Bailey","1","17","Texas","5/31/20","10","7","48017","70"
"Bandera","0","6","Texas","5/31/20","6","0","48019","0"
"Bastrop","5","211","Texas","5/31/20","177","34","48021","19.21"
"Bee","0","9","Texas","5/31/20","9","0","48025","0"
"Bell","9","362","Texas","5/31/20","298","64","48027","21.48"
"Bexar","58","2825","Texas","5/31/20","2418","407","48029","16.83"
"Blanco","0","11","Texas","5/31/20","8","3","48031","37.5"
"Bosque","0","7","Texas","5/31/20","6","1","48035","16.67"
"Bowie","16","265","Texas","5/31/20","153","112","48037","73.2"
"Brazoria","10","907","Texas","5/31/20","835","72","48039","8.62"
"Brazos","6","477","Texas","5/31/20","436","41","48041","9.4"
"Brewster","0","1","Texas","5/31/20","1","0","48043","0"
"Briscoe","0","1","Texas","5/31/20","1","0","48045","0"
"Brooks","0","1","Texas","5/31/20","1","0","48047","0"
"Brown","0","58","Texas","5/31/20","56","2","48049","3.57"
"Burleson","0","24","Texas","5/31/20","22","2","48051","9.09"
"Burnet","1","37","Texas","5/31/20","29","8","48053","27.59"
"Caldwell","2","65","Texas","5/31/20","50","15","48055","30"
"Calhoun","0","37","Texas","5/31/20","37","0","48057","0"
"Callahan","0","9","Texas","5/31/20","8","1","48059","12.5"
"Cameron","9","764","Texas","5/31/20","698","66","48061","9.46"
"Camp","6","83","Texas","5/31/20","42","41","48063","97.62"
"Carson","0","6","Texas","5/31/20","6","0","48065","0"
"Cass","1","29","Texas","5/31/20","21","8","48067","38.1"
"Castro","0","33","Texas","5/31/20","32","1","48069","3.12"
"Chambers","1","68","Texas","5/31/20","59","9","48071","15.25"
"Cherokee","0","44","Texas","5/31/20","42","2","48073","4.76"
"Childress","0","2","Texas","5/31/20","2","0","48075","0"
"Clay","0","3","Texas","5/31/20","3","0","48077","0"
"Cochran","0","1","Texas","5/31/20","1","0","48079","0"
"Coke","0","1","Texas","5/31/20","1","0","48081","0"
"Coleman","0","3","Texas","5/31/20","2","1","48083","50"
"Collin","23","1297","Texas","5/31/20","1136","161","48085","14.17"
"Collingsworth","0","5","Texas","5/31/20","4","1","48087","25"
"Colorado","0","22","Texas","5/31/20","19","3","48089","15.79"
"Comal","2","94","Texas","5/31/20","82","12","48091","14.63"
"Comanche","0","12","Texas","5/31/20","10","2","48093","20"
"Concho","0","1","Texas","5/31/20","1","0","48095","0"
"Cooke","0","14","Texas","5/31/20","13","1","48097","7.69"
"Coryell","8","281","Texas","5/31/20","226","55","48099","24.34"
"Cottle","0","4","Texas","5/31/20","4","0","48101","0"
"Crane","2","23","Texas","5/31/20","7","16","48103","228.57"
"Crosby","0","4","Texas","5/31/20","3","1","48107","33.33"
"Dallam","0","25","Texas","5/31/20","22","3","48111","13.64"
"Dallas","201","10234","Texas","5/31/20","8827","1407","48113","15.94"
"Dawson","0","42","Texas","5/31/20","39","3","48115","7.69"
"Deaf Smith","1","164","Texas","5/31/20","157","7","48117","4.46"
"Delta","0","1","Texas","5/31/20","1","0","48119","0"
"Denton","21","1357","Texas","5/31/20","1212","145","48121","11.96"
"DeWitt","0","17","Texas","5/31/20","17","0","48123","0"
"Dickens","0","1","Texas","5/31/20","1","0","48125","0"
"Dimmit","0","1","Texas","5/31/20","1","0","48127","0"
"Donley","0","26","Texas","5/31/20","26","0","48129","0"
"Duval","0","5","Texas","5/31/20","5","0","48131","0"
"Eastland","0","6","Texas","5/31/20","5","1","48133","20"
"Ector","1","154","Texas","5/31/20","144","10","48135","6.94"
"El Paso","61","2764","Texas","5/31/20","2340","424","48141","18.12"
"Ellis","9","335","Texas","5/31/20","272","63","48139","23.16"
"Erath","0","17","Texas","5/31/20","15","2","48143","13.33"
"Falls","0","7","Texas","5/31/20","6","1","48145","16.67"
"Fannin","1","41","Texas","5/31/20","34","7","48147","20.59"
"Fayette","0","34","Texas","5/31/20","32","2","48149","6.25"
"Fisher","0","2","Texas","5/31/20","2","0","48151","0"
"Floyd","1","11","Texas","5/31/20","5","6","48153","120"
"Fort Bend","25","1861","Texas","5/31/20","1685","176","48157","10.45"
"Franklin","0","15","Texas","5/31/20","12","3","48159","25"
"Freestone","0","10","Texas","5/31/20","10","0","48161","0"
"Frio","0","37","Texas","5/31/20","36","1","48163","2.78"
"Gaines","0","7","Texas","5/31/20","6","1","48165","16.67"
"Galveston","8","807","Texas","5/31/20","749","58","48167","7.74"
"Garza","0","5","Texas","5/31/20","5","0","48169","0"
"Gillespie","0","5","Texas","5/31/20","5","0","48171","0"
"Glasscock","0","1","Texas","5/31/20","1","0","48173","0"
"Goliad","0","7","Texas","5/31/20","7","0","48175","0"
"Gonzales","5","129","Texas","5/31/20","91","38","48177","41.76"
"Gray","0","98","Texas","5/31/20","96","2","48179","2.08"
"Grayson","5","333","Texas","5/31/20","296","37","48181","12.5"
"Gregg","4","213","Texas","5/31/20","185","28","48183","15.14"
"Grimes","17","215","Texas","5/31/20","99","116","48185","117.17"
"Guadalupe","2","133","Texas","5/31/20","122","11","48187","9.02"
"Hale","0","58","Texas","5/31/20","55","3","48189","5.45"
"Hall","0","2","Texas","5/31/20","2","0","48191","0"
"Hamilton","0","8","Texas","5/31/20","7","1","48193","14.29"
"Hansford","0","19","Texas","5/31/20","18","1","48195","5.56"
"Hardeman","0","1","Texas","5/31/20","1","0","48197","0"
"Hardin","0","138","Texas","5/31/20","136","2","48199","1.47"
"Harris","194","12276","Texas","5/31/20","10921","1355","48201","12.41"
"Harrison","3","245","Texas","5/31/20","225","20","48203","8.89"
"Hartley","0","11","Texas","5/31/20","11","0","48205","0"
"Haskell","0","3","Texas","5/31/20","2","1","48207","50"
"Hays","8","329","Texas","5/31/20","270","59","48209","21.85"
"Hemphill","0","1","Texas","5/31/20","1","0","48211","0"
"Henderson","0","57","Texas","5/31/20","55","2","48213","3.64"
"Hidalgo","11","560","Texas","5/31/20","482","78","48215","16.18"
"Hill","0","24","Texas","5/31/20","24","0","48217","0"
"Hockley","0","27","Texas","5/31/20","27","0","48219","0"
"Hood","1","27","Texas","5/31/20","23","4","48221","17.39"
"Hopkins","2","26","Texas","5/31/20","15","11","48223","73.33"
"Houston","4","114","Texas","5/31/20","84","30","48225","35.71"
"Howard","0","8","Texas","5/31/20","6","2","48227","33.33"
"Hudspeth","0","2","Texas","5/31/20","0","2","48229","1"
"Hunt","2","88","Texas","5/31/20","75","13","48231","17.33"
"Hutchinson","1","36","Texas","5/31/20","30","6","48233","20"
"Jack","0","4","Texas","5/31/20","4","0","48237","0"
"Jackson","0","18","Texas","5/31/20","17","1","48239","5.88"
"Jasper","0","29","Texas","5/31/20","28","1","48241","3.57"
"Jefferson","7","544","Texas","5/31/20","492","52","48245","10.57"
"Jim Hogg","0","4","Texas","5/31/20","4","0","48247","0"
"Jim Wells","0","9","Texas","5/31/20","9","0","48249","0"
"Johnson","4","175","Texas","5/31/20","148","27","48251","18.24"
"Jones","38","401","Texas","5/31/20","135","266","48253","197.04"
"Karnes","0","4","Texas","5/31/20","4","0","48255","0"
"Kaufman","6","223","Texas","5/31/20","182","41","48257","22.53"
"Kendall","1","29","Texas","5/31/20","24","5","48259","20.83"
"Kerr","0","19","Texas","5/31/20","16","3","48265","18.75"
"Kimble","0","1","Texas","5/31/20","1","0","48267","0"
"Kinney","0","1","Texas","5/31/20","0","1","48271","1"
"Kleberg","0","16","Texas","5/31/20","15","1","48273","6.67"
"Knox","0","1","Texas","5/31/20","1","0","48275","0"
"La Salle","0","4","Texas","5/31/20","4","0","48283","0"
"Lamar","2","145","Texas","5/31/20","133","12","48277","9.02"
"Lamb","0","16","Texas","5/31/20","15","1","48279","6.67"
"Lampasas","0","9","Texas","5/31/20","8","1","48281","12.5"
"Lavaca","0","12","Texas","5/31/20","9","3","48285","33.33"
"Lee","2","24","Texas","5/31/20","9","15","48287","166.67"
"Leon","0","10","Texas","5/31/20","9","1","48289","11.11"
"Liberty","2","95","Texas","5/31/20","80","15","48291","18.75"
"Limestone","0","24","Texas","5/31/20","23","1","48293","4.35"
"Lipscomb","0","2","Texas","5/31/20","2","0","48295","0"
"Live Oak","0","9","Texas","5/31/20","9","0","48297","0"
"Llano","0","3","Texas","5/31/20","3","0","48299","0"
"Lubbock","4","691","Texas","5/31/20","662","29","48303","4.38"
"Lynn","0","7","Texas","5/31/20","5","2","48305","40"
"Madison","0","8","Texas","5/31/20","8","0","48313","0"
"Marion","0","16","Texas","5/31/20","15","1","48315","6.67"
"Martin","0","3","Texas","5/31/20","3","0","48317","0"
"Mason","0","32","Texas","5/31/20","31","1","48319","3.23"
"Matagorda","0","70","Texas","5/31/20","67","3","48321","4.48"
"Maverick","3","116","Texas","5/31/20","97","19","48323","19.59"
"McCulloch","0","3","Texas","5/31/20","3","0","48307","0"
"McLennan","2","118","Texas","5/31/20","107","11","48309","10.28"
"Medina","1","73","Texas","5/31/20","67","6","48325","8.96"
"Midland","1","129","Texas","5/31/20","124","5","48329","4.03"
"Milam","0","28","Texas","5/31/20","28","0","48331","0"
"Mills","0","1","Texas","5/31/20","1","0","48333","0"
"Mitchell","0","1","Texas","5/31/20","1","0","48335","0"
"Montague","0","9","Texas","5/31/20","9","0","48337","0"
"Montgomery","9","954","Texas","5/31/20","888","66","48339","7.43"
"Moore","15","686","Texas","5/31/20","579","107","48341","18.48"
"Morris","1","26","Texas","5/31/20","17","9","48343","52.94"
"Motley","0","1","Texas","5/31/20","1","0","48345","0"
"Nacogdoches","4","287","Texas","5/31/20","257","30","48347","11.67"
"Navarro","2","56","Texas","5/31/20","44","12","48349","27.27"
"Newton","0","5","Texas","5/31/20","4","1","48351","25"
"Nolan","0","4","Texas","5/31/20","2","2","48353","100"
"Nueces","2","274","Texas","5/31/20","262","12","48355","4.58"
"Ochiltree","1","49","Texas","5/31/20","43","6","48357","13.95"
"Oldham","0","3","Texas","5/31/20","3","0","48359","0"
"Orange","0","98","Texas","5/31/20","96","2","48361","2.08"
"Palo Pinto","0","13","Texas","5/31/20","10","3","48363","30"
"Panola","1","197","Texas","5/31/20","188","9","48365","4.79"
"Parker","1","76","Texas","5/31/20","67","9","48367","13.43"
"Parmer","1","59","Texas","5/31/20","53","6","48369","11.32"
"Pecos","9","93","Texas","5/31/20","27","66","48371","244.44"
"Polk","1","56","Texas","5/31/20","52","4","48373","7.69"
"Potter","12","2321","Texas","5/31/20","2238","83","48375","3.71"
"Presidio","0","1","Texas","5/31/20","0","1","48377","1"
"Rains","0","3","Texas","5/31/20","3","0","48379","0"
"Randall","4","674","Texas","5/31/20","648","26","48381","4.01"
"Reagan","0","2","Texas","5/31/20","0","2","48383","1"
"Red River","3","70","Texas","5/31/20","46","24","48387","52.17"
"Reeves","0","7","Texas","5/31/20","7","0","48389","0"
"Refugio","0","3","Texas","5/31/20","3","0","48391","0"
"Roberts","0","2","Texas","5/31/20","2","0","48393","0"
"Robertson","0","8","Texas","5/31/20","7","1","48395","14.29"
"Rockwall","2","167","Texas","5/31/20","151","16","48397","10.6"
"Runnels","0","3","Texas","5/31/20","2","1","48399","50"
"Rusk","2","55","Texas","5/31/20","43","12","48401","27.91"
"Sabine","1","14","Texas","5/31/20","5","9","48403","180"
"San Augustine","1","38","Texas","5/31/20","29","9","48405","31.03"
"San Jacinto","0","14","Texas","5/31/20","14","0","48407","0"
"San Patricio","1","33","Texas","5/31/20","28","5","48409","17.86"
"San Saba","0","1","Texas","5/31/20","1","0","48411","0"
"Scurry","3","24","Texas","5/31/20","2","22","48415","1100"
"Shackelford","0","1","Texas","5/31/20","1","0","48417","0"
"Shelby","3","201","Texas","5/31/20","183","18","48419","9.84"
"Sherman","0","24","Texas","5/31/20","21","3","48421","14.29"
"Smith","1","204","Texas","5/31/20","198","6","48423","3.03"
"Starr","1","33","Texas","5/31/20","24","9","48427","37.5"
"Stephens","0","4","Texas","5/31/20","2","2","48429","100"
"Swisher","0","17","Texas","5/31/20","17","0","48437","0"
"Tarrant","73","5463","Texas","5/31/20","4951","512","48439","10.34"
"Taylor","1","235","Texas","5/31/20","228","7","48441","3.07"
"Terry","0","13","Texas","5/31/20","13","0","48445","0"
"Titus","29","451","Texas","5/31/20","248","203","48449","81.85"
"Tom Green","1","100","Texas","5/31/20","90","10","48451","11.11"
"Travis","63","3232","Texas","5/31/20","2788","444","48453","15.93"
"Trinity","0","15","Texas","5/31/20","13","2","48455","15.38"
"Tyler","0","12","Texas","5/31/20","11","1","48457","9.09"
"Upshur","1","26","Texas","5/31/20","18","8","48459","44.44"
"Uvalde","1","12","Texas","5/31/20","6","6","48463","100"
"Val Verde","1","20","Texas","5/31/20","14","6","48465","42.86"
"Van Zandt","1","31","Texas","5/31/20","26","5","48467","19.23"
"Victoria","0","160","Texas","5/31/20","157","3","48469","1.91"
"Walker","140","1455","Texas","5/31/20","474","981","48471","206.96"
"Waller","1","57","Texas","5/31/20","49","8","48473","16.33"
"Ward","0","1","Texas","5/31/20","1","0","48475","0"
"Washington","1","202","Texas","5/31/20","193","9","48477","4.66"
"Webb","5","546","Texas","5/31/20","511","35","48479","6.85"
"Wharton","2","58","Texas","5/31/20","45","13","48481","28.89"
"Wheeler","0","15","Texas","5/31/20","15","0","48483","0"
"Wichita","0","84","Texas","5/31/20","82","2","48485","2.44"
"Wilbarger","0","7","Texas","5/31/20","6","1","48487","16.67"
"Willacy","0","16","Texas","5/31/20","14","2","48489","14.29"
"Williamson","10","621","Texas","5/31/20","553","68","48491","12.3"
"Wilson","0","38","Texas","5/31/20","38","0","48493","0"
"Winkler","0","3","Texas","5/31/20","3","0","48495","0"
"Wise","1","46","Texas","5/31/20","42","4","48497","9.52"
"Wood","1","29","Texas","5/31/20","23","6","48499","26.09"
"Yoakum","0","3","Texas","5/31/20","3","0","48501","0"
"Young","0","4","Texas","5/31/20","4","0","48503","0"
"Zapata","0","9","Texas","5/31/20","8","1","48505","12.5"
"Zavala","0","11","Texas","5/31/20","11","0","48507","0"
"Bear River","17","218","Utah","5/31/20","102","116","00000","113.73"
"Central Utah","1","38","Utah","5/31/20","33","5","00000","15.15"
"Davis","8","465","Utah","5/31/20","410","55","49011","13.41"
"Salt Lake","104","5242","Utah","5/31/20","4515","727","49035","16.1"
"San Juan","5","297","Utah","5/31/20","264","33","49037","12.5"
"Southeast Utah","1","24","Utah","5/31/20","20","4","00000","20"
"Southwest Utah","19","440","Utah","5/31/20","305","135","00000","44.26"
"Summit","1","415","Utah","5/31/20","405","10","49043","2.47"
"Tooele","2","128","Utah","5/31/20","113","15","49045","13.27"
"TriCounty","0","21","Utah","5/31/20","20","1","00000","5"
"Utah","32","1929","Utah","5/31/20","1704","225","49049","13.2"
"Wasatch","6","282","Utah","5/31/20","241","41","49051","17.01"
"Weber-Morgan","5","298","Utah","5/31/20","260","38","00000","14.62"
"Addison","0","64","Vermont","5/31/20","62","2","50001","3.23"
"Bennington","0","63","Vermont","5/31/20","61","2","50003","3.28"
"Caledonia","0","15","Vermont","5/31/20","15","0","50005","0"
"Chittenden","2","451","Vermont","5/31/20","440","11","50007","2.5"
"Essex","0","3","Vermont","5/31/20","3","0","50009","0"
"Franklin","0","99","Vermont","5/31/20","99","0","50011","0"
"Grand Isle","0","7","Vermont","5/31/20","6","1","50013","16.67"
"Lamoille","0","29","Vermont","5/31/20","29","0","50015","0"
"Orange","0","9","Vermont","5/31/20","8","1","50017","12.5"
"Orleans","0","10","Vermont","5/31/20","9","1","50019","11.11"
"Rutland","1","55","Vermont","5/31/20","51","4","50021","7.84"
"Washington","0","39","Vermont","5/31/20","39","0","50023","0"
"Windham","0","81","Vermont","5/31/20","80","1","50025","1.25"
"Windsor","0","51","Vermont","5/31/20","49","2","50027","4.08"
"","0","69","Virgin Islands","5/31/20","69","0",,"0"
"Accomack","26","909","Virginia","5/31/20","727","182","51001","25.03"
"Albemarle","6","187","Virginia","5/31/20","148","39","51003","26.35"
"Alexandria","34","1974","Virginia","5/31/20","1733","241","51510","13.91"
"Alleghany","1","20","Virginia","5/31/20","13","7","51005","53.85"
"Amelia","1","25","Virginia","5/31/20","21","4","51007","19.05"
"Amherst","0","27","Virginia","5/31/20","25","2","51009","8"
"Appomattox","1","31","Virginia","5/31/20","26","5","51011","19.23"
"Arlington","35","2116","Virginia","5/31/20","1873","243","51013","12.97"
"Augusta","3","109","Virginia","5/31/20","90","19","51015","21.11"
"Bedford","2","57","Virginia","5/31/20","41","16","51019","39.02"
"Botetourt","0","32","Virginia","5/31/20","31","1","51023","3.23"
"Bristol","0","4","Virginia","5/31/20","4","0","51520","0"
"Brunswick","1","25","Virginia","5/31/20","21","4","51025","19.05"
"Buchanan","0","18","Virginia","5/31/20","18","0","51027","0"
"Buckingham","2","459","Virginia","5/31/20","442","17","51029","3.85"
"Buena Vista","0","13","Virginia","5/31/20","12","1","51530","8.33"
"Campbell","1","18","Virginia","5/31/20","13","5","51031","38.46"
"Caroline","3","67","Virginia","5/31/20","47","20","51033","42.55"
"Carroll","3","96","Virginia","5/31/20","74","22","51035","29.73"
"Charles City","0","27","Virginia","5/31/20","27","0","51036","0"
"Charlotte","1","23","Virginia","5/31/20","19","4","51037","21.05"
"Charlottesville","5","116","Virginia","5/31/20","80","36","51540","45"
"Chesapeake","13","521","Virginia","5/31/20","433","88","51550","20.32"
"Chesterfield","51","1548","Virginia","5/31/20","1193","355","51041","29.76"
"Clarke","1","27","Virginia","5/31/20","21","6","51043","28.57"
"Colonial Heights","2","95","Virginia","5/31/20","83","12","51570","14.46"
"Covington","0","4","Virginia","5/31/20","3","1","51580","33.33"
"Craig","0","5","Virginia","5/31/20","5","0","51045","0"
"Culpeper","14","691","Virginia","5/31/20","594","97","51047","16.33"
"Cumberland","2","37","Virginia","5/31/20","26","11","51049","42.31"
"Danville","1","55","Virginia","5/31/20","46","9","51590","19.57"
"Dinwiddie","5","80","Virginia","5/31/20","48","32","51053","66.67"
"Emporia","3","79","Virginia","5/31/20","60","19","51595","31.67"
"Essex","1","48","Virginia","5/31/20","43","5","51057","11.63"
"Fairfax","303","11110","Virginia","5/31/20","8989","2121","51059","23.6"
"Fairfax City","2","65","Virginia","5/31/20","52","13","51600","25"
"Falls Church","1","55","Virginia","5/31/20","47","8","51610","17.02"
"Fauquier","5","315","Virginia","5/31/20","282","33","51061","11.7"
"Floyd","0","6","Virginia","5/31/20","4","2","51063","50"
"Fluvanna","1","92","Virginia","5/31/20","84","8","51065","9.52"
"Franklin","1","36","Virginia","5/31/20","32","4","51067","12.5"
"Franklin City","1","42","Virginia","5/31/20","38","4","51620","10.53"
"Frederick","12","349","Virginia","5/31/20","262","87","51069","33.21"
"Fredericksburg","7","164","Virginia","5/31/20","118","46","51630","38.98"
"Galax","5","123","Virginia","5/31/20","88","35","51640","39.77"
"Giles","0","5","Virginia","5/31/20","5","0","51071","0"
"Gloucester","0","31","Virginia","5/31/20","30","1","51073","3.33"
"Goochland","1","99","Virginia","5/31/20","90","9","51075","10"
"Grayson","2","38","Virginia","5/31/20","26","12","51077","46.15"
"Greene","2","34","Virginia","5/31/20","22","12","51079","54.55"
"Greensville","3","73","Virginia","5/31/20","55","18","51081","32.73"
"Halifax","0","30","Virginia","5/31/20","29","1","51083","3.45"
"Hampton","5","207","Virginia","5/31/20","174","33","51650","18.97"
"Hanover","11","326","Virginia","5/31/20","252","74","51085","29.37"
"Harrisonburg","9","779","Virginia","5/31/20","716","63","51660","8.8"
"Henrico","53","1820","Virginia","5/31/20","1446","374","51087","25.86"
"Henry","7","113","Virginia","5/31/20","67","46","51089","68.66"
"Highland","0","3","Virginia","5/31/20","3","0","51091","0"
"Hopewell","3","90","Virginia","5/31/20","66","24","51670","36.36"
"Isle of Wight","1","128","Virginia","5/31/20","124","4","51093","3.23"
"James City","1","205","Virginia","5/31/20","196","9","51095","4.59"
"King and Queen","1","13","Virginia","5/31/20","7","6","51097","85.71"
"King George","2","68","Virginia","5/31/20","54","14","51099","25.93"
"King William","1","30","Virginia","5/31/20","20","10","51101","50"
"Lancaster","0","10","Virginia","5/31/20","10","0","51103","0"
"Lee","0","9","Virginia","5/31/20","9","0","51105","0"
"Lexington","0","7","Virginia","5/31/20","6","1","51678","16.67"
"Loudoun","108","2575","Virginia","5/31/20","1821","754","51107","41.41"
"Louisa","1","79","Virginia","5/31/20","69","10","51109","14.49"
"Lunenburg","1","13","Virginia","5/31/20","8","5","51111","62.5"
"Lynchburg","0","80","Virginia","5/31/20","77","3","51680","3.9"
"Madison","1","41","Virginia","5/31/20","32","9","51113","28.12"
"Manassas","41","1092","Virginia","5/31/20","806","286","51683","35.48"
"Manassas Park","9","305","Virginia","5/31/20","239","66","51685","27.62"
"Martinsville","1","31","Virginia","5/31/20","24","7","51690","29.17"
"Mathews","0","5","Virginia","5/31/20","5","0","51115","0"
"Mecklenburg","2","217","Virginia","5/31/20","200","17","51117","8.5"
"Middlesex","0","15","Virginia","5/31/20","12","3","51119","25"
"Montgomery","1","77","Virginia","5/31/20","69","8","51121","11.59"
"Nelson","1","17","Virginia","5/31/20","13","4","51125","30.77"
"New Kent","1","36","Virginia","5/31/20","27","9","51127","33.33"
"Newport News","5","273","Virginia","5/31/20","237","36","51700","15.19"
"Norfolk","15","503","Virginia","5/31/20","399","104","51710","26.07"
"Northampton","3","237","Virginia","5/31/20","213","24","51131","11.27"
"Northumberland","0","25","Virginia","5/31/20","22","3","51133","13.64"
"Norton","0","2","Virginia","5/31/20","2","0","51720","0"
"Nottoway","1","29","Virginia","5/31/20","19","10","51135","52.63"
"Orange","3","102","Virginia","5/31/20","80","22","51137","27.5"
"Page","5","220","Virginia","5/31/20","188","32","51139","17.02"
"Patrick","1","19","Virginia","5/31/20","14","5","51141","35.71"
"Petersburg","7","134","Virginia","5/31/20","86","48","51730","55.81"
"Pittsylvania","2","44","Virginia","5/31/20","32","12","51143","37.5"
"Poquoson","0","8","Virginia","5/31/20","7","1","51735","14.29"
"Portsmouth","7","308","Virginia","5/31/20","262","46","51740","17.56"
"Powhatan","1","35","Virginia","5/31/20","29","6","51145","20.69"
"Prince Edward","4","134","Virginia","5/31/20","108","26","51147","24.07"
"Prince George","9","126","Virginia","5/31/20","60","66","51149","110"
"Prince William","152","5533","Virginia","5/31/20","4468","1065","51153","23.84"
"Pulaski","1","19","Virginia","5/31/20","10","9","51155","90"
"Radford","0","6","Virginia","5/31/20","6","0","51750","0"
"Rappahannock","0","13","Virginia","5/31/20","12","1","51157","8.33"
"Richmond","0","276","Virginia","5/31/20","275","1","51159","0.36"
"Richmond City","43","1316","Virginia","5/31/20","1012","304","51760","30.04"
"Roanoke","2","105","Virginia","5/31/20","90","15","51161","16.67"
"Roanoke City","3","160","Virginia","5/31/20","140","20","51770","14.29"
"Rockbridge","1","18","Virginia","5/31/20","14","4","51163","28.57"
"Rockingham","9","518","Virginia","5/31/20","453","65","51165","14.35"
"Russell","0","8","Virginia","5/31/20","8","0","51167","0"
"Salem","0","34","Virginia","5/31/20","32","2","51775","6.25"
"Scott","0","7","Virginia","5/31/20","7","0","51169","0"
"Shenandoah","11","448","Virginia","5/31/20","372","76","51171","20.43"
"Smyth","0","15","Virginia","5/31/20","15","0","51173","0"
"Southampton","1","147","Virginia","5/31/20","143","4","51175","2.8"
"Spotsylvania","22","556","Virginia","5/31/20","401","155","51177","38.65"
"Stafford","19","713","Virginia","5/31/20","581","132","51179","22.72"
"Staunton","1","45","Virginia","5/31/20","35","10","51790","28.57"
"Suffolk","3","315","Virginia","5/31/20","295","20","51800","6.78"
"Surry","1","10","Virginia","5/31/20","6","4","51181","66.67"
"Sussex","6","154","Virginia","5/31/20","114","40","51183","35.09"
"Tazewell","0","9","Virginia","5/31/20","6","3","51185","50"
"Virginia Beach","15","708","Virginia","5/31/20","603","105","51810","17.41"
"Warren","7","157","Virginia","5/31/20","111","46","51187","41.44"
"Washington","0","51","Virginia","5/31/20","51","0","51191","0"
"Waynesboro","1","46","Virginia","5/31/20","38","8","51820","21.05"
"Westmoreland","2","65","Virginia","5/31/20","48","17","51193","35.42"
"Williamsburg","0","44","Virginia","5/31/20","43","1","51830","2.33"
"Winchester","7","189","Virginia","5/31/20","143","46","51840","32.17"
"Wise","0","25","Virginia","5/31/20","24","1","51195","4.17"
"Wythe","1","23","Virginia","5/31/20","17","6","51197","35.29"
"York","1","74","Virginia","5/31/20","68","6","51199","8.82"
"Adams","1","63","Washington","5/31/20","53","10","53001","18.87"
"Asotin","0","19","Washington","5/31/20","18","1","53003","5.56"
"Benton","14","794","Washington","5/31/20","696","98","53005","14.08"
"Chelan","3","248","Washington","5/31/20","229","19","53007","8.3"
"Clallam","0","25","Washington","5/31/20","25","0","53009","0"
"Clark","15","514","Washington","5/31/20","410","104","53011","25.37"
"Columbia","0","1","Washington","5/31/20","1","0","53013","0"
"Cowlitz","0","73","Washington","5/31/20","72","1","53015","1.39"
"Douglas","2","172","Washington","5/31/20","157","15","53017","9.55"
"Ferry","0","1","Washington","5/31/20","1","0","53019","0"
"Franklin","11","574","Washington","5/31/20","499","75","53021","15.03"
"Grant","2","204","Washington","5/31/20","190","14","53025","7.37"
"Grays Harbor","0","17","Washington","5/31/20","16","1","53027","6.25"
"Island","0","178","Washington","5/31/20","177","1","53029","0.56"
"Jefferson","0","30","Washington","5/31/20","30","0","53031","0"
"King","44","8092","Washington","5/31/20","7783","309","53033","3.97"
"Kitsap","0","161","Washington","5/31/20","161","0","53035","0"
"Kittitas","2","88","Washington","5/31/20","72","16","53037","22.22"
"Klickitat","0","25","Washington","5/31/20","24","1","53039","4.17"
"Lewis","0","37","Washington","5/31/20","35","2","53041","5.71"
"Lincoln","0","2","Washington","5/31/20","2","0","53043","0"
"Mason","0","36","Washington","5/31/20","34","2","53045","5.88"
"Okanogan","1","49","Washington","5/31/20","43","6","53047","13.95"
"Pacific","0","9","Washington","5/31/20","9","0","53049","0"
"Pend Oreille","0","3","Washington","5/31/20","3","0","53051","0"
"Pierce","26","1937","Washington","5/31/20","1756","181","53053","10.31"
"San Juan","0","15","Washington","5/31/20","15","0","53055","0"
"Skagit","1","434","Washington","5/31/20","426","8","53057","1.88"
"Skamania","0","3","Washington","5/31/20","3","0","53059","0"
"Snohomish","10","2967","Washington","5/31/20","2895","72","53061","2.49"
"Spokane","17","596","Washington","5/31/20","477","119","53063","24.95"
"Stevens","0","11","Washington","5/31/20","10","1","53065","10"
"Thurston","3","147","Washington","5/31/20","127","20","53067","15.75"
"Wahkiakum","0","4","Washington","5/31/20","4","0","53069","0"
"Walla Walla","0","108","Washington","5/31/20","107","1","53071","0.93"
"Whatcom","4","396","Washington","5/31/20","368","28","53073","7.61"
"Whitman","0","16","Washington","5/31/20","16","0","53075","0"
"Yakima","110","3585","Washington","5/31/20","2812","773","53077","27.49"
"Barbour","0","9","West Virginia","5/31/20","7","2","54001","28.57"
"Berkeley","3","308","West Virginia","5/31/20","285","23","54003","8.07"
"Boone","0","9","West Virginia","5/31/20","9","0","54005","0"
"Braxton","0","2","West Virginia","5/31/20","2","0","54007","0"
"Brooke","0","5","West Virginia","5/31/20","3","2","54009","66.67"
"Cabell","1","66","West Virginia","5/31/20","59","7","54011","11.86"
"Calhoun","0","2","West Virginia","5/31/20","2","0","54013","0"
"Clay","0","4","West Virginia","5/31/20","2","2","54015","100"
"Fayette","0","48","West Virginia","5/31/20","46","2","54019","4.35"
"Gilmer","0","10","West Virginia","5/31/20","10","0","54021","0"
"Grant","0","12","West Virginia","5/31/20","9","3","54023","33.33"
"Greenbrier","0","9","West Virginia","5/31/20","9","0","54025","0"
"Hampshire","2","29","West Virginia","5/31/20","15","14","54027","93.33"
"Hancock","0","18","West Virginia","5/31/20","18","0","54029","0"
"Hardy","0","39","West Virginia","5/31/20","37","2","54031","5.41"
"Harrison","0","41","West Virginia","5/31/20","39","2","54033","5.13"
"Jackson","0","137","West Virginia","5/31/20","135","2","54035","1.48"
"Jefferson","4","182","West Virginia","5/31/20","153","29","54037","18.95"
"Kanawha","2","229","West Virginia","5/31/20","212","17","54039","8.02"
"Lewis","1","9","West Virginia","5/31/20","5","4","54041","80"
"Lincoln","0","6","West Virginia","5/31/20","5","1","54043","20"
"Logan","0","17","West Virginia","5/31/20","16","1","54045","6.25"
"Marion","0","51","West Virginia","5/31/20","48","3","54049","6.25"
"Marshall","0","30","West Virginia","5/31/20","27","3","54051","11.11"
"Mason","0","15","West Virginia","5/31/20","16","-1","54053","-6.25"
"McDowell","0","6","West Virginia","5/31/20","6","0","54047","0"
"Mercer","0","13","West Virginia","5/31/20","13","0","54055","0"
"Mineral","1","46","West Virginia","5/31/20","38","8","54057","21.05"
"Mingo","0","7","West Virginia","5/31/20","5","2","54059","40"
"Monongalia","2","133","West Virginia","5/31/20","121","12","54061","9.92"
"Monroe","0","7","West Virginia","5/31/20","7","0","54063","0"
"Morgan","0","18","West Virginia","5/31/20","17","1","54065","5.88"
"Nicholas","0","8","West Virginia","5/31/20","10","-2","54067","-20"
"Ohio","1","42","West Virginia","5/31/20","38","4","54069","10.53"
"Pendleton","0","12","West Virginia","5/31/20","9","3","54071","33.33"
"Pleasants","0","4","West Virginia","5/31/20","4","0","54073","0"
"Pocahontas","0","21","West Virginia","5/31/20","24","-3","54075","-12.5"
"Preston","1","25","West Virginia","5/31/20","20","5","54077","25"
"Putnam","0","34","West Virginia","5/31/20","31","3","54079","9.68"
"Raleigh","0","16","West Virginia","5/31/20","15","1","54081","6.67"
"Randolph","14","131","West Virginia","5/31/20","36","95","54083","263.89"
"Ritchie","0","1","West Virginia","5/31/20","1","0","54085","0"
"Roane","0","9","West Virginia","5/31/20","8","1","54087","12.5"
"Summers","0","1","West Virginia","5/31/20","2","-1","54089","-50"
"Taylor","0","8","West Virginia","5/31/20","8","0","54091","0"
"Tucker","0","4","West Virginia","5/31/20","4","0","54093","0"
"Tyler","0","3","West Virginia","5/31/20","3","0","54095","0"
"Upshur","0","7","West Virginia","5/31/20","7","0","54097","0"
"Wayne","0","99","West Virginia","5/31/20","97","2","54099","2.06"
"Wetzel","0","8","West Virginia","5/31/20","8","0","54103","0"
"Wirt","0","4","West Virginia","5/31/20","4","0","54105","0"
"Wood","0","53","West Virginia","5/31/20","51","2","54107","3.92"
"Wyoming","0","3","West Virginia","5/31/20","3","0","54109","0"
"Adams","0","4","Wisconsin","5/31/20","4","0","55001","0"
"Ashland","0","2","Wisconsin","5/31/20","2","0","55003","0"
"Barron","1","17","Wisconsin","5/31/20","12","5","55005","41.67"
"Bayfield","0","3","Wisconsin","5/31/20","3","0","55007","0"
"Brown","11","2319","Wisconsin","5/31/20","2243","76","55009","3.39"
"Buffalo","0","6","Wisconsin","5/31/20","5","1","55011","20"
"Burnett","0","1","Wisconsin","5/31/20","1","0","55013","0"
"Calumet","1","76","Wisconsin","5/31/20","69","7","55015","10.14"
"Chippewa","1","56","Wisconsin","5/31/20","49","7","55017","14.29"
"Clark","1","32","Wisconsin","5/31/20","28","4","55019","14.29"
"Columbia","1","44","Wisconsin","5/31/20","37","7","55021","18.92"
"Crawford","0","26","Wisconsin","5/31/20","25","1","55023","4"
"Dane","19","730","Wisconsin","5/31/20","596","134","55025","22.48"
"Dodge","10","221","Wisconsin","5/31/20","152","69","55027","45.39"
"Door","0","38","Wisconsin","5/31/20","37","1","55029","2.7"
"Douglas","0","19","Wisconsin","5/31/20","17","2","55031","11.76"
"Dunn","0","24","Wisconsin","5/31/20","22","2","55033","9.09"
"Eau Claire","2","108","Wisconsin","5/31/20","96","12","55035","12.5"
"Florence","0","2","Wisconsin","5/31/20","2","0","55037","0"
"Fond du Lac","7","213","Wisconsin","5/31/20","165","48","55039","29.09"
"Forest","3","29","Wisconsin","5/31/20","11","18","55041","163.64"
"Grant","2","95","Wisconsin","5/31/20","82","13","55043","15.85"
"Green","2","66","Wisconsin","5/31/20","53","13","55045","24.53"
"Green Lake","1","20","Wisconsin","5/31/20","14","6","55047","42.86"
"Iowa","1","16","Wisconsin","5/31/20","11","5","55049","45.45"
"Iron","0","2","Wisconsin","5/31/20","2","0","55051","0"
"Jackson","0","17","Wisconsin","5/31/20","15","2","55053","13.33"
"Jefferson","4","106","Wisconsin","5/31/20","80","26","55055","32.5"
"Juneau","0","23","Wisconsin","5/31/20","22","1","55057","4.55"
"Kenosha","24","1168","Wisconsin","5/31/20","998","170","55059","17.03"
"Kewaunee","0","35","Wisconsin","5/31/20","33","2","55061","6.06"
"La Crosse","1","53","Wisconsin","5/31/20","47","6","55063","12.77"
"Lafayette","1","27","Wisconsin","5/31/20","20","7","55065","35"
"Langlade","0","3","Wisconsin","5/31/20","1","2","55067","200"
"Lincoln","0","7","Wisconsin","5/31/20","4","3","55069","75"
"Manitowoc","1","36","Wisconsin","5/31/20","29","7","55071","24.14"
"Marathon","1","50","Wisconsin","5/31/20","41","9","55073","21.95"
"Marinette","0","33","Wisconsin","5/31/20","31","2","55075","6.45"
"Marquette","0","4","Wisconsin","5/31/20","3","1","55077","33.33"
"Menominee","0","3","Wisconsin","5/31/20","3","0","55078","0"
"Milwaukee","224","7750","Wisconsin","5/31/20","6185","1565","55079","25.3"
"Monroe","0","17","Wisconsin","5/31/20","16","1","55081","6.25"
"Oconto","0","37","Wisconsin","5/31/20","34","3","55083","8.82"
"Oneida","0","9","Wisconsin","5/31/20","7","2","55085","28.57"
"Outagamie","6","227","Wisconsin","5/31/20","184","43","55087","23.37"
"Ozaukee","4","162","Wisconsin","5/31/20","137","25","55089","18.25"
"Pepin","0","1","Wisconsin","5/31/20","1","0","55091","0"
"Pierce","0","45","Wisconsin","5/31/20","42","3","55093","7.14"
"Polk","0","19","Wisconsin","5/31/20","16","3","55095","18.75"
"Portage","0","11","Wisconsin","5/31/20","10","1","55097","10"
"Price","0","2","Wisconsin","5/31/20","2","0","55099","0"
"Racine","48","1722","Wisconsin","5/31/20","1387","335","55101","24.15"
"Richland","0","14","Wisconsin","5/31/20","14","0","55103","0"
"Rock","13","636","Wisconsin","5/31/20","545","91","55105","16.7"
"Rusk","0","5","Wisconsin","5/31/20","4","1","55107","25"
"Sauk","0","78","Wisconsin","5/31/20","77","1","55111","1.3"
"Sawyer","0","8","Wisconsin","5/31/20","7","1","55113","14.29"
"Shawano","1","47","Wisconsin","5/31/20","38","9","55115","23.68"
"Sheboygan","1","90","Wisconsin","5/31/20","82","8","55117","9.76"
"St. Croix","3","86","Wisconsin","5/31/20","67","19","55109","28.36"
"Taylor","0","2","Wisconsin","5/31/20","1","1","55119","100"
"Trempealeau","1","25","Wisconsin","5/31/20","18","7","55121","38.89"
"Vernon","1","21","Wisconsin","5/31/20","16","5","55123","31.25"
"Vilas","0","7","Wisconsin","5/31/20","6","1","55125","16.67"
"Walworth","7","395","Wisconsin","5/31/20","348","47","55127","13.51"
"Washburn","0","2","Wisconsin","5/31/20","2","0","55129","0"
"Washington","8","252","Wisconsin","5/31/20","193","59","55131","30.57"
"Waukesha","19","696","Wisconsin","5/31/20","561","135","55133","24.06"
"Waupaca","3","41","Wisconsin","5/31/20","23","18","55135","78.26"
"Waushara","0","8","Wisconsin","5/31/20","8","0","55137","0"
"Winnebago","10","244","Wisconsin","5/31/20","172","72","55139","41.86"
"Wood","0","10","Wisconsin","5/31/20","9","1","55141","11.11"
"Albany","1","25","Wyoming","5/31/20","17","8","56001","47.06"
"Big Horn","0","6","Wyoming","5/31/20","4","2","56003","50"
"Campbell","0","31","Wyoming","5/31/20","30","1","56005","3.33"
"Carbon","0","16","Wyoming","5/31/20","16","0","56007","0"
"Converse","0","24","Wyoming","5/31/20","24","0","56009","0"
"Crook","0","5","Wyoming","5/31/20","5","0","56011","0"
"Fremont","4","278","Wyoming","5/31/20","248","30","56013","12.1"
"Goshen","0","5","Wyoming","5/31/20","5","0","56015","0"
"Hot Springs","0","12","Wyoming","5/31/20","10","2","56017","20"
"Johnson","0","18","Wyoming","5/31/20","18","0","56019","0"
"Laramie","1","188","Wyoming","5/31/20","182","6","56021","3.3"
"Lincoln","0","15","Wyoming","5/31/20","15","0","56023","0"
"Natrona","1","77","Wyoming","5/31/20","71","6","56025","8.45"
"Niobrara","0","2","Wyoming","5/31/20","2","0","56027","0"
"Park","0","2","Wyoming","5/31/20","2","0","56029","0"
"Platte","0","1","Wyoming","5/31/20","1","0","56031","0"
"Sheridan","0","16","Wyoming","5/31/20","16","0","56033","0"
"Sublette","0","3","Wyoming","5/31/20","3","0","56035","0"
"Sweetwater","1","30","Wyoming","5/31/20","25","5","56037","20"
"Teton","0","100","Wyoming","5/31/20","100","0","56039","0"
"Uinta","0","12","Wyoming","5/31/20","12","0","56041","0"
"Washakie","1","36","Wyoming","5/31/20","32","4","56043","12.5"
"Weston","0","1","Wyoming","5/31/20","0","1","56045","1"
