"Locality","DailyAvgNewCasesPast7Days","TotalCases","State","Date","TotalCases7DaysAgo","NewCasesPast7Days","FIPS-Code","PercentIncreaseTotalCasesPast7Days"
"Autauga","7","239","Alabama","6/3/20","192","47","01001","24.48"
"Baldwin","1","292","Alabama","6/3/20","282","10","01003","3.55"
"Barbour","7","177","Alabama","6/3/20","130","47","01005","36.15"
"Bibb","1","76","Alabama","6/3/20","71","5","01007","7.04"
"Blount","1","63","Alabama","6/3/20","53","10","01009","18.87"
"Bullock","6","215","Alabama","6/3/20","176","39","01011","22.16"
"Butler","4","419","Alabama","6/3/20","391","28","01013","7.16"
"Calhoun","2","165","Alabama","6/3/20","152","13","01015","8.55"
"Chambers","3","359","Alabama","6/3/20","340","19","01017","5.59"
"Cherokee","1","38","Alabama","6/3/20","33","5","01019","15.15"
"Chilton","2","105","Alabama","6/3/20","93","12","01021","12.9"
"Choctaw","1","153","Alabama","6/3/20","148","5","01023","3.38"
"Clarke","3","149","Alabama","6/3/20","128","21","01025","16.41"
"Clay","0","28","Alabama","6/3/20","27","1","01027","3.7"
"Cleburne","0","15","Alabama","6/3/20","13","2","01029","15.38"
"Coffee","3","239","Alabama","6/3/20","219","20","01031","9.13"
"Colbert","4","187","Alabama","6/3/20","161","26","01033","16.15"
"Conecuh","1","41","Alabama","6/3/20","35","6","01035","17.14"
"Coosa","1","40","Alabama","6/3/20","34","6","01037","17.65"
"Covington","1","81","Alabama","6/3/20","75","6","01039","8"
"Crenshaw","2","78","Alabama","6/3/20","66","12","01041","18.18"
"Cullman","9","150","Alabama","6/3/20","88","62","01043","70.45"
"Dale","4","123","Alabama","6/3/20","96","27","01045","28.12"
"Dallas","8","287","Alabama","6/3/20","232","55","01047","23.71"
"DeKalb","2","257","Alabama","6/3/20","240","17","01049","7.08"
"Elmore","10","372","Alabama","6/3/20","300","72","01051","24"
"Escambia","4","75","Alabama","6/3/20","48","27","01053","56.25"
"Etowah","3","262","Alabama","6/3/20","240","22","01055","9.17"
"Fayette","0","16","Alabama","6/3/20","13","3","01057","23.08"
"Franklin","11","578","Alabama","6/3/20","498","80","01059","16.06"
"Geneva","1","44","Alabama","6/3/20","40","4","01061","10"
"Greene","1","95","Alabama","6/3/20","91","4","01063","4.4"
"Hale","5","179","Alabama","6/3/20","141","38","01065","26.95"
"Henry","2","81","Alabama","6/3/20","70","11","01067","15.71"
"Houston","6","226","Alabama","6/3/20","185","41","01069","22.16"
"Jackson","1","83","Alabama","6/3/20","74","9","01071","12.16"
"Jefferson","30","1884","Alabama","6/3/20","1673","211","01073","12.61"
"Lamar","1","26","Alabama","6/3/20","21","5","01075","23.81"
"Lauderdale","3","169","Alabama","6/3/20","145","24","01077","16.55"
"Lawrence","1","51","Alabama","6/3/20","46","5","01079","10.87"
"Lee","5","558","Alabama","6/3/20","526","32","01081","6.08"
"Limestone","3","108","Alabama","6/3/20","86","22","01083","25.58"
"Lowndes","6","259","Alabama","6/3/20","216","43","01085","19.91"
"Macon","3","87","Alabama","6/3/20","67","20","01087","29.85"
"Madison","4","346","Alabama","6/3/20","315","31","01089","9.84"
"Marengo","3","174","Alabama","6/3/20","150","24","01091","16"
"Marion","1","124","Alabama","6/3/20","117","7","01093","5.98"
"Marshall","6","705","Alabama","6/3/20","660","45","01095","6.82"
"Mobile","28","2284","Alabama","6/3/20","2085","199","01097","9.54"
"Monroe","2","45","Alabama","6/3/20","34","11","01099","32.35"
"Montgomery","54","1823","Alabama","6/3/20","1446","377","01101","26.07"
"Morgan","12","298","Alabama","6/3/20","211","87","01103","41.23"
"Perry","1","42","Alabama","6/3/20","36","6","01105","16.67"
"Pickens","4","121","Alabama","6/3/20","96","25","01107","26.04"
"Pike","5","208","Alabama","6/3/20","173","35","01109","20.23"
"Randolph","1","128","Alabama","6/3/20","124","4","01111","3.23"
"Russell","4","177","Alabama","6/3/20","148","29","01113","19.59"
"Shelby","7","522","Alabama","6/3/20","470","52","01117","11.06"
"St. Clair","3","131","Alabama","6/3/20","108","23","01115","21.3"
"Sumter","3","228","Alabama","6/3/20","210","18","01119","8.57"
"Talladega","3","117","Alabama","6/3/20","96","21","01121","21.88"
"Tallapoosa","3","432","Alabama","6/3/20","410","22","01123","5.37"
"Tuscaloosa","27","822","Alabama","6/3/20","632","190","01125","30.06"
"Walker","14","381","Alabama","6/3/20","282","99","01127","35.11"
"Washington","1","72","Alabama","6/3/20","65","7","01129","10.77"
"Wilcox","3","154","Alabama","6/3/20","132","22","01131","16.67"
"Winston","2","91","Alabama","6/3/20","77","14","01133","18.18"
"Anchorage","7","254","Alaska","6/3/20","207","47","02020","22.71"
"Bethel","0","3","Alaska","6/3/20","3","0","02050","0"
"Fairbanks North Star","0","85","Alaska","6/3/20","85","0","02090","0"
"Juneau","0","33","Alaska","6/3/20","31","2","02110","6.45"
"Kenai Peninsula","5","60","Alaska","6/3/20","27","33","02122","122.22"
"Ketchikan Gateway","0","16","Alaska","6/3/20","16","0","02130","0"
"Kodiak Island","0","1","Alaska","6/3/20","1","0","02150","0"
"Matanuska-Susitna","1","34","Alaska","6/3/20","24","10","02170","41.67"
"Nome","0","3","Alaska","6/3/20","3","0","02180","0"
"North Slope","0","1","Alaska","6/3/20","0","1","02185","1"
"Northwest Arctic","0","2","Alaska","6/3/20","2","0","02188","0"
"Petersburg","0","4","Alaska","6/3/20","4","0","02195","0"
"Prince of Wales-Hyder","0","2","Alaska","6/3/20","2","0","02198","0"
"Sitka","0","2","Alaska","6/3/20","2","0","02220","0"
"Southeast Fairbanks","0","3","Alaska","6/3/20","3","0","02240","0"
"Yukon-Koyukuk","0","1","Alaska","6/3/20","1","0","02290","0"
"Apache","48","1586","Arizona","6/3/20","1250","336","04001","26.88"
"Cochise","4","94","Arizona","6/3/20","63","31","04003","49.21"
"Coconino","17","1186","Arizona","6/3/20","1066","120","04005","11.26"
"Gila","2","37","Arizona","6/3/20","25","12","04007","48"
"Graham","2","41","Arizona","6/3/20","25","16","04009","64"
"Greenlee","1","8","Arizona","6/3/20","3","5","04011","166.67"
"La Paz","5","91","Arizona","6/3/20","54","37","04012","68.52"
"Maricopa","349","11068","Arizona","6/3/20","8627","2441","04013","28.29"
"Mohave","12","422","Arizona","6/3/20","339","83","04015","24.48"
"Navajo","49","1994","Arizona","6/3/20","1652","342","04017","20.7"
"Pima","73","2627","Arizona","6/3/20","2119","508","04019","23.97"
"Pinal","23","940","Arizona","6/3/20","777","163","04021","20.98"
"Santa Cruz","36","438","Arizona","6/3/20","188","250","04023","132.98"
"Yavapai","2","304","Arizona","6/3/20","292","12","04025","4.11"
"Yuma","97","1520","Arizona","6/3/20","838","682","04027","81.38"
"Arkansas","1","7","Arkansas","6/3/20","3","4","05001","133.33"
"Ashley","0","20","Arkansas","6/3/20","19","1","05003","5.26"
"Baxter","1","12","Arkansas","6/3/20","8","4","05005","50"
"Benton","52","700","Arkansas","6/3/20","339","361","05007","106.49"
"Boone","0","7","Arkansas","6/3/20","6","1","05009","16.67"
"Bradley","1","23","Arkansas","6/3/20","18","5","05011","27.78"
"Carroll","1","29","Arkansas","6/3/20","21","8","05015","38.1"
"Chicot","0","16","Arkansas","6/3/20","14","2","05017","14.29"
"Clark","1","41","Arkansas","6/3/20","37","4","05019","10.81"
"Clay","0","5","Arkansas","6/3/20","4","1","05021","25"
"Cleburne","0","76","Arkansas","6/3/20","73","3","05023","4.11"
"Cleveland","0","19","Arkansas","6/3/20","18","1","05025","5.56"
"Columbia","0","22","Arkansas","6/3/20","20","2","05027","10"
"Conway","0","14","Arkansas","6/3/20","14","0","05029","0"
"Craighead","9","257","Arkansas","6/3/20","191","66","05031","34.55"
"Crawford","2","34","Arkansas","6/3/20","17","17","05033","100"
"Crittenden","16","413","Arkansas","6/3/20","301","112","05035","37.21"
"Cross","1","56","Arkansas","6/3/20","46","10","05037","21.74"
"Dallas","0","3","Arkansas","6/3/20","1","2","05039","200"
"Desha","0","19","Arkansas","6/3/20","19","0","05041","0"
"Drew","0","20","Arkansas","6/3/20","19","1","05043","5.26"
"Faulkner","1","106","Arkansas","6/3/20","100","6","05045","6"
"Franklin","0","4","Arkansas","6/3/20","4","0","05047","0"
"Fulton","0","7","Arkansas","6/3/20","6","1","05049","16.67"
"Garland","0","138","Arkansas","6/3/20","135","3","05051","2.22"
"Grant","0","18","Arkansas","6/3/20","17","1","05053","5.88"
"Greene","2","66","Arkansas","6/3/20","54","12","05055","22.22"
"Hempstead","1","20","Arkansas","6/3/20","14","6","05057","42.86"
"Hot Spring","0","33","Arkansas","6/3/20","30","3","05059","10"
"Howard","1","26","Arkansas","6/3/20","17","9","05061","52.94"
"Independence","1","33","Arkansas","6/3/20","29","4","05063","13.79"
"Izard","0","17","Arkansas","6/3/20","15","2","05065","13.33"
"Jackson","0","4","Arkansas","6/3/20","1","3","05067","300"
"Jefferson","3","532","Arkansas","6/3/20","510","22","05069","4.31"
"Johnson","1","48","Arkansas","6/3/20","38","10","05071","26.32"
"Lafayette","0","9","Arkansas","6/3/20","9","0","05073","0"
"Lawrence","0","85","Arkansas","6/3/20","82","3","05075","3.66"
"Lee","1","24","Arkansas","6/3/20","17","7","05077","41.18"
"Lincoln","1","984","Arkansas","6/3/20","975","9","05079","0.92"
"Little River","1","9","Arkansas","6/3/20","5","4","05081","80"
"Logan","1","10","Arkansas","6/3/20","4","6","05083","150"
"Lonoke","1","55","Arkansas","6/3/20","45","10","05085","22.22"
"Madison","3","30","Arkansas","6/3/20","6","24","05087","400"
"Marion","0","2","Arkansas","6/3/20","1","1","05089","100"
"Miller","1","49","Arkansas","6/3/20","42","7","05091","16.67"
"Mississippi","1","78","Arkansas","6/3/20","72","6","05093","8.33"
"Monroe","0","6","Arkansas","6/3/20","5","1","05095","20"
"Montgomery","0","2","Arkansas","6/3/20","1","1","05097","100"
"Nevada","0","7","Arkansas","6/3/20","5","2","05099","40"
"Newton","0","3","Arkansas","6/3/20","3","0","05101","0"
"Ouachita","0","10","Arkansas","6/3/20","10","0","05103","0"
"Perry","0","14","Arkansas","6/3/20","14","0","05105","0"
"Phillips","2","24","Arkansas","6/3/20","12","12","05107","100"
"Pike","0","5","Arkansas","6/3/20","5","0","05109","0"
"Poinsett","1","38","Arkansas","6/3/20","31","7","05111","22.58"
"Polk","2","28","Arkansas","6/3/20","11","17","05113","154.55"
"Pope","7","171","Arkansas","6/3/20","125","46","05115","36.8"
"Prairie","0","3","Arkansas","6/3/20","2","1","05117","50"
"Pulaski","28","1003","Arkansas","6/3/20","808","195","05119","24.13"
"Randolph","0","26","Arkansas","6/3/20","26","0","05121","0"
"Saline","3","121","Arkansas","6/3/20","99","22","05125","22.22"
"Scott","0","1","Arkansas","6/3/20","1","0","05127","0"
"Searcy","0","7","Arkansas","6/3/20","7","0","05129","0"
"Sebastian","4","53","Arkansas","6/3/20","23","30","05131","130.43"
"Sevier","23","283","Arkansas","6/3/20","120","163","05133","135.83"
"Sharp","1","47","Arkansas","6/3/20","42","5","05135","11.9"
"St. Francis","5","687","Arkansas","6/3/20","655","32","05123","4.89"
"Stone","0","9","Arkansas","6/3/20","8","1","05137","12.5"
"Union","2","177","Arkansas","6/3/20","162","15","05139","9.26"
"Van Buren","0","29","Arkansas","6/3/20","28","1","05141","3.57"
"Washington","47","652","Arkansas","6/3/20","326","326","05143","100"
"White","1","48","Arkansas","6/3/20","42","6","05145","14.29"
"Woodruff","0","1","Arkansas","6/3/20","1","0","05147","0"
"Yell","11","183","Arkansas","6/3/20","108","75","05149","69.44"
"Alameda","71","3548","California","6/3/20","3049","499","06001","16.37"
"Alpine","0","2","California","6/3/20","2","0","06003","0"
"Amador","0","10","California","6/3/20","10","0","06005","0"
"Butte","2","55","California","6/3/20","40","15","06007","37.5"
"Calaveras","0","15","California","6/3/20","15","0","06009","0"
"Colusa","0","7","California","6/3/20","5","2","06011","40"
"Contra Costa","20","1513","California","6/3/20","1375","138","06013","10.04"
"Del Norte","1","47","California","6/3/20","40","7","06015","17.5"
"El Dorado","2","96","California","6/3/20","80","16","06017","20"
"Fresno","54","1914","California","6/3/20","1535","379","06019","24.69"
"Glenn","1","17","California","6/3/20","13","4","06021","30.77"
"Humboldt","1","103","California","6/3/20","98","5","06023","5.1"
"Imperial","96","2025","California","6/3/20","1352","673","06025","49.78"
"Inyo","0","20","California","6/3/20","19","1","06027","5.26"
"Kern","68","2418","California","6/3/20","1941","477","06029","24.57"
"Kings","67","1168","California","6/3/20","698","470","06031","67.34"
"Lake","2","30","California","6/3/20","19","11","06033","57.89"
"Lassen","0","5","California","6/3/20","4","1","06035","25"
"Los Angeles","1357","58261","California","6/3/20","48761","9500","06037","19.48"
"Madera","4","117","California","6/3/20","90","27","06039","30"
"Marin","12","506","California","6/3/20","420","86","06041","20.48"
"Mariposa","0","16","California","6/3/20","16","0","06043","0"
"Mendocino","1","30","California","6/3/20","23","7","06045","30.43"
"Merced","5","310","California","6/3/20","273","37","06047","13.55"
"Mono","0","37","California","6/3/20","35","2","06051","5.71"
"Monterey","22","586","California","6/3/20","429","157","06053","36.6"
"Napa","2","124","California","6/3/20","109","15","06055","13.76"
"Nevada","1","48","California","6/3/20","41","7","06057","17.07"
"Orange","147","6678","California","6/3/20","5646","1032","06059","18.28"
"Placer","7","240","California","6/3/20","194","46","06061","23.71"
"Plumas","0","4","California","6/3/20","4","0","06063","0"
"Riverside","145","8155","California","6/3/20","7139","1016","06065","14.23"
"Sacramento","21","1463","California","6/3/20","1319","144","06067","10.92"
"San Benito","2","90","California","6/3/20","76","14","06069","18.42"
"San Bernardino","155","5650","California","6/3/20","4567","1083","06071","23.71"
"San Diego","113","7674","California","6/3/20","6882","792","06073","11.51"
"San Francisco","29","2613","California","6/3/20","2408","205","06075","8.51"
"San Joaquin","44","1080","California","6/3/20","771","309","06077","40.08"
"San Luis Obispo","2","279","California","6/3/20","263","16","06079","6.08"
"San Mateo","36","2212","California","6/3/20","1963","249","06081","12.68"
"Santa Barbara","13","1697","California","6/3/20","1604","93","06083","5.8"
"Santa Clara","21","2832","California","6/3/20","2688","144","06085","5.36"
"Santa Cruz","2","219","California","6/3/20","205","14","06087","6.83"
"Shasta","0","40","California","6/3/20","37","3","06089","8.11"
"Sierra","0","1","California","6/3/20","1","0","06091","0"
"Siskiyou","0","9","California","6/3/20","6","3","06093","50"
"Solano","7","547","California","6/3/20","499","48","06095","9.62"
"Sonoma","8","579","California","6/3/20","524","55","06097","10.5"
"Stanislaus","14","767","California","6/3/20","670","97","06099","14.48"
"Sutter","1","46","California","6/3/20","42","4","06101","9.52"
"Tehama","0","6","California","6/3/20","4","2","06103","50"
"Trinity","0","1","California","6/3/20","1","0","06105","0"
"Tulare","33","2026","California","6/3/20","1796","230","06107","12.81"
"Tuolumne","0","4","California","6/3/20","4","0","06109","0"
"Ventura","21","1164","California","6/3/20","1017","147","06111","14.45"
"Yolo","2","213","California","6/3/20","200","13","06113","6.5"
"Yuba","0","31","California","6/3/20","28","3","06115","10.71"
"Adams","53","3379","Colorado","6/3/20","3006","373","08001","12.41"
"Alamosa","4","84","Colorado","6/3/20","57","27","08003","47.37"
"Arapahoe","47","4496","Colorado","6/3/20","4166","330","08005","7.92"
"Archuleta","0","8","Colorado","6/3/20","8","0","08007","0"
"Baca","0","12","Colorado","6/3/20","12","0","08009","0"
"Bent","0","2","Colorado","6/3/20","2","0","08011","0"
"Boulder","7","995","Colorado","6/3/20","947","48","08013","5.07"
"Broomfield","3","245","Colorado","6/3/20","226","19","08014","8.41"
"Chaffee","1","76","Colorado","6/3/20","71","5","08015","7.04"
"Cheyenne","0","5","Colorado","6/3/20","5","0","08017","0"
"Clear Creek","0","17","Colorado","6/3/20","16","1","08019","6.25"
"Conejos","0","2","Colorado","6/3/20","1","1","08021","100"
"Costilla","0","6","Colorado","6/3/20","5","1","08023","20"
"Crowley","0","64","Colorado","6/3/20","63","1","08025","1.59"
"Custer","0","2","Colorado","6/3/20","2","0","08027","0"
"Delta","1","72","Colorado","6/3/20","67","5","08029","7.46"
"Denver","86","5917","Colorado","6/3/20","5316","601","08031","11.31"
"Douglas","5","733","Colorado","6/3/20","695","38","08035","5.47"
"Eagle","3","599","Colorado","6/3/20","580","19","08037","3.28"
"El Paso","25","1778","Colorado","6/3/20","1600","178","08041","11.12"
"Elbert","0","53","Colorado","6/3/20","51","2","08039","3.92"
"Fremont","0","26","Colorado","6/3/20","26","0","08043","0"
"Garfield","2","150","Colorado","6/3/20","135","15","08045","11.11"
"Gilpin","0","4","Colorado","6/3/20","3","1","08047","33.33"
"Grand","1","15","Colorado","6/3/20","8","7","08049","87.5"
"Gunnison","0","178","Colorado","6/3/20","177","1","08051","0.56"
"Hinsdale","0","3","Colorado","6/3/20","3","0","08053","0"
"Huerfano","0","3","Colorado","6/3/20","3","0","08055","0"
"Jefferson","28","2294","Colorado","6/3/20","2098","196","08059","9.34"
"Kit Carson","0","26","Colorado","6/3/20","26","0","08063","0"
"La Plata","1","82","Colorado","6/3/20","77","5","08067","6.49"
"Lake","1","32","Colorado","6/3/20","27","5","08065","18.52"
"Larimer","8","606","Colorado","6/3/20","552","54","08069","9.78"
"Las Animas","0","5","Colorado","6/3/20","5","0","08071","0"
"Lincoln","0","3","Colorado","6/3/20","3","0","08073","0"
"Logan","6","621","Colorado","6/3/20","582","39","08075","6.7"
"Mesa","1","56","Colorado","6/3/20","51","5","08077","9.8"
"Mineral","0","2","Colorado","6/3/20","2","0","08079","0"
"Moffat","0","8","Colorado","6/3/20","7","1","08081","14.29"
"Montezuma","1","46","Colorado","6/3/20","36","10","08083","27.78"
"Montrose","3","181","Colorado","6/3/20","163","18","08085","11.04"
"Morgan","3","635","Colorado","6/3/20","616","19","08087","3.08"
"Otero","1","20","Colorado","6/3/20","15","5","08089","33.33"
"Ouray","0","8","Colorado","6/3/20","8","0","08091","0"
"Park","0","23","Colorado","6/3/20","23","0","08093","0"
"Phillips","0","14","Colorado","6/3/20","12","2","08095","16.67"
"Pitkin","0","59","Colorado","6/3/20","57","2","08097","3.51"
"Prowers","0","15","Colorado","6/3/20","13","2","08099","15.38"
"Pueblo","3","300","Colorado","6/3/20","278","22","08101","7.91"
"Rio Blanco","0","1","Colorado","6/3/20","1","0","08103","0"
"Rio Grande","3","36","Colorado","6/3/20","13","23","08105","176.92"
"Routt","0","62","Colorado","6/3/20","61","1","08107","1.64"
"Saguache","9","90","Colorado","6/3/20","25","65","08109","260"
"San Juan","0","1","Colorado","6/3/20","1","0","08111","0"
"San Miguel","0","24","Colorado","6/3/20","23","1","08113","4.35"
"Summit","3","237","Colorado","6/3/20","214","23","08117","10.75"
"Teller","0","33","Colorado","6/3/20","32","1","08119","3.12"
"Washington","1","41","Colorado","6/3/20","33","8","08121","24.24"
"Weld","13","2521","Colorado","6/3/20","2430","91","08123","3.74"
"Yuma","3","40","Colorado","6/3/20","19","21","08125","110.53"
"Fairfield","68","15789","Connecticut","6/3/20","15314","475","09001","3.1"
"Hartford","90","10593","Connecticut","6/3/20","9962","631","09003","6.33"
"Litchfield","6","1404","Connecticut","6/3/20","1360","44","09005","3.24"
"Middlesex","14","1161","Connecticut","6/3/20","1061","100","09007","9.43"
"New Haven","61","11548","Connecticut","6/3/20","11124","424","09009","3.81"
"New London","7","1100","Connecticut","6/3/20","1053","47","09011","4.46"
"Tolland","6","856","Connecticut","6/3/20","815","41","09013","5.03"
"Windham","3","392","Connecticut","6/3/20","371","21","09015","5.66"
"Kent","11","1451","Delaware","6/3/20","1374","77","10001","5.6"
"New Castle","54","3903","Delaware","6/3/20","3528","375","10003","10.63"
"Sussex","24","4305","Delaware","6/3/20","4140","165","10005","3.99"
"","0","49","Diamond Princess","6/3/20","49","0",,"0"
"District of Columbia","87","9016","District of Columbia","6/3/20","8406","610","11001","7.26"
"Alachua","2","383","Florida","6/3/20","370","13","12001","3.51"
"Baker","0","29","Florida","6/3/20","29","0","12003","0"
"Bay","1","105","Florida","6/3/20","97","8","12005","8.25"
"Bradford","0","51","Florida","6/3/20","51","0","12007","0"
"Brevard","4","428","Florida","6/3/20","399","29","12009","7.27"
"Broward","73","7339","Florida","6/3/20","6825","514","12011","7.53"
"Calhoun","1","62","Florida","6/3/20","52","10","12013","19.23"
"Charlotte","5","470","Florida","6/3/20","433","37","12015","8.55"
"Citrus","0","122","Florida","6/3/20","119","3","12017","2.52"
"Clay","3","390","Florida","6/3/20","366","24","12019","6.56"
"Collier","49","1679","Florida","6/3/20","1334","345","12021","25.86"
"Columbia","3","153","Florida","6/3/20","135","18","12023","13.33"
"DeSoto","12","205","Florida","6/3/20","124","81","12027","65.32"
"Dixie","1","55","Florida","6/3/20","46","9","12029","19.57"
"Duval","23","1669","Florida","6/3/20","1507","162","12031","10.75"
"Escambia","11","853","Florida","6/3/20","776","77","12033","9.92"
"Flagler","2","191","Florida","6/3/20","178","13","12035","7.3"
"Franklin","0","2","Florida","6/3/20","2","0","12037","0"
"Gadsden","2","285","Florida","6/3/20","268","17","12039","6.34"
"Gilchrist","0","15","Florida","6/3/20","12","3","12041","25"
"Glades","6","64","Florida","6/3/20","24","40","12043","166.67"
"Gulf","0","2","Florida","6/3/20","1","1","12045","100"
"Hamilton","6","250","Florida","6/3/20","208","42","12047","20.19"
"Hardee","3","111","Florida","6/3/20","88","23","12049","26.14"
"Hendry","20","476","Florida","6/3/20","339","137","12051","40.41"
"Hernando","1","120","Florida","6/3/20","113","7","12053","6.19"
"Highlands","3","134","Florida","6/3/20","114","20","12055","17.54"
"Hillsborough","56","2384","Florida","6/3/20","1995","389","12057","19.5"
"Holmes","1","24","Florida","6/3/20","18","6","12059","33.33"
"Indian River","3","139","Florida","6/3/20","119","20","12061","16.81"
"Jackson","4","269","Florida","6/3/20","240","29","12063","12.08"
"Jefferson","0","29","Florida","6/3/20","29","0","12065","0"
"Lafayette","0","8","Florida","6/3/20","8","0","12067","0"
"Lake","4","309","Florida","6/3/20","279","30","12069","10.75"
"Lee","46","2087","Florida","6/3/20","1767","320","12071","18.11"
"Leon","7","428","Florida","6/3/20","377","51","12073","13.53"
"Levy","1","35","Florida","6/3/20","30","5","12075","16.67"
"Liberty","1","218","Florida","6/3/20","209","9","12077","4.31"
"Madison","0","69","Florida","6/3/20","69","0","12079","0"
"Manatee","16","1110","Florida","6/3/20","996","114","12081","11.45"
"Marion","2","257","Florida","6/3/20","240","17","12083","7.08"
"Martin","26","729","Florida","6/3/20","550","179","12085","32.55"
"Miami-Dade","176","18456","Florida","6/3/20","17225","1231","12086","7.15"
"Monroe","0","109","Florida","6/3/20","107","2","12087","1.87"
"Nassau","1","81","Florida","6/3/20","72","9","12089","12.5"
"Okaloosa","5","236","Florida","6/3/20","198","38","12091","19.19"
"Okeechobee","4","97","Florida","6/3/20","67","30","12093","44.78"
"Orange","35","2121","Florida","6/3/20","1877","244","12095","13"
"Osceola","6","715","Florida","6/3/20","673","42","12097","6.24"
"Palm Beach","146","6477","Florida","6/3/20","5455","1022","12099","18.74"
"Pasco","4","398","Florida","6/3/20","373","25","12101","6.7"
"Pinellas","22","1361","Florida","6/3/20","1205","156","12103","12.95"
"Polk","24","1074","Florida","6/3/20","907","167","12105","18.41"
"Putnam","1","154","Florida","6/3/20","144","10","12107","6.94"
"Santa Rosa","2","250","Florida","6/3/20","237","13","12113","5.49"
"Sarasota","7","649","Florida","6/3/20","598","51","12115","8.53"
"Seminole","5","505","Florida","6/3/20","471","34","12117","7.22"
"St. Johns","3","269","Florida","6/3/20","245","24","12109","9.8"
"St. Lucie","13","508","Florida","6/3/20","420","88","12111","20.95"
"Sumter","1","258","Florida","6/3/20","253","5","12119","1.98"
"Suwannee","1","170","Florida","6/3/20","166","4","12121","2.41"
"Taylor","1","24","Florida","6/3/20","14","10","12123","71.43"
"Union","0","33","Florida","6/3/20","31","2","12125","6.45"
"Volusia","13","771","Florida","6/3/20","683","88","12127","12.88"
"Wakulla","0","35","Florida","6/3/20","32","3","12129","9.38"
"Walton","1","118","Florida","6/3/20","109","9","12131","8.26"
"Washington","2","68","Florida","6/3/20","51","17","12133","33.33"
"Appling","4","170","Georgia","6/3/20","143","27","13001","18.88"
"Atkinson","2","53","Georgia","6/3/20","38","15","13003","39.47"
"Bacon","8","136","Georgia","6/3/20","83","53","13005","63.86"
"Baker","0","34","Georgia","6/3/20","34","0","13007","0"
"Baldwin","2","352","Georgia","6/3/20","337","15","13009","4.45"
"Banks","0","86","Georgia","6/3/20","88","-2","13011","-2.27"
"Barrow","2","333","Georgia","6/3/20","316","17","13013","5.38"
"Bartow","5","496","Georgia","6/3/20","458","38","13015","8.3"
"Ben Hill","2","81","Georgia","6/3/20","69","12","13017","17.39"
"Berrien","1","48","Georgia","6/3/20","39","9","13019","23.08"
"Bibb","6","481","Georgia","6/3/20","441","40","13021","9.07"
"Bleckley","1","48","Georgia","6/3/20","43","5","13023","11.63"
"Brantley","1","59","Georgia","6/3/20","50","9","13025","18"
"Brooks","1","72","Georgia","6/3/20","68","4","13027","5.88"
"Bryan","1","77","Georgia","6/3/20","73","4","13029","5.48"
"Bulloch","3","77","Georgia","6/3/20","54","23","13031","42.59"
"Burke","0","123","Georgia","6/3/20","123","0","13033","0"
"Butts","3","237","Georgia","6/3/20","219","18","13035","8.22"
"Calhoun","1","135","Georgia","6/3/20","130","5","13037","3.85"
"Camden","1","66","Georgia","6/3/20","56","10","13039","17.86"
"Candler","0","14","Georgia","6/3/20","13","1","13043","7.69"
"Carroll","3","535","Georgia","6/3/20","512","23","13045","4.49"
"Catoosa","4","145","Georgia","6/3/20","115","30","13047","26.09"
"Charlton","0","33","Georgia","6/3/20","33","0","13049","0"
"Chatham","7","522","Georgia","6/3/20","476","46","13051","9.66"
"Chattahoochee","18","160","Georgia","6/3/20","33","127","13053","384.85"
"Chattooga","0","25","Georgia","6/3/20","24","1","13055","4.17"
"Cherokee","9","923","Georgia","6/3/20","861","62","13057","7.2"
"Clarke","5","296","Georgia","6/3/20","259","37","13059","14.29"
"Clay","1","41","Georgia","6/3/20","37","4","13061","10.81"
"Clayton","10","1260","Georgia","6/3/20","1189","71","13063","5.97"
"Clinch","0","59","Georgia","6/3/20","57","2","13065","3.51"
"Cobb","27","3097","Georgia","6/3/20","2907","190","13067","6.54"
"Coffee","3","285","Georgia","6/3/20","262","23","13069","8.78"
"Colquitt","8","488","Georgia","6/3/20","434","54","13071","12.44"
"Columbia","4","266","Georgia","6/3/20","237","29","13073","12.24"
"Cook","0","45","Georgia","6/3/20","47","-2","13075","-4.26"
"Coweta","5","432","Georgia","6/3/20","397","35","13077","8.82"
"Crawford","0","28","Georgia","6/3/20","28","0","13079","0"
"Crisp","2","237","Georgia","6/3/20","226","11","13081","4.87"
"Dade","2","39","Georgia","6/3/20","27","12","13083","44.44"
"Dawson","0","110","Georgia","6/3/20","108","2","13085","1.85"
"Decatur","6","206","Georgia","6/3/20","161","45","13087","27.95"
"DeKalb","43","3874","Georgia","6/3/20","3573","301","13089","8.42"
"Dodge","0","52","Georgia","6/3/20","50","2","13091","4"
"Dooly","1","185","Georgia","6/3/20","176","9","13093","5.11"
"Dougherty","1","1790","Georgia","6/3/20","1784","6","13095","0.34"
"Douglas","5","556","Georgia","6/3/20","521","35","13097","6.72"
"Early","1","247","Georgia","6/3/20","239","8","13099","3.35"
"Echols","4","125","Georgia","6/3/20","99","26","13101","26.26"
"Effingham","0","75","Georgia","6/3/20","74","1","13103","1.35"
"Elbert","0","75","Georgia","6/3/20","73","2","13105","2.74"
"Emanuel","0","28","Georgia","6/3/20","27","1","13107","3.7"
"Evans","0","5","Georgia","6/3/20","5","0","13109","0"
"Fannin","1","49","Georgia","6/3/20","40","9","13111","22.5"
"Fayette","1","239","Georgia","6/3/20","235","4","13113","1.7"
"Floyd","4","281","Georgia","6/3/20","253","28","13115","11.07"
"Forsyth","5","534","Georgia","6/3/20","502","32","13117","6.37"
"Franklin","9","105","Georgia","6/3/20","41","64","13119","156.1"
"Fulton","54","4688","Georgia","6/3/20","4309","379","13121","8.8"
"Gilmer","2","157","Georgia","6/3/20","145","12","13123","8.28"
"Glascock","0","1","Georgia","6/3/20","1","0","13125","0"
"Glynn","5","135","Georgia","6/3/20","102","33","13127","32.35"
"Gordon","4","170","Georgia","6/3/20","142","28","13129","19.72"
"Grady","3","117","Georgia","6/3/20","96","21","13131","21.88"
"Greene","1","71","Georgia","6/3/20","66","5","13133","7.58"
"Gwinnett","83","4063","Georgia","6/3/20","3480","583","13135","16.75"
"Habersham","4","538","Georgia","6/3/20","511","27","13137","5.28"
"Hall","17","2539","Georgia","6/3/20","2422","117","13139","4.83"
"Hancock","1","197","Georgia","6/3/20","192","5","13141","2.6"
"Haralson","1","49","Georgia","6/3/20","40","9","13143","22.5"
"Harris","3","111","Georgia","6/3/20","88","23","13145","26.14"
"Hart","1","34","Georgia","6/3/20","26","8","13147","30.77"
"Heard","1","35","Georgia","6/3/20","30","5","13149","16.67"
"Henry","6","716","Georgia","6/3/20","672","44","13151","6.55"
"Houston","3","381","Georgia","6/3/20","362","19","13153","5.25"
"Irwin","1","31","Georgia","6/3/20","24","7","13155","29.17"
"Jackson","4","199","Georgia","6/3/20","171","28","13157","16.37"
"Jasper","1","40","Georgia","6/3/20","32","8","13159","25"
"Jeff Davis","0","38","Georgia","6/3/20","35","3","13161","8.57"
"Jefferson","2","46","Georgia","6/3/20","32","14","13163","43.75"
"Jenkins","0","21","Georgia","6/3/20","19","2","13165","10.53"
"Johnson","0","82","Georgia","6/3/20","82","0","13167","0"
"Jones","1","44","Georgia","6/3/20","34","10","13169","29.41"
"Lamar","2","73","Georgia","6/3/20","60","13","13171","21.67"
"Lanier","1","24","Georgia","6/3/20","20","4","13173","20"
"Laurens","1","108","Georgia","6/3/20","104","4","13175","3.85"
"Lee","0","361","Georgia","6/3/20","363","-2","13177","-0.55"
"Liberty","2","83","Georgia","6/3/20","70","13","13179","18.57"
"Lincoln","0","16","Georgia","6/3/20","16","0","13181","0"
"Long","0","16","Georgia","6/3/20","15","1","13183","6.67"
"Lowndes","8","326","Georgia","6/3/20","268","58","13185","21.64"
"Lumpkin","1","101","Georgia","6/3/20","95","6","13187","6.32"
"Macon","1","104","Georgia","6/3/20","99","5","13193","5.05"
"Madison","2","59","Georgia","6/3/20","44","15","13195","34.09"
"Marion","1","59","Georgia","6/3/20","52","7","13197","13.46"
"McDuffie","1","69","Georgia","6/3/20","65","4","13189","6.15"
"McIntosh","1","16","Georgia","6/3/20","12","4","13191","33.33"
"Meriwether","2","95","Georgia","6/3/20","81","14","13199","17.28"
"Miller","0","42","Georgia","6/3/20","40","2","13201","5"
"Mitchell","0","415","Georgia","6/3/20","412","3","13205","0.73"
"Monroe","1","124","Georgia","6/3/20","118","6","13207","5.08"
"Montgomery","1","13","Georgia","6/3/20","9","4","13209","44.44"
"Morgan","0","38","Georgia","6/3/20","37","1","13211","2.7"
"Murray","2","99","Georgia","6/3/20","83","16","13213","19.28"
"Muscogee","12","673","Georgia","6/3/20","587","86","13215","14.65"
"Newton","5","376","Georgia","6/3/20","341","35","13217","10.26"
"Oconee","1","119","Georgia","6/3/20","109","10","13219","9.17"
"Oglethorpe","1","63","Georgia","6/3/20","58","5","13221","8.62"
"Out of GA","37","2183","Georgia","6/3/20","1925","258","80013","13.4"
"Paulding","4","334","Georgia","6/3/20","305","29","13223","9.51"
"Peach","1","76","Georgia","6/3/20","70","6","13225","8.57"
"Pickens","1","50","Georgia","6/3/20","43","7","13227","16.28"
"Pierce","2","105","Georgia","6/3/20","92","13","13229","14.13"
"Pike","0","56","Georgia","6/3/20","54","2","13231","3.7"
"Polk","3","131","Georgia","6/3/20","107","24","13233","22.43"
"Pulaski","1","43","Georgia","6/3/20","39","4","13235","10.26"
"Putnam","1","95","Georgia","6/3/20","88","7","13237","7.95"
"Quitman","0","14","Georgia","6/3/20","12","2","13239","16.67"
"Rabun","1","25","Georgia","6/3/20","17","8","13241","47.06"
"Randolph","0","179","Georgia","6/3/20","176","3","13243","1.7"
"Richmond","6","606","Georgia","6/3/20","563","43","13245","7.64"
"Rockdale","3","297","Georgia","6/3/20","276","21","13247","7.61"
"Schley","0","16","Georgia","6/3/20","16","0","13249","0"
"Screven","1","55","Georgia","6/3/20","47","8","13251","17.02"
"Seminole","0","45","Georgia","6/3/20","43","2","13253","4.65"
"Spalding","2","280","Georgia","6/3/20","264","16","13255","6.06"
"Stephens","2","147","Georgia","6/3/20","132","15","13257","11.36"
"Stewart","1","53","Georgia","6/3/20","47","6","13259","12.77"
"Sumter","4","490","Georgia","6/3/20","460","30","13261","6.52"
"Talbot","0","40","Georgia","6/3/20","38","2","13263","5.26"
"Taliaferro","0","1","Georgia","6/3/20","1","0","13265","0"
"Tattnall","1","29","Georgia","6/3/20","19","10","13267","52.63"
"Taylor","0","23","Georgia","6/3/20","21","2","13269","9.52"
"Telfair","0","37","Georgia","6/3/20","34","3","13271","8.82"
"Terrell","0","215","Georgia","6/3/20","215","0","13273","0"
"Thomas","3","346","Georgia","6/3/20","324","22","13275","6.79"
"Tift","5","271","Georgia","6/3/20","238","33","13277","13.87"
"Toombs","1","58","Georgia","6/3/20","54","4","13279","7.41"
"Towns","0","26","Georgia","6/3/20","23","3","13281","13.04"
"Treutlen","1","13","Georgia","6/3/20","8","5","13283","62.5"
"Troup","11","345","Georgia","6/3/20","268","77","13285","28.73"
"Turner","3","134","Georgia","6/3/20","110","24","13287","21.82"
"Twiggs","0","18","Georgia","6/3/20","15","3","13289","20"
"Union","1","48","Georgia","6/3/20","44","4","13291","9.09"
"Upson","1","290","Georgia","6/3/20","280","10","13293","3.57"
"Walker","9","171","Georgia","6/3/20","109","62","13295","56.88"
"Walton","4","273","Georgia","6/3/20","242","31","13297","12.81"
"Ware","2","234","Georgia","6/3/20","223","11","13299","4.93"
"Warren","0","18","Georgia","6/3/20","18","0","13301","0"
"Washington","0","74","Georgia","6/3/20","74","0","13303","0"
"Wayne","1","22","Georgia","6/3/20","18","4","13305","22.22"
"Webster","0","13","Georgia","6/3/20","11","2","13307","18.18"
"Wheeler","1","13","Georgia","6/3/20","9","4","13309","44.44"
"White","1","105","Georgia","6/3/20","98","7","13311","7.14"
"Whitfield","14","408","Georgia","6/3/20","311","97","13313","31.19"
"Wilcox","2","117","Georgia","6/3/20","105","12","13315","11.43"
"Wilkes","0","34","Georgia","6/3/20","33","1","13317","3.03"
"Wilkinson","0","69","Georgia","6/3/20","70","-1","13319","-1.43"
"Worth","2","226","Georgia","6/3/20","209","17","13321","8.13"
"","0","103","Grand Princess","6/3/20","103","0",,"0"
"","1","177","Guam","6/3/20","170","7",,"4.12"
"Hawaii","0","81","Hawaii","6/3/20","82","-1","15001","-1.22"
"Honolulu","1","423","Hawaii","6/3/20","414","9","15003","2.17"
"Kauai","0","20","Hawaii","6/3/20","20","0","15007","0"
"Maui","0","119","Hawaii","6/3/20","118","1","15009","0.85"
"Out of HI","0","10","Hawaii","6/3/20","10","0","80015","0"
"Ada","3","818","Idaho","6/3/20","798","20","16001","2.51"
"Adams","0","3","Idaho","6/3/20","3","0","16003","0"
"Bannock","2","34","Idaho","6/3/20","20","14","16005","70"
"Benewah","1","12","Idaho","6/3/20","3","9","16009","300"
"Bingham","0","8","Idaho","6/3/20","6","2","16011","33.33"
"Blaine","0","512","Idaho","6/3/20","510","2","16013","0.39"
"Bonner","0","6","Idaho","6/3/20","4","2","16017","50"
"Bonneville","3","51","Idaho","6/3/20","33","18","16019","54.55"
"Camas","0","1","Idaho","6/3/20","1","0","16025","0"
"Canyon","3","310","Idaho","6/3/20","287","23","16027","8.01"
"Caribou","0","1","Idaho","6/3/20","1","0","16029","0"
"Cassia","5","85","Idaho","6/3/20","49","36","16031","73.47"
"Custer","0","2","Idaho","6/3/20","2","0","16037","0"
"Elmore","0","31","Idaho","6/3/20","31","0","16039","0"
"Franklin","1","9","Idaho","6/3/20","0","9","16041","1"
"Fremont","0","3","Idaho","6/3/20","3","0","16043","0"
"Gem","0","17","Idaho","6/3/20","17","0","16045","0"
"Gooding","1","49","Idaho","6/3/20","40","9","16047","22.5"
"Idaho","0","3","Idaho","6/3/20","3","0","16049","0"
"Jefferson","0","7","Idaho","6/3/20","7","0","16051","0"
"Jerome","3","175","Idaho","6/3/20","154","21","16053","13.64"
"Kootenai","1","73","Idaho","6/3/20","66","7","16055","10.61"
"Latah","0","7","Idaho","6/3/20","7","0","16057","0"
"Lemhi","0","1","Idaho","6/3/20","1","0","16059","0"
"Lincoln","0","33","Idaho","6/3/20","32","1","16063","3.12"
"Madison","0","21","Idaho","6/3/20","21","0","16065","0"
"Minidoka","3","58","Idaho","6/3/20","40","18","16067","45"
"Nez Perce","0","82","Idaho","6/3/20","82","0","16069","0"
"Owyhee","0","8","Idaho","6/3/20","8","0","16073","0"
"Payette","0","23","Idaho","6/3/20","23","0","16075","0"
"Power","0","6","Idaho","6/3/20","3","3","16077","100"
"Teton","0","11","Idaho","6/3/20","11","0","16081","0"
"Twin Falls","5","428","Idaho","6/3/20","396","32","16083","8.08"
"Valley","0","2","Idaho","6/3/20","2","0","16085","0"
"Washington","1","43","Idaho","6/3/20","34","9","16087","26.47"
"Adams","0","44","Illinois","6/3/20","44","0","17001","0"
"Alexander","1","12","Illinois","6/3/20","8","4","17003","50"
"Bond","0","12","Illinois","6/3/20","10","2","17005","20"
"Boone","10","481","Illinois","6/3/20","410","71","17007","17.32"
"Brown","0","10","Illinois","6/3/20","10","0","17009","0"
"Bureau","0","17","Illinois","6/3/20","15","2","17011","13.33"
"Calhoun","0","1","Illinois","6/3/20","1","0","17013","0"
"Carroll","0","15","Illinois","6/3/20","14","1","17015","7.14"
"Cass","1","74","Illinois","6/3/20","68","6","17017","8.82"
"Champaign","12","661","Illinois","6/3/20","580","81","17019","13.97"
"Christian","0","35","Illinois","6/3/20","33","2","17021","6.06"
"Clark","0","11","Illinois","6/3/20","10","1","17023","10"
"Clay","0","2","Illinois","6/3/20","2","0","17025","0"
"Clinton","1","188","Illinois","6/3/20","178","10","17027","5.62"
"Coles","1","128","Illinois","6/3/20","119","9","17029","7.56"
"Cook","812","80204","Illinois","6/3/20","74521","5683","17031","7.63"
"Crawford","0","12","Illinois","6/3/20","11","1","17033","9.09"
"Cumberland","0","10","Illinois","6/3/20","10","0","17035","0"
"De Witt","0","4","Illinois","6/3/20","4","0","17039","0"
"DeKalb","14","435","Illinois","6/3/20","334","101","17037","30.24"
"Douglas","0","28","Illinois","6/3/20","26","2","17041","7.69"
"DuPage","77","7891","Illinois","6/3/20","7350","541","17043","7.36"
"Edgar","0","1","Illinois","6/3/20","0","1","17045","1"
"Edwards","0","2","Illinois","6/3/20","2","0","17047","0"
"Effingham","0","7","Illinois","6/3/20","6","1","17049","16.67"
"Fayette","0","21","Illinois","6/3/20","20","1","17051","5"
"Ford","0","20","Illinois","6/3/20","20","0","17053","0"
"Franklin","0","12","Illinois","6/3/20","12","0","17055","0"
"Fulton","0","12","Illinois","6/3/20","11","1","17057","9.09"
"Gallatin","0","2","Illinois","6/3/20","2","0","17059","0"
"Greene","0","6","Illinois","6/3/20","5","1","17061","20"
"Grundy","2","104","Illinois","6/3/20","88","16","17063","18.18"
"Hamilton","0","2","Illinois","6/3/20","2","0","17065","0"
"Hancock","0","17","Illinois","6/3/20","15","2","17067","13.33"
"Hardin","0","1","Illinois","6/3/20","1","0","17069","0"
"Henderson","0","8","Illinois","6/3/20","8","0","17071","0"
"Henry","0","70","Illinois","6/3/20","67","3","17073","4.48"
"Iroquois","0","133","Illinois","6/3/20","131","2","17075","1.53"
"Jackson","7","293","Illinois","6/3/20","242","51","17077","21.07"
"Jasper","0","46","Illinois","6/3/20","45","1","17079","2.22"
"Jefferson","0","101","Illinois","6/3/20","101","0","17081","0"
"Jersey","1","24","Illinois","6/3/20","20","4","17083","20"
"Jo Daviess","0","32","Illinois","6/3/20","31","1","17085","3.23"
"Johnson","0","10","Illinois","6/3/20","7","3","17087","42.86"
"Kane","82","6518","Illinois","6/3/20","5947","571","17089","9.6"
"Kankakee","22","959","Illinois","6/3/20","808","151","17091","18.69"
"Kendall","13","825","Illinois","6/3/20","736","89","17093","12.09"
"Knox","1","101","Illinois","6/3/20","94","7","17095","7.45"
"Lake","95","8511","Illinois","6/3/20","7845","666","17097","8.49"
"LaSalle","2","157","Illinois","6/3/20","140","17","17099","12.14"
"Lawrence","0","4","Illinois","6/3/20","4","0","17101","0"
"Lee","1","82","Illinois","6/3/20","76","6","17103","7.89"
"Livingston","1","36","Illinois","6/3/20","31","5","17105","16.13"
"Logan","0","11","Illinois","6/3/20","10","1","17107","10"
"Macon","1","195","Illinois","6/3/20","189","6","17115","3.17"
"Macoupin","0","46","Illinois","6/3/20","43","3","17117","6.98"
"Madison","8","600","Illinois","6/3/20","544","56","17119","10.29"
"Marion","0","51","Illinois","6/3/20","50","1","17121","2"
"Marshall","0","5","Illinois","6/3/20","5","0","17123","0"
"Mason","0","18","Illinois","6/3/20","17","1","17125","5.88"
"Massac","0","7","Illinois","6/3/20","7","0","17127","0"
"McDonough","2","94","Illinois","6/3/20","83","11","17109","13.25"
"McHenry","22","1628","Illinois","6/3/20","1475","153","17111","10.37"
"McLean","1","224","Illinois","6/3/20","215","9","17113","4.19"
"Menard","0","20","Illinois","6/3/20","17","3","17129","17.65"
"Mercer","0","17","Illinois","6/3/20","16","1","17131","6.25"
"Monroe","1","97","Illinois","6/3/20","93","4","17133","4.3"
"Montgomery","0","40","Illinois","6/3/20","39","1","17135","2.56"
"Morgan","1","39","Illinois","6/3/20","34","5","17137","14.71"
"Moultrie","0","12","Illinois","6/3/20","10","2","17139","20"
"Ogle","3","214","Illinois","6/3/20","193","21","17141","10.88"
"Out of IL","-12","120","Illinois","6/3/20","205","-85","80017","-41.46"
"Peoria","12","273","Illinois","6/3/20","188","85","17143","45.21"
"Perry","0","42","Illinois","6/3/20","41","1","17145","2.44"
"Piatt","0","11","Illinois","6/3/20","12","-1","17147","-8.33"
"Pike","0","1","Illinois","6/3/20","1","0","17149","0"
"Pope","0","1","Illinois","6/3/20","1","0","17151","0"
"Pulaski","2","56","Illinois","6/3/20","41","15","17153","36.59"
"Putnam","0","1","Illinois","6/3/20","1","0","17155","0"
"Randolph","1","271","Illinois","6/3/20","264","7","17157","2.65"
"Richland","0","3","Illinois","6/3/20","3","0","17159","0"
"Rock Island","8","691","Illinois","6/3/20","638","53","17161","8.31"
"Saline","0","7","Illinois","6/3/20","7","0","17165","0"
"Sangamon","2","353","Illinois","6/3/20","337","16","17167","4.75"
"Schuyler","0","13","Illinois","6/3/20","12","1","17169","8.33"
"Shelby","0","16","Illinois","6/3/20","16","0","17173","0"
"St. Clair","25","1210","Illinois","6/3/20","1035","175","17163","16.91"
"Stark","0","3","Illinois","6/3/20","3","0","17175","0"
"Stephenson","2","210","Illinois","6/3/20","194","16","17177","8.25"
"Tazewell","1","78","Illinois","6/3/20","69","9","17179","13.04"
"Union","4","168","Illinois","6/3/20","143","25","17181","17.48"
"Vermilion","0","40","Illinois","6/3/20","37","3","17183","8.11"
"Wabash","0","5","Illinois","6/3/20","2","3","17185","150"
"Warren","1","118","Illinois","6/3/20","113","5","17187","4.42"
"Washington","0","19","Illinois","6/3/20","18","1","17189","5.56"
"Wayne","0","9","Illinois","6/3/20","9","0","17191","0"
"White","0","2","Illinois","6/3/20","2","0","17193","0"
"Whiteside","1","144","Illinois","6/3/20","134","10","17195","7.46"
"Will","61","5704","Illinois","6/3/20","5279","425","17197","8.05"
"Williamson","2","71","Illinois","6/3/20","57","14","17199","24.56"
"Winnebago","50","2354","Illinois","6/3/20","2001","353","17201","17.64"
"Woodford","0","21","Illinois","6/3/20","18","3","17203","16.67"
"Adams","1","20","Indiana","6/3/20","12","8","18001","66.67"
"Allen","56","1743","Indiana","6/3/20","1353","390","18003","28.82"
"Bartholomew","5","522","Indiana","6/3/20","486","36","18005","7.41"
"Benton","1","32","Indiana","6/3/20","25","7","18007","28"
"Blackford","1","27","Indiana","6/3/20","20","7","18009","35"
"Boone","4","318","Indiana","6/3/20","293","25","18011","8.53"
"Brown","0","33","Indiana","6/3/20","33","0","18013","0"
"Carroll","0","93","Indiana","6/3/20","93","0","18015","0"
"Cass","1","1592","Indiana","6/3/20","1586","6","18017","0.38"
"Clark","8","528","Indiana","6/3/20","471","57","18019","12.1"
"Clay","2","52","Indiana","6/3/20","41","11","18021","26.83"
"Clinton","3","240","Indiana","6/3/20","222","18","18023","8.11"
"Crawford","0","24","Indiana","6/3/20","23","1","18025","4.35"
"Daviess","2","95","Indiana","6/3/20","84","11","18027","13.1"
"Dearborn","1","170","Indiana","6/3/20","164","6","18029","3.66"
"Decatur","1","230","Indiana","6/3/20","224","6","18031","2.68"
"DeKalb","1","43","Indiana","6/3/20","33","10","18033","30.3"
"Delaware","4","387","Indiana","6/3/20","359","28","18035","7.8"
"Dubois","3","205","Indiana","6/3/20","185","20","18037","10.81"
"Elkhart","52","1435","Indiana","6/3/20","1070","365","18039","34.11"
"Fayette","1","79","Indiana","6/3/20","71","8","18041","11.27"
"Floyd","1","321","Indiana","6/3/20","315","6","18043","1.9"
"Fountain","1","22","Indiana","6/3/20","18","4","18045","22.22"
"Franklin","1","115","Indiana","6/3/20","106","9","18047","8.49"
"Fulton","0","50","Indiana","6/3/20","47","3","18049","6.38"
"Gibson","1","18","Indiana","6/3/20","14","4","18051","28.57"
"Grant","4","221","Indiana","6/3/20","195","26","18053","13.33"
"Greene","0","171","Indiana","6/3/20","168","3","18055","1.79"
"Hamilton","8","1180","Indiana","6/3/20","1123","57","18057","5.08"
"Hancock","4","349","Indiana","6/3/20","323","26","18059","8.05"
"Harrison","1","196","Indiana","6/3/20","188","8","18061","4.26"
"Hendricks","6","1180","Indiana","6/3/20","1135","45","18063","3.96"
"Henry","2","184","Indiana","6/3/20","170","14","18065","8.24"
"Howard","9","437","Indiana","6/3/20","376","61","18067","16.22"
"Huntington","1","34","Indiana","6/3/20","26","8","18069","30.77"
"Jackson","4","394","Indiana","6/3/20","368","26","18071","7.07"
"Jasper","1","70","Indiana","6/3/20","62","8","18073","12.9"
"Jay","1","53","Indiana","6/3/20","46","7","18075","15.22"
"Jefferson","1","47","Indiana","6/3/20","42","5","18077","11.9"
"Jennings","0","131","Indiana","6/3/20","128","3","18079","2.34"
"Johnson","4","1120","Indiana","6/3/20","1092","28","18081","2.56"
"Knox","1","31","Indiana","6/3/20","25","6","18083","24"
"Kosciusko","10","166","Indiana","6/3/20","97","69","18085","71.13"
"LaGrange","6","102","Indiana","6/3/20","62","40","18087","64.52"
"Lake","66","3806","Indiana","6/3/20","3347","459","18089","13.71"
"LaPorte","3","436","Indiana","6/3/20","415","21","18091","5.06"
"Lawrence","3","165","Indiana","6/3/20","146","19","18093","13.01"
"Madison","2","597","Indiana","6/3/20","582","15","18095","2.58"
"Marion","95","10037","Indiana","6/3/20","9371","666","18097","7.11"
"Marshall","10","147","Indiana","6/3/20","80","67","18099","83.75"
"Martin","0","12","Indiana","6/3/20","9","3","18101","33.33"
"Miami","0","141","Indiana","6/3/20","139","2","18103","1.44"
"Monroe","1","170","Indiana","6/3/20","162","8","18105","4.94"
"Montgomery","2","244","Indiana","6/3/20","233","11","18107","4.72"
"Morgan","2","283","Indiana","6/3/20","270","13","18109","4.81"
"Newton","1","78","Indiana","6/3/20","74","4","18111","5.41"
"Noble","8","251","Indiana","6/3/20","192","59","18113","30.73"
"Ohio","0","13","Indiana","6/3/20","13","0","18115","0"
"Orange","1","131","Indiana","6/3/20","124","7","18117","5.65"
"Owen","0","34","Indiana","6/3/20","34","0","18119","0"
"Parke","0","18","Indiana","6/3/20","18","0","18121","0"
"Perry","1","34","Indiana","6/3/20","26","8","18123","30.77"
"Pike","0","6","Indiana","6/3/20","6","0","18125","0"
"Porter","8","553","Indiana","6/3/20","495","58","18127","11.72"
"Posey","0","16","Indiana","6/3/20","16","0","18129","0"
"Pulaski","1","49","Indiana","6/3/20","40","9","18131","22.5"
"Putnam","0","137","Indiana","6/3/20","134","3","18133","2.24"
"Randolph","1","50","Indiana","6/3/20","45","5","18135","11.11"
"Ripley","-1","108","Indiana","6/3/20","113","-5","18137","-4.42"
"Rush","1","50","Indiana","6/3/20","45","5","18139","11.11"
"Scott","1","122","Indiana","6/3/20","118","4","18143","3.39"
"Shelby","11","398","Indiana","6/3/20","321","77","18145","23.99"
"Spencer","1","21","Indiana","6/3/20","17","4","18147","23.53"
"St. Joseph","15","1320","Indiana","6/3/20","1218","102","18141","8.37"
"Starke","1","39","Indiana","6/3/20","31","8","18149","25.81"
"Steuben","1","87","Indiana","6/3/20","80","7","18151","8.75"
"Sullivan","1","37","Indiana","6/3/20","33","4","18153","12.12"
"Switzerland","0","21","Indiana","6/3/20","19","2","18155","10.53"
"Tippecanoe","6","421","Indiana","6/3/20","380","41","18157","10.79"
"Tipton","0","26","Indiana","6/3/20","24","2","18159","8.33"
"Union","0","9","Indiana","6/3/20","8","1","18161","12.5"
"Vanderburgh","5","290","Indiana","6/3/20","253","37","18163","14.62"
"Vermillion","0","10","Indiana","6/3/20","10","0","18165","0"
"Vigo","4","175","Indiana","6/3/20","150","25","18167","16.67"
"Wabash","1","80","Indiana","6/3/20","73","7","18169","9.59"
"Warren","0","12","Indiana","6/3/20","12","0","18171","0"
"Warrick","0","167","Indiana","6/3/20","165","2","18173","1.21"
"Washington","0","51","Indiana","6/3/20","52","-1","18175","-1.92"
"Wayne","2","86","Indiana","6/3/20","75","11","18177","14.67"
"Wells","1","32","Indiana","6/3/20","26","6","18179","23.08"
"White","1","238","Indiana","6/3/20","228","10","18181","4.39"
"Whitley","0","44","Indiana","6/3/20","41","3","18183","7.32"
"Adair","0","9","Iowa","6/3/20","7","2","19001","28.57"
"Adams","0","7","Iowa","6/3/20","7","0","19003","0"
"Allamakee","0","120","Iowa","6/3/20","119","1","19005","0.84"
"Appanoose","0","14","Iowa","6/3/20","13","1","19007","7.69"
"Audubon","0","13","Iowa","6/3/20","12","1","19009","8.33"
"Benton","1","44","Iowa","6/3/20","39","5","19011","12.82"
"Black Hawk","7","1759","Iowa","6/3/20","1713","46","19013","2.69"
"Boone","2","67","Iowa","6/3/20","56","11","19015","19.64"
"Bremer","0","69","Iowa","6/3/20","67","2","19017","2.99"
"Buchanan","0","33","Iowa","6/3/20","31","2","19019","6.45"
"Buena Vista","34","918","Iowa","6/3/20","682","236","19021","34.6"
"Butler","0","17","Iowa","6/3/20","15","2","19023","13.33"
"Calhoun","0","4","Iowa","6/3/20","2","2","19025","100"
"Carroll","1","13","Iowa","6/3/20","9","4","19027","44.44"
"Cass","0","12","Iowa","6/3/20","11","1","19029","9.09"
"Cedar","0","49","Iowa","6/3/20","46","3","19031","6.52"
"Cerro Gordo","1","30","Iowa","6/3/20","22","8","19033","36.36"
"Cherokee","2","36","Iowa","6/3/20","23","13","19035","56.52"
"Chickasaw","1","12","Iowa","6/3/20","8","4","19037","50"
"Clarke","3","64","Iowa","6/3/20","40","24","19039","60"
"Clay","1","21","Iowa","6/3/20","13","8","19041","61.54"
"Clayton","0","34","Iowa","6/3/20","31","3","19043","9.68"
"Clinton","1","65","Iowa","6/3/20","60","5","19045","8.33"
"Crawford","8","542","Iowa","6/3/20","488","54","19047","11.07"
"Dallas","8","929","Iowa","6/3/20","873","56","19049","6.41"
"Davis","1","27","Iowa","6/3/20","20","7","19051","35"
"Decatur","0","1","Iowa","6/3/20","1","0","19053","0"
"Delaware","1","19","Iowa","6/3/20","15","4","19055","26.67"
"Des Moines","1","66","Iowa","6/3/20","58","8","19057","13.79"
"Dickinson","2","27","Iowa","6/3/20","13","14","19059","107.69"
"Dubuque","3","351","Iowa","6/3/20","330","21","19061","6.36"
"Emmet","2","19","Iowa","6/3/20","8","11","19063","137.5"
"Fayette","0","27","Iowa","6/3/20","26","1","19065","3.85"
"Floyd","0","19","Iowa","6/3/20","18","1","19067","5.56"
"Franklin","1","15","Iowa","6/3/20","9","6","19069","66.67"
"Fremont","0","4","Iowa","6/3/20","4","0","19071","0"
"Greene","0","13","Iowa","6/3/20","13","0","19073","0"
"Grundy","0","20","Iowa","6/3/20","19","1","19075","5.26"
"Guthrie","1","53","Iowa","6/3/20","44","9","19077","20.45"
"Hamilton","2","45","Iowa","6/3/20","28","17","19079","60.71"
"Hancock","0","16","Iowa","6/3/20","14","2","19081","14.29"
"Hardin","1","19","Iowa","6/3/20","15","4","19083","26.67"
"Harrison","1","26","Iowa","6/3/20","19","7","19085","36.84"
"Henry","1","72","Iowa","6/3/20","67","5","19087","7.46"
"Howard","0","12","Iowa","6/3/20","12","0","19089","0"
"Humboldt","1","18","Iowa","6/3/20","14","4","19091","28.57"
"Ida","0","14","Iowa","6/3/20","14","0","19093","0"
"Iowa","0","33","Iowa","6/3/20","36","-3","19095","-8.33"
"Jackson","0","13","Iowa","6/3/20","13","0","19097","0"
"Jasper","1","263","Iowa","6/3/20","257","6","19099","2.33"
"Jefferson","2","33","Iowa","6/3/20","19","14","19101","73.68"
"Johnson","2","616","Iowa","6/3/20","605","11","19103","1.82"
"Jones","0","37","Iowa","6/3/20","36","1","19105","2.78"
"Keokuk","0","14","Iowa","6/3/20","14","0","19107","0"
"Kossuth","1","13","Iowa","6/3/20","8","5","19109","62.5"
"Lee","1","28","Iowa","6/3/20","23","5","19111","21.74"
"Linn","4","967","Iowa","6/3/20","938","29","19113","3.09"
"Louisa","1","346","Iowa","6/3/20","336","10","19115","2.98"
"Lucas","2","19","Iowa","6/3/20","7","12","19117","171.43"
"Lyon","1","25","Iowa","6/3/20","19","6","19119","31.58"
"Madison","0","29","Iowa","6/3/20","26","3","19121","11.54"
"Mahaska","1","97","Iowa","6/3/20","88","9","19123","10.23"
"Marion","1","34","Iowa","6/3/20","30","4","19125","13.33"
"Marshall","3","901","Iowa","6/3/20","878","23","19127","2.62"
"Mills","1","20","Iowa","6/3/20","16","4","19129","25"
"Mitchell","0","4","Iowa","6/3/20","5","-1","19131","-20"
"Monona","0","25","Iowa","6/3/20","24","1","19133","4.17"
"Monroe","0","38","Iowa","6/3/20","35","3","19135","8.57"
"Montgomery","0","8","Iowa","6/3/20","6","2","19137","33.33"
"Muscatine","2","563","Iowa","6/3/20","547","16","19139","2.93"
"O'Brien","1","36","Iowa","6/3/20","27","9","19141","33.33"
"Osceola","0","34","Iowa","6/3/20","31","3","19143","9.68"
"Page","1","14","Iowa","6/3/20","10","4","19145","40"
"Palo Alto","1","7","Iowa","6/3/20","3","4","19147","133.33"
"Plymouth","3","139","Iowa","6/3/20","119","20","19149","16.81"
"Pocahontas","1","14","Iowa","6/3/20","9","5","19151","55.56"
"Polk","76","4406","Iowa","6/3/20","3876","530","19153","13.67"
"Pottawattamie","10","296","Iowa","6/3/20","227","69","19155","30.4"
"Poweshiek","0","91","Iowa","6/3/20","88","3","19157","3.41"
"Ringgold","0","4","Iowa","6/3/20","4","0","19159","0"
"Sac","1","25","Iowa","6/3/20","17","8","19161","47.06"
"Scott","3","368","Iowa","6/3/20","346","22","19163","6.36"
"Shelby","0","37","Iowa","6/3/20","35","2","19165","5.71"
"Sioux","11","290","Iowa","6/3/20","210","80","19167","38.1"
"Story","3","118","Iowa","6/3/20","96","22","19169","22.92"
"Tama","1","408","Iowa","6/3/20","400","8","19171","2"
"Taylor","2","59","Iowa","6/3/20","48","11","19173","22.92"
"Union","0","9","Iowa","6/3/20","6","3","19175","50"
"Van Buren","0","9","Iowa","6/3/20","9","0","19177","0"
"Wapello","10","607","Iowa","6/3/20","538","69","19179","12.83"
"Warren","6","153","Iowa","6/3/20","114","39","19181","34.21"
"Washington","1","192","Iowa","6/3/20","185","7","19183","3.78"
"Wayne","0","1","Iowa","6/3/20","1","0","19185","0"
"Webster","2","44","Iowa","6/3/20","29","15","19187","51.72"
"Winnebago","0","11","Iowa","6/3/20","11","0","19189","0"
"Winneshiek","0","24","Iowa","6/3/20","23","1","19191","4.35"
"Woodbury","23","2817","Iowa","6/3/20","2658","159","19193","5.98"
"Worth","0","3","Iowa","6/3/20","3","0","19195","0"
"Wright","10","194","Iowa","6/3/20","124","70","19197","56.45"
"Allen","0","1","Kansas","6/3/20","1","0","20001","0"
"Anderson","0","1","Kansas","6/3/20","1","0","20003","0"
"Atchison","0","23","Kansas","6/3/20","21","2","20005","9.52"
"Barber","0","1","Kansas","6/3/20","1","0","20007","0"
"Barton","0","44","Kansas","6/3/20","45","-1","20009","-2.22"
"Bourbon","0","7","Kansas","6/3/20","7","0","20011","0"
"Brown","0","6","Kansas","6/3/20","6","0","20013","0"
"Butler","1","37","Kansas","6/3/20","29","8","20015","27.59"
"Chase","0","4","Kansas","6/3/20","4","0","20017","0"
"Chautauqua","0","4","Kansas","6/3/20","4","0","20019","0"
"Cherokee","0","10","Kansas","6/3/20","9","1","20021","11.11"
"Cheyenne","0","2","Kansas","6/3/20","2","0","20023","0"
"Clark","0","33","Kansas","6/3/20","31","2","20025","6.45"
"Clay","0","5","Kansas","6/3/20","5","0","20027","0"
"Cloud","0","5","Kansas","6/3/20","5","0","20029","0"
"Coffey","0","50","Kansas","6/3/20","50","0","20031","0"
"Comanche","0","2","Kansas","6/3/20","1","1","20033","100"
"Cowley","2","15","Kansas","6/3/20","4","11","20035","275"
"Crawford","0","8","Kansas","6/3/20","8","0","20037","0"
"Dickinson","0","4","Kansas","6/3/20","3","1","20041","33.33"
"Doniphan","1","18","Kansas","6/3/20","12","6","20043","50"
"Douglas","1","67","Kansas","6/3/20","63","4","20045","6.35"
"Edwards","0","5","Kansas","6/3/20","5","0","20047","0"
"Ellis","0","9","Kansas","6/3/20","8","1","20051","12.5"
"Ellsworth","0","2","Kansas","6/3/20","2","0","20053","0"
"Finney","9","1518","Kansas","6/3/20","1458","60","20055","4.12"
"Ford","25","1794","Kansas","6/3/20","1622","172","20057","10.6"
"Franklin","0","35","Kansas","6/3/20","34","1","20059","2.94"
"Geary","1","23","Kansas","6/3/20","19","4","20061","21.05"
"Gove","0","1","Kansas","6/3/20","1","0","20063","0"
"Grant","0","18","Kansas","6/3/20","18","0","20067","0"
"Gray","0","23","Kansas","6/3/20","22","1","20069","4.55"
"Greenwood","1","9","Kansas","6/3/20","3","6","20073","200"
"Hamilton","1","20","Kansas","6/3/20","16","4","20075","25"
"Harper","0","2","Kansas","6/3/20","2","0","20077","0"
"Harvey","0","11","Kansas","6/3/20","11","0","20079","0"
"Haskell","1","22","Kansas","6/3/20","18","4","20081","22.22"
"Hodgeman","1","5","Kansas","6/3/20","1","4","20083","400"
"Jackson","1","102","Kansas","6/3/20","93","9","20085","9.68"
"Jefferson","0","22","Kansas","6/3/20","22","0","20087","0"
"Jewell","0","4","Kansas","6/3/20","4","0","20089","0"
"Johnson","15","865","Kansas","6/3/20","760","105","20091","13.82"
"Kearny","0","45","Kansas","6/3/20","44","1","20093","2.27"
"Kiowa","0","3","Kansas","6/3/20","2","1","20097","50"
"Labette","0","22","Kansas","6/3/20","22","0","20099","0"
"Lane","0","4","Kansas","6/3/20","3","1","20101","33.33"
"Leavenworth","3","1094","Kansas","6/3/20","1074","20","20103","1.86"
"Linn","1","11","Kansas","6/3/20","7","4","20107","57.14"
"Lyon","5","377","Kansas","6/3/20","339","38","20111","11.21"
"Marion","0","5","Kansas","6/3/20","5","0","20115","0"
"McPherson","0","30","Kansas","6/3/20","27","3","20113","11.11"
"Meade","1","31","Kansas","6/3/20","26","5","20119","19.23"
"Miami","0","8","Kansas","6/3/20","7","1","20121","14.29"
"Mitchell","0","4","Kansas","6/3/20","3","1","20123","33.33"
"Montgomery","0","20","Kansas","6/3/20","20","0","20125","0"
"Morris","0","5","Kansas","6/3/20","5","0","20127","0"
"Morton","0","6","Kansas","6/3/20","4","2","20129","50"
"Nemaha","1","19","Kansas","6/3/20","14","5","20131","35.71"
"Neosho","0","2","Kansas","6/3/20","2","0","20133","0"
"Ness","0","3","Kansas","6/3/20","1","2","20135","200"
"Norton","0","2","Kansas","6/3/20","2","0","20137","0"
"Osage","0","8","Kansas","6/3/20","7","1","20139","14.29"
"Osborne","0","2","Kansas","6/3/20","2","0","20141","0"
"Ottawa","0","4","Kansas","6/3/20","4","0","20143","0"
"Pawnee","0","1","Kansas","6/3/20","0","1","20145","1"
"Phillips","0","2","Kansas","6/3/20","2","0","20147","0"
"Pottawatomie","0","26","Kansas","6/3/20","23","3","20149","13.04"
"Pratt","0","2","Kansas","6/3/20","1","1","20151","100"
"Reno","0","43","Kansas","6/3/20","43","0","20155","0"
"Republic","0","4","Kansas","6/3/20","4","0","20157","0"
"Rice","0","4","Kansas","6/3/20","4","0","20159","0"
"Riley","0","67","Kansas","6/3/20","64","3","20161","4.69"
"Rooks","0","6","Kansas","6/3/20","6","0","20163","0"
"Saline","0","25","Kansas","6/3/20","24","1","20169","4.17"
"Scott","0","14","Kansas","6/3/20","13","1","20171","7.69"
"Sedgwick","7","616","Kansas","6/3/20","564","52","20173","9.22"
"Seward","6","888","Kansas","6/3/20","849","39","20175","4.59"
"Shawnee","9","334","Kansas","6/3/20","270","64","20177","23.7"
"Sheridan","0","2","Kansas","6/3/20","2","0","20179","0"
"Sherman","0","7","Kansas","6/3/20","6","1","20181","16.67"
"Smith","0","2","Kansas","6/3/20","2","0","20183","0"
"Stafford","0","1","Kansas","6/3/20","1","0","20185","0"
"Stanton","0","10","Kansas","6/3/20","9","1","20187","11.11"
"Stevens","0","30","Kansas","6/3/20","27","3","20189","11.11"
"Sumner","0","8","Kansas","6/3/20","6","2","20191","33.33"
"Trego","0","1","Kansas","6/3/20","1","0","20195","0"
"Wabaunsee","0","31","Kansas","6/3/20","31","0","20197","0"
"Wilson","0","1","Kansas","6/3/20","1","0","20205","0"
"Woodson","0","6","Kansas","6/3/20","6","0","20207","0"
"Wyandotte","20","1419","Kansas","6/3/20","1281","138","20209","10.77"
"Adair","0","97","Kentucky","6/3/20","96","1","21001","1.04"
"Allen","6","96","Kentucky","6/3/20","56","40","21003","71.43"
"Anderson","1","21","Kentucky","6/3/20","15","6","21005","40"
"Ballard","0","12","Kentucky","6/3/20","10","2","21007","20"
"Barren","1","49","Kentucky","6/3/20","44","5","21009","11.36"
"Bath","0","9","Kentucky","6/3/20","8","1","21011","12.5"
"Bell","0","1","Kentucky","6/3/20","1","0","21013","0"
"Boone","13","492","Kentucky","6/3/20","403","89","21015","22.08"
"Bourbon","0","11","Kentucky","6/3/20","10","1","21017","10"
"Boyd","0","40","Kentucky","6/3/20","39","1","21019","2.56"
"Boyle","0","26","Kentucky","6/3/20","23","3","21021","13.04"
"Bracken","0","13","Kentucky","6/3/20","11","2","21023","18.18"
"Breathitt","0","3","Kentucky","6/3/20","3","0","21025","0"
"Breckinridge","0","17","Kentucky","6/3/20","17","0","21027","0"
"Bullitt","1","119","Kentucky","6/3/20","109","10","21029","9.17"
"Butler","1","235","Kentucky","6/3/20","226","9","21031","3.98"
"Caldwell","0","12","Kentucky","6/3/20","12","0","21033","0"
"Calloway","1","53","Kentucky","6/3/20","48","5","21035","10.42"
"Campbell","6","191","Kentucky","6/3/20","150","41","21037","27.33"
"Carlisle","0","5","Kentucky","6/3/20","5","0","21039","0"
"Carroll","1","14","Kentucky","6/3/20","7","7","21041","100"
"Carter","1","14","Kentucky","6/3/20","9","5","21043","55.56"
"Casey","0","5","Kentucky","6/3/20","2","3","21045","150"
"Christian","1","114","Kentucky","6/3/20","106","8","21047","7.55"
"Clark","1","43","Kentucky","6/3/20","38","5","21049","13.16"
"Clay","0","7","Kentucky","6/3/20","7","0","21051","0"
"Clinton","0","4","Kentucky","6/3/20","3","1","21053","33.33"
"Crittenden","0","7","Kentucky","6/3/20","5","2","21055","40"
"Cumberland","0","5","Kentucky","6/3/20","5","0","21057","0"
"Daviess","3","330","Kentucky","6/3/20","312","18","21059","5.77"
"Edmonson","0","57","Kentucky","6/3/20","56","1","21061","1.79"
"Elliott","0","1","Kentucky","6/3/20","1","0","21063","0"
"Estill","0","1","Kentucky","6/3/20","0","1","21065","1"
"Fayette","22","803","Kentucky","6/3/20","650","153","21067","23.54"
"Fleming","0","2","Kentucky","6/3/20","3","-1","21069","-33.33"
"Floyd","0","17","Kentucky","6/3/20","16","1","21071","6.25"
"Franklin","5","63","Kentucky","6/3/20","25","38","21073","152"
"Fulton","1","8","Kentucky","6/3/20","4","4","21075","100"
"Gallatin","5","46","Kentucky","6/3/20","12","34","21077","283.33"
"Garrard","0","5","Kentucky","6/3/20","5","0","21079","0"
"Grant","1","46","Kentucky","6/3/20","39","7","21081","17.95"
"Graves","1","166","Kentucky","6/3/20","159","7","21083","4.4"
"Grayson","0","127","Kentucky","6/3/20","124","3","21085","2.42"
"Green","0","1","Kentucky","6/3/20","1","0","21087","0"
"Greenup","0","14","Kentucky","6/3/20","14","0","21089","0"
"Hancock","0","7","Kentucky","6/3/20","7","0","21091","0"
"Hardin","2","109","Kentucky","6/3/20","98","11","21093","11.22"
"Harlan","0","4","Kentucky","6/3/20","1","3","21095","300"
"Harrison","1","23","Kentucky","6/3/20","18","5","21097","27.78"
"Hart","0","23","Kentucky","6/3/20","21","2","21099","9.52"
"Henderson","1","112","Kentucky","6/3/20","103","9","21101","8.74"
"Henry","0","22","Kentucky","6/3/20","19","3","21103","15.79"
"Hickman","0","5","Kentucky","6/3/20","5","0","21105","0"
"Hopkins","1","224","Kentucky","6/3/20","219","5","21107","2.28"
"Jackson","0","61","Kentucky","6/3/20","61","0","21109","0"
"Jefferson","51","2612","Kentucky","6/3/20","2253","359","21111","15.93"
"Jessamine","2","67","Kentucky","6/3/20","56","11","21113","19.64"
"Johnson","0","5","Kentucky","6/3/20","5","0","21115","0"
"Kenton","14","638","Kentucky","6/3/20","541","97","21117","17.93"
"Knott","0","4","Kentucky","6/3/20","4","0","21119","0"
"Knox","0","10","Kentucky","6/3/20","8","2","21121","25"
"Larue","0","8","Kentucky","6/3/20","7","1","21123","14.29"
"Laurel","0","21","Kentucky","6/3/20","21","0","21125","0"
"Lawrence","0","4","Kentucky","6/3/20","2","2","21127","100"
"Lee","0","1","Kentucky","6/3/20","0","1","21129","1"
"Leslie","0","6","Kentucky","6/3/20","6","0","21131","0"
"Letcher","0","3","Kentucky","6/3/20","4","-1","21133","-25"
"Lewis","0","7","Kentucky","6/3/20","7","0","21135","0"
"Lincoln","0","8","Kentucky","6/3/20","8","0","21137","0"
"Livingston","0","9","Kentucky","6/3/20","9","0","21139","0"
"Logan","4","155","Kentucky","6/3/20","125","30","21141","24"
"Lyon","0","15","Kentucky","6/3/20","14","1","21143","7.14"
"Madison","1","54","Kentucky","6/3/20","47","7","21151","14.89"
"Magoffin","0","2","Kentucky","6/3/20","2","0","21153","0"
"Marion","1","25","Kentucky","6/3/20","19","6","21155","31.58"
"Marshall","0","37","Kentucky","6/3/20","37","0","21157","0"
"Martin","0","3","Kentucky","6/3/20","3","0","21159","0"
"Mason","0","10","Kentucky","6/3/20","8","2","21161","25"
"McCracken","1","99","Kentucky","6/3/20","89","10","21145","11.24"
"McCreary","0","13","Kentucky","6/3/20","13","0","21147","0"
"McLean","0","22","Kentucky","6/3/20","22","0","21149","0"
"Meade","0","22","Kentucky","6/3/20","21","1","21163","4.76"
"Menifee","0","10","Kentucky","6/3/20","10","0","21165","0"
"Mercer","0","14","Kentucky","6/3/20","13","1","21167","7.69"
"Metcalfe","0","7","Kentucky","6/3/20","4","3","21169","75"
"Monroe","1","21","Kentucky","6/3/20","16","5","21171","31.25"
"Montgomery","0","25","Kentucky","6/3/20","22","3","21173","13.64"
"Morgan","0","3","Kentucky","6/3/20","1","2","21175","200"
"Muhlenberg","1","479","Kentucky","6/3/20","475","4","21177","0.84"
"Nelson","1","44","Kentucky","6/3/20","38","6","21179","15.79"
"Nicholas","0","3","Kentucky","6/3/20","3","0","21181","0"
"Ohio","1","148","Kentucky","6/3/20","138","10","21183","7.25"
"Oldham","5","103","Kentucky","6/3/20","70","33","21185","47.14"
"Owen","0","3","Kentucky","6/3/20","1","2","21187","200"
"Owsley","0","2","Kentucky","6/3/20","2","0","21189","0"
"Pendleton","0","11","Kentucky","6/3/20","8","3","21191","37.5"
"Perry","0","22","Kentucky","6/3/20","19","3","21193","15.79"
"Pike","0","30","Kentucky","6/3/20","28","2","21195","7.14"
"Powell","0","1","Kentucky","6/3/20","1","0","21197","0"
"Pulaski","1","61","Kentucky","6/3/20","56","5","21199","8.93"
"Rockcastle","0","13","Kentucky","6/3/20","13","0","21203","0"
"Rowan","0","7","Kentucky","6/3/20","7","0","21205","0"
"Russell","0","25","Kentucky","6/3/20","23","2","21207","8.7"
"Scott","0","35","Kentucky","6/3/20","35","0","21209","0"
"Shelby","7","184","Kentucky","6/3/20","138","46","21211","33.33"
"Simpson","1","55","Kentucky","6/3/20","49","6","21213","12.24"
"Spencer","1","24","Kentucky","6/3/20","17","7","21215","41.18"
"Taylor","0","13","Kentucky","6/3/20","11","2","21217","18.18"
"Todd","0","18","Kentucky","6/3/20","17","1","21219","5.88"
"Trigg","0","10","Kentucky","6/3/20","10","0","21221","0"
"Trimble","0","6","Kentucky","6/3/20","5","1","21223","20"
"Union","1","15","Kentucky","6/3/20","10","5","21225","50"
"Warren","17","1067","Kentucky","6/3/20","950","117","21227","12.32"
"Washington","0","7","Kentucky","6/3/20","6","1","21229","16.67"
"Wayne","0","8","Kentucky","6/3/20","8","0","21231","0"
"Webster","0","33","Kentucky","6/3/20","32","1","21233","3.12"
"Whitley","0","13","Kentucky","6/3/20","13","0","21235","0"
"Wolfe","0","1","Kentucky","6/3/20","1","0","21237","0"
"Woodford","0","29","Kentucky","6/3/20","26","3","21239","11.54"
"Acadia","7","446","Louisiana","6/3/20","397","49","22001","12.34"
"Allen","0","185","Louisiana","6/3/20","184","1","22003","0.54"
"Ascension","7","852","Louisiana","6/3/20","805","47","22005","5.84"
"Assumption","1","252","Louisiana","6/3/20","245","7","22007","2.86"
"Avoyelles","3","141","Louisiana","6/3/20","117","24","22009","20.51"
"Beauregard","3","81","Louisiana","6/3/20","61","20","22011","32.79"
"Bienville","1","149","Louisiana","6/3/20","139","10","22013","7.19"
"Bossier","3","425","Louisiana","6/3/20","402","23","22015","5.72"
"Caddo","29","2633","Louisiana","6/3/20","2427","206","22017","8.49"
"Calcasieu","5","613","Louisiana","6/3/20","581","32","22019","5.51"
"Caldwell","1","61","Louisiana","6/3/20","52","9","22021","17.31"
"Cameron","0","6","Louisiana","6/3/20","3","3","22023","100"
"Catahoula","1","117","Louisiana","6/3/20","112","5","22025","4.46"
"Claiborne","1","66","Louisiana","6/3/20","62","4","22027","6.45"
"Concordia","1","94","Louisiana","6/3/20","86","8","22029","9.3"
"De Soto","1","250","Louisiana","6/3/20","241","9","22031","3.73"
"East Baton Rouge","40","3773","Louisiana","6/3/20","3491","282","22033","8.08"
"East Carroll","7","165","Louisiana","6/3/20","115","50","22035","43.48"
"East Feliciana","1","198","Louisiana","6/3/20","191","7","22037","3.66"
"Evangeline","1","81","Louisiana","6/3/20","75","6","22039","8"
"Franklin","10","377","Louisiana","6/3/20","310","67","22041","21.61"
"Grant","0","30","Louisiana","6/3/20","28","2","22043","7.14"
"Iberia","2","418","Louisiana","6/3/20","403","15","22045","3.72"
"Iberville","3","579","Louisiana","6/3/20","559","20","22047","3.58"
"Jackson","1","110","Louisiana","6/3/20","100","10","22049","10"
"Jefferson","49","7738","Louisiana","6/3/20","7394","344","22051","4.65"
"Jefferson Davis","0","78","Louisiana","6/3/20","75","3","22053","4"
"Lafayette","19","821","Louisiana","6/3/20","689","132","22055","19.16"
"Lafourche","14","878","Louisiana","6/3/20","781","97","22057","12.42"
"LaSalle","1","53","Louisiana","6/3/20","48","5","22059","10.42"
"Lincoln","3","161","Louisiana","6/3/20","142","19","22061","13.38"
"Livingston","6","446","Louisiana","6/3/20","403","43","22063","10.67"
"Madison","4","106","Louisiana","6/3/20","77","29","22065","37.66"
"Morehouse","1","131","Louisiana","6/3/20","121","10","22067","8.26"
"Natchitoches","2","173","Louisiana","6/3/20","157","16","22069","10.19"
"Orleans","18","7174","Louisiana","6/3/20","7045","129","22071","1.83"
"Ouachita","23","1312","Louisiana","6/3/20","1150","162","22073","14.09"
"Plaquemines","2","215","Louisiana","6/3/20","201","14","22075","6.97"
"Pointe Coupee","2","205","Louisiana","6/3/20","189","16","22077","8.47"
"Rapides","21","829","Louisiana","6/3/20","679","150","22079","22.09"
"Red River","0","50","Louisiana","6/3/20","48","2","22081","4.17"
"Richland","3","143","Louisiana","6/3/20","124","19","22083","15.32"
"Sabine","1","49","Louisiana","6/3/20","41","8","22085","19.51"
"St. Bernard","2","545","Louisiana","6/3/20","531","14","22087","2.64"
"St. Charles","2","647","Louisiana","6/3/20","631","16","22089","2.54"
"St. Helena","0","51","Louisiana","6/3/20","51","0","22091","0"
"St. James","1","303","Louisiana","6/3/20","293","10","22093","3.41"
"St. John the Baptist","3","868","Louisiana","6/3/20","849","19","22095","2.24"
"St. Landry","2","269","Louisiana","6/3/20","252","17","22097","6.75"
"St. Martin","2","306","Louisiana","6/3/20","292","14","22099","4.79"
"St. Mary","3","328","Louisiana","6/3/20","308","20","22101","6.49"
"St. Tammany","15","1790","Louisiana","6/3/20","1687","103","22103","6.11"
"Tangipahoa","9","891","Louisiana","6/3/20","826","65","22105","7.87"
"Tensas","1","16","Louisiana","6/3/20","10","6","22107","60"
"Terrebonne","9","709","Louisiana","6/3/20","647","62","22109","9.58"
"Union","4","331","Louisiana","6/3/20","303","28","22111","9.24"
"Vermilion","1","58","Louisiana","6/3/20","53","5","22113","9.43"
"Vernon","1","28","Louisiana","6/3/20","24","4","22115","16.67"
"Washington","5","444","Louisiana","6/3/20","407","37","22117","9.09"
"Webster","3","163","Louisiana","6/3/20","142","21","22119","14.79"
"West Baton Rouge","3","176","Louisiana","6/3/20","158","18","22121","11.39"
"West Carroll","3","68","Louisiana","6/3/20","44","24","22123","54.55"
"West Feliciana","1","215","Louisiana","6/3/20","205","10","22125","4.88"
"Winn","4","178","Louisiana","6/3/20","150","28","22127","18.67"
"Androscoggin","11","326","Maine","6/3/20","252","74","23001","29.37"
"Aroostook","0","10","Maine","6/3/20","8","2","23003","25"
"Cumberland","23","1226","Maine","6/3/20","1065","161","23005","15.12"
"Franklin","0","36","Maine","6/3/20","36","0","23007","0"
"Hancock","0","11","Maine","6/3/20","11","0","23009","0"
"Kennebec","0","127","Maine","6/3/20","128","-1","23011","-0.78"
"Knox","0","21","Maine","6/3/20","20","1","23013","5"
"Lincoln","0","20","Maine","6/3/20","20","0","23015","0"
"Oxford","1","33","Maine","6/3/20","26","7","23017","26.92"
"Penobscot","0","100","Maine","6/3/20","99","1","23019","1.01"
"Piscataquis","0","1","Maine","6/3/20","1","0","23021","0"
"Sagadahoc","0","31","Maine","6/3/20","29","2","23023","6.9"
"Somerset","0","22","Maine","6/3/20","21","1","23025","4.76"
"Waldo","0","51","Maine","6/3/20","51","0","23027","0"
"Washington","0","1","Maine","6/3/20","2","-1","23029","-50"
"York","5","398","Maine","6/3/20","365","33","23031","9.04"
"Allegany","1","182","Maryland","6/3/20","177","5","24001","2.82"
"Anne Arundel","80","4009","Maryland","6/3/20","3448","561","24003","16.27"
"Baltimore","128","6457","Maryland","6/3/20","5562","895","24005","16.09"
"Baltimore City","107","5801","Maryland","6/3/20","5054","747","24510","14.78"
"Calvert","5","348","Maryland","6/3/20","314","34","24009","10.83"
"Caroline","3","265","Maryland","6/3/20","243","22","24011","9.05"
"Carroll","18","940","Maryland","6/3/20","817","123","24013","15.06"
"Cecil","4","381","Maryland","6/3/20","354","27","24015","7.63"
"Charles","21","1152","Maryland","6/3/20","1008","144","24017","14.29"
"Dorchester","2","147","Maryland","6/3/20","133","14","24019","10.53"
"Frederick","31","2005","Maryland","6/3/20","1786","219","24021","12.26"
"Garrett","0","10","Maryland","6/3/20","10","0","24023","0"
"Harford","14","901","Maryland","6/3/20","801","100","24025","12.48"
"Howard","35","2004","Maryland","6/3/20","1760","244","24027","13.86"
"Kent","3","178","Maryland","6/3/20","160","18","24029","11.25"
"Montgomery","208","11924","Maryland","6/3/20","10467","1457","24031","13.92"
"Prince George's","234","15738","Maryland","6/3/20","14100","1638","24033","11.62"
"Queen Anne's","2","162","Maryland","6/3/20","151","11","24035","7.28"
"Somerset","0","75","Maryland","6/3/20","73","2","24039","2.74"
"St. Mary's","19","536","Maryland","6/3/20","400","136","24037","34"
"Talbot","3","103","Maryland","6/3/20","84","19","24041","22.62"
"Washington","10","486","Maryland","6/3/20","418","68","24043","16.27"
"Wicomico","7","959","Maryland","6/3/20","910","49","24045","5.38"
"Worcester","4","219","Maryland","6/3/20","193","26","24047","13.47"
"Barnstable","7","1435","Massachusetts","6/3/20","1385","50","25001","3.61"
"Berkshire","1","566","Massachusetts","6/3/20","560","6","25003","1.07"
"Bristol","75","7453","Massachusetts","6/3/20","6928","525","25005","7.58"
"Dukes and Nantucket","0","54","Massachusetts","6/3/20","52","2","00000","3.85"
"Essex","96","14857","Massachusetts","6/3/20","14182","675","25009","4.76"
"Franklin","1","335","Massachusetts","6/3/20","329","6","25011","1.82"
"Hampden","38","6237","Massachusetts","6/3/20","5969","268","25013","4.49"
"Hampshire","3","891","Massachusetts","6/3/20","871","20","25015","2.3"
"Middlesex","130","22403","Massachusetts","6/3/20","21493","910","25017","4.23"
"Norfolk","40","8613","Massachusetts","6/3/20","8331","282","25021","3.38"
"Plymouth","41","8243","Massachusetts","6/3/20","7953","290","25023","3.65"
"Suffolk","84","18733","Massachusetts","6/3/20","18143","590","25025","3.25"
"Worcester","83","11465","Massachusetts","6/3/20","10887","578","25027","5.31"
"Alcona","1","20","Michigan","6/3/20","15","5","26001","33.33"
"Allegan","2","260","Michigan","6/3/20","246","14","26005","5.69"
"Alpena","0","102","Michigan","6/3/20","102","0","26007","0"
"Antrim","0","13","Michigan","6/3/20","13","0","26009","0"
"Arenac","0","38","Michigan","6/3/20","37","1","26011","2.7"
"Baraga","0","1","Michigan","6/3/20","1","0","26013","0"
"Barry","1","82","Michigan","6/3/20","78","4","26015","5.13"
"Bay","4","359","Michigan","6/3/20","330","29","26017","8.79"
"Benzie","0","4","Michigan","6/3/20","4","0","26019","0"
"Berrien","8","784","Michigan","6/3/20","730","54","26021","7.4"
"Branch","3","136","Michigan","6/3/20","115","21","26023","18.26"
"Calhoun","6","439","Michigan","6/3/20","394","45","26025","11.42"
"Cass","1","97","Michigan","6/3/20","92","5","26027","5.43"
"Charlevoix","0","18","Michigan","6/3/20","18","0","26029","0"
"Cheboygan","0","26","Michigan","6/3/20","26","0","26031","0"
"Chippewa","0","3","Michigan","6/3/20","3","0","26033","0"
"Clare","0","20","Michigan","6/3/20","18","2","26035","11.11"
"Clinton","0","178","Michigan","6/3/20","176","2","26037","1.14"
"Crawford","0","62","Michigan","6/3/20","62","0","26039","0"
"Delta","0","20","Michigan","6/3/20","20","0","26041","0"
"Dickinson","0","5","Michigan","6/3/20","5","0","26043","0"
"Eaton","3","249","Michigan","6/3/20","230","19","26045","8.26"
"Emmet","0","26","Michigan","6/3/20","25","1","26047","4"
"Federal Correctional Institution (FCI)","2","149","Michigan","6/3/20","138","11","00000","7.97"
"Genesee","18","2519","Michigan","6/3/20","2396","123","26049","5.13"
"Gladwin","0","18","Michigan","6/3/20","18","0","26051","0"
"Gogebic","0","5","Michigan","6/3/20","5","0","26053","0"
"Grand Traverse","1","28","Michigan","6/3/20","24","4","26055","16.67"
"Gratiot","0","85","Michigan","6/3/20","83","2","26057","2.41"
"Hillsdale","0","177","Michigan","6/3/20","176","1","26059","0.57"
"Houghton","0","6","Michigan","6/3/20","4","2","26061","50"
"Huron","1","56","Michigan","6/3/20","50","6","26063","12"
"Ingham","4","783","Michigan","6/3/20","752","31","26065","4.12"
"Ionia","1","172","Michigan","6/3/20","163","9","26067","5.52"
"Iosco","1","111","Michigan","6/3/20","104","7","26069","6.73"
"Iron","0","1","Michigan","6/3/20","0","1","26071","1"
"Isabella","1","94","Michigan","6/3/20","89","5","26073","5.62"
"Jackson","3","480","Michigan","6/3/20","460","20","26075","4.35"
"Kalamazoo","6","903","Michigan","6/3/20","864","39","26077","4.51"
"Kalkaska","0","30","Michigan","6/3/20","30","0","26079","0"
"Kent","55","4062","Michigan","6/3/20","3676","386","26081","10.5"
"Lake","0","7","Michigan","6/3/20","6","1","26085","16.67"
"Lapeer","2","224","Michigan","6/3/20","212","12","26087","5.66"
"Leelanau","0","11","Michigan","6/3/20","11","0","26089","0"
"Lenawee","4","208","Michigan","6/3/20","180","28","26091","15.56"
"Livingston","3","503","Michigan","6/3/20","480","23","26093","4.79"
"Luce","0","3","Michigan","6/3/20","3","0","26095","0"
"Mackinac","0","8","Michigan","6/3/20","6","2","26097","33.33"
"Macomb","33","6927","Michigan","6/3/20","6693","234","26099","3.5"
"Manistee","0","12","Michigan","6/3/20","12","0","26101","0"
"Marquette","0","56","Michigan","6/3/20","54","2","26103","3.7"
"Mason","0","38","Michigan","6/3/20","37","1","26105","2.7"
"Mecosta","0","24","Michigan","6/3/20","23","1","26107","4.35"
"Menominee","0","8","Michigan","6/3/20","8","0","26109","0"
"Michigan Department of Corrections (MDOC)","60","4074","Michigan","6/3/20","3652","422","00000","11.56"
"Midland","1","121","Michigan","6/3/20","117","4","26111","3.42"
"Missaukee","0","22","Michigan","6/3/20","22","0","26113","0"
"Monroe","3","534","Michigan","6/3/20","515","19","26115","3.69"
"Montcalm","0","73","Michigan","6/3/20","71","2","26117","2.82"
"Montmorency","0","5","Michigan","6/3/20","5","0","26119","0"
"Muskegon","8","668","Michigan","6/3/20","613","55","26121","8.97"
"Newaygo","2","113","Michigan","6/3/20","101","12","26123","11.88"
"Oakland","80","10999","Michigan","6/3/20","10439","560","26125","5.36"
"Oceana","1","100","Michigan","6/3/20","93","7","26127","7.53"
"Ogemaw","0","30","Michigan","6/3/20","29","1","26129","3.45"
"Osceola","0","16","Michigan","6/3/20","14","2","26133","14.29"
"Oscoda","0","8","Michigan","6/3/20","8","0","26135","0"
"Otsego","0","120","Michigan","6/3/20","118","2","26137","1.69"
"Ottawa","12","866","Michigan","6/3/20","780","86","26139","11.03"
"Out of MI","-3","45","Michigan","6/3/20","64","-19","80026","-29.69"
"Presque Isle","0","11","Michigan","6/3/20","11","0","26141","0"
"Roscommon","0","24","Michigan","6/3/20","23","1","26143","4.35"
"Saginaw","8","1083","Michigan","6/3/20","1025","58","26145","5.66"
"Sanilac","0","43","Michigan","6/3/20","41","2","26151","4.88"
"Schoolcraft","0","4","Michigan","6/3/20","4","0","26153","0"
"Shiawassee","0","261","Michigan","6/3/20","258","3","26155","1.16"
"St. Clair","3","513","Michigan","6/3/20","492","21","26147","4.27"
"St. Joseph","3","134","Michigan","6/3/20","113","21","26149","18.58"
"Tuscola","0","191","Michigan","6/3/20","189","2","26157","1.06"
"Van Buren","3","170","Michigan","6/3/20","152","18","26159","11.84"
"Washtenaw","7","1528","Michigan","6/3/20","1477","51","26161","3.45"
"Wayne","84","21225","Michigan","6/3/20","20640","585","26163","2.83"
"Wexford","0","14","Michigan","6/3/20","13","1","26165","7.69"
"Aitkin","1","11","Minnesota","6/3/20","7","4","27001","57.14"
"Anoka","30","1470","Minnesota","6/3/20","1262","208","27003","16.48"
"Becker","1","41","Minnesota","6/3/20","37","4","27005","10.81"
"Beltrami","1","18","Minnesota","6/3/20","13","5","27007","38.46"
"Benton","2","181","Minnesota","6/3/20","169","12","27009","7.1"
"Big Stone","1","8","Minnesota","6/3/20","3","5","27011","166.67"
"Blue Earth","4","148","Minnesota","6/3/20","122","26","27013","21.31"
"Brown","0","17","Minnesota","6/3/20","14","3","27015","21.43"
"Carlton","0","75","Minnesota","6/3/20","73","2","27017","2.74"
"Carver","6","224","Minnesota","6/3/20","185","39","27019","21.08"
"Cass","0","12","Minnesota","6/3/20","12","0","27021","0"
"Chippewa","1","51","Minnesota","6/3/20","44","7","27023","15.91"
"Chisago","2","64","Minnesota","6/3/20","50","14","27025","28"
"Clay","4","435","Minnesota","6/3/20","406","29","27027","7.14"
"Clearwater","0","3","Minnesota","6/3/20","3","0","27029","0"
"Cottonwood","2","77","Minnesota","6/3/20","65","12","27033","18.46"
"Crow Wing","3","75","Minnesota","6/3/20","57","18","27035","31.58"
"Dakota","29","1388","Minnesota","6/3/20","1182","206","27037","17.43"
"Dodge","1","53","Minnesota","6/3/20","46","7","27039","15.22"
"Douglas","1","44","Minnesota","6/3/20","39","5","27041","12.82"
"Faribault","1","20","Minnesota","6/3/20","13","7","27043","53.85"
"Fillmore","0","17","Minnesota","6/3/20","17","0","27045","0"
"Freeborn","5","130","Minnesota","6/3/20","97","33","27047","34.02"
"Goodhue","1","70","Minnesota","6/3/20","60","10","27049","16.67"
"Grant","0","4","Minnesota","6/3/20","3","1","27051","33.33"
"Hennepin","171","8738","Minnesota","6/3/20","7540","1198","27053","15.89"
"Houston","0","2","Minnesota","6/3/20","2","0","27055","0"
"Hubbard","0","3","Minnesota","6/3/20","1","2","27057","200"
"Isanti","0","35","Minnesota","6/3/20","33","2","27059","6.06"
"Itasca","0","56","Minnesota","6/3/20","53","3","27061","5.66"
"Jackson","0","40","Minnesota","6/3/20","39","1","27063","2.56"
"Kanabec","0","12","Minnesota","6/3/20","11","1","27065","9.09"
"Kandiyohi","4","505","Minnesota","6/3/20","475","30","27067","6.32"
"Kittson","0","1","Minnesota","6/3/20","1","0","27069","0"
"Koochiching","0","9","Minnesota","6/3/20","7","2","27071","28.57"
"Lac qui Parle","0","3","Minnesota","6/3/20","3","0","27073","0"
"Lake","0","1","Minnesota","6/3/20","1","0","27075","0"
"Le Sueur","0","46","Minnesota","6/3/20","43","3","27079","6.98"
"Lincoln","0","6","Minnesota","6/3/20","5","1","27081","20"
"Lyon","5","71","Minnesota","6/3/20","36","35","27083","97.22"
"Mahnomen","0","6","Minnesota","6/3/20","5","1","27087","20"
"Marshall","0","12","Minnesota","6/3/20","9","3","27089","33.33"
"Martin","1","132","Minnesota","6/3/20","126","6","27091","4.76"
"McLeod","1","37","Minnesota","6/3/20","29","8","27085","27.59"
"Meeker","0","45","Minnesota","6/3/20","44","1","27093","2.27"
"Mille Lacs","1","22","Minnesota","6/3/20","17","5","27095","29.41"
"Morrison","1","48","Minnesota","6/3/20","40","8","27097","20"
"Mower","21","366","Minnesota","6/3/20","216","150","27099","69.44"
"Murray","0","39","Minnesota","6/3/20","36","3","27101","8.33"
"Nicollet","2","88","Minnesota","6/3/20","74","14","27103","18.92"
"Nobles","10","1558","Minnesota","6/3/20","1488","70","27105","4.7"
"Norman","0","14","Minnesota","6/3/20","11","3","27107","27.27"
"Olmsted","11","654","Minnesota","6/3/20","575","79","27109","13.74"
"Otter Tail","1","71","Minnesota","6/3/20","62","9","27111","14.52"
"Pennington","1","21","Minnesota","6/3/20","17","4","27113","23.53"
"Pine","1","90","Minnesota","6/3/20","85","5","27115","5.88"
"Pipestone","0","12","Minnesota","6/3/20","10","2","27117","20"
"Polk","0","61","Minnesota","6/3/20","59","2","27119","3.39"
"Pope","0","9","Minnesota","6/3/20","8","1","27121","12.5"
"Ramsey","83","3189","Minnesota","6/3/20","2610","579","27123","22.18"
"Red Lake","0","4","Minnesota","6/3/20","4","0","27125","0"
"Redwood","0","6","Minnesota","6/3/20","3","3","27127","100"
"Renville","0","5","Minnesota","6/3/20","5","0","27129","0"
"Rice","10","480","Minnesota","6/3/20","411","69","27131","16.79"
"Rock","0","23","Minnesota","6/3/20","21","2","27133","9.52"
"Roseau","0","3","Minnesota","6/3/20","1","2","27135","200"
"Scott","11","455","Minnesota","6/3/20","379","76","27139","20.05"
"Sherburne","4","248","Minnesota","6/3/20","219","29","27141","13.24"
"Sibley","0","16","Minnesota","6/3/20","13","3","27143","23.08"
"St. Louis","0","118","Minnesota","6/3/20","115","3","27137","2.61"
"Stearns","9","2047","Minnesota","6/3/20","1984","63","27145","3.18"
"Steele","3","167","Minnesota","6/3/20","148","19","27147","12.84"
"Stevens","0","1","Minnesota","6/3/20","0","1","27149","1"
"Swift","0","19","Minnesota","6/3/20","17","2","27151","11.76"
"Todd","5","330","Minnesota","6/3/20","296","34","27153","11.49"
"Traverse","0","4","Minnesota","6/3/20","3","1","27155","33.33"
"Wabasha","0","18","Minnesota","6/3/20","17","1","27157","5.88"
"Wadena","0","10","Minnesota","6/3/20","8","2","27159","25"
"Waseca","0","27","Minnesota","6/3/20","24","3","27161","12.5"
"Washington","15","670","Minnesota","6/3/20","562","108","27163","19.22"
"Watonwan","3","78","Minnesota","6/3/20","59","19","27165","32.2"
"Wilkin","0","11","Minnesota","6/3/20","11","0","27167","0"
"Winona","0","80","Minnesota","6/3/20","78","2","27169","2.56"
"Wright","9","332","Minnesota","6/3/20","269","63","27171","23.42"
"Yellow Medicine","0","6","Minnesota","6/3/20","6","0","27173","0"
"Adams","2","202","Mississippi","6/3/20","190","12","28001","6.32"
"Alcorn","1","19","Mississippi","6/3/20","14","5","28003","35.71"
"Amite","1","65","Mississippi","6/3/20","56","9","28005","16.07"
"Attala","4","307","Mississippi","6/3/20","277","30","28007","10.83"
"Benton","0","14","Mississippi","6/3/20","14","0","28009","0"
"Bolivar","2","166","Mississippi","6/3/20","149","17","28011","11.41"
"Calhoun","1","67","Mississippi","6/3/20","61","6","28013","9.84"
"Carroll","0","116","Mississippi","6/3/20","114","2","28015","1.75"
"Chickasaw","2","140","Mississippi","6/3/20","128","12","28017","9.38"
"Choctaw","2","48","Mississippi","6/3/20","35","13","28019","37.14"
"Claiborne","7","114","Mississippi","6/3/20","64","50","28021","78.12"
"Clarke","3","155","Mississippi","6/3/20","135","20","28023","14.81"
"Clay","2","118","Mississippi","6/3/20","104","14","28025","13.46"
"Coahoma","2","128","Mississippi","6/3/20","113","15","28027","13.27"
"Copiah","6","325","Mississippi","6/3/20","285","40","28029","14.04"
"Covington","5","177","Mississippi","6/3/20","141","36","28031","25.53"
"DeSoto","9","559","Mississippi","6/3/20","493","66","28033","13.39"
"Forrest","12","592","Mississippi","6/3/20","511","81","28035","15.85"
"Franklin","0","29","Mississippi","6/3/20","27","2","28037","7.41"
"George","1","28","Mississippi","6/3/20","20","8","28039","40"
"Greene","3","33","Mississippi","6/3/20","11","22","28041","200"
"Grenada","3","100","Mississippi","6/3/20","82","18","28043","21.95"
"Hancock","0","90","Mississippi","6/3/20","87","3","28045","3.45"
"Harrison","3","265","Mississippi","6/3/20","245","20","28047","8.16"
"Hinds","21","1066","Mississippi","6/3/20","920","146","28049","15.87"
"Holmes","10","441","Mississippi","6/3/20","373","68","28051","18.23"
"Humphreys","1","60","Mississippi","6/3/20","53","7","28053","13.21"
"Itawamba","1","90","Mississippi","6/3/20","85","5","28057","5.88"
"Jackson","1","309","Mississippi","6/3/20","300","9","28059","3"
"Jasper","3","166","Mississippi","6/3/20","148","18","28061","12.16"
"Jefferson","0","42","Mississippi","6/3/20","40","2","28063","5"
"Jefferson Davis","1","81","Mississippi","6/3/20","75","6","28065","8"
"Jones","23","686","Mississippi","6/3/20","525","161","28067","30.67"
"Kemper","3","149","Mississippi","6/3/20","131","18","28069","13.74"
"Lafayette","4","150","Mississippi","6/3/20","125","25","28071","20"
"Lamar","3","248","Mississippi","6/3/20","227","21","28073","9.25"
"Lauderdale","9","760","Mississippi","6/3/20","699","61","28075","8.73"
"Lawrence","1","108","Mississippi","6/3/20","99","9","28077","9.09"
"Leake","8","454","Mississippi","6/3/20","395","59","28079","14.94"
"Lee","10","185","Mississippi","6/3/20","117","68","28081","58.12"
"Leflore","3","273","Mississippi","6/3/20","250","23","28083","9.2"
"Lincoln","4","278","Mississippi","6/3/20","250","28","28085","11.2"
"Lowndes","8","241","Mississippi","6/3/20","182","59","28087","32.42"
"Madison","10","757","Mississippi","6/3/20","687","70","28089","10.19"
"Marion","1","116","Mississippi","6/3/20","112","4","28091","3.57"
"Marshall","1","85","Mississippi","6/3/20","76","9","28093","11.84"
"Monroe","2","267","Mississippi","6/3/20","253","14","28095","5.53"
"Montgomery","1","86","Mississippi","6/3/20","81","5","28097","6.17"
"Neshoba","22","722","Mississippi","6/3/20","565","157","28099","27.79"
"Newton","5","283","Mississippi","6/3/20","250","33","28101","13.2"
"Noxubee","3","193","Mississippi","6/3/20","169","24","28103","14.2"
"Oktibbeha","17","267","Mississippi","6/3/20","150","117","28105","78"
"Panola","3","85","Mississippi","6/3/20","64","21","28107","32.81"
"Pearl River","1","212","Mississippi","6/3/20","207","5","28109","2.42"
"Perry","0","51","Mississippi","6/3/20","49","2","28111","4.08"
"Pike","0","205","Mississippi","6/3/20","202","3","28113","1.49"
"Pontotoc","2","45","Mississippi","6/3/20","28","17","28115","60.71"
"Prentiss","2","53","Mississippi","6/3/20","41","12","28117","29.27"
"Quitman","1","31","Mississippi","6/3/20","25","6","28119","24"
"Rankin","11","453","Mississippi","6/3/20","373","80","28121","21.45"
"Scott","6","662","Mississippi","6/3/20","623","39","28123","6.26"
"Sharkey","0","7","Mississippi","6/3/20","7","0","28125","0"
"Simpson","2","104","Mississippi","6/3/20","93","11","28127","11.83"
"Smith","3","153","Mississippi","6/3/20","133","20","28129","15.04"
"Stone","0","32","Mississippi","6/3/20","30","2","28131","6.67"
"Sunflower","2","93","Mississippi","6/3/20","78","15","28133","19.23"
"Tallahatchie","1","30","Mississippi","6/3/20","25","5","28135","20"
"Tate","3","88","Mississippi","6/3/20","69","19","28137","27.54"
"Tippah","1","76","Mississippi","6/3/20","71","5","28139","7.04"
"Tishomingo","1","35","Mississippi","6/3/20","26","9","28141","34.62"
"Tunica","1","56","Mississippi","6/3/20","52","4","28143","7.69"
"Union","1","86","Mississippi","6/3/20","78","8","28145","10.26"
"Walthall","2","63","Mississippi","6/3/20","51","12","28147","23.53"
"Warren","5","191","Mississippi","6/3/20","158","33","28149","20.89"
"Washington","4","194","Mississippi","6/3/20","163","31","28151","19.02"
"Wayne","12","235","Mississippi","6/3/20","148","87","28153","58.78"
"Webster","1","67","Mississippi","6/3/20","59","8","28155","13.56"
"Wilkinson","0","85","Mississippi","6/3/20","85","0","28157","0"
"Winston","2","122","Mississippi","6/3/20","105","17","28159","16.19"
"Yalobusha","2","97","Mississippi","6/3/20","85","12","28161","14.12"
"Yazoo","10","291","Mississippi","6/3/20","223","68","28163","30.49"
"Adair","2","60","Missouri","6/3/20","46","14","29001","30.43"
"Andrew","0","31","Missouri","6/3/20","30","1","29003","3.33"
"Atchison","0","3","Missouri","6/3/20","3","0","29005","0"
"Audrain","4","97","Missouri","6/3/20","68","29","29007","42.65"
"Barry","0","9","Missouri","6/3/20","9","0","29009","0"
"Bates","0","10","Missouri","6/3/20","7","3","29013","42.86"
"Benton","0","11","Missouri","6/3/20","10","1","29015","10"
"Bollinger","0","7","Missouri","6/3/20","6","1","29017","16.67"
"Boone","5","162","Missouri","6/3/20","130","32","29019","24.62"
"Buchanan","9","725","Missouri","6/3/20","662","63","29021","9.52"
"Butler","2","42","Missouri","6/3/20","29","13","29023","44.83"
"Caldwell","0","6","Missouri","6/3/20","5","1","29025","20"
"Callaway","1","30","Missouri","6/3/20","26","4","29027","15.38"
"Camden","0","38","Missouri","6/3/20","38","0","29029","0"
"Cape Girardeau","1","76","Missouri","6/3/20","68","8","29031","11.76"
"Carroll","0","8","Missouri","6/3/20","7","1","29033","14.29"
"Carter","0","5","Missouri","6/3/20","5","0","29035","0"
"Cass","2","97","Missouri","6/3/20","82","15","29037","18.29"
"Cedar","0","9","Missouri","6/3/20","9","0","29039","0"
"Chariton","0","6","Missouri","6/3/20","6","0","29041","0"
"Christian","1","27","Missouri","6/3/20","21","6","29043","28.57"
"Clark","0","1","Missouri","6/3/20","1","0","29045","0"
"Clay","3","177","Missouri","6/3/20","158","19","29047","12.03"
"Clinton","0","18","Missouri","6/3/20","18","0","29049","0"
"Cole","0","61","Missouri","6/3/20","60","1","29051","1.67"
"Cooper","0","9","Missouri","6/3/20","9","0","29053","0"
"Crawford","0","9","Missouri","6/3/20","9","0","29055","0"
"Dallas","0","3","Missouri","6/3/20","3","0","29059","0"
"Daviess","0","4","Missouri","6/3/20","4","0","29061","0"
"DeKalb","0","6","Missouri","6/3/20","6","0","29063","0"
"Dunklin","2","45","Missouri","6/3/20","31","14","29069","45.16"
"Franklin","0","143","Missouri","6/3/20","140","3","29071","2.14"
"Gasconade","0","2","Missouri","6/3/20","2","0","29073","0"
"Gentry","3","41","Missouri","6/3/20","21","20","29075","95.24"
"Greene","6","164","Missouri","6/3/20","125","39","29077","31.2"
"Harrison","0","9","Missouri","6/3/20","9","0","29081","0"
"Henry","0","12","Missouri","6/3/20","10","2","29083","20"
"Holt","0","2","Missouri","6/3/20","1","1","29087","100"
"Howard","0","3","Missouri","6/3/20","3","0","29089","0"
"Howell","1","9","Missouri","6/3/20","5","4","29091","80"
"Iron","0","3","Missouri","6/3/20","2","1","29093","50"
"Jackson","20","656","Missouri","6/3/20","515","141","29095","27.38"
"Jasper","1","39","Missouri","6/3/20","33","6","29097","18.18"
"Jefferson","7","395","Missouri","6/3/20","345","50","29099","14.49"
"Johnson","1","77","Missouri","6/3/20","73","4","29101","5.48"
"Kansas City","40","1366","Missouri","6/3/20","1086","280","00000","25.78"
"Laclede","1","7","Missouri","6/3/20","3","4","29105","133.33"
"Lafayette","1","76","Missouri","6/3/20","72","4","29107","5.56"
"Lawrence","0","8","Missouri","6/3/20","8","0","29109","0"
"Lewis","0","7","Missouri","6/3/20","7","0","29111","0"
"Lincoln","1","118","Missouri","6/3/20","109","9","29113","8.26"
"Linn","1","10","Missouri","6/3/20","6","4","29115","66.67"
"Livingston","0","3","Missouri","6/3/20","3","0","29117","0"
"Macon","1","6","Missouri","6/3/20","2","4","29121","200"
"Madison","0","3","Missouri","6/3/20","3","0","29123","0"
"Maries","0","2","Missouri","6/3/20","2","0","29125","0"
"Marion","0","5","Missouri","6/3/20","5","0","29127","0"
"McDonald","1","22","Missouri","6/3/20","18","4","29119","22.22"
"Miller","0","4","Missouri","6/3/20","4","0","29131","0"
"Mississippi","1","59","Missouri","6/3/20","54","5","29133","9.26"
"Moniteau","0","48","Missouri","6/3/20","45","3","29135","6.67"
"Montgomery","0","9","Missouri","6/3/20","8","1","29139","12.5"
"Morgan","0","9","Missouri","6/3/20","9","0","29141","0"
"New Madrid","1","21","Missouri","6/3/20","17","4","29143","23.53"
"Newton","1","21","Missouri","6/3/20","16","5","29145","31.25"
"Nodaway","0","14","Missouri","6/3/20","12","2","29147","16.67"
"Oregon","0","2","Missouri","6/3/20","2","0","29149","0"
"Osage","0","5","Missouri","6/3/20","5","0","29151","0"
"Pemiscot","2","89","Missouri","6/3/20","76","13","29155","17.11"
"Perry","2","64","Missouri","6/3/20","50","14","29157","28"
"Pettis","1","79","Missouri","6/3/20","72","7","29159","9.72"
"Phelps","0","5","Missouri","6/3/20","4","1","29161","25"
"Pike","2","27","Missouri","6/3/20","16","11","29163","68.75"
"Platte","1","73","Missouri","6/3/20","68","5","29165","7.35"
"Polk","0","3","Missouri","6/3/20","3","0","29167","0"
"Pulaski","1","39","Missouri","6/3/20","34","5","29169","14.71"
"Ralls","0","5","Missouri","6/3/20","3","2","29173","66.67"
"Randolph","0","10","Missouri","6/3/20","9","1","29175","11.11"
"Ray","0","22","Missouri","6/3/20","19","3","29177","15.79"
"Reynolds","0","2","Missouri","6/3/20","2","0","29179","0"
"Ripley","0","10","Missouri","6/3/20","7","3","29181","42.86"
"Saline","0","269","Missouri","6/3/20","268","1","29195","0.37"
"Scotland","1","8","Missouri","6/3/20","4","4","29199","100"
"Scott","3","113","Missouri","6/3/20","94","19","29201","20.21"
"Shelby","0","1","Missouri","6/3/20","1","0","29205","0"
"St. Charles","6","799","Missouri","6/3/20","755","44","29183","5.83"
"St. Clair","0","3","Missouri","6/3/20","3","0","29185","0"
"St. Francois","0","36","Missouri","6/3/20","33","3","29187","9.09"
"St. Louis","43","5190","Missouri","6/3/20","4887","303","29189","6.2"
"St. Louis City","17","2006","Missouri","6/3/20","1884","122","29510","6.48"
"Ste. Genevieve","0","12","Missouri","6/3/20","9","3","29186","33.33"
"Stoddard","3","94","Missouri","6/3/20","74","20","29207","27.03"
"Stone","0","5","Missouri","6/3/20","4","1","29209","25"
"Sullivan","1","61","Missouri","6/3/20","53","8","29211","15.09"
"Taney","0","14","Missouri","6/3/20","14","0","29213","0"
"Texas","0","1","Missouri","6/3/20","0","1","29215","1"
"Vernon","0","10","Missouri","6/3/20","9","1","29217","11.11"
"Warren","0","28","Missouri","6/3/20","28","0","29219","0"
"Washington","0","12","Missouri","6/3/20","10","2","29221","20"
"Webster","0","18","Missouri","6/3/20","17","1","29225","5.88"
"Worth","0","4","Missouri","6/3/20","4","0","29227","0"
"Wright","0","11","Missouri","6/3/20","11","0","29229","0"
"Beaverhead","0","1","Montana","6/3/20","1","0","30001","0"
"Big Horn","3","31","Montana","6/3/20","9","22","30003","244.44"
"Broadwater","0","4","Montana","6/3/20","4","0","30007","0"
"Carbon","0","6","Montana","6/3/20","6","0","30009","0"
"Cascade","0","17","Montana","6/3/20","17","0","30013","0"
"Deer Lodge","0","3","Montana","6/3/20","3","0","30023","0"
"Flathead","0","37","Montana","6/3/20","37","0","30029","0"
"Gallatin","1","155","Montana","6/3/20","149","6","30031","4.03"
"Glacier","0","6","Montana","6/3/20","6","0","30035","0"
"Golden Valley","0","3","Montana","6/3/20","3","0","30037","0"
"Hill","0","1","Montana","6/3/20","1","0","30041","0"
"Jefferson","0","3","Montana","6/3/20","3","0","30043","0"
"Lake","0","5","Montana","6/3/20","5","0","30047","0"
"Lewis and Clark","0","16","Montana","6/3/20","16","0","30049","0"
"Liberty","0","1","Montana","6/3/20","1","0","30051","0"
"Lincoln","0","7","Montana","6/3/20","7","0","30053","0"
"Madison","0","8","Montana","6/3/20","8","0","30057","0"
"Meagher","0","1","Montana","6/3/20","1","0","30059","0"
"Missoula","0","40","Montana","6/3/20","39","1","30063","2.56"
"Musselshell","0","1","Montana","6/3/20","1","0","30065","0"
"Park","0","8","Montana","6/3/20","8","0","30067","0"
"Pondera","0","2","Montana","6/3/20","2","0","30073","0"
"Ravalli","0","14","Montana","6/3/20","13","1","30081","7.69"
"Richland","0","3","Montana","6/3/20","3","0","30083","0"
"Roosevelt","0","7","Montana","6/3/20","7","0","30085","0"
"Rosebud","0","1","Montana","6/3/20","0","1","30087","1"
"Silver Bow","0","11","Montana","6/3/20","11","0","30093","0"
"Stillwater","0","1","Montana","6/3/20","1","0","30095","0"
"Toole","0","29","Montana","6/3/20","29","0","30101","0"
"Wheatland","0","1","Montana","6/3/20","1","0","30107","0"
"Yellowstone","2","102","Montana","6/3/20","89","13","30111","14.61"
"Adams","1","273","Nebraska","6/3/20","264","9","31001","3.41"
"Antelope","0","8","Nebraska","6/3/20","8","0","31003","0"
"Boone","0","6","Nebraska","6/3/20","3","3","31011","100"
"Box Butte","0","2","Nebraska","6/3/20","2","0","31013","0"
"Boyd","0","1","Nebraska","6/3/20","0","1","31015","1"
"Buffalo","3","168","Nebraska","6/3/20","148","20","31019","13.51"
"Burt","0","8","Nebraska","6/3/20","9","-1","31021","-11.11"
"Butler","1","50","Nebraska","6/3/20","45","5","31023","11.11"
"Cass","2","53","Nebraska","6/3/20","40","13","31025","32.5"
"Cedar","0","8","Nebraska","6/3/20","7","1","31027","14.29"
"Chase","0","1","Nebraska","6/3/20","1","0","31029","0"
"Cherry","0","1","Nebraska","6/3/20","1","0","31031","0"
"Cheyenne","0","9","Nebraska","6/3/20","9","0","31033","0"
"Clay","0","24","Nebraska","6/3/20","24","0","31035","0"
"Colfax","3","624","Nebraska","6/3/20","604","20","31037","3.31"
"Cuming","0","34","Nebraska","6/3/20","31","3","31039","9.68"
"Custer","0","31","Nebraska","6/3/20","31","0","31041","0"
"Dakota","6","1684","Nebraska","6/3/20","1639","45","31043","2.75"
"Dawes","0","1","Nebraska","6/3/20","1","0","31045","0"
"Dawson","2","840","Nebraska","6/3/20","827","13","31047","1.57"
"Dixon","1","29","Nebraska","6/3/20","25","4","31051","16"
"Dodge","14","503","Nebraska","6/3/20","407","96","31053","23.59"
"Douglas","151","4640","Nebraska","6/3/20","3583","1057","31055","29.5"
"Fillmore","0","7","Nebraska","6/3/20","5","2","31059","40"
"Franklin","0","6","Nebraska","6/3/20","6","0","31061","0"
"Frontier","0","1","Nebraska","6/3/20","1","0","31063","0"
"Furnas","0","9","Nebraska","6/3/20","8","1","31065","12.5"
"Gage","0","45","Nebraska","6/3/20","44","1","31067","2.27"
"Garden","1","4","Nebraska","6/3/20","0","4","31069","1"
"Gosper","0","13","Nebraska","6/3/20","13","0","31073","0"
"Greeley","0","2","Nebraska","6/3/20","2","0","31077","0"
"Hall","8","1525","Nebraska","6/3/20","1472","53","31079","3.6"
"Hamilton","0","55","Nebraska","6/3/20","54","1","31081","1.85"
"Harlan","0","0","Nebraska","6/3/20","1","-1","31083","-100"
"Hitchcock","0","1","Nebraska","6/3/20","1","0","31087","0"
"Holt","0","1","Nebraska","6/3/20","1","0","31089","0"
"Howard","0","42","Nebraska","6/3/20","40","2","31093","5"
"Jefferson","0","7","Nebraska","6/3/20","6","1","31095","16.67"
"Johnson","0","6","Nebraska","6/3/20","7","-1","31097","-14.29"
"Kearney","0","11","Nebraska","6/3/20","12","-1","31099","-8.33"
"Keith","0","2","Nebraska","6/3/20","2","0","31101","0"
"Kimball","0","8","Nebraska","6/3/20","8","0","31105","0"
"Knox","0","10","Nebraska","6/3/20","10","0","31107","0"
"Lancaster","20","1262","Nebraska","6/3/20","1119","143","31109","12.78"
"Lincoln","0","48","Nebraska","6/3/20","47","1","31111","2.13"
"Madison","2","320","Nebraska","6/3/20","305","15","31119","4.92"
"Merrick","0","33","Nebraska","6/3/20","33","0","31121","0"
"Morrill","0","11","Nebraska","6/3/20","11","0","31123","0"
"Nance","0","4","Nebraska","6/3/20","5","-1","31125","-20"
"Nemaha","0","4","Nebraska","6/3/20","3","1","31127","33.33"
"Nuckolls","0","1","Nebraska","6/3/20","1","0","31129","0"
"Otoe","0","7","Nebraska","6/3/20","6","1","31131","16.67"
"Phelps","0","20","Nebraska","6/3/20","20","0","31137","0"
"Pierce","0","6","Nebraska","6/3/20","3","3","31139","100"
"Platte","9","611","Nebraska","6/3/20","547","64","31141","11.7"
"Polk","0","11","Nebraska","6/3/20","10","1","31143","10"
"Red Willow","0","5","Nebraska","6/3/20","5","0","31145","0"
"Richardson","0","1","Nebraska","6/3/20","1","0","31147","0"
"Saline","2","508","Nebraska","6/3/20","491","17","31151","3.46"
"Sarpy","29","703","Nebraska","6/3/20","503","200","31153","39.76"
"Saunders","2","42","Nebraska","6/3/20","31","11","31155","35.48"
"Scotts Bluff","6","120","Nebraska","6/3/20","75","45","31157","60"
"Seward","0","29","Nebraska","6/3/20","27","2","31159","7.41"
"Sherman","0","4","Nebraska","6/3/20","4","0","31163","0"
"Stanton","0","21","Nebraska","6/3/20","21","0","31167","0"
"Thayer","0","1","Nebraska","6/3/20","0","1","31169","1"
"Thomas","0","1","Nebraska","6/3/20","1","0","31171","0"
"Thurston","2","49","Nebraska","6/3/20","37","12","31173","32.43"
"Valley","0","4","Nebraska","6/3/20","3","1","31175","33.33"
"Washington","1","32","Nebraska","6/3/20","28","4","31177","14.29"
"Wayne","1","18","Nebraska","6/3/20","13","5","31179","38.46"
"Webster","0","5","Nebraska","6/3/20","5","0","31181","0"
"York","0","36","Nebraska","6/3/20","35","1","31185","2.86"
"Carson City","1","99","Nevada","6/3/20","91","8","32510","8.79"
"Churchill","0","8","Nevada","6/3/20","7","1","32001","14.29"
"Clark","91","6923","Nevada","6/3/20","6287","636","32003","10.12"
"Douglas","1","35","Nevada","6/3/20","30","5","32005","16.67"
"Elko","0","26","Nevada","6/3/20","24","2","32007","8.33"
"Humboldt","0","78","Nevada","6/3/20","78","0","32013","0"
"Lander","0","21","Nevada","6/3/20","20","1","32015","5"
"Lincoln","0","2","Nevada","6/3/20","2","0","32017","0"
"Lyon","2","67","Nevada","6/3/20","56","11","32019","19.64"
"Mineral","0","4","Nevada","6/3/20","4","0","32021","0"
"Nye","0","64","Nevada","6/3/20","61","3","32023","4.92"
"Pershing","0","2","Nevada","6/3/20","0","2","32027","1"
"Storey","0","1","Nevada","6/3/20","1","0","32029","0"
"Washoe","19","1618","Nevada","6/3/20","1485","133","32031","8.96"
"White Pine","0","3","Nevada","6/3/20","4","-1","32033","-25"
"Belknap","1","63","New Hampshire","6/3/20","57","6","33001","10.53"
"Carroll","0","48","New Hampshire","6/3/20","46","2","33003","4.35"
"Cheshire","0","57","New Hampshire","6/3/20","54","3","33005","5.56"
"Coos","0","5","New Hampshire","6/3/20","5","0","33007","0"
"Grafton","1","76","New Hampshire","6/3/20","72","4","33009","5.56"
"Hillsborough","53","2554","New Hampshire","6/3/20","2183","371","33011","16.99"
"Merrimack","4","353","New Hampshire","6/3/20","327","26","33013","7.95"
"Rockingham","12","1336","New Hampshire","6/3/20","1254","82","33015","6.54"
"Strafford","2","273","New Hampshire","6/3/20","261","12","33017","4.6"
"Sullivan","0","20","New Hampshire","6/3/20","17","3","33019","17.65"
"Atlantic","28","2284","New Jersey","6/3/20","2087","197","34001","9.44"
"Bergen","50","18376","New Jersey","6/3/20","18023","353","34003","1.96"
"Burlington","38","4700","New Jersey","6/3/20","4432","268","34005","6.05"
"Camden","60","6645","New Jersey","6/3/20","6227","418","34007","6.71"
"Cape May","5","629","New Jersey","6/3/20","592","37","34009","6.25"
"Cumberland","48","2431","New Jersey","6/3/20","2098","333","34011","15.87"
"Essex","68","17813","New Jersey","6/3/20","17338","475","34013","2.74"
"Gloucester","21","2278","New Jersey","6/3/20","2130","148","34015","6.95"
"Hudson","35","18852","New Jersey","6/3/20","18606","246","34017","1.32"
"Hunterdon","5","1006","New Jersey","6/3/20","973","33","34019","3.39"
"Mercer","63","7033","New Jersey","6/3/20","6592","441","34021","6.69"
"Middlesex","74","16066","New Jersey","6/3/20","15547","519","34023","3.34"
"Monmouth","53","8332","New Jersey","6/3/20","7961","371","34025","4.66"
"Morris","36","6540","New Jersey","6/3/20","6289","251","34027","3.99"
"Ocean","48","8853","New Jersey","6/3/20","8514","339","34029","3.98"
"Passaic","58","16277","New Jersey","6/3/20","15873","404","34031","2.55"
"Salem","11","653","New Jersey","6/3/20","579","74","34033","12.78"
"Somerset","16","4619","New Jersey","6/3/20","4505","114","34035","2.53"
"Sussex","5","1128","New Jersey","6/3/20","1095","33","34037","3.01"
"Union","84","15911","New Jersey","6/3/20","15324","587","34039","3.83"
"Warren","5","1182","New Jersey","6/3/20","1145","37","34041","3.23"
"Bernalillo","20","1524","New Mexico","6/3/20","1383","141","35001","10.2"
"Catron","0","2","New Mexico","6/3/20","2","0","35003","0"
"Chaves","1","50","New Mexico","6/3/20","42","8","35005","19.05"
"Cibola","2","147","New Mexico","6/3/20","134","13","35006","9.7"
"Colfax","0","5","New Mexico","6/3/20","5","0","35007","0"
"Curry","1","56","New Mexico","6/3/20","50","6","35009","12"
"Dona Ana","7","488","New Mexico","6/3/20","439","49","35013","11.16"
"Eddy","1","23","New Mexico","6/3/20","19","4","35015","21.05"
"Grant","0","15","New Mexico","6/3/20","15","0","35017","0"
"Guadalupe","0","20","New Mexico","6/3/20","20","0","35019","0"
"Harding","0","1","New Mexico","6/3/20","1","0","35021","0"
"Hidalgo","0","1","New Mexico","6/3/20","1","0","35023","0"
"Lea","0","26","New Mexico","6/3/20","24","2","35025","8.33"
"Lincoln","0","5","New Mexico","6/3/20","2","3","35027","150"
"Los Alamos","0","6","New Mexico","6/3/20","6","0","35028","0"
"Luna","0","10","New Mexico","6/3/20","7","3","35029","42.86"
"McKinley","35","2515","New Mexico","6/3/20","2270","245","35031","10.79"
"Otero","1","22","New Mexico","6/3/20","17","5","35035","29.41"
"Quay","0","5","New Mexico","6/3/20","5","0","35037","0"
"Rio Arriba","2","52","New Mexico","6/3/20","38","14","35039","36.84"
"Roosevelt","1","41","New Mexico","6/3/20","37","4","35041","10.81"
"San Juan","26","1821","New Mexico","6/3/20","1642","179","35045","10.9"
"San Miguel","0","15","New Mexico","6/3/20","14","1","35047","7.14"
"Sandoval","3","575","New Mexico","6/3/20","551","24","35043","4.36"
"Santa Fe","2","150","New Mexico","6/3/20","137","13","35049","9.49"
"Sierra","0","1","New Mexico","6/3/20","1","0","35051","0"
"Socorro","0","52","New Mexico","6/3/20","49","3","35053","6.12"
"Taos","1","30","New Mexico","6/3/20","24","6","35055","25"
"Torrance","0","32","New Mexico","6/3/20","33","-1","35057","-3.03"
"Union","0","4","New Mexico","6/3/20","3","1","35059","33.33"
"Valencia","1","79","New Mexico","6/3/20","73","6","35061","8.22"
"Albany","18","1920","New York","6/3/20","1796","124","36001","6.9"
"Allegany","1","49","New York","6/3/20","45","4","36003","8.89"
"Broome","9","589","New York","6/3/20","528","61","36007","11.55"
"Cattaraugus","1","90","New York","6/3/20","82","8","36009","9.76"
"Cayuga","2","96","New York","6/3/20","80","16","36011","20"
"Chautauqua","2","89","New York","6/3/20","78","11","36013","14.1"
"Chemung","0","137","New York","6/3/20","136","1","36015","0.74"
"Chenango","1","133","New York","6/3/20","125","8","36017","6.4"
"Clinton","0","97","New York","6/3/20","95","2","36019","2.11"
"Columbia","3","399","New York","6/3/20","380","19","36021","5"
"Cortland","0","41","New York","6/3/20","39","2","36023","5.13"
"Delaware","1","82","New York","6/3/20","78","4","36025","5.13"
"Dutchess","15","3951","New York","6/3/20","3847","104","36027","2.7"
"Erie","61","6234","New York","6/3/20","5810","424","36029","7.3"
"Essex","0","38","New York","6/3/20","36","2","36031","5.56"
"Franklin","0","23","New York","6/3/20","20","3","36033","15"
"Fulton","2","213","New York","6/3/20","198","15","36035","7.58"
"Genesee","1","202","New York","6/3/20","195","7","36037","3.59"
"Greene","1","241","New York","6/3/20","231","10","36039","4.33"
"Hamilton","0","5","New York","6/3/20","5","0","36041","0"
"Herkimer","1","113","New York","6/3/20","105","8","36043","7.62"
"Jefferson","0","74","New York","6/3/20","72","2","36045","2.78"
"Lewis","0","20","New York","6/3/20","20","0","36049","0"
"Livingston","0","120","New York","6/3/20","118","2","36051","1.69"
"Madison","1","319","New York","6/3/20","310","9","36053","2.9"
"Monroe","37","3048","New York","6/3/20","2791","257","36055","9.21"
"Montgomery","2","94","New York","6/3/20","82","12","36057","14.63"
"Nassau","87","40644","New York","6/3/20","40034","610","36059","1.52"
"New York","701","204872","New York","6/3/20","199968","4904","36061","2.45"
"Niagara","14","1067","New York","6/3/20","972","95","36063","9.77"
"Oneida","18","1058","New York","6/3/20","929","129","36065","13.89"
"Onondaga","32","2256","New York","6/3/20","2033","223","36067","10.97"
"Ontario","2","215","New York","6/3/20","198","17","36069","8.59"
"Orange","24","10460","New York","6/3/20","10292","168","36071","1.63"
"Orleans","5","246","New York","6/3/20","210","36","36073","17.14"
"Oswego","1","112","New York","6/3/20","105","7","36075","6.67"
"Otsego","1","73","New York","6/3/20","69","4","36077","5.8"
"Putnam","5","1264","New York","6/3/20","1227","37","36079","3.02"
"Rensselaer","4","495","New York","6/3/20","466","29","36083","6.22"
"Rockland","30","13259","New York","6/3/20","13047","212","36087","1.62"
"Saratoga","3","489","New York","6/3/20","465","24","36091","5.16"
"Schenectady","4","701","New York","6/3/20","673","28","36093","4.16"
"Schoharie","0","51","New York","6/3/20","49","2","36095","4.08"
"Schuyler","0","12","New York","6/3/20","11","1","36097","9.09"
"Seneca","1","60","New York","6/3/20","55","5","36099","9.09"
"St. Lawrence","1","206","New York","6/3/20","200","6","36089","3"
"Steuben","0","243","New York","6/3/20","241","2","36101","0.83"
"Suffolk","115","40062","New York","6/3/20","39258","804","36103","2.05"
"Sullivan","8","1393","New York","6/3/20","1340","53","36105","3.96"
"Tioga","1","133","New York","6/3/20","124","9","36107","7.26"
"Tompkins","1","165","New York","6/3/20","155","10","36109","6.45"
"Ulster","8","1701","New York","6/3/20","1645","56","36111","3.4"
"Warren","1","256","New York","6/3/20","252","4","36113","1.59"
"Washington","1","238","New York","6/3/20","228","10","36115","4.39"
"Wayne","1","120","New York","6/3/20","110","10","36117","9.09"
"Westchester","72","33691","New York","6/3/20","33186","505","36119","1.52"
"Wyoming","1","87","New York","6/3/20","82","5","36121","6.1"
"Yates","0","39","New York","6/3/20","39","0","36123","0"
"Alamance","15","413","North Carolina","6/3/20","305","108","37001","35.41"
"Alexander","1","38","North Carolina","6/3/20","28","10","37003","35.71"
"Alleghany","1","24","North Carolina","6/3/20","14","10","37005","71.43"
"Anson","1","68","North Carolina","6/3/20","62","6","37007","9.68"
"Ashe","0","37","North Carolina","6/3/20","35","2","37009","5.71"
"Avery","0","2","North Carolina","6/3/20","2","0","37011","0"
"Beaufort","0","36","North Carolina","6/3/20","36","0","37013","0"
"Bertie","2","126","North Carolina","6/3/20","115","11","37015","9.57"
"Bladen","2","106","North Carolina","6/3/20","94","12","37017","12.77"
"Brunswick","4","110","North Carolina","6/3/20","81","29","37019","35.8"
"Buncombe","12","361","North Carolina","6/3/20","279","82","37021","29.39"
"Burke","20","477","North Carolina","6/3/20","337","140","37023","41.54"
"Cabarrus","8","511","North Carolina","6/3/20","457","54","37025","11.82"
"Caldwell","7","161","North Carolina","6/3/20","114","47","37027","41.23"
"Camden","0","3","North Carolina","6/3/20","3","0","37029","0"
"Carteret","0","37","North Carolina","6/3/20","37","0","37031","0"
"Caswell","6","94","North Carolina","6/3/20","55","39","37033","70.91"
"Catawba","11","255","North Carolina","6/3/20","181","74","37035","40.88"
"Chatham","10","660","North Carolina","6/3/20","588","72","37037","12.24"
"Cherokee","0","30","North Carolina","6/3/20","30","0","37039","0"
"Chowan","0","17","North Carolina","6/3/20","16","1","37041","6.25"
"Clay","0","8","North Carolina","6/3/20","8","0","37043","0"
"Cleveland","5","109","North Carolina","6/3/20","73","36","37045","49.32"
"Columbus","6","349","North Carolina","6/3/20","306","43","37047","14.05"
"Craven","3","210","North Carolina","6/3/20","192","18","37049","9.38"
"Cumberland","17","721","North Carolina","6/3/20","600","121","37051","20.17"
"Currituck","0","14","North Carolina","6/3/20","13","1","37053","7.69"
"Dare","0","22","North Carolina","6/3/20","22","0","37055","0"
"Davidson","12","446","North Carolina","6/3/20","361","85","37057","23.55"
"Davie","4","105","North Carolina","6/3/20","79","26","37059","32.91"
"Duplin","26","890","North Carolina","6/3/20","707","183","37061","25.88"
"Durham","64","1828","North Carolina","6/3/20","1379","449","37063","32.56"
"Edgecombe","3","210","North Carolina","6/3/20","190","20","37065","10.53"
"Forsyth","71","1517","North Carolina","6/3/20","1022","495","37067","48.43"
"Franklin","2","167","North Carolina","6/3/20","151","16","37069","10.6"
"Gaston","6","297","North Carolina","6/3/20","255","42","37071","16.47"
"Gates","0","24","North Carolina","6/3/20","24","0","37073","0"
"Graham","0","2","North Carolina","6/3/20","2","0","37075","0"
"Granville","9","324","North Carolina","6/3/20","258","66","37077","25.58"
"Greene","2","81","North Carolina","6/3/20","66","15","37079","22.73"
"Guilford","39","1415","North Carolina","6/3/20","1143","272","37081","23.8"
"Halifax","6","197","North Carolina","6/3/20","157","40","37083","25.48"
"Harnett","4","306","North Carolina","6/3/20","278","28","37085","10.07"
"Haywood","1","53","North Carolina","6/3/20","44","9","37087","20.45"
"Henderson","4","352","North Carolina","6/3/20","325","27","37089","8.31"
"Hertford","9","132","North Carolina","6/3/20","72","60","37091","83.33"
"Hoke","6","255","North Carolina","6/3/20","214","41","37093","19.16"
"Hyde","0","1","North Carolina","6/3/20","1","0","37095","0"
"Iredell","6","280","North Carolina","6/3/20","236","44","37097","18.64"
"Jackson","2","38","North Carolina","6/3/20","27","11","37099","40.74"
"Johnston","21","513","North Carolina","6/3/20","365","148","37101","40.55"
"Jones","0","28","North Carolina","6/3/20","28","0","37103","0"
"Lee","16","486","North Carolina","6/3/20","376","110","37105","29.26"
"Lenoir","4","222","North Carolina","6/3/20","197","25","37107","12.69"
"Lincoln","2","78","North Carolina","6/3/20","61","17","37109","27.87"
"Macon","10","89","North Carolina","6/3/20","18","71","37113","394.44"
"Madison","0","4","North Carolina","6/3/20","4","0","37115","0"
"Martin","2","74","North Carolina","6/3/20","61","13","37117","21.31"
"McDowell","4","82","North Carolina","6/3/20","52","30","37111","57.69"
"Mecklenburg","170","4670","North Carolina","6/3/20","3478","1192","37119","34.27"
"Mitchell","1","15","North Carolina","6/3/20","9","6","37121","66.67"
"Montgomery","9","162","North Carolina","6/3/20","98","64","37123","65.31"
"Moore","3","235","North Carolina","6/3/20","213","22","37125","10.33"
"Nash","4","213","North Carolina","6/3/20","184","29","37127","15.76"
"New Hanover","8","225","North Carolina","6/3/20","168","57","37129","33.93"
"Northampton","2","165","North Carolina","6/3/20","149","16","37131","10.74"
"Onslow","2","114","North Carolina","6/3/20","98","16","37133","16.33"
"Orange","7","364","North Carolina","6/3/20","314","50","37135","15.92"
"Pamlico","0","10","North Carolina","6/3/20","10","0","37137","0"
"Pasquotank","2","112","North Carolina","6/3/20","100","12","37139","12"
"Pender","3","93","North Carolina","6/3/20","74","19","37141","25.68"
"Perquimans","0","25","North Carolina","6/3/20","23","2","37143","8.7"
"Person","2","54","North Carolina","6/3/20","39","15","37145","38.46"
"Pitt","8","321","North Carolina","6/3/20","267","54","37147","20.22"
"Polk","1","39","North Carolina","6/3/20","35","4","37149","11.43"
"Randolph","15","728","North Carolina","6/3/20","624","104","37151","16.67"
"Richmond","2","170","North Carolina","6/3/20","153","17","37153","11.11"
"Robeson","29","885","North Carolina","6/3/20","680","205","37155","30.15"
"Rockingham","4","102","North Carolina","6/3/20","73","29","37157","39.73"
"Rowan","11","688","North Carolina","6/3/20","613","75","37159","12.23"
"Rutherford","2","186","North Carolina","6/3/20","174","12","37161","6.9"
"Sampson","14","510","North Carolina","6/3/20","409","101","37163","24.69"
"Scotland","3","87","North Carolina","6/3/20","69","18","37165","26.09"
"Stanly","5","92","North Carolina","6/3/20","54","38","37167","70.37"
"Stokes","2","75","North Carolina","6/3/20","58","17","37169","29.31"
"Surry","8","231","North Carolina","6/3/20","173","58","37171","33.53"
"Swain","2","21","North Carolina","6/3/20","10","11","37173","110"
"Transylvania","1","15","North Carolina","6/3/20","11","4","37175","36.36"
"Tyrrell","0","4","North Carolina","6/3/20","4","0","37177","0"
"Union","14","506","North Carolina","6/3/20","408","98","37179","24.02"
"Vance","10","337","North Carolina","6/3/20","266","71","37181","26.69"
"Wake","54","1901","North Carolina","6/3/20","1523","378","37183","24.82"
"Warren","2","70","North Carolina","6/3/20","54","16","37185","29.63"
"Washington","1","32","North Carolina","6/3/20","27","5","37187","18.52"
"Watauga","2","31","North Carolina","6/3/20","14","17","37189","121.43"
"Wayne","20","1188","North Carolina","6/3/20","1047","141","37191","13.47"
"Wilkes","2","500","North Carolina","6/3/20","483","17","37193","3.52"
"Wilson","8","384","North Carolina","6/3/20","330","54","37195","16.36"
"Yadkin","7","203","North Carolina","6/3/20","153","50","37197","32.68"
"Yancey","1","18","North Carolina","6/3/20","11","7","37199","63.64"
"Barnes","0","5","North Dakota","6/3/20","4","1","38003","25"
"Benson","0","1","North Dakota","6/3/20","1","0","38005","0"
"Bottineau","0","2","North Dakota","6/3/20","2","0","38009","0"
"Bowman","0","1","North Dakota","6/3/20","1","0","38011","0"
"Burke","0","5","North Dakota","6/3/20","5","0","38013","0"
"Burleigh","1","132","North Dakota","6/3/20","123","9","38015","7.32"
"Cass","27","1783","North Dakota","6/3/20","1596","187","38017","11.72"
"Dickey","0","1","North Dakota","6/3/20","0","1","38021","1"
"Divide","0","1","North Dakota","6/3/20","1","0","38023","0"
"Dunn","0","11","North Dakota","6/3/20","12","-1","38025","-8.33"
"Eddy","0","4","North Dakota","6/3/20","4","0","38027","0"
"Emmons","0","4","North Dakota","6/3/20","4","0","38029","0"
"Foster","0","1","North Dakota","6/3/20","1","0","38031","0"
"Grand Forks","1","336","North Dakota","6/3/20","327","9","38035","2.75"
"Grant","0","2","North Dakota","6/3/20","2","0","38037","0"
"Griggs","0","1","North Dakota","6/3/20","1","0","38039","0"
"McHenry","0","2","North Dakota","6/3/20","2","0","38049","0"
"McIntosh","0","1","North Dakota","6/3/20","1","0","38051","0"
"McKenzie","0","17","North Dakota","6/3/20","16","1","38053","6.25"
"McLean","0","7","North Dakota","6/3/20","7","0","38055","0"
"Mercer","0","5","North Dakota","6/3/20","5","0","38057","0"
"Morton","0","60","North Dakota","6/3/20","59","1","38059","1.69"
"Mountrail","0","41","North Dakota","6/3/20","39","2","38061","5.13"
"Nelson","0","1","North Dakota","6/3/20","1","0","38063","0"
"Oliver","0","1","North Dakota","6/3/20","1","0","38065","0"
"Pembina","0","6","North Dakota","6/3/20","6","0","38067","0"
"Pierce","0","3","North Dakota","6/3/20","3","0","38069","0"
"Ramsey","0","8","North Dakota","6/3/20","8","0","38071","0"
"Ransom","0","11","North Dakota","6/3/20","8","3","38073","37.5"
"Renville","0","3","North Dakota","6/3/20","1","2","38075","200"
"Richland","0","22","North Dakota","6/3/20","19","3","38077","15.79"
"Rolette","0","6","North Dakota","6/3/20","5","1","38079","20"
"Sargent","0","3","North Dakota","6/3/20","3","0","38081","0"
"Sioux","0","1","North Dakota","6/3/20","2","-1","38085","-50"
"Slope","0","3","North Dakota","6/3/20","3","0","38087","0"
"Stark","0","62","North Dakota","6/3/20","61","1","38089","1.64"
"Steele","0","1","North Dakota","6/3/20","1","0","38091","0"
"Stutsman","2","29","North Dakota","6/3/20","18","11","38093","61.11"
"Traill","1","14","North Dakota","6/3/20","10","4","38097","40"
"Walsh","0","15","North Dakota","6/3/20","13","2","38099","15.38"
"Ward","0","39","North Dakota","6/3/20","36","3","38101","8.33"
"Wells","0","3","North Dakota","6/3/20","3","0","38103","0"
"Williams","0","25","North Dakota","6/3/20","24","1","38105","4.17"
"","0","24","Northern Mariana Islands","6/3/20","22","2",,"9.09"
"Adams","0","10","Ohio","6/3/20","8","2","39001","25"
"Allen","2","214","Ohio","6/3/20","201","13","39003","6.47"
"Ashland","0","21","Ohio","6/3/20","19","2","39005","10.53"
"Ashtabula","4","345","Ohio","6/3/20","316","29","39007","9.18"
"Athens","0","18","Ohio","6/3/20","18","0","39009","0"
"Auglaize","2","76","Ohio","6/3/20","64","12","39011","18.75"
"Belmont","5","439","Ohio","6/3/20","403","36","39013","8.93"
"Brown","1","30","Ohio","6/3/20","25","5","39015","20"
"Butler","15","933","Ohio","6/3/20","826","107","39017","12.95"
"Carroll","0","31","Ohio","6/3/20","29","2","39019","6.9"
"Champaign","0","28","Ohio","6/3/20","27","1","39021","3.7"
"Clark","11","306","Ohio","6/3/20","231","75","39023","32.47"
"Clermont","3","216","Ohio","6/3/20","197","19","39025","9.64"
"Clinton","0","45","Ohio","6/3/20","43","2","39027","4.65"
"Columbiana","30","889","Ohio","6/3/20","682","207","39029","30.35"
"Coshocton","1","40","Ohio","6/3/20","34","6","39031","17.65"
"Crawford","1","117","Ohio","6/3/20","110","7","39033","6.36"
"Cuyahoga","76","4669","Ohio","6/3/20","4137","532","39035","12.86"
"Darke","4","184","Ohio","6/3/20","156","28","39037","17.95"
"Defiance","0","34","Ohio","6/3/20","33","1","39039","3.03"
"Delaware","6","344","Ohio","6/3/20","302","42","39041","13.91"
"Erie","3","182","Ohio","6/3/20","163","19","39043","11.66"
"Fairfield","9","310","Ohio","6/3/20","248","62","39045","25"
"Fayette","0","40","Ohio","6/3/20","37","3","39047","8.11"
"Franklin","89","6112","Ohio","6/3/20","5486","626","39049","11.41"
"Fulton","1","45","Ohio","6/3/20","36","9","39051","25"
"Gallia","0","8","Ohio","6/3/20","7","1","39053","14.29"
"Geauga","5","295","Ohio","6/3/20","261","34","39055","13.03"
"Greene","1","102","Ohio","6/3/20","98","4","39057","4.08"
"Guernsey","0","36","Ohio","6/3/20","33","3","39059","9.09"
"Hamilton","31","2739","Ohio","6/3/20","2523","216","39061","8.56"
"Hancock","0","51","Ohio","6/3/20","48","3","39063","6.25"
"Hardin","3","64","Ohio","6/3/20","41","23","39065","56.1"
"Harrison","0","10","Ohio","6/3/20","10","0","39067","0"
"Henry","0","17","Ohio","6/3/20","15","2","39069","13.33"
"Highland","1","26","Ohio","6/3/20","19","7","39071","36.84"
"Hocking","0","70","Ohio","6/3/20","69","1","39073","1.45"
"Holmes","2","46","Ohio","6/3/20","29","17","39075","58.62"
"Huron","1","60","Ohio","6/3/20","55","5","39077","9.09"
"Jackson","0","14","Ohio","6/3/20","12","2","39079","16.67"
"Jefferson","0","67","Ohio","6/3/20","65","2","39081","3.08"
"Knox","0","25","Ohio","6/3/20","23","2","39083","8.7"
"Lake","4","318","Ohio","6/3/20","287","31","39085","10.8"
"Lawrence","0","30","Ohio","6/3/20","28","2","39087","7.14"
"Licking","7","265","Ohio","6/3/20","218","47","39089","21.56"
"Logan","0","40","Ohio","6/3/20","37","3","39091","8.11"
"Lorain","7","709","Ohio","6/3/20","659","50","39093","7.59"
"Lucas","19","2296","Ohio","6/3/20","2162","134","39095","6.2"
"Madison","3","162","Ohio","6/3/20","144","18","39097","12.5"
"Mahoning","14","1463","Ohio","6/3/20","1367","96","39099","7.02"
"Marion","7","2679","Ohio","6/3/20","2628","51","39101","1.94"
"Medina","8","366","Ohio","6/3/20","310","56","39103","18.06"
"Meigs","0","6","Ohio","6/3/20","6","0","39105","0"
"Mercer","3","220","Ohio","6/3/20","201","19","39107","9.45"
"Miami","2","362","Ohio","6/3/20","351","11","39109","3.13"
"Monroe","1","79","Ohio","6/3/20","74","5","39111","6.76"
"Montgomery","11","695","Ohio","6/3/20","617","78","39113","12.64"
"Morgan","0","5","Ohio","6/3/20","5","0","39115","0"
"Morrow","0","107","Ohio","6/3/20","104","3","39117","2.88"
"Muskingum","1","52","Ohio","6/3/20","46","6","39119","13.04"
"Noble","0","6","Ohio","6/3/20","5","1","39121","20"
"Ottawa","1","102","Ohio","6/3/20","94","8","39123","8.51"
"Paulding","0","14","Ohio","6/3/20","13","1","39125","7.69"
"Perry","0","19","Ohio","6/3/20","18","1","39127","5.56"
"Pickaway","7","2095","Ohio","6/3/20","2046","49","39129","2.39"
"Pike","0","9","Ohio","6/3/20","6","3","39131","50"
"Portage","3","332","Ohio","6/3/20","313","19","39133","6.07"
"Preble","1","39","Ohio","6/3/20","31","8","39135","25.81"
"Putnam","1","95","Ohio","6/3/20","87","8","39137","9.2"
"Richland","3","209","Ohio","6/3/20","189","20","39139","10.58"
"Ross","1","73","Ohio","6/3/20","67","6","39141","8.96"
"Sandusky","2","85","Ohio","6/3/20","70","15","39143","21.43"
"Scioto","0","17","Ohio","6/3/20","15","2","39145","13.33"
"Seneca","1","24","Ohio","6/3/20","19","5","39147","26.32"
"Shelby","1","46","Ohio","6/3/20","40","6","39149","15"
"Stark","7","752","Ohio","6/3/20","700","52","39151","7.43"
"Summit","25","1487","Ohio","6/3/20","1315","172","39153","13.08"
"Trumbull","6","584","Ohio","6/3/20","544","40","39155","7.35"
"Tuscarawas","5","360","Ohio","6/3/20","326","34","39157","10.43"
"Union","1","55","Ohio","6/3/20","46","9","39159","19.57"
"Van Wert","0","7","Ohio","6/3/20","6","1","39161","16.67"
"Vinton","0","21","Ohio","6/3/20","19","2","39163","10.53"
"Warren","7","390","Ohio","6/3/20","344","46","39165","13.37"
"Washington","0","118","Ohio","6/3/20","118","0","39167","0"
"Wayne","5","288","Ohio","6/3/20","256","32","39169","12.5"
"Williams","1","56","Ohio","6/3/20","52","4","39171","7.69"
"Wood","3","303","Ohio","6/3/20","280","23","39173","8.21"
"Wyandot","1","44","Ohio","6/3/20","37","7","39175","18.92"
"Adair","1","91","Oklahoma","6/3/20","82","9","40001","10.98"
"Alfalfa","0","1","Oklahoma","6/3/20","1","0","40003","0"
"Atoka","0","4","Oklahoma","6/3/20","2","2","40005","100"
"Beaver","0","24","Oklahoma","6/3/20","24","0","40007","0"
"Beckham","0","7","Oklahoma","6/3/20","6","1","40009","16.67"
"Blaine","0","8","Oklahoma","6/3/20","6","2","40011","33.33"
"Bryan","1","32","Oklahoma","6/3/20","23","9","40013","39.13"
"Caddo","2","167","Oklahoma","6/3/20","153","14","40015","9.15"
"Canadian","1","133","Oklahoma","6/3/20","128","5","40017","3.91"
"Carter","1","45","Oklahoma","6/3/20","36","9","40019","25"
"Cherokee","0","31","Oklahoma","6/3/20","29","2","40021","6.9"
"Choctaw","9","87","Oklahoma","6/3/20","27","60","40023","222.22"
"Cimarron","0","1","Oklahoma","6/3/20","1","0","40025","0"
"Cleveland","2","511","Oklahoma","6/3/20","494","17","40027","3.44"
"Coal","0","3","Oklahoma","6/3/20","1","2","40029","200"
"Comanche","2","290","Oklahoma","6/3/20","274","16","40031","5.84"
"Cotton","0","5","Oklahoma","6/3/20","5","0","40033","0"
"Craig","0","15","Oklahoma","6/3/20","15","0","40035","0"
"Creek","1","97","Oklahoma","6/3/20","93","4","40037","4.3"
"Custer","2","30","Oklahoma","6/3/20","13","17","40039","130.77"
"Delaware","0","100","Oklahoma","6/3/20","100","0","40041","0"
"Dewey","0","3","Oklahoma","6/3/20","4","-1","40043","-25"
"Garfield","0","27","Oklahoma","6/3/20","26","1","40047","3.85"
"Garvin","0","18","Oklahoma","6/3/20","16","2","40049","12.5"
"Grady","2","100","Oklahoma","6/3/20","83","17","40051","20.48"
"Grant","0","2","Oklahoma","6/3/20","2","0","40053","0"
"Greer","0","66","Oklahoma","6/3/20","66","0","40055","0"
"Harper","0","1","Oklahoma","6/3/20","1","0","40059","0"
"Haskell","0","6","Oklahoma","6/3/20","6","0","40061","0"
"Hughes","0","3","Oklahoma","6/3/20","0","3","40063","1"
"Jackson","0","27","Oklahoma","6/3/20","24","3","40065","12.5"
"Jefferson","0","4","Oklahoma","6/3/20","4","0","40067","0"
"Johnston","0","3","Oklahoma","6/3/20","3","0","40069","0"
"Kay","1","57","Oklahoma","6/3/20","52","5","40071","9.62"
"Kingfisher","0","11","Oklahoma","6/3/20","11","0","40073","0"
"Kiowa","0","6","Oklahoma","6/3/20","6","0","40075","0"
"Latimer","0","5","Oklahoma","6/3/20","5","0","40077","0"
"Le Flore","0","14","Oklahoma","6/3/20","14","0","40079","0"
"Lincoln","0","22","Oklahoma","6/3/20","22","0","40081","0"
"Logan","0","19","Oklahoma","6/3/20","19","0","40083","0"
"Love","0","16","Oklahoma","6/3/20","15","1","40085","6.67"
"Major","0","6","Oklahoma","6/3/20","6","0","40093","0"
"Marshall","0","8","Oklahoma","6/3/20","8","0","40095","0"
"Mayes","0","30","Oklahoma","6/3/20","30","0","40097","0"
"McClain","1","106","Oklahoma","6/3/20","101","5","40087","4.95"
"McCurtain","6","75","Oklahoma","6/3/20","32","43","40089","134.38"
"McIntosh","0","12","Oklahoma","6/3/20","11","1","40091","9.09"
"Murray","0","5","Oklahoma","6/3/20","3","2","40099","66.67"
"Muskogee","3","60","Oklahoma","6/3/20","39","21","40101","53.85"
"Noble","0","7","Oklahoma","6/3/20","7","0","40103","0"
"Nowata","0","23","Oklahoma","6/3/20","23","0","40105","0"
"Okfuskee","0","5","Oklahoma","6/3/20","3","2","40107","66.67"
"Oklahoma","12","1309","Oklahoma","6/3/20","1227","82","40109","6.68"
"Okmulgee","0","25","Oklahoma","6/3/20","23","2","40111","8.7"
"Osage","0","96","Oklahoma","6/3/20","93","3","40113","3.23"
"Ottawa","0","35","Oklahoma","6/3/20","35","0","40115","0"
"Pawnee","0","31","Oklahoma","6/3/20","30","1","40117","3.33"
"Payne","0","48","Oklahoma","6/3/20","45","3","40119","6.67"
"Pittsburg","0","41","Oklahoma","6/3/20","40","1","40121","2.5"
"Pontotoc","0","15","Oklahoma","6/3/20","12","3","40123","25"
"Pottawatomie","1","63","Oklahoma","6/3/20","58","5","40125","8.62"
"Pushmataha","0","5","Oklahoma","6/3/20","2","3","40127","150"
"Rogers","0","82","Oklahoma","6/3/20","79","3","40131","3.8"
"Seminole","1","28","Oklahoma","6/3/20","23","5","40133","21.74"
"Sequoyah","0","15","Oklahoma","6/3/20","14","1","40135","7.14"
"Stephens","0","40","Oklahoma","6/3/20","37","3","40137","8.11"
"Texas","5","939","Oklahoma","6/3/20","902","37","40139","4.1"
"Tillman","0","23","Oklahoma","6/3/20","23","0","40141","0"
"Tulsa","18","1087","Oklahoma","6/3/20","958","129","40143","13.47"
"Wagoner","0","150","Oklahoma","6/3/20","150","0","40145","0"
"Washington","3","334","Oklahoma","6/3/20","314","20","40147","6.37"
"Washita","0","2","Oklahoma","6/3/20","2","0","40149","0"
"Woods","0","3","Oklahoma","6/3/20","3","0","40151","0"
"Woodward","0","5","Oklahoma","6/3/20","4","1","40153","25"
"Baker","0","1","Oregon","6/3/20","1","0","41001","0"
"Benton","0","57","Oregon","6/3/20","55","2","41003","3.64"
"Clackamas","3","324","Oregon","6/3/20","300","24","41005","8"
"Clatsop","0","45","Oregon","6/3/20","45","0","41007","0"
"Columbia","0","16","Oregon","6/3/20","16","0","41009","0"
"Coos","0","31","Oregon","6/3/20","31","0","41011","0"
"Crook","0","6","Oregon","6/3/20","6","0","41013","0"
"Curry","0","7","Oregon","6/3/20","6","1","41015","16.67"
"Deschutes","1","128","Oregon","6/3/20","120","8","41017","6.67"
"Douglas","0","28","Oregon","6/3/20","25","3","41019","12"
"Grant","0","1","Oregon","6/3/20","1","0","41023","0"
"Harney","0","1","Oregon","6/3/20","1","0","41025","0"
"Hood River","2","28","Oregon","6/3/20","13","15","41027","115.38"
"Jackson","0","68","Oregon","6/3/20","65","3","41029","4.62"
"Jefferson","3","45","Oregon","6/3/20","24","21","41031","87.5"
"Josephine","0","23","Oregon","6/3/20","25","-2","41033","-8"
"Klamath","0","44","Oregon","6/3/20","41","3","41035","7.32"
"Lake","0","2","Oregon","6/3/20","2","0","41037","0"
"Lane","1","77","Oregon","6/3/20","67","10","41039","14.93"
"Lincoln","1","18","Oregon","6/3/20","11","7","41041","63.64"
"Linn","1","119","Oregon","6/3/20","115","4","41043","3.48"
"Malheur","1","32","Oregon","6/3/20","28","4","41045","14.29"
"Marion","11","999","Oregon","6/3/20","920","79","41047","8.59"
"Morrow","0","12","Oregon","6/3/20","12","0","41049","0"
"Multnomah","14","1194","Oregon","6/3/20","1093","101","41051","9.24"
"Polk","0","101","Oregon","6/3/20","98","3","41053","3.06"
"Sherman","0","1","Oregon","6/3/20","1","0","41055","0"
"Tillamook","0","6","Oregon","6/3/20","6","0","41057","0"
"Umatilla","2","123","Oregon","6/3/20","112","11","41059","9.82"
"Union","0","6","Oregon","6/3/20","6","0","41061","0"
"Wallowa","0","2","Oregon","6/3/20","2","0","41063","0"
"Wasco","1","28","Oregon","6/3/20","20","8","41065","40"
"Washington","7","752","Oregon","6/3/20","703","49","41067","6.97"
"Yamhill","1","74","Oregon","6/3/20","67","7","41071","10.45"
"Adams","3","260","Pennsylvania","6/3/20","236","24","42001","10.17"
"Allegheny","18","1952","Pennsylvania","6/3/20","1828","124","42003","6.78"
"Armstrong","0","64","Pennsylvania","6/3/20","61","3","42005","4.92"
"Beaver","3","594","Pennsylvania","6/3/20","570","24","42007","4.21"
"Bedford","0","41","Pennsylvania","6/3/20","38","3","42009","7.89"
"Berks","26","4132","Pennsylvania","6/3/20","3952","180","42011","4.55"
"Blair","1","52","Pennsylvania","6/3/20","48","4","42013","8.33"
"Bradford","0","46","Pennsylvania","6/3/20","46","0","42015","0"
"Bucks","30","5137","Pennsylvania","6/3/20","4930","207","42017","4.2"
"Butler","2","235","Pennsylvania","6/3/20","222","13","42019","5.86"
"Cambria","0","59","Pennsylvania","6/3/20","57","2","42021","3.51"
"Cameron","0","2","Pennsylvania","6/3/20","2","0","42023","0"
"Carbon","1","239","Pennsylvania","6/3/20","232","7","42025","3.02"
"Centre","1","154","Pennsylvania","6/3/20","149","5","42027","3.36"
"Chester","51","2863","Pennsylvania","6/3/20","2504","359","42029","14.34"
"Clarion","0","27","Pennsylvania","6/3/20","29","-2","42031","-6.9"
"Clearfield","1","42","Pennsylvania","6/3/20","37","5","42033","13.51"
"Clinton","1","60","Pennsylvania","6/3/20","54","6","42035","11.11"
"Columbia","0","349","Pennsylvania","6/3/20","346","3","42037","0.87"
"Crawford","1","29","Pennsylvania","6/3/20","23","6","42039","26.09"
"Cumberland","6","654","Pennsylvania","6/3/20","611","43","42041","7.04"
"Dauphin","30","1385","Pennsylvania","6/3/20","1174","211","42043","17.97"
"Delaware","37","6548","Pennsylvania","6/3/20","6289","259","42045","4.12"
"Elk","0","6","Pennsylvania","6/3/20","6","0","42047","0"
"Erie","11","314","Pennsylvania","6/3/20","235","79","42049","33.62"
"Fayette","0","95","Pennsylvania","6/3/20","95","0","42051","0"
"Forest","0","7","Pennsylvania","6/3/20","7","0","42053","0"
"Franklin","4","782","Pennsylvania","6/3/20","756","26","42055","3.44"
"Fulton","0","15","Pennsylvania","6/3/20","15","0","42057","0"
"Greene","0","27","Pennsylvania","6/3/20","27","0","42059","0"
"Huntingdon","1","232","Pennsylvania","6/3/20","228","4","42061","1.75"
"Indiana","0","91","Pennsylvania","6/3/20","90","1","42063","1.11"
"Jefferson","1","14","Pennsylvania","6/3/20","7","7","42065","100"
"Juniata","0","95","Pennsylvania","6/3/20","95","0","42067","0"
"Lackawanna","6","1556","Pennsylvania","6/3/20","1511","45","42069","2.98"
"Lancaster","34","3267","Pennsylvania","6/3/20","3031","236","42071","7.79"
"Lawrence","1","83","Pennsylvania","6/3/20","74","9","42073","12.16"
"Lebanon","8","994","Pennsylvania","6/3/20","936","58","42075","6.2"
"Lehigh","15","3802","Pennsylvania","6/3/20","3699","103","42077","2.78"
"Luzerne","13","2766","Pennsylvania","6/3/20","2677","89","42079","3.32"
"Lycoming","1","166","Pennsylvania","6/3/20","161","5","42081","3.11"
"McKean","0","12","Pennsylvania","6/3/20","12","0","42083","0"
"Mercer","0","107","Pennsylvania","6/3/20","106","1","42085","0.94"
"Mifflin","0","59","Pennsylvania","6/3/20","58","1","42087","1.72"
"Monroe","2","1326","Pennsylvania","6/3/20","1310","16","42089","1.22"
"Montgomery","72","7242","Pennsylvania","6/3/20","6738","504","42091","7.48"
"Montour","0","53","Pennsylvania","6/3/20","50","3","42093","6"
"Northampton","23","3120","Pennsylvania","6/3/20","2958","162","42095","5.48"
"Northumberland","2","199","Pennsylvania","6/3/20","182","17","42097","9.34"
"Perry","1","62","Pennsylvania","6/3/20","53","9","42099","16.98"
"Philadelphia","169","23160","Pennsylvania","6/3/20","21975","1185","42101","5.39"
"Pike","0","478","Pennsylvania","6/3/20","476","2","42103","0.42"
"Potter","0","4","Pennsylvania","6/3/20","4","0","42105","0"
"Schuylkill","6","646","Pennsylvania","6/3/20","601","45","42107","7.49"
"Snyder","1","45","Pennsylvania","6/3/20","39","6","42109","15.38"
"Somerset","0","38","Pennsylvania","6/3/20","37","1","42111","2.7"
"Sullivan","0","3","Pennsylvania","6/3/20","2","1","42113","50"
"Susquehanna","2","111","Pennsylvania","6/3/20","98","13","42115","13.27"
"Tioga","0","19","Pennsylvania","6/3/20","16","3","42117","18.75"
"Union","1","63","Pennsylvania","6/3/20","56","7","42119","12.5"
"Venango","0","9","Pennsylvania","6/3/20","8","1","42121","12.5"
"Warren","0","4","Pennsylvania","6/3/20","3","1","42123","33.33"
"Washington","0","140","Pennsylvania","6/3/20","138","2","42125","1.45"
"Wayne","0","120","Pennsylvania","6/3/20","118","2","42127","1.69"
"Westmoreland","2","453","Pennsylvania","6/3/20","442","11","42129","2.49"
"Wyoming","0","34","Pennsylvania","6/3/20","33","1","42131","3.03"
"York","12","1037","Pennsylvania","6/3/20","956","81","42133","8.47"
"","89","4023","Puerto Rico","6/3/20","3397","626",,"18.43"
"Bristol","0","224","Rhode Island","6/3/20","223","1","44001","0.45"
"Kent","3","1052","Rhode Island","6/3/20","1032","20","44003","1.94"
"Newport","1","244","Rhode Island","6/3/20","235","9","44005","3.83"
"Providence","25","11052","Rhode Island","6/3/20","10874","178","44007","1.64"
"Washington","1","499","Rhode Island","6/3/20","493","6","44009","1.22"
"Abbeville","2","46","South Carolina","6/3/20","35","11","45001","31.43"
"Aiken","3","208","South Carolina","6/3/20","184","24","45003","13.04"
"Allendale","1","38","South Carolina","6/3/20","34","4","45005","11.76"
"Anderson","3","244","South Carolina","6/3/20","222","22","45007","9.91"
"Bamberg","0","23","South Carolina","6/3/20","21","2","45009","9.52"
"Barnwell","1","48","South Carolina","6/3/20","43","5","45011","11.63"
"Beaufort","7","398","South Carolina","6/3/20","346","52","45013","15.03"
"Berkeley","3","242","South Carolina","6/3/20","219","23","45015","10.5"
"Calhoun","1","15","South Carolina","6/3/20","10","5","45017","50"
"Charleston","10","646","South Carolina","6/3/20","576","70","45019","12.15"
"Cherokee","2","43","South Carolina","6/3/20","32","11","45021","34.38"
"Chester","4","87","South Carolina","6/3/20","59","28","45023","47.46"
"Chesterfield","8","203","South Carolina","6/3/20","149","54","45025","36.24"
"Clarendon","1","302","South Carolina","6/3/20","295","7","45027","2.37"
"Colleton","5","114","South Carolina","6/3/20","76","38","45029","50"
"Darlington","7","308","South Carolina","6/3/20","260","48","45031","18.46"
"Dillon","2","170","South Carolina","6/3/20","155","15","45033","9.68"
"Dorchester","2","165","South Carolina","6/3/20","151","14","45035","9.27"
"Edgefield","0","51","South Carolina","6/3/20","49","2","45037","4.08"
"Fairfield","3","181","South Carolina","6/3/20","163","18","45039","11.04"
"Florence","9","678","South Carolina","6/3/20","612","66","45041","10.78"
"Georgetown","1","78","South Carolina","6/3/20","71","7","45043","9.86"
"Greenville","55","1751","South Carolina","6/3/20","1364","387","45045","28.37"
"Greenwood","6","148","South Carolina","6/3/20","103","45","45047","43.69"
"Hampton","1","38","South Carolina","6/3/20","34","4","45049","11.76"
"Horry","11","472","South Carolina","6/3/20","392","80","45051","20.41"
"Jasper","1","43","South Carolina","6/3/20","39","4","45053","10.26"
"Kershaw","4","339","South Carolina","6/3/20","312","27","45055","8.65"
"Lancaster","6","166","South Carolina","6/3/20","124","42","45057","33.87"
"Laurens","1","69","South Carolina","6/3/20","60","9","45059","15"
"Lee","2","221","South Carolina","6/3/20","208","13","45061","6.25"
"Lexington","14","677","South Carolina","6/3/20","581","96","45063","16.52"
"Marion","1","72","South Carolina","6/3/20","67","5","45067","7.46"
"Marlboro","7","183","South Carolina","6/3/20","132","51","45069","38.64"
"McCormick","0","9","South Carolina","6/3/20","8","1","45065","12.5"
"Newberry","2","63","South Carolina","6/3/20","49","14","45071","28.57"
"Oconee","1","55","South Carolina","6/3/20","48","7","45073","14.58"
"Orangeburg","7","210","South Carolina","6/3/20","160","50","45075","31.25"
"Pickens","7","174","South Carolina","6/3/20","128","46","45077","35.94"
"Richland","20","1542","South Carolina","6/3/20","1405","137","45079","9.75"
"Saluda","2","148","South Carolina","6/3/20","137","11","45081","8.03"
"Spartanburg","17","645","South Carolina","6/3/20","529","116","45083","21.93"
"Sumter","6","396","South Carolina","6/3/20","357","39","45085","10.92"
"Union","1","40","South Carolina","6/3/20","35","5","45087","14.29"
"Williamsburg","3","245","South Carolina","6/3/20","226","19","45089","8.41"
"York","8","421","South Carolina","6/3/20","363","58","45091","15.98"
"Aurora","1","27","South Dakota","6/3/20","22","5","46003","22.73"
"Beadle","21","308","South Dakota","6/3/20","163","145","46005","88.96"
"Bon Homme","0","8","South Dakota","6/3/20","8","0","46009","0"
"Brookings","1","20","South Dakota","6/3/20","15","5","46011","33.33"
"Brown","4","286","South Dakota","6/3/20","261","25","46013","9.58"
"Brule","0","2","South Dakota","6/3/20","0","2","46015","1"
"Buffalo","2","22","South Dakota","6/3/20","9","13","46017","144.44"
"Charles Mix","1","18","South Dakota","6/3/20","14","4","46023","28.57"
"Clark","0","4","South Dakota","6/3/20","4","0","46025","0"
"Clay","0","15","South Dakota","6/3/20","15","0","46027","0"
"Codington","1","38","South Dakota","6/3/20","34","4","46029","11.76"
"Corson","0","4","South Dakota","6/3/20","4","0","46031","0"
"Davison","1","20","South Dakota","6/3/20","11","9","46035","81.82"
"Day","0","13","South Dakota","6/3/20","13","0","46037","0"
"Deuel","0","1","South Dakota","6/3/20","1","0","46039","0"
"Dewey","0","1","South Dakota","6/3/20","0","1","46041","1"
"Douglas","0","3","South Dakota","6/3/20","3","0","46043","0"
"Edmunds","0","3","South Dakota","6/3/20","0","3","46045","1"
"Fall River","0","6","South Dakota","6/3/20","4","2","46047","50"
"Faulk","0","1","South Dakota","6/3/20","1","0","46049","0"
"Grant","0","13","South Dakota","6/3/20","11","2","46051","18.18"
"Gregory","0","1","South Dakota","6/3/20","0","1","46053","1"
"Hamlin","0","4","South Dakota","6/3/20","4","0","46057","0"
"Hand","0","3","South Dakota","6/3/20","1","2","46059","200"
"Hanson","0","1","South Dakota","6/3/20","0","1","46061","1"
"Hughes","0","19","South Dakota","6/3/20","19","0","46065","0"
"Hutchinson","0","6","South Dakota","6/3/20","4","2","46067","50"
"Hyde","0","1","South Dakota","6/3/20","1","0","46069","0"
"Jackson","0","4","South Dakota","6/3/20","2","2","46071","100"
"Jerauld","1","38","South Dakota","6/3/20","29","9","46073","31.03"
"Kingsbury","0","3","South Dakota","6/3/20","0","3","46077","1"
"Lake","1","10","South Dakota","6/3/20","6","4","46079","66.67"
"Lawrence","0","11","South Dakota","6/3/20","9","2","46081","22.22"
"Lincoln","1","240","South Dakota","6/3/20","236","4","46083","1.69"
"Lyman","0","15","South Dakota","6/3/20","13","2","46085","15.38"
"Marshall","0","4","South Dakota","6/3/20","4","0","46091","0"
"McCook","0","6","South Dakota","6/3/20","5","1","46087","20"
"McPherson","0","1","South Dakota","6/3/20","1","0","46089","0"
"Meade","2","22","South Dakota","6/3/20","10","12","46093","120"
"Miner","0","2","South Dakota","6/3/20","1","1","46097","100"
"Minnehaha","11","3377","South Dakota","6/3/20","3300","77","46099","2.33"
"Moody","0","19","South Dakota","6/3/20","18","1","46101","5.56"
"Oglala Lakota","2","32","South Dakota","6/3/20","20","12","46102","60"
"Pennington","12","257","South Dakota","6/3/20","172","85","46103","49.42"
"Roberts","0","36","South Dakota","6/3/20","39","-3","46109","-7.69"
"Sanborn","0","13","South Dakota","6/3/20","11","2","46111","18.18"
"Spink","0","5","South Dakota","6/3/20","4","1","46115","25"
"Stanley","0","10","South Dakota","6/3/20","10","0","46117","0"
"Sully","0","1","South Dakota","6/3/20","1","0","46119","0"
"Todd","1","28","South Dakota","6/3/20","22","6","46121","27.27"
"Tripp","0","6","South Dakota","6/3/20","6","0","46123","0"
"Turner","0","25","South Dakota","6/3/20","24","1","46125","4.17"
"Union","1","92","South Dakota","6/3/20","87","5","46127","5.75"
"Walworth","0","5","South Dakota","6/3/20","5","0","46129","0"
"Yankton","0","51","South Dakota","6/3/20","51","0","46135","0"
"Ziebach","0","1","South Dakota","6/3/20","1","0","46137","0"
"Anderson","0","41","Tennessee","6/3/20","40","1","47001","2.5"
"Bedford","4","295","Tennessee","6/3/20","270","25","47003","9.26"
"Benton","0","7","Tennessee","6/3/20","7","0","47005","0"
"Bledsoe","0","610","Tennessee","6/3/20","608","2","47007","0.33"
"Blount","1","93","Tennessee","6/3/20","89","4","47009","4.49"
"Bradley","8","161","Tennessee","6/3/20","105","56","47011","53.33"
"Campbell","0","18","Tennessee","6/3/20","17","1","47013","5.88"
"Cannon","2","32","Tennessee","6/3/20","17","15","47015","88.24"
"Carroll","0","28","Tennessee","6/3/20","27","1","47017","3.7"
"Carter","0","19","Tennessee","6/3/20","19","0","47019","0"
"Cheatham","3","135","Tennessee","6/3/20","114","21","47021","18.42"
"Chester","0","12","Tennessee","6/3/20","13","-1","47023","-7.69"
"Claiborne","1","12","Tennessee","6/3/20","8","4","47025","50"
"Clay","0","8","Tennessee","6/3/20","6","2","47027","33.33"
"Cocke","0","21","Tennessee","6/3/20","20","1","47029","5"
"Coffee","1","74","Tennessee","6/3/20","66","8","47031","12.12"
"Crockett","0","16","Tennessee","6/3/20","16","0","47033","0"
"Cumberland","1","119","Tennessee","6/3/20","111","8","47035","7.21"
"Davidson","86","5429","Tennessee","6/3/20","4826","603","47037","12.49"
"Decatur","0","5","Tennessee","6/3/20","5","0","47039","0"
"DeKalb","0","38","Tennessee","6/3/20","37","1","47041","2.7"
"Dickson","2","118","Tennessee","6/3/20","107","11","47043","10.28"
"Dyer","1","57","Tennessee","6/3/20","49","8","47045","16.33"
"Fayette","2","125","Tennessee","6/3/20","110","15","47047","13.64"
"Fentress","0","12","Tennessee","6/3/20","12","0","47049","0"
"Franklin","1","54","Tennessee","6/3/20","49","5","47051","10.2"
"Gibson","0","63","Tennessee","6/3/20","60","3","47053","5"
"Giles","0","12","Tennessee","6/3/20","12","0","47055","0"
"Grainger","1","11","Tennessee","6/3/20","6","5","47057","83.33"
"Greene","1","52","Tennessee","6/3/20","48","4","47059","8.33"
"Grundy","0","31","Tennessee","6/3/20","32","-1","47061","-3.12"
"Hamblen","2","43","Tennessee","6/3/20","30","13","47063","43.33"
"Hamilton","38","935","Tennessee","6/3/20","670","265","47065","39.55"
"Hancock","0","1","Tennessee","6/3/20","1","0","47067","0"
"Hardeman","1","201","Tennessee","6/3/20","192","9","47069","4.69"
"Hardin","2","22","Tennessee","6/3/20","11","11","47071","100"
"Hawkins","0","34","Tennessee","6/3/20","31","3","47073","9.68"
"Haywood","0","33","Tennessee","6/3/20","30","3","47075","10"
"Henderson","0","15","Tennessee","6/3/20","14","1","47077","7.14"
"Henry","0","31","Tennessee","6/3/20","30","1","47079","3.33"
"Hickman","1","58","Tennessee","6/3/20","54","4","47081","7.41"
"Houston","0","8","Tennessee","6/3/20","8","0","47083","0"
"Humphreys","0","15","Tennessee","6/3/20","13","2","47085","15.38"
"Jackson","0","19","Tennessee","6/3/20","17","2","47087","11.76"
"Jefferson","0","28","Tennessee","6/3/20","28","0","47089","0"
"Johnson","1","19","Tennessee","6/3/20","15","4","47091","26.67"
"Knox","11","436","Tennessee","6/3/20","356","80","47093","22.47"
"Lake","60","835","Tennessee","6/3/20","413","422","47095","102.18"
"Lauderdale","0","59","Tennessee","6/3/20","56","3","47097","5.36"
"Lawrence","1","33","Tennessee","6/3/20","24","9","47099","37.5"
"Lewis","0","3","Tennessee","6/3/20","3","0","47101","0"
"Lincoln","1","29","Tennessee","6/3/20","25","4","47103","16"
"Loudon","3","157","Tennessee","6/3/20","137","20","47105","14.6"
"Macon","6","158","Tennessee","6/3/20","119","39","47111","32.77"
"Madison","0","173","Tennessee","6/3/20","174","-1","47113","-0.57"
"Marion","1","42","Tennessee","6/3/20","37","5","47115","13.51"
"Marshall","1","33","Tennessee","6/3/20","29","4","47117","13.79"
"Maury","3","105","Tennessee","6/3/20","81","24","47119","29.63"
"McMinn","1","144","Tennessee","6/3/20","136","8","47107","5.88"
"McNairy","0","15","Tennessee","6/3/20","12","3","47109","25"
"Meigs","0","27","Tennessee","6/3/20","25","2","47121","8"
"Monroe","1","69","Tennessee","6/3/20","59","10","47123","16.95"
"Montgomery","4","283","Tennessee","6/3/20","258","25","47125","9.69"
"Moore","0","5","Tennessee","6/3/20","3","2","47127","66.67"
"Morgan","0","17","Tennessee","6/3/20","17","0","47129","0"
"Obion","2","43","Tennessee","6/3/20","28","15","47131","53.57"
"Out of TN","12","426","Tennessee","6/3/20","339","87","80047","25.66"
"Overton","1","32","Tennessee","6/3/20","25","7","47133","28"
"Perry","2","24","Tennessee","6/3/20","13","11","47135","84.62"
"Pickett","0","3","Tennessee","6/3/20","3","0","47137","0"
"Polk","0","18","Tennessee","6/3/20","15","3","47139","20"
"Putnam","13","519","Tennessee","6/3/20","428","91","47141","21.26"
"Rhea","2","214","Tennessee","6/3/20","197","17","47143","8.63"
"Roane","0","16","Tennessee","6/3/20","16","0","47145","0"
"Robertson","13","516","Tennessee","6/3/20","426","90","47147","21.13"
"Rutherford","33","1321","Tennessee","6/3/20","1090","231","47149","21.19"
"Scott","0","12","Tennessee","6/3/20","11","1","47151","9.09"
"Sequatchie","1","19","Tennessee","6/3/20","13","6","47153","46.15"
"Sevier","3","94","Tennessee","6/3/20","75","19","47155","25.33"
"Shelby","116","5428","Tennessee","6/3/20","4615","813","47157","17.62"
"Smith","1","37","Tennessee","6/3/20","30","7","47159","23.33"
"Stewart","0","13","Tennessee","6/3/20","10","3","47161","30"
"Sullivan","0","60","Tennessee","6/3/20","60","0","47163","0"
"Sumner","13","931","Tennessee","6/3/20","843","88","47165","10.44"
"Tipton","4","459","Tennessee","6/3/20","428","31","47167","7.24"
"Trousdale","0","1394","Tennessee","6/3/20","1392","2","47169","0.14"
"Unicoi","6","48","Tennessee","6/3/20","3","45","47171","1500"
"Union","0","4","Tennessee","6/3/20","4","0","47173","0"
"Van Buren","0","4","Tennessee","6/3/20","4","0","47175","0"
"Warren","1","26","Tennessee","6/3/20","22","4","47177","18.18"
"Washington","0","75","Tennessee","6/3/20","75","0","47179","0"
"Wayne","0","64","Tennessee","6/3/20","63","1","47181","1.59"
"Weakley","0","26","Tennessee","6/3/20","26","0","47183","0"
"White","1","34","Tennessee","6/3/20","28","6","47185","21.43"
"Williamson","6","577","Tennessee","6/3/20","532","45","47187","8.46"
"Wilson","9","442","Tennessee","6/3/20","382","60","47189","15.71"
"Anderson","2","78","Texas","6/3/20","66","12","48001","18.18"
"Andrews","0","27","Texas","6/3/20","27","0","48003","0"
"Angelina","6","232","Texas","6/3/20","193","39","48005","20.21"
"Aransas","0","5","Texas","6/3/20","5","0","48007","0"
"Archer","0","1","Texas","6/3/20","1","0","48009","0"
"Armstrong","0","3","Texas","6/3/20","2","1","48011","50"
"Atascosa","0","37","Texas","6/3/20","35","2","48013","5.71"
"Austin","0","27","Texas","6/3/20","24","3","48015","12.5"
"Bailey","1","19","Texas","6/3/20","14","5","48017","35.71"
"Bandera","0","6","Texas","6/3/20","6","0","48019","0"
"Bastrop","6","231","Texas","6/3/20","190","41","48021","21.58"
"Bee","0","11","Texas","6/3/20","9","2","48025","22.22"
"Bell","12","411","Texas","6/3/20","329","82","48027","24.92"
"Bexar","62","2882","Texas","6/3/20","2449","433","48029","17.68"
"Blanco","0","11","Texas","6/3/20","8","3","48031","37.5"
"Bosque","0","7","Texas","6/3/20","6","1","48035","16.67"
"Bowie","19","287","Texas","6/3/20","156","131","48037","83.97"
"Brazoria","13","941","Texas","6/3/20","853","88","48039","10.32"
"Brazos","8","501","Texas","6/3/20","444","57","48041","12.84"
"Brewster","0","1","Texas","6/3/20","1","0","48043","0"
"Briscoe","0","1","Texas","6/3/20","1","0","48045","0"
"Brooks","0","1","Texas","6/3/20","1","0","48047","0"
"Brown","0","59","Texas","6/3/20","57","2","48049","3.51"
"Burleson","1","26","Texas","6/3/20","22","4","48051","18.18"
"Burnet","2","45","Texas","6/3/20","30","15","48053","50"
"Caldwell","3","73","Texas","6/3/20","52","21","48055","40.38"
"Calhoun","0","37","Texas","6/3/20","37","0","48057","0"
"Callahan","0","9","Texas","6/3/20","9","0","48059","0"
"Cameron","13","799","Texas","6/3/20","711","88","48061","12.38"
"Camp","4","84","Texas","6/3/20","58","26","48063","44.83"
"Carson","0","6","Texas","6/3/20","6","0","48065","0"
"Cass","1","30","Texas","6/3/20","25","5","48067","20"
"Castro","0","33","Texas","6/3/20","32","1","48069","3.12"
"Chambers","1","69","Texas","6/3/20","62","7","48071","11.29"
"Cherokee","0","47","Texas","6/3/20","44","3","48073","6.82"
"Childress","0","2","Texas","6/3/20","2","0","48075","0"
"Clay","0","4","Texas","6/3/20","3","1","48077","33.33"
"Cochran","0","1","Texas","6/3/20","1","0","48079","0"
"Coke","0","1","Texas","6/3/20","1","0","48081","0"
"Coleman","0","4","Texas","6/3/20","2","2","48083","100"
"Collin","22","1346","Texas","6/3/20","1189","157","48085","13.2"
"Collingsworth","0","5","Texas","6/3/20","5","0","48087","0"
"Colorado","0","23","Texas","6/3/20","21","2","48089","9.52"
"Comal","4","108","Texas","6/3/20","83","25","48091","30.12"
"Comanche","0","12","Texas","6/3/20","9","3","48093","33.33"
"Concho","0","1","Texas","6/3/20","1","0","48095","0"
"Cooke","1","18","Texas","6/3/20","13","5","48097","38.46"
"Coryell","9","289","Texas","6/3/20","227","62","48099","27.31"
"Cottle","0","4","Texas","6/3/20","4","0","48101","0"
"Crane","0","25","Texas","6/3/20","22","3","48103","13.64"
"Crosby","0","3","Texas","6/3/20","3","0","48107","0"
"Dallam","1","27","Texas","6/3/20","22","5","48111","22.73"
"Dallas","225","10958","Texas","6/3/20","9385","1573","48113","16.76"
"Dawson","0","43","Texas","6/3/20","40","3","48115","7.5"
"Deaf Smith","1","166","Texas","6/3/20","158","8","48117","5.06"
"Delta","0","2","Texas","6/3/20","1","1","48119","100"
"Denton","23","1416","Texas","6/3/20","1255","161","48121","12.83"
"DeWitt","0","17","Texas","6/3/20","17","0","48123","0"
"Dickens","0","1","Texas","6/3/20","1","0","48125","0"
"Dimmit","0","1","Texas","6/3/20","1","0","48127","0"
"Donley","0","26","Texas","6/3/20","26","0","48129","0"
"Duval","0","5","Texas","6/3/20","5","0","48131","0"
"Eastland","0","7","Texas","6/3/20","6","1","48133","16.67"
"Ector","2","167","Texas","6/3/20","152","15","48135","9.87"
"El Paso","59","2872","Texas","6/3/20","2461","411","48141","16.7"
"Ellis","6","335","Texas","6/3/20","290","45","48139","15.52"
"Erath","0","17","Texas","6/3/20","16","1","48143","6.25"
"Falls","0","9","Texas","6/3/20","6","3","48145","50"
"Fannin","1","41","Texas","6/3/20","37","4","48147","10.81"
"Fayette","1","36","Texas","6/3/20","32","4","48149","12.5"
"Fisher","0","2","Texas","6/3/20","2","0","48151","0"
"Floyd","1","15","Texas","6/3/20","7","8","48153","114.29"
"Fort Bend","26","1916","Texas","6/3/20","1732","184","48157","10.62"
"Franklin","1","17","Texas","6/3/20","13","4","48159","30.77"
"Freestone","0","10","Texas","6/3/20","10","0","48161","0"
"Frio","0","37","Texas","6/3/20","37","0","48163","0"
"Gaines","0","7","Texas","6/3/20","7","0","48165","0"
"Galveston","13","857","Texas","6/3/20","763","94","48167","12.32"
"Garza","0","6","Texas","6/3/20","5","1","48169","20"
"Gillespie","0","5","Texas","6/3/20","5","0","48171","0"
"Glasscock","0","1","Texas","6/3/20","1","0","48173","0"
"Goliad","0","7","Texas","6/3/20","7","0","48175","0"
"Gonzales","6","143","Texas","6/3/20","100","43","48177","43"
"Gray","1","100","Texas","6/3/20","96","4","48179","4.17"
"Grayson","6","350","Texas","6/3/20","310","40","48181","12.9"
"Gregg","7","244","Texas","6/3/20","197","47","48183","23.86"
"Grimes","16","226","Texas","6/3/20","111","115","48185","103.6"
"Guadalupe","2","135","Texas","6/3/20","124","11","48187","8.87"
"Hale","1","60","Texas","6/3/20","56","4","48189","7.14"
"Hall","0","2","Texas","6/3/20","2","0","48191","0"
"Hamilton","0","8","Texas","6/3/20","7","1","48193","14.29"
"Hansford","0","20","Texas","6/3/20","18","2","48195","11.11"
"Hardeman","0","2","Texas","6/3/20","1","1","48197","100"
"Hardin","0","138","Texas","6/3/20","136","2","48199","1.47"
"Harris","247","13268","Texas","6/3/20","11542","1726","48201","14.95"
"Harrison","2","250","Texas","6/3/20","236","14","48203","5.93"
"Hartley","0","12","Texas","6/3/20","11","1","48205","9.09"
"Haskell","0","3","Texas","6/3/20","2","1","48207","50"
"Hays","13","371","Texas","6/3/20","279","92","48209","32.97"
"Hemphill","0","1","Texas","6/3/20","1","0","48211","0"
"Henderson","1","63","Texas","6/3/20","56","7","48213","12.5"
"Hidalgo","13","610","Texas","6/3/20","516","94","48215","18.22"
"Hill","0","24","Texas","6/3/20","24","0","48217","0"
"Hockley","0","27","Texas","6/3/20","27","0","48219","0"
"Hood","0","27","Texas","6/3/20","26","1","48221","3.85"
"Hopkins","1","27","Texas","6/3/20","21","6","48223","28.57"
"Houston","6","127","Texas","6/3/20","84","43","48225","51.19"
"Howard","0","9","Texas","6/3/20","6","3","48227","50"
"Hudspeth","0","2","Texas","6/3/20","1","1","48229","100"
"Hunt","2","91","Texas","6/3/20","76","15","48231","19.74"
"Hutchinson","2","42","Texas","6/3/20","30","12","48233","40"
"Irion","0","1","Texas","6/3/20","0","1","48235","1"
"Jack","0","4","Texas","6/3/20","4","0","48237","0"
"Jackson","0","19","Texas","6/3/20","17","2","48239","11.76"
"Jasper","0","29","Texas","6/3/20","28","1","48241","3.57"
"Jefferson","11","581","Texas","6/3/20","506","75","48245","14.82"
"Jim Hogg","0","4","Texas","6/3/20","4","0","48247","0"
"Jim Wells","0","12","Texas","6/3/20","9","3","48249","33.33"
"Johnson","3","176","Texas","6/3/20","158","18","48251","11.39"
"Jones","77","637","Texas","6/3/20","101","536","48253","530.69"
"Karnes","0","4","Texas","6/3/20","4","0","48255","0"
"Kaufman","4","230","Texas","6/3/20","199","31","48257","15.58"
"Kendall","0","31","Texas","6/3/20","28","3","48259","10.71"
"Kerr","0","20","Texas","6/3/20","17","3","48265","17.65"
"Kimble","0","1","Texas","6/3/20","1","0","48267","0"
"Kinney","0","1","Texas","6/3/20","0","1","48271","1"
"Kleberg","0","17","Texas","6/3/20","16","1","48273","6.25"
"Knox","0","1","Texas","6/3/20","1","0","48275","0"
"La Salle","0","4","Texas","6/3/20","4","0","48283","0"
"Lamar","2","151","Texas","6/3/20","134","17","48277","12.69"
"Lamb","0","16","Texas","6/3/20","16","0","48279","0"
"Lampasas","0","9","Texas","6/3/20","8","1","48281","12.5"
"Lavaca","0","14","Texas","6/3/20","11","3","48285","27.27"
"Lee","2","25","Texas","6/3/20","11","14","48287","127.27"
"Leon","0","10","Texas","6/3/20","9","1","48289","11.11"
"Liberty","2","97","Texas","6/3/20","80","17","48291","21.25"
"Limestone","1","27","Texas","6/3/20","23","4","48293","17.39"
"Lipscomb","0","3","Texas","6/3/20","2","1","48295","50"
"Live Oak","0","9","Texas","6/3/20","9","0","48297","0"
"Llano","0","3","Texas","6/3/20","3","0","48299","0"
"Lubbock","5","706","Texas","6/3/20","674","32","48303","4.75"
"Lynn","0","7","Texas","6/3/20","6","1","48305","16.67"
"Madison","0","9","Texas","6/3/20","8","1","48313","12.5"
"Marion","0","17","Texas","6/3/20","16","1","48315","6.25"
"Martin","0","3","Texas","6/3/20","3","0","48317","0"
"Mason","0","32","Texas","6/3/20","31","1","48319","3.23"
"Matagorda","0","70","Texas","6/3/20","67","3","48321","4.48"
"Maverick","2","120","Texas","6/3/20","109","11","48323","10.09"
"McCulloch","0","3","Texas","6/3/20","3","0","48307","0"
"McLennan","1","121","Texas","6/3/20","112","9","48309","8.04"
"Medina","1","74","Texas","6/3/20","68","6","48325","8.82"
"Midland","2","137","Texas","6/3/20","125","12","48329","9.6"
"Milam","0","29","Texas","6/3/20","28","1","48331","3.57"
"Mills","0","1","Texas","6/3/20","1","0","48333","0"
"Mitchell","0","1","Texas","6/3/20","1","0","48335","0"
"Montague","0","9","Texas","6/3/20","9","0","48337","0"
"Montgomery","15","1033","Texas","6/3/20","926","107","48339","11.56"
"Moore","37","840","Texas","6/3/20","583","257","48341","44.08"
"Morris","0","25","Texas","6/3/20","22","3","48343","13.64"
"Motley","0","1","Texas","6/3/20","1","0","48345","0"
"Nacogdoches","5","294","Texas","6/3/20","261","33","48347","12.64"
"Navarro","1","58","Texas","6/3/20","49","9","48349","18.37"
"Newton","0","5","Texas","6/3/20","4","1","48351","25"
"Nolan","0","3","Texas","6/3/20","2","1","48353","50"
"Nueces","2","280","Texas","6/3/20","266","14","48355","5.26"
"Ochiltree","1","50","Texas","6/3/20","43","7","48357","16.28"
"Oldham","0","4","Texas","6/3/20","3","1","48359","33.33"
"Orange","0","98","Texas","6/3/20","96","2","48361","2.08"
"Palo Pinto","0","13","Texas","6/3/20","11","2","48363","18.18"
"Panola","1","199","Texas","6/3/20","194","5","48365","2.58"
"Parker","2","81","Texas","6/3/20","68","13","48367","19.12"
"Parmer","2","69","Texas","6/3/20","54","15","48369","27.78"
"Pecos","11","103","Texas","6/3/20","27","76","48371","281.48"
"Polk","1","60","Texas","6/3/20","53","7","48373","13.21"
"Potter","26","2432","Texas","6/3/20","2251","181","48375","8.04"
"Presidio","0","1","Texas","6/3/20","1","0","48377","0"
"Rains","0","4","Texas","6/3/20","3","1","48379","33.33"
"Randall","8","711","Texas","6/3/20","652","59","48381","9.05"
"Reagan","0","2","Texas","6/3/20","1","1","48383","100"
"Red River","3","74","Texas","6/3/20","50","24","48387","48"
"Reeves","0","7","Texas","6/3/20","7","0","48389","0"
"Refugio","0","3","Texas","6/3/20","3","0","48391","0"
"Roberts","0","2","Texas","6/3/20","2","0","48393","0"
"Robertson","1","11","Texas","6/3/20","7","4","48395","57.14"
"Rockwall","2","171","Texas","6/3/20","156","15","48397","9.62"
"Runnels","0","2","Texas","6/3/20","2","0","48399","0"
"Rusk","2","57","Texas","6/3/20","44","13","48401","29.55"
"Sabine","1","15","Texas","6/3/20","5","10","48403","200"
"San Augustine","2","44","Texas","6/3/20","31","13","48405","41.94"
"San Jacinto","0","14","Texas","6/3/20","14","0","48407","0"
"San Patricio","1","36","Texas","6/3/20","29","7","48409","24.14"
"San Saba","0","1","Texas","6/3/20","1","0","48411","0"
"Scurry","4","32","Texas","6/3/20","2","30","48415","1500"
"Shackelford","0","1","Texas","6/3/20","1","0","48417","0"
"Shelby","3","207","Texas","6/3/20","187","20","48419","10.7"
"Sherman","1","27","Texas","6/3/20","22","5","48421","22.73"
"Smith","2","212","Texas","6/3/20","199","13","48423","6.53"
"Starr","2","37","Texas","6/3/20","26","11","48427","42.31"
"Stephens","0","4","Texas","6/3/20","4","0","48429","0"
"Swisher","0","17","Texas","6/3/20","17","0","48437","0"
"Tarrant","83","5623","Texas","6/3/20","5039","584","48439","11.59"
"Taylor","2","241","Texas","6/3/20","230","11","48441","4.78"
"Terry","0","13","Texas","6/3/20","13","0","48445","0"
"Titus","23","511","Texas","6/3/20","347","164","48449","47.26"
"Tom Green","2","107","Texas","6/3/20","93","14","48451","15.05"
"Travis","64","3433","Texas","6/3/20","2984","449","48453","15.05"
"Trinity","0","15","Texas","6/3/20","13","2","48455","15.38"
"Tyler","0","12","Texas","6/3/20","11","1","48457","9.09"
"Upshur","1","28","Texas","6/3/20","19","9","48459","47.37"
"Uvalde","1","16","Texas","6/3/20","6","10","48463","166.67"
"Val Verde","0","21","Texas","6/3/20","18","3","48465","16.67"
"Van Zandt","1","35","Texas","6/3/20","30","5","48467","16.67"
"Victoria","1","162","Texas","6/3/20","157","5","48469","3.18"
"Walker","145","1730","Texas","6/3/20","716","1014","48471","141.62"
"Waller","1","63","Texas","6/3/20","56","7","48473","12.5"
"Ward","0","1","Texas","6/3/20","1","0","48475","0"
"Washington","1","204","Texas","6/3/20","196","8","48477","4.08"
"Webb","4","552","Texas","6/3/20","521","31","48479","5.95"
"Wharton","2","68","Texas","6/3/20","56","12","48481","21.43"
"Wheeler","0","15","Texas","6/3/20","15","0","48483","0"
"Wichita","0","85","Texas","6/3/20","84","1","48485","1.19"
"Wilbarger","0","7","Texas","6/3/20","6","1","48487","16.67"
"Willacy","1","21","Texas","6/3/20","15","6","48489","40"
"Williamson","9","649","Texas","6/3/20","588","61","48491","10.37"
"Wilson","0","41","Texas","6/3/20","38","3","48493","7.89"
"Winkler","0","3","Texas","6/3/20","3","0","48495","0"
"Wise","0","47","Texas","6/3/20","45","2","48497","4.44"
"Wood","2","38","Texas","6/3/20","25","13","48499","52"
"Yoakum","0","3","Texas","6/3/20","3","0","48501","0"
"Young","0","4","Texas","6/3/20","4","0","48503","0"
"Zapata","0","11","Texas","6/3/20","8","3","48505","37.5"
"Zavala","0","12","Texas","6/3/20","11","1","48507","9.09"
"Bear River","28","305","Utah","6/3/20","111","194","00000","174.77"
"Central Utah","1","39","Utah","6/3/20","33","6","00000","18.18"
"Davis","10","494","Utah","6/3/20","424","70","49011","16.51"
"Salt Lake","132","5603","Utah","6/3/20","4682","921","49035","19.67"
"San Juan","5","309","Utah","6/3/20","272","37","49037","13.6"
"Southeast Utah","0","26","Utah","6/3/20","23","3","00000","13.04"
"Southwest Utah","23","498","Utah","6/3/20","335","163","00000","48.66"
"Summit","2","418","Utah","6/3/20","407","11","49043","2.7"
"Tooele","3","136","Utah","6/3/20","115","21","49045","18.26"
"TriCounty","0","20","Utah","6/3/20","20","0","00000","0"
"Utah","39","2028","Utah","6/3/20","1753","275","49049","15.69"
"Wasatch","7","305","Utah","6/3/20","258","47","49051","18.22"
"Weber-Morgan","6","316","Utah","6/3/20","273","43","00000","15.75"
"Addison","0","64","Vermont","6/3/20","62","2","50001","3.23"
"Bennington","0","64","Vermont","6/3/20","62","2","50003","3.23"
"Caledonia","0","16","Vermont","6/3/20","15","1","50005","6.67"
"Chittenden","2","457","Vermont","6/3/20","446","11","50007","2.47"
"Essex","0","3","Vermont","6/3/20","3","0","50009","0"
"Franklin","0","99","Vermont","6/3/20","99","0","50011","0"
"Grand Isle","0","7","Vermont","6/3/20","7","0","50013","0"
"Lamoille","0","29","Vermont","6/3/20","29","0","50015","0"
"Orange","0","9","Vermont","6/3/20","8","1","50017","12.5"
"Orleans","0","10","Vermont","6/3/20","10","0","50019","0"
"Rutland","0","55","Vermont","6/3/20","54","1","50021","1.85"
"Washington","0","39","Vermont","6/3/20","39","0","50023","0"
"Windham","0","81","Vermont","6/3/20","80","1","50025","1.25"
"Windsor","0","52","Vermont","6/3/20","51","1","50027","1.96"
"","0","70","Virgin Islands","6/3/20","69","1",,"1.45"
"Accomack","25","953","Virginia","6/3/20","780","173","51001","22.18"
"Albemarle","5","204","Virginia","6/3/20","168","36","51003","21.43"
"Alexandria","27","2016","Virginia","6/3/20","1824","192","51510","10.53"
"Alleghany","1","24","Virginia","6/3/20","16","8","51005","50"
"Amelia","1","28","Virginia","6/3/20","23","5","51007","21.74"
"Amherst","0","27","Virginia","6/3/20","27","0","51009","0"
"Appomattox","0","31","Virginia","6/3/20","31","0","51011","0"
"Arlington","22","2142","Virginia","6/3/20","1988","154","51013","7.75"
"Augusta","2","115","Virginia","6/3/20","102","13","51015","12.75"
"Bedford","2","62","Virginia","6/3/20","45","17","51019","37.78"
"Botetourt","0","34","Virginia","6/3/20","32","2","51023","6.25"
"Bristol","0","4","Virginia","6/3/20","4","0","51520","0"
"Brunswick","1","30","Virginia","6/3/20","21","9","51025","42.86"
"Buchanan","0","18","Virginia","6/3/20","18","0","51027","0"
"Buckingham","3","467","Virginia","6/3/20","445","22","51029","4.94"
"Buena Vista","0","13","Virginia","6/3/20","13","0","51530","0"
"Campbell","0","18","Virginia","6/3/20","16","2","51031","12.5"
"Caroline","3","76","Virginia","6/3/20","55","21","51033","38.18"
"Carroll","3","105","Virginia","6/3/20","86","19","51035","22.09"
"Charles City","0","27","Virginia","6/3/20","27","0","51036","0"
"Charlotte","1","27","Virginia","6/3/20","23","4","51037","17.39"
"Charlottesville","4","128","Virginia","6/3/20","97","31","51540","31.96"
"Chesapeake","11","548","Virginia","6/3/20","472","76","51550","16.1"
"Chesterfield","57","1661","Virginia","6/3/20","1263","398","51041","31.51"
"Clarke","1","29","Virginia","6/3/20","23","6","51043","26.09"
"Colonial Heights","2","96","Virginia","6/3/20","85","11","51570","12.94"
"Covington","0","4","Virginia","6/3/20","3","1","51580","33.33"
"Craig","0","5","Virginia","6/3/20","5","0","51045","0"
"Culpeper","12","727","Virginia","6/3/20","645","82","51047","12.71"
"Cumberland","1","39","Virginia","6/3/20","32","7","51049","21.88"
"Danville","1","58","Virginia","6/3/20","48","10","51590","20.83"
"Dinwiddie","3","84","Virginia","6/3/20","61","23","51053","37.7"
"Emporia","2","86","Virginia","6/3/20","70","16","51595","22.86"
"Essex","1","48","Virginia","6/3/20","43","5","51057","11.63"
"Fairfax","218","11596","Virginia","6/3/20","10069","1527","51059","15.17"
"Fairfax City","1","67","Virginia","6/3/20","59","8","51600","13.56"
"Falls Church","0","55","Virginia","6/3/20","53","2","51610","3.77"
"Fauquier","4","329","Virginia","6/3/20","302","27","51061","8.94"
"Floyd","0","7","Virginia","6/3/20","5","2","51063","40"
"Fluvanna","1","92","Virginia","6/3/20","87","5","51065","5.75"
"Franklin","0","36","Virginia","6/3/20","35","1","51067","2.86"
"Franklin City","0","42","Virginia","6/3/20","39","3","51620","7.69"
"Frederick","12","378","Virginia","6/3/20","296","82","51069","27.7"
"Fredericksburg","5","172","Virginia","6/3/20","135","37","51630","27.41"
"Galax","4","131","Virginia","6/3/20","106","25","51640","23.58"
"Giles","0","5","Virginia","6/3/20","5","0","51071","0"
"Gloucester","0","31","Virginia","6/3/20","30","1","51073","3.33"
"Goochland","1","103","Virginia","6/3/20","94","9","51075","9.57"
"Grayson","1","42","Virginia","6/3/20","32","10","51077","31.25"
"Greene","1","34","Virginia","6/3/20","27","7","51079","25.93"
"Greensville","13","150","Virginia","6/3/20","58","92","51081","158.62"
"Halifax","0","30","Virginia","6/3/20","30","0","51083","0"
"Hampton","4","212","Virginia","6/3/20","183","29","51650","15.85"
"Hanover","3","331","Virginia","6/3/20","309","22","51085","7.12"
"Harrisonburg","9","809","Virginia","6/3/20","746","63","51660","8.45"
"Henrico","51","1933","Virginia","6/3/20","1579","354","51087","22.42"
"Henry","8","145","Virginia","6/3/20","92","53","51089","57.61"
"Highland","0","3","Virginia","6/3/20","3","0","51091","0"
"Hopewell","3","98","Virginia","6/3/20","78","20","51670","25.64"
"Isle of Wight","1","133","Virginia","6/3/20","125","8","51093","6.4"
"James City","2","211","Virginia","6/3/20","200","11","51095","5.5"
"King and Queen","1","13","Virginia","6/3/20","8","5","51097","62.5"
"King George","1","70","Virginia","6/3/20","60","10","51099","16.67"
"King William","1","31","Virginia","6/3/20","25","6","51101","24"
"Lancaster","0","10","Virginia","6/3/20","10","0","51103","0"
"Lee","0","9","Virginia","6/3/20","9","0","51105","0"
"Lexington","0","7","Virginia","6/3/20","6","1","51678","16.67"
"Loudoun","55","2659","Virginia","6/3/20","2274","385","51107","16.93"
"Louisa","1","81","Virginia","6/3/20","75","6","51109","8"
"Lunenburg","1","15","Virginia","6/3/20","10","5","51111","50"
"Lynchburg","0","80","Virginia","6/3/20","80","0","51680","0"
"Madison","0","41","Virginia","6/3/20","38","3","51113","7.89"
"Manassas","27","1154","Virginia","6/3/20","966","188","51683","19.46"
"Manassas Park","7","332","Virginia","6/3/20","280","52","51685","18.57"
"Martinsville","1","38","Virginia","6/3/20","29","9","51690","31.03"
"Mathews","0","5","Virginia","6/3/20","5","0","51115","0"
"Mecklenburg","1","219","Virginia","6/3/20","212","7","51117","3.3"
"Middlesex","0","15","Virginia","6/3/20","14","1","51119","7.14"
"Montgomery","1","80","Virginia","6/3/20","70","10","51121","14.29"
"Nelson","0","17","Virginia","6/3/20","16","1","51125","6.25"
"New Kent","0","38","Virginia","6/3/20","35","3","51127","8.57"
"Newport News","5","292","Virginia","6/3/20","254","38","51700","14.96"
"Norfolk","13","539","Virginia","6/3/20","451","88","51710","19.51"
"Northampton","3","245","Virginia","6/3/20","225","20","51131","8.89"
"Northumberland","0","25","Virginia","6/3/20","23","2","51133","8.7"
"Norton","0","2","Virginia","6/3/20","2","0","51720","0"
"Nottoway","3","40","Virginia","6/3/20","21","19","51135","90.48"
"Orange","3","111","Virginia","6/3/20","91","20","51137","21.98"
"Page","3","231","Virginia","6/3/20","208","23","51139","11.06"
"Patrick","1","21","Virginia","6/3/20","15","6","51141","40"
"Petersburg","6","143","Virginia","6/3/20","101","42","51730","41.58"
"Pittsylvania","1","45","Virginia","6/3/20","35","10","51143","28.57"
"Poquoson","0","8","Virginia","6/3/20","7","1","51735","14.29"
"Portsmouth","6","322","Virginia","6/3/20","282","40","51740","14.18"
"Powhatan","1","36","Virginia","6/3/20","29","7","51145","24.14"
"Prince Edward","2","143","Virginia","6/3/20","129","14","51147","10.85"
"Prince George","8","135","Virginia","6/3/20","79","56","51149","70.89"
"Prince William","109","5837","Virginia","6/3/20","5074","763","51153","15.04"
"Pulaski","1","21","Virginia","6/3/20","14","7","51155","50"
"Radford","0","6","Virginia","6/3/20","7","-1","51750","-14.29"
"Rappahannock","0","14","Virginia","6/3/20","13","1","51157","7.69"
"Richmond","2","287","Virginia","6/3/20","275","12","51159","4.36"
"Richmond City","49","1455","Virginia","6/3/20","1112","343","51760","30.85"
"Roanoke","2","113","Virginia","6/3/20","96","17","51161","17.71"
"Roanoke City","4","176","Virginia","6/3/20","146","30","51770","20.55"
"Rockbridge","0","19","Virginia","6/3/20","17","2","51163","11.76"
"Rockingham","9","548","Virginia","6/3/20","483","65","51165","13.46"
"Russell","0","8","Virginia","6/3/20","8","0","51167","0"
"Salem","1","36","Virginia","6/3/20","32","4","51775","12.5"
"Scott","0","7","Virginia","6/3/20","7","0","51169","0"
"Shenandoah","10","465","Virginia","6/3/20","394","71","51171","18.02"
"Smyth","0","15","Virginia","6/3/20","15","0","51173","0"
"Southampton","1","150","Virginia","6/3/20","144","6","51175","4.17"
"Spotsylvania","17","590","Virginia","6/3/20","474","116","51177","24.47"
"Stafford","12","738","Virginia","6/3/20","657","81","51179","12.33"
"Staunton","2","50","Virginia","6/3/20","36","14","51790","38.89"
"Suffolk","1","318","Virginia","6/3/20","308","10","51800","3.25"
"Surry","0","11","Virginia","6/3/20","8","3","51181","37.5"
"Sussex","4","165","Virginia","6/3/20","138","27","51183","19.57"
"Tazewell","0","9","Virginia","6/3/20","6","3","51185","50"
"Virginia Beach","15","752","Virginia","6/3/20","646","106","51810","16.41"
"Warren","11","204","Virginia","6/3/20","129","75","51187","58.14"
"Washington","0","53","Virginia","6/3/20","51","2","51191","3.92"
"Waynesboro","1","47","Virginia","6/3/20","41","6","51820","14.63"
"Westmoreland","2","76","Virginia","6/3/20","61","15","51193","24.59"
"Williamsburg","0","45","Virginia","6/3/20","43","2","51830","4.65"
"Winchester","6","198","Virginia","6/3/20","156","42","51840","26.92"
"Wise","0","25","Virginia","6/3/20","24","1","51195","4.17"
"Wythe","1","29","Virginia","6/3/20","21","8","51197","38.1"
"York","1","77","Virginia","6/3/20","71","6","51199","8.45"
"Adams","3","73","Washington","6/3/20","53","20","53001","37.74"
"Asotin","0","19","Washington","6/3/20","19","0","53003","0"
"Benton","15","838","Washington","6/3/20","733","105","53005","14.32"
"Chelan","3","254","Washington","6/3/20","236","18","53007","7.63"
"Clallam","0","27","Washington","6/3/20","25","2","53009","8"
"Clark","18","550","Washington","6/3/20","424","126","53011","29.72"
"Columbia","0","1","Washington","6/3/20","1","0","53013","0"
"Cowlitz","0","76","Washington","6/3/20","73","3","53015","4.11"
"Douglas","1","172","Washington","6/3/20","162","10","53017","6.17"
"Ferry","0","1","Washington","6/3/20","1","0","53019","0"
"Franklin","17","632","Washington","6/3/20","513","119","53021","23.2"
"Grant","2","211","Washington","6/3/20","194","17","53025","8.76"
"Grays Harbor","0","18","Washington","6/3/20","16","2","53027","12.5"
"Island","1","181","Washington","6/3/20","177","4","53029","2.26"
"Jefferson","0","31","Washington","6/3/20","30","1","53031","3.33"
"King","57","8264","Washington","6/3/20","7863","401","53033","5.1"
"Kitsap","0","163","Washington","6/3/20","161","2","53035","1.24"
"Kittitas","1","89","Washington","6/3/20","80","9","53037","11.25"
"Klickitat","1","28","Washington","6/3/20","24","4","53039","16.67"
"Lewis","0","37","Washington","6/3/20","35","2","53041","5.71"
"Lincoln","0","2","Washington","6/3/20","2","0","53043","0"
"Mason","0","36","Washington","6/3/20","34","2","53045","5.88"
"Okanogan","1","52","Washington","6/3/20","45","7","53047","15.56"
"Pacific","0","9","Washington","6/3/20","9","0","53049","0"
"Pend Oreille","0","3","Washington","6/3/20","3","0","53051","0"
"Pierce","16","1968","Washington","6/3/20","1856","112","53053","6.03"
"San Juan","0","15","Washington","6/3/20","15","0","53055","0"
"Skagit","2","443","Washington","6/3/20","428","15","53057","3.5"
"Skamania","0","4","Washington","6/3/20","3","1","53059","33.33"
"Snohomish","9","2991","Washington","6/3/20","2927","64","53061","2.19"
"Spokane","16","627","Washington","6/3/20","516","111","53063","21.51"
"Stevens","0","13","Washington","6/3/20","10","3","53065","30"
"Thurston","3","154","Washington","6/3/20","131","23","53067","17.56"
"Wahkiakum","0","4","Washington","6/3/20","4","0","53069","0"
"Walla Walla","0","110","Washington","6/3/20","108","2","53071","1.85"
"Whatcom","3","402","Washington","6/3/20","380","22","53073","5.79"
"Whitman","1","20","Washington","6/3/20","16","4","53075","25"
"Yakima","127","3938","Washington","6/3/20","3048","890","53077","29.2"
"Barbour","0","8","West Virginia","6/3/20","9","-1","54001","-11.11"
"Berkeley","4","326","West Virginia","6/3/20","297","29","54003","9.76"
"Boone","0","9","West Virginia","6/3/20","9","0","54005","0"
"Braxton","0","2","West Virginia","6/3/20","2","0","54007","0"
"Brooke","0","5","West Virginia","6/3/20","4","1","54009","25"
"Cabell","1","67","West Virginia","6/3/20","60","7","54011","11.67"
"Calhoun","0","2","West Virginia","6/3/20","2","0","54013","0"
"Clay","1","6","West Virginia","6/3/20","2","4","54015","200"
"Fayette","1","52","West Virginia","6/3/20","47","5","54019","10.64"
"Gilmer","0","10","West Virginia","6/3/20","10","0","54021","0"
"Grant","0","12","West Virginia","6/3/20","11","1","54023","9.09"
"Greenbrier","0","9","West Virginia","6/3/20","9","0","54025","0"
"Hampshire","1","31","West Virginia","6/3/20","23","8","54027","34.78"
"Hancock","0","19","West Virginia","6/3/20","17","2","54029","11.76"
"Hardy","0","39","West Virginia","6/3/20","38","1","54031","2.63"
"Harrison","0","40","West Virginia","6/3/20","40","0","54033","0"
"Jackson","0","137","West Virginia","6/3/20","135","2","54035","1.48"
"Jefferson","5","199","West Virginia","6/3/20","167","32","54037","19.16"
"Kanawha","2","230","West Virginia","6/3/20","216","14","54039","6.48"
"Lewis","0","9","West Virginia","6/3/20","6","3","54041","50"
"Lincoln","0","5","West Virginia","6/3/20","5","0","54043","0"
"Logan","0","19","West Virginia","6/3/20","16","3","54045","18.75"
"Marion","0","51","West Virginia","6/3/20","51","0","54049","0"
"Marshall","0","30","West Virginia","6/3/20","28","2","54051","7.14"
"Mason","0","15","West Virginia","6/3/20","15","0","54053","0"
"McDowell","0","6","West Virginia","6/3/20","6","0","54047","0"
"Mercer","0","13","West Virginia","6/3/20","13","0","54055","0"
"Mineral","1","47","West Virginia","6/3/20","41","6","54057","14.63"
"Mingo","0","8","West Virginia","6/3/20","6","2","54059","33.33"
"Monongalia","1","135","West Virginia","6/3/20","129","6","54061","4.65"
"Monroe","0","8","West Virginia","6/3/20","7","1","54063","14.29"
"Morgan","0","19","West Virginia","6/3/20","18","1","54065","5.56"
"Nicholas","0","9","West Virginia","6/3/20","10","-1","54067","-10"
"Ohio","1","47","West Virginia","6/3/20","41","6","54069","14.63"
"Pendleton","0","13","West Virginia","6/3/20","10","3","54071","30"
"Pleasants","0","4","West Virginia","6/3/20","5","-1","54073","-20"
"Pocahontas","1","21","West Virginia","6/3/20","17","4","54075","23.53"
"Preston","0","24","West Virginia","6/3/20","22","2","54077","9.09"
"Putnam","1","38","West Virginia","6/3/20","33","5","54079","15.15"
"Raleigh","0","17","West Virginia","6/3/20","16","1","54081","6.25"
"Randolph","4","132","West Virginia","6/3/20","104","28","54083","26.92"
"Ritchie","0","1","West Virginia","6/3/20","1","0","54085","0"
"Roane","0","9","West Virginia","6/3/20","10","-1","54087","-10"
"Summers","0","1","West Virginia","6/3/20","1","0","54089","0"
"Taylor","0","9","West Virginia","6/3/20","9","0","54091","0"
"Tucker","0","4","West Virginia","6/3/20","4","0","54093","0"
"Tyler","0","3","West Virginia","6/3/20","3","0","54095","0"
"Upshur","0","7","West Virginia","6/3/20","7","0","54097","0"
"Wayne","1","102","West Virginia","6/3/20","97","5","54099","5.15"
"Wetzel","0","9","West Virginia","6/3/20","9","0","54103","0"
"Wirt","0","4","West Virginia","6/3/20","4","0","54105","0"
"Wood","0","53","West Virginia","6/3/20","54","-1","54107","-1.85"
"Wyoming","0","2","West Virginia","6/3/20","3","-1","54109","-33.33"
"Adams","0","4","Wisconsin","6/3/20","4","0","55001","0"
"Ashland","0","2","Wisconsin","6/3/20","2","0","55003","0"
"Barron","1","21","Wisconsin","6/3/20","14","7","55005","50"
"Bayfield","0","3","Wisconsin","6/3/20","3","0","55007","0"
"Brown","9","2350","Wisconsin","6/3/20","2285","65","55009","2.84"
"Buffalo","0","6","Wisconsin","6/3/20","5","1","55011","20"
"Burnett","0","1","Wisconsin","6/3/20","1","0","55013","0"
"Calumet","1","79","Wisconsin","6/3/20","74","5","55015","6.76"
"Chippewa","1","58","Wisconsin","6/3/20","54","4","55017","7.41"
"Clark","1","35","Wisconsin","6/3/20","29","6","55019","20.69"
"Columbia","1","44","Wisconsin","6/3/20","40","4","55021","10"
"Crawford","0","26","Wisconsin","6/3/20","26","0","55023","0"
"Dane","17","773","Wisconsin","6/3/20","652","121","55025","18.56"
"Dodge","31","383","Wisconsin","6/3/20","166","217","55027","130.72"
"Door","0","38","Wisconsin","6/3/20","38","0","55029","0"
"Douglas","0","19","Wisconsin","6/3/20","19","0","55031","0"
"Dunn","0","25","Wisconsin","6/3/20","24","1","55033","4.17"
"Eau Claire","2","114","Wisconsin","6/3/20","99","15","55035","15.15"
"Florence","0","2","Wisconsin","6/3/20","2","0","55037","0"
"Fond du Lac","5","221","Wisconsin","6/3/20","185","36","55039","19.46"
"Forest","1","28","Wisconsin","6/3/20","24","4","55041","16.67"
"Grant","1","98","Wisconsin","6/3/20","89","9","55043","10.11"
"Green","2","70","Wisconsin","6/3/20","58","12","55045","20.69"
"Green Lake","1","22","Wisconsin","6/3/20","16","6","55047","37.5"
"Iowa","1","17","Wisconsin","6/3/20","12","5","55049","41.67"
"Iron","0","2","Wisconsin","6/3/20","2","0","55051","0"
"Jackson","1","19","Wisconsin","6/3/20","14","5","55053","35.71"
"Jefferson","3","114","Wisconsin","6/3/20","92","22","55055","23.91"
"Juneau","0","22","Wisconsin","6/3/20","22","0","55057","0"
"Kenosha","26","1217","Wisconsin","6/3/20","1033","184","55059","17.81"
"Kewaunee","0","36","Wisconsin","6/3/20","33","3","55061","9.09"
"La Crosse","1","58","Wisconsin","6/3/20","51","7","55063","13.73"
"Lafayette","0","27","Wisconsin","6/3/20","25","2","55065","8"
"Langlade","0","3","Wisconsin","6/3/20","2","1","55067","50"
"Lincoln","0","7","Wisconsin","6/3/20","5","2","55069","40"
"Manitowoc","1","38","Wisconsin","6/3/20","32","6","55071","18.75"
"Marathon","2","55","Wisconsin","6/3/20","43","12","55073","27.91"
"Marinette","0","32","Wisconsin","6/3/20","32","0","55075","0"
"Marquette","0","6","Wisconsin","6/3/20","3","3","55077","100"
"Menominee","0","3","Wisconsin","6/3/20","3","0","55078","0"
"Milwaukee","194","8108","Wisconsin","6/3/20","6748","1360","55079","20.15"
"Monroe","0","18","Wisconsin","6/3/20","16","2","55081","12.5"
"Oconto","1","39","Wisconsin","6/3/20","35","4","55083","11.43"
"Oneida","0","11","Wisconsin","6/3/20","8","3","55085","37.5"
"Outagamie","6","239","Wisconsin","6/3/20","198","41","55087","20.71"
"Ozaukee","4","170","Wisconsin","6/3/20","144","26","55089","18.06"
"Pepin","0","1","Wisconsin","6/3/20","1","0","55091","0"
"Pierce","1","47","Wisconsin","6/3/20","43","4","55093","9.3"
"Polk","1","24","Wisconsin","6/3/20","17","7","55095","41.18"
"Portage","1","14","Wisconsin","6/3/20","10","4","55097","40"
"Price","0","2","Wisconsin","6/3/20","2","0","55099","0"
"Racine","31","1797","Wisconsin","6/3/20","1579","218","55101","13.81"
"Richland","0","14","Wisconsin","6/3/20","14","0","55103","0"
"Rock","10","658","Wisconsin","6/3/20","588","70","55105","11.9"
"Rusk","0","5","Wisconsin","6/3/20","5","0","55107","0"
"Sauk","0","81","Wisconsin","6/3/20","78","3","55111","3.85"
"Sawyer","0","8","Wisconsin","6/3/20","7","1","55113","14.29"
"Shawano","1","51","Wisconsin","6/3/20","41","10","55115","24.39"
"Sheboygan","2","98","Wisconsin","6/3/20","83","15","55117","18.07"
"St. Croix","4","97","Wisconsin","6/3/20","71","26","55109","36.62"
"Taylor","0","2","Wisconsin","6/3/20","1","1","55119","100"
"Trempealeau","1","29","Wisconsin","6/3/20","22","7","55121","31.82"
"Vernon","0","21","Wisconsin","6/3/20","19","2","55123","10.53"
"Vilas","0","8","Wisconsin","6/3/20","6","2","55125","33.33"
"Walworth","9","424","Wisconsin","6/3/20","363","61","55127","16.8"
"Washburn","0","2","Wisconsin","6/3/20","2","0","55129","0"
"Washington","7","261","Wisconsin","6/3/20","212","49","55131","23.11"
"Waukesha","22","744","Wisconsin","6/3/20","593","151","55133","25.46"
"Waupaca","3","45","Wisconsin","6/3/20","27","18","55135","66.67"
"Waushara","0","10","Wisconsin","6/3/20","8","2","55137","25"
"Winnebago","12","284","Wisconsin","6/3/20","199","85","55139","42.71"
"Wood","0","10","Wisconsin","6/3/20","9","1","55141","11.11"
"Albany","0","25","Wyoming","6/3/20","23","2","56001","8.7"
"Big Horn","0","6","Wyoming","6/3/20","5","1","56003","20"
"Campbell","0","31","Wyoming","6/3/20","30","1","56005","3.33"
"Carbon","0","16","Wyoming","6/3/20","16","0","56007","0"
"Converse","0","24","Wyoming","6/3/20","24","0","56009","0"
"Crook","0","5","Wyoming","6/3/20","5","0","56011","0"
"Fremont","4","285","Wyoming","6/3/20","255","30","56013","11.76"
"Goshen","0","5","Wyoming","6/3/20","5","0","56015","0"
"Hot Springs","0","12","Wyoming","6/3/20","12","0","56017","0"
"Johnson","0","18","Wyoming","6/3/20","18","0","56019","0"
"Laramie","0","188","Wyoming","6/3/20","185","3","56021","1.62"
"Lincoln","0","15","Wyoming","6/3/20","15","0","56023","0"
"Natrona","1","79","Wyoming","6/3/20","72","7","56025","9.72"
"Niobrara","0","2","Wyoming","6/3/20","2","0","56027","0"
"Park","0","2","Wyoming","6/3/20","2","0","56029","0"
"Platte","0","1","Wyoming","6/3/20","1","0","56031","0"
"Sheridan","0","16","Wyoming","6/3/20","16","0","56033","0"
"Sublette","0","3","Wyoming","6/3/20","3","0","56035","0"
"Sweetwater","1","31","Wyoming","6/3/20","25","6","56037","24"
"Teton","0","100","Wyoming","6/3/20","100","0","56039","0"
"Uinta","0","13","Wyoming","6/3/20","12","1","56041","8.33"
"Washakie","1","37","Wyoming","6/3/20","33","4","56043","12.12"
"Weston","0","1","Wyoming","6/3/20","1","0","56045","0"
