"Locality","DailyAvgNewCasesPast7Days","TotalCases","State","Date","TotalCases7DaysAgo","NewCasesPast7Days","FIPS-Code","PercentIncreaseTotalCasesPast7Days"
"Autauga","10","312","Alabama","6/11/20","241","71","01001","29.46"
"Baldwin","7","343","Alabama","6/11/20","293","50","01003","17.06"
"Barbour","5","214","Alabama","6/11/20","177","37","01005","20.9"
"Bibb","2","93","Alabama","6/11/20","76","17","01007","22.37"
"Blount","3","87","Alabama","6/11/20","63","24","01009","38.1"
"Bullock","5","253","Alabama","6/11/20","217","36","01011","16.59"
"Butler","9","484","Alabama","6/11/20","421","63","01013","14.96"
"Calhoun","2","184","Alabama","6/11/20","167","17","01015","10.18"
"Chambers","8","417","Alabama","6/11/20","360","57","01017","15.83"
"Cherokee","1","42","Alabama","6/11/20","38","4","01019","10.53"
"Chilton","2","121","Alabama","6/11/20","107","14","01021","13.08"
"Choctaw","1","162","Alabama","6/11/20","153","9","01023","5.88"
"Clarke","2","165","Alabama","6/11/20","149","16","01025","10.74"
"Clay","0","30","Alabama","6/11/20","28","2","01027","7.14"
"Cleburne","1","20","Alabama","6/11/20","15","5","01029","33.33"
"Coffee","3","260","Alabama","6/11/20","239","21","01031","8.79"
"Colbert","6","230","Alabama","6/11/20","190","40","01033","21.05"
"Conecuh","4","70","Alabama","6/11/20","41","29","01035","70.73"
"Coosa","0","43","Alabama","6/11/20","40","3","01037","7.5"
"Covington","2","98","Alabama","6/11/20","82","16","01039","19.51"
"Crenshaw","3","99","Alabama","6/11/20","78","21","01041","26.92"
"Cullman","10","220","Alabama","6/11/20","152","68","01043","44.74"
"Dale","4","149","Alabama","6/11/20","124","25","01045","20.16"
"Dallas","16","406","Alabama","6/11/20","292","114","01047","39.04"
"DeKalb","5","291","Alabama","6/11/20","257","34","01049","13.23"
"Elmore","14","471","Alabama","6/11/20","374","97","01051","25.94"
"Escambia","3","93","Alabama","6/11/20","75","18","01053","24"
"Etowah","3","287","Alabama","6/11/20","263","24","01055","9.13"
"Fayette","1","23","Alabama","6/11/20","16","7","01057","43.75"
"Franklin","10","652","Alabama","6/11/20","585","67","01059","11.45"
"Geneva","0","46","Alabama","6/11/20","44","2","01061","4.55"
"Greene","2","112","Alabama","6/11/20","95","17","01063","17.89"
"Hale","5","219","Alabama","6/11/20","185","34","01065","18.38"
"Henry","2","94","Alabama","6/11/20","82","12","01067","14.63"
"Houston","6","270","Alabama","6/11/20","226","44","01069","19.47"
"Jackson","3","107","Alabama","6/11/20","83","24","01071","28.92"
"Jefferson","50","2250","Alabama","6/11/20","1901","349","01073","18.36"
"Lamar","0","30","Alabama","6/11/20","28","2","01075","7.14"
"Lauderdale","5","207","Alabama","6/11/20","172","35","01077","20.35"
"Lawrence","1","60","Alabama","6/11/20","51","9","01079","17.65"
"Lee","9","625","Alabama","6/11/20","562","63","01081","11.21"
"Limestone","8","162","Alabama","6/11/20","108","54","01083","50"
"Lowndes","9","326","Alabama","6/11/20","265","61","01085","23.02"
"Macon","2","110","Alabama","6/11/20","93","17","01087","18.28"
"Madison","11","428","Alabama","6/11/20","353","75","01089","21.25"
"Marengo","4","200","Alabama","6/11/20","175","25","01091","14.29"
"Marion","1","129","Alabama","6/11/20","124","5","01093","4.03"
"Marshall","11","786","Alabama","6/11/20","708","78","01095","11.02"
"Mobile","39","2593","Alabama","6/11/20","2321","272","01097","11.72"
"Monroe","7","95","Alabama","6/11/20","46","49","01099","106.52"
"Montgomery","83","2436","Alabama","6/11/20","1858","578","01101","31.11"
"Morgan","25","477","Alabama","6/11/20","302","175","01103","57.95"
"Perry","2","56","Alabama","6/11/20","43","13","01105","30.23"
"Pickens","2","131","Alabama","6/11/20","120","11","01107","9.17"
"Pike","10","283","Alabama","6/11/20","212","71","01109","33.49"
"Randolph","1","137","Alabama","6/11/20","128","9","01111","7.03"
"Russell","10","250","Alabama","6/11/20","181","69","01113","38.12"
"Shelby","7","580","Alabama","6/11/20","528","52","01117","9.85"
"St. Clair","3","153","Alabama","6/11/20","135","18","01115","13.33"
"Sumter","4","253","Alabama","6/11/20","228","25","01119","10.96"
"Talladega","4","146","Alabama","6/11/20","119","27","01121","22.69"
"Tallapoosa","3","454","Alabama","6/11/20","434","20","01123","4.61"
"Tuscaloosa","33","1070","Alabama","6/11/20","836","234","01125","27.99"
"Walker","16","500","Alabama","6/11/20","386","114","01127","29.53"
"Washington","2","84","Alabama","6/11/20","73","11","01129","15.07"
"Wilcox","5","190","Alabama","6/11/20","157","33","01131","21.02"
"Winston","2","106","Alabama","6/11/20","91","15","01133","16.48"
"Anchorage","6","301","Alaska","6/11/20","258","43","02020","16.67"
"Bethel","0","3","Alaska","6/11/20","3","0","02050","0"
"Fairbanks North Star","0","88","Alaska","6/11/20","85","3","02090","3.53"
"Haines","0","1","Alaska","6/11/20","0","1","02100","1"
"Juneau","1","37","Alaska","6/11/20","33","4","02110","12.12"
"Kenai Peninsula","5","97","Alaska","6/11/20","63","34","02122","53.97"
"Ketchikan Gateway","0","16","Alaska","6/11/20","16","0","02130","0"
"Kodiak Island","0","2","Alaska","6/11/20","1","1","02150","100"
"Matanuska-Susitna","1","39","Alaska","6/11/20","35","4","02170","11.43"
"Nome","0","4","Alaska","6/11/20","3","1","02180","33.33"
"North Slope","0","1","Alaska","6/11/20","1","0","02185","0"
"Northwest Arctic","0","4","Alaska","6/11/20","2","2","02188","100"
"Petersburg","0","4","Alaska","6/11/20","4","0","02195","0"
"Prince of Wales-Hyder","0","2","Alaska","6/11/20","2","0","02198","0"
"Sitka","0","5","Alaska","6/11/20","2","3","02220","150"
"Southeast Fairbanks","0","3","Alaska","6/11/20","3","0","02240","0"
"Wrangell","0","1","Alaska","6/11/20","0","1","02275","1"
"Yukon-Koyukuk","0","1","Alaska","6/11/20","1","0","02290","0"
"Apache","36","1887","Arizona","6/11/20","1637","250","04001","15.27"
"Cochise","9","171","Arizona","6/11/20","105","66","04003","62.86"
"Coconino","14","1317","Arizona","6/11/20","1221","96","04005","7.86"
"Gila","1","49","Arizona","6/11/20","39","10","04007","25.64"
"Graham","1","48","Arizona","6/11/20","38","10","04009","26.32"
"Greenlee","1","12","Arizona","6/11/20","8","4","04011","50"
"La Paz","14","211","Arizona","6/11/20","110","101","04012","91.82"
"Maricopa","684","16018","Arizona","6/11/20","11229","4789","04013","42.65"
"Mohave","19","563","Arizona","6/11/20","428","135","04015","31.54"
"Navajo","62","2479","Arizona","6/11/20","2042","437","04017","21.4"
"Pima","116","3479","Arizona","6/11/20","2669","810","04019","30.35"
"Pinal","48","1281","Arizona","6/11/20","948","333","04021","35.13"
"Santa Cruz","49","805","Arizona","6/11/20","462","343","04023","74.24"
"Yavapai","7","359","Arizona","6/11/20","307","52","04025","16.94"
"Yuma","135","2588","Arizona","6/11/20","1643","945","04027","57.52"
"Arkansas","0","7","Arkansas","6/11/20","7","0","05001","0"
"Ashley","1","35","Arkansas","6/11/20","26","9","05003","34.62"
"Baxter","0","14","Arkansas","6/11/20","12","2","05005","16.67"
"Benton","59","1219","Arkansas","6/11/20","804","415","05007","51.62"
"Boone","0","7","Arkansas","6/11/20","7","0","05009","0"
"Bradley","2","34","Arkansas","6/11/20","23","11","05011","47.83"
"Carroll","4","56","Arkansas","6/11/20","30","26","05015","86.67"
"Chicot","2","32","Arkansas","6/11/20","16","16","05017","100"
"Clark","0","43","Arkansas","6/11/20","40","3","05019","7.5"
"Clay","1","9","Arkansas","6/11/20","5","4","05021","80"
"Cleburne","0","74","Arkansas","6/11/20","76","-2","05023","-2.63"
"Cleveland","0","19","Arkansas","6/11/20","19","0","05025","0"
"Columbia","1","27","Arkansas","6/11/20","23","4","05027","17.39"
"Conway","0","16","Arkansas","6/11/20","15","1","05029","6.67"
"Craighead","10","337","Arkansas","6/11/20","266","71","05031","26.69"
"Crawford","2","47","Arkansas","6/11/20","35","12","05033","34.29"
"Crittenden","11","500","Arkansas","6/11/20","426","74","05035","17.37"
"Cross","2","72","Arkansas","6/11/20","60","12","05037","20"
"Dallas","0","3","Arkansas","6/11/20","3","0","05039","0"
"Desha","0","20","Arkansas","6/11/20","19","1","05041","5.26"
"Drew","1","25","Arkansas","6/11/20","20","5","05043","25"
"Faulkner","4","136","Arkansas","6/11/20","108","28","05045","25.93"
"Franklin","0","6","Arkansas","6/11/20","4","2","05047","50"
"Fulton","0","8","Arkansas","6/11/20","7","1","05049","14.29"
"Garland","2","154","Arkansas","6/11/20","138","16","05051","11.59"
"Grant","1","22","Arkansas","6/11/20","18","4","05053","22.22"
"Greene","0","68","Arkansas","6/11/20","66","2","05055","3.03"
"Hempstead","2","33","Arkansas","6/11/20","21","12","05057","57.14"
"Hot Spring","0","37","Arkansas","6/11/20","34","3","05059","8.82"
"Howard","2","38","Arkansas","6/11/20","26","12","05061","46.15"
"Independence","1","37","Arkansas","6/11/20","33","4","05063","12.12"
"Izard","0","17","Arkansas","6/11/20","17","0","05065","0"
"Jackson","1","14","Arkansas","6/11/20","5","9","05067","180"
"Jefferson","6","578","Arkansas","6/11/20","536","42","05069","7.84"
"Johnson","3","75","Arkansas","6/11/20","54","21","05071","38.89"
"Lafayette","0","10","Arkansas","6/11/20","9","1","05073","11.11"
"Lawrence","0","89","Arkansas","6/11/20","87","2","05075","2.3"
"Lee","13","120","Arkansas","6/11/20","27","93","05077","344.44"
"Lincoln","0","986","Arkansas","6/11/20","985","1","05079","0.1"
"Little River","3","33","Arkansas","6/11/20","10","23","05081","230"
"Logan","1","15","Arkansas","6/11/20","11","4","05083","36.36"
"Lonoke","2","67","Arkansas","6/11/20","56","11","05085","19.64"
"Madison","5","67","Arkansas","6/11/20","34","33","05087","97.06"
"Marion","0","2","Arkansas","6/11/20","2","0","05089","0"
"Miller","2","64","Arkansas","6/11/20","50","14","05091","28"
"Mississippi","1","86","Arkansas","6/11/20","79","7","05093","8.86"
"Monroe","0","5","Arkansas","6/11/20","6","-1","05095","-16.67"
"Montgomery","0","2","Arkansas","6/11/20","2","0","05097","0"
"Nevada","9","71","Arkansas","6/11/20","9","62","05099","688.89"
"Newton","0","3","Arkansas","6/11/20","3","0","05101","0"
"Ouachita","0","12","Arkansas","6/11/20","11","1","05103","9.09"
"Perry","0","15","Arkansas","6/11/20","14","1","05105","7.14"
"Phillips","1","31","Arkansas","6/11/20","25","6","05107","24"
"Pike","0","6","Arkansas","6/11/20","5","1","05109","20"
"Poinsett","1","46","Arkansas","6/11/20","40","6","05111","15"
"Polk","3","48","Arkansas","6/11/20","28","20","05113","71.43"
"Pope","8","232","Arkansas","6/11/20","178","54","05115","30.34"
"Prairie","0","5","Arkansas","6/11/20","3","2","05117","66.67"
"Pulaski","27","1225","Arkansas","6/11/20","1039","186","05119","17.9"
"Randolph","0","28","Arkansas","6/11/20","26","2","05121","7.69"
"Saline","6","163","Arkansas","6/11/20","120","43","05125","35.83"
"Scott","0","2","Arkansas","6/11/20","1","1","05127","100"
"Searcy","0","7","Arkansas","6/11/20","7","0","05129","0"
"Sebastian","7","109","Arkansas","6/11/20","62","47","05131","75.81"
"Sevier","13","387","Arkansas","6/11/20","297","90","05133","30.3"
"Sharp","0","50","Arkansas","6/11/20","47","3","05135","6.38"
"St. Francis","11","768","Arkansas","6/11/20","691","77","05123","11.14"
"Stone","0","11","Arkansas","6/11/20","10","1","05137","10"
"Union","2","194","Arkansas","6/11/20","179","15","05139","8.38"
"Van Buren","0","30","Arkansas","6/11/20","29","1","05141","3.45"
"Washington","88","1389","Arkansas","6/11/20","771","618","05143","80.16"
"White","1","55","Arkansas","6/11/20","48","7","05145","14.58"
"Woodruff","0","1","Arkansas","6/11/20","1","0","05147","0"
"Yell","10","261","Arkansas","6/11/20","192","69","05149","35.94"
"Alameda","84","4232","California","6/11/20","3641","591","06001","16.23"
"Alpine","0","2","California","6/11/20","2","0","06003","0"
"Amador","0","10","California","6/11/20","10","0","06005","0"
"Butte","2","73","California","6/11/20","60","13","06007","21.67"
"Calaveras","1","25","California","6/11/20","16","9","06009","56.25"
"Colusa","0","7","California","6/11/20","7","0","06011","0"
"Contra Costa","40","1829","California","6/11/20","1547","282","06013","18.23"
"Del Norte","0","47","California","6/11/20","47","0","06015","0"
"El Dorado","2","111","California","6/11/20","98","13","06017","13.27"
"Fresno","64","2395","California","6/11/20","1944","451","06019","23.2"
"Glenn","1","23","California","6/11/20","17","6","06021","35.29"
"Humboldt","0","105","California","6/11/20","104","1","06023","0.96"
"Imperial","130","3405","California","6/11/20","2493","912","06025","36.58"
"Inyo","0","22","California","6/11/20","20","2","06027","10"
"Kern","79","3016","California","6/11/20","2462","554","06029","22.5"
"Kings","72","1688","California","6/11/20","1187","501","06031","42.21"
"Lake","0","31","California","6/11/20","30","1","06033","3.33"
"Lassen","1","9","California","6/11/20","5","4","06035","80"
"Los Angeles","1324","68959","California","6/11/20","59692","9267","06037","15.52"
"Madera","8","188","California","6/11/20","129","59","06039","45.74"
"Marin","18","651","California","6/11/20","525","126","06041","24"
"Mariposa","0","16","California","6/11/20","16","0","06043","0"
"Mendocino","0","36","California","6/11/20","33","3","06045","9.09"
"Merced","12","391","California","6/11/20","310","81","06047","26.13"
"Mono","0","37","California","6/11/20","37","0","06051","0"
"Monterey","28","814","California","6/11/20","621","193","06053","31.08"
"Napa","5","163","California","6/11/20","126","37","06055","29.37"
"Nevada","0","52","California","6/11/20","49","3","06057","6.12"
"Orange","172","7987","California","6/11/20","6783","1204","06059","17.75"
"Placer","10","327","California","6/11/20","259","68","06061","26.25"
"Plumas","0","4","California","6/11/20","4","0","06063","0"
"Riverside","277","10240","California","6/11/20","8303","1937","06065","23.33"
"Sacramento","26","1670","California","6/11/20","1490","180","06067","12.08"
"San Benito","2","109","California","6/11/20","96","13","06069","13.54"
"San Bernardino","156","6742","California","6/11/20","5650","1092","06071","19.33"
"San Diego","171","8998","California","6/11/20","7798","1200","06073","15.39"
"San Francisco","28","2840","California","6/11/20","2644","196","06075","7.41"
"San Joaquin","52","1388","California","6/11/20","1024","364","06077","35.55"
"San Luis Obispo","4","317","California","6/11/20","288","29","06079","10.07"
"San Mateo","36","2494","California","6/11/20","2244","250","06081","11.14"
"Santa Barbara","28","1910","California","6/11/20","1714","196","06083","11.44"
"Santa Clara","30","3063","California","6/11/20","2850","213","06085","7.47"
"Santa Cruz","4","249","California","6/11/20","219","30","06087","13.7"
"Shasta","1","48","California","6/11/20","40","8","06089","20"
"Sierra","0","1","California","6/11/20","1","0","06091","0"
"Siskiyou","1","14","California","6/11/20","9","5","06093","55.56"
"Solano","12","643","California","6/11/20","559","84","06095","15.03"
"Sonoma","12","680","California","6/11/20","593","87","06097","14.67"
"Stanislaus","40","1072","California","6/11/20","792","280","06099","35.35"
"Sutter","3","69","California","6/11/20","48","21","06101","43.75"
"Tehama","1","12","California","6/11/20","6","6","06103","100"
"Trinity","0","2","California","6/11/20","1","1","06105","100"
"Tulare","56","2475","California","6/11/20","2083","392","06107","18.82"
"Tuolumne","0","8","California","6/11/20","5","3","06109","60"
"Ventura","31","1404","California","6/11/20","1190","214","06111","17.98"
"Yolo","3","240","California","6/11/20","216","24","06113","11.11"
"Yuba","0","34","California","6/11/20","31","3","06115","9.68"
"Adams","29","3663","Colorado","6/11/20","3458","205","08001","5.93"
"Alamosa","4","112","Colorado","6/11/20","84","28","08003","33.33"
"Arapahoe","24","4723","Colorado","6/11/20","4553","170","08005","3.73"
"Archuleta","0","8","Colorado","6/11/20","8","0","08007","0"
"Baca","0","12","Colorado","6/11/20","12","0","08009","0"
"Bent","0","3","Colorado","6/11/20","2","1","08011","50"
"Boulder","5","1040","Colorado","6/11/20","1004","36","08013","3.59"
"Broomfield","1","259","Colorado","6/11/20","251","8","08014","3.19"
"Chaffee","0","78","Colorado","6/11/20","76","2","08015","2.63"
"Cheyenne","0","5","Colorado","6/11/20","5","0","08017","0"
"Clear Creek","0","17","Colorado","6/11/20","17","0","08019","0"
"Conejos","0","5","Colorado","6/11/20","3","2","08021","66.67"
"Costilla","1","12","Colorado","6/11/20","6","6","08023","100"
"Crowley","0","66","Colorado","6/11/20","64","2","08025","3.12"
"Custer","0","2","Colorado","6/11/20","2","0","08027","0"
"Delta","1","76","Colorado","6/11/20","72","4","08029","5.56"
"Denver","36","6232","Colorado","6/11/20","5977","255","08031","4.27"
"Douglas","5","779","Colorado","6/11/20","746","33","08035","4.42"
"Eagle","3","617","Colorado","6/11/20","599","18","08037","3.01"
"El Paso","17","1907","Colorado","6/11/20","1788","119","08041","6.66"
"Elbert","0","54","Colorado","6/11/20","53","1","08039","1.89"
"Fremont","0","26","Colorado","6/11/20","26","0","08043","0"
"Garfield","3","176","Colorado","6/11/20","157","19","08045","12.1"
"Gilpin","0","5","Colorado","6/11/20","4","1","08047","25"
"Grand","0","15","Colorado","6/11/20","15","0","08049","0"
"Gunnison","0","181","Colorado","6/11/20","178","3","08051","1.69"
"Hinsdale","0","3","Colorado","6/11/20","3","0","08053","0"
"Huerfano","0","3","Colorado","6/11/20","3","0","08055","0"
"Jefferson","18","2436","Colorado","6/11/20","2310","126","08059","5.45"
"Kit Carson","0","30","Colorado","6/11/20","30","0","08063","0"
"La Plata","0","84","Colorado","6/11/20","82","2","08067","2.44"
"Lake","1","38","Colorado","6/11/20","34","4","08065","11.76"
"Larimer","4","635","Colorado","6/11/20","610","25","08069","4.1"
"Las Animas","0","6","Colorado","6/11/20","5","1","08071","20"
"Lincoln","0","3","Colorado","6/11/20","3","0","08073","0"
"Logan","1","632","Colorado","6/11/20","624","8","08075","1.28"
"Mesa","1","65","Colorado","6/11/20","59","6","08077","10.17"
"Mineral","0","2","Colorado","6/11/20","2","0","08079","0"
"Moffat","0","8","Colorado","6/11/20","8","0","08081","0"
"Montezuma","2","58","Colorado","6/11/20","46","12","08083","26.09"
"Montrose","1","191","Colorado","6/11/20","182","9","08085","4.95"
"Morgan","1","645","Colorado","6/11/20","638","7","08087","1.1"
"Otero","0","22","Colorado","6/11/20","21","1","08089","4.76"
"Ouray","0","8","Colorado","6/11/20","8","0","08091","0"
"Park","0","23","Colorado","6/11/20","23","0","08093","0"
"Phillips","0","15","Colorado","6/11/20","14","1","08095","7.14"
"Pitkin","1","64","Colorado","6/11/20","59","5","08097","8.47"
"Prowers","0","17","Colorado","6/11/20","15","2","08099","13.33"
"Pueblo","3","326","Colorado","6/11/20","302","24","08101","7.95"
"Rio Blanco","0","1","Colorado","6/11/20","1","0","08103","0"
"Rio Grande","2","51","Colorado","6/11/20","38","13","08105","34.21"
"Routt","0","64","Colorado","6/11/20","62","2","08107","3.23"
"Saguache","1","95","Colorado","6/11/20","89","6","08109","6.74"
"San Juan","0","1","Colorado","6/11/20","1","0","08111","0"
"San Miguel","0","23","Colorado","6/11/20","24","-1","08113","-4.17"
"Summit","2","253","Colorado","6/11/20","239","14","08117","5.86"
"Teller","1","37","Colorado","6/11/20","33","4","08119","12.12"
"Washington","0","44","Colorado","6/11/20","42","2","08121","4.76"
"Weld","14","2629","Colorado","6/11/20","2534","95","08123","3.75"
"Yuma","1","47","Colorado","6/11/20","42","5","08125","11.9"
"Fairfield","45","16155","Connecticut","6/11/20","15843","312","09001","1.97"
"Hartford","47","10967","Connecticut","6/11/20","10636","331","09003","3.11"
"Litchfield","4","1435","Connecticut","6/11/20","1406","29","09005","2.06"
"Middlesex","6","1210","Connecticut","6/11/20","1171","39","09007","3.33"
"New Haven","50","11930","Connecticut","6/11/20","11582","348","09009","3"
"New London","6","1147","Connecticut","6/11/20","1104","43","09011","3.89"
"Tolland","3","883","Connecticut","6/11/20","859","24","09013","2.79"
"Windham","6","441","Connecticut","6/11/20","397","44","09015","11.08"
"Kent","13","1543","Delaware","6/11/20","1454","89","10001","6.12"
"New Castle","35","4171","Delaware","6/11/20","3925","246","10003","6.27"
"Sussex","9","4379","Delaware","6/11/20","4314","65","10005","1.51"
"","0","49","Diamond Princess","6/11/20","49","0",,"0"
"District of Columbia","67","9589","District of Columbia","6/11/20","9120","469","11001","5.14"
"Alachua","8","443","Florida","6/11/20","387","56","12001","14.47"
"Baker","0","29","Florida","6/11/20","29","0","12003","0"
"Bay","3","135","Florida","6/11/20","111","24","12005","21.62"
"Bradford","0","52","Florida","6/11/20","51","1","12007","1.96"
"Brevard","11","506","Florida","6/11/20","431","75","12009","17.4"
"Broward","125","8337","Florida","6/11/20","7462","875","12011","11.73"
"Calhoun","0","64","Florida","6/11/20","62","2","12013","3.23"
"Charlotte","6","515","Florida","6/11/20","476","39","12015","8.19"
"Citrus","1","132","Florida","6/11/20","122","10","12017","8.2"
"Clay","5","427","Florida","6/11/20","394","33","12019","8.38"
"Collier","68","2291","Florida","6/11/20","1814","477","12021","26.3"
"Columbia","2","177","Florida","6/11/20","160","17","12023","10.62"
"DeSoto","12","304","Florida","6/11/20","218","86","12027","39.45"
"Dixie","1","60","Florida","6/11/20","56","4","12029","7.14"
"Duval","27","1893","Florida","6/11/20","1702","191","12031","11.22"
"Escambia","11","944","Florida","6/11/20","866","78","12033","9.01"
"Flagler","1","201","Florida","6/11/20","193","8","12035","4.15"
"Franklin","0","2","Florida","6/11/20","2","0","12037","0"
"Gadsden","2","300","Florida","6/11/20","288","12","12039","4.17"
"Gilchrist","0","20","Florida","6/11/20","17","3","12041","17.65"
"Glades","5","107","Florida","6/11/20","70","37","12043","52.86"
"Gulf","1","8","Florida","6/11/20","3","5","12045","166.67"
"Hamilton","2","268","Florida","6/11/20","255","13","12047","5.1"
"Hardee","7","164","Florida","6/11/20","118","46","12049","38.98"
"Hendry","13","590","Florida","6/11/20","501","89","12051","17.76"
"Hernando","1","130","Florida","6/11/20","122","8","12053","6.56"
"Highlands","3","160","Florida","6/11/20","138","22","12055","15.94"
"Hillsborough","99","3174","Florida","6/11/20","2479","695","12057","28.04"
"Holmes","1","31","Florida","6/11/20","26","5","12059","19.23"
"Indian River","5","177","Florida","6/11/20","144","33","12061","22.92"
"Jackson","4","315","Florida","6/11/20","290","25","12063","8.62"
"Jefferson","0","31","Florida","6/11/20","29","2","12065","6.9"
"Lafayette","0","12","Florida","6/11/20","9","3","12067","33.33"
"Lake","6","355","Florida","6/11/20","313","42","12069","13.42"
"Lee","50","2500","Florida","6/11/20","2147","353","12071","16.44"
"Leon","3","456","Florida","6/11/20","432","24","12073","5.56"
"Levy","8","95","Florida","6/11/20","38","57","12075","150"
"Liberty","0","218","Florida","6/11/20","218","0","12077","0"
"Madison","1","75","Florida","6/11/20","69","6","12079","8.7"
"Manatee","17","1253","Florida","6/11/20","1134","119","12081","10.49"
"Marion","4","292","Florida","6/11/20","261","31","12083","11.88"
"Martin","37","1020","Florida","6/11/20","764","256","12085","33.51"
"Miami-Dade","253","20548","Florida","6/11/20","18779","1769","12086","9.42"
"Monroe","1","120","Florida","6/11/20","110","10","12087","9.09"
"Nassau","1","86","Florida","6/11/20","82","4","12089","4.88"
"Okaloosa","8","294","Florida","6/11/20","241","53","12091","21.99"
"Okeechobee","7","154","Florida","6/11/20","104","50","12093","48.08"
"Orange","73","2678","Florida","6/11/20","2169","509","12095","23.47"
"Osceola","8","785","Florida","6/11/20","726","59","12097","8.13"
"Palm Beach","171","7887","Florida","6/11/20","6688","1199","12099","17.93"
"Pasco","10","473","Florida","6/11/20","405","68","12101","16.79"
"Pinellas","66","1862","Florida","6/11/20","1397","465","12103","33.29"
"Polk","32","1325","Florida","6/11/20","1100","225","12105","20.45"
"Putnam","2","181","Florida","6/11/20","165","16","12107","9.7"
"Santa Rosa","3","273","Florida","6/11/20","255","18","12113","7.06"
"Sarasota","9","716","Florida","6/11/20","652","64","12115","9.82"
"Seminole","16","621","Florida","6/11/20","512","109","12117","21.29"
"St. Johns","3","287","Florida","6/11/20","267","20","12109","7.49"
"St. Lucie","32","760","Florida","6/11/20","535","225","12111","42.06"
"Sumter","1","265","Florida","6/11/20","260","5","12119","1.92"
"Suwannee","1","182","Florida","6/11/20","172","10","12121","5.81"
"Taylor","4","51","Florida","6/11/20","26","25","12123","96.15"
"Union","1","38","Florida","6/11/20","34","4","12125","11.76"
"Volusia","11","860","Florida","6/11/20","784","76","12127","9.69"
"Wakulla","0","35","Florida","6/11/20","35","0","12129","0"
"Walton","3","142","Florida","6/11/20","120","22","12131","18.33"
"Washington","2","87","Florida","6/11/20","74","13","12133","17.57"
"Appling","4","200","Georgia","6/11/20","172","28","13001","16.28"
"Atkinson","2","71","Georgia","6/11/20","54","17","13003","31.48"
"Bacon","4","164","Georgia","6/11/20","137","27","13005","19.71"
"Baker","0","37","Georgia","6/11/20","35","2","13007","5.71"
"Baldwin","5","414","Georgia","6/11/20","380","34","13009","8.95"
"Banks","2","103","Georgia","6/11/20","87","16","13011","18.39"
"Barrow","6","377","Georgia","6/11/20","333","44","13013","13.21"
"Bartow","4","532","Georgia","6/11/20","504","28","13015","5.56"
"Ben Hill","2","96","Georgia","6/11/20","84","12","13017","14.29"
"Berrien","1","59","Georgia","6/11/20","51","8","13019","15.69"
"Bibb","4","525","Georgia","6/11/20","494","31","13021","6.28"
"Bleckley","1","54","Georgia","6/11/20","48","6","13023","12.5"
"Brantley","0","64","Georgia","6/11/20","61","3","13025","4.92"
"Brooks","2","91","Georgia","6/11/20","76","15","13027","19.74"
"Bryan","1","83","Georgia","6/11/20","78","5","13029","6.41"
"Bulloch","1","87","Georgia","6/11/20","77","10","13031","12.99"
"Burke","0","125","Georgia","6/11/20","123","2","13033","1.63"
"Butts","2","255","Georgia","6/11/20","240","15","13035","6.25"
"Calhoun","1","145","Georgia","6/11/20","136","9","13037","6.62"
"Camden","0","70","Georgia","6/11/20","68","2","13039","2.94"
"Candler","0","17","Georgia","6/11/20","14","3","13043","21.43"
"Carroll","4","593","Georgia","6/11/20","568","25","13045","4.4"
"Catoosa","5","184","Georgia","6/11/20","146","38","13047","26.03"
"Charlton","1","37","Georgia","6/11/20","33","4","13049","12.12"
"Chatham","8","584","Georgia","6/11/20","525","59","13051","11.24"
"Chattahoochee","9","232","Georgia","6/11/20","166","66","13053","39.76"
"Chattooga","1","30","Georgia","6/11/20","25","5","13055","20"
"Cherokee","9","1000","Georgia","6/11/20","934","66","13057","7.07"
"Clarke","5","332","Georgia","6/11/20","299","33","13059","11.04"
"Clay","1","51","Georgia","6/11/20","42","9","13061","21.43"
"Clayton","17","1399","Georgia","6/11/20","1282","117","13063","9.13"
"Clinch","1","73","Georgia","6/11/20","65","8","13065","12.31"
"Cobb","44","3471","Georgia","6/11/20","3165","306","13067","9.67"
"Coffee","5","321","Georgia","6/11/20","289","32","13069","11.07"
"Colquitt","13","615","Georgia","6/11/20","523","92","13071","17.59"
"Columbia","3","290","Georgia","6/11/20","266","24","13073","9.02"
"Cook","2","62","Georgia","6/11/20","47","15","13075","31.91"
"Coweta","7","488","Georgia","6/11/20","440","48","13077","10.91"
"Crawford","0","31","Georgia","6/11/20","28","3","13079","10.71"
"Crisp","0","240","Georgia","6/11/20","238","2","13081","0.84"
"Dade","1","45","Georgia","6/11/20","40","5","13083","12.5"
"Dawson","1","118","Georgia","6/11/20","110","8","13085","7.27"
"Decatur","2","219","Georgia","6/11/20","206","13","13087","6.31"
"DeKalb","41","4229","Georgia","6/11/20","3939","290","13089","7.36"
"Dodge","0","53","Georgia","6/11/20","52","1","13091","1.92"
"Dooly","1","196","Georgia","6/11/20","186","10","13093","5.38"
"Dougherty","5","1827","Georgia","6/11/20","1794","33","13095","1.84"
"Douglas","9","634","Georgia","6/11/20","571","63","13097","11.03"
"Early","1","254","Georgia","6/11/20","247","7","13099","2.83"
"Echols","3","153","Georgia","6/11/20","130","23","13101","17.69"
"Effingham","1","84","Georgia","6/11/20","77","7","13103","9.09"
"Elbert","1","83","Georgia","6/11/20","76","7","13105","9.21"
"Emanuel","1","36","Georgia","6/11/20","28","8","13107","28.57"
"Evans","0","7","Georgia","6/11/20","6","1","13109","16.67"
"Fannin","2","63","Georgia","6/11/20","50","13","13111","26"
"Fayette","2","258","Georgia","6/11/20","241","17","13113","7.05"
"Floyd","9","356","Georgia","6/11/20","292","64","13115","21.92"
"Forsyth","6","579","Georgia","6/11/20","535","44","13117","8.22"
"Franklin","2","134","Georgia","6/11/20","123","11","13119","8.94"
"Fulton","44","5031","Georgia","6/11/20","4724","307","13121","6.5"
"Gilmer","1","167","Georgia","6/11/20","158","9","13123","5.7"
"Glascock","0","1","Georgia","6/11/20","1","0","13125","0"
"Glynn","5","172","Georgia","6/11/20","139","33","13127","23.74"
"Gordon","8","234","Georgia","6/11/20","181","53","13129","29.28"
"Grady","2","133","Georgia","6/11/20","119","14","13131","11.76"
"Greene","2","86","Georgia","6/11/20","73","13","13133","17.81"
"Gwinnett","102","4980","Georgia","6/11/20","4267","713","13135","16.71"
"Habersham","4","576","Georgia","6/11/20","545","31","13137","5.69"
"Hall","19","2699","Georgia","6/11/20","2566","133","13139","5.18"
"Hancock","1","201","Georgia","6/11/20","197","4","13141","2.03"
"Haralson","1","56","Georgia","6/11/20","50","6","13143","12"
"Harris","9","185","Georgia","6/11/20","120","65","13145","54.17"
"Hart","0","39","Georgia","6/11/20","36","3","13147","8.33"
"Heard","1","41","Georgia","6/11/20","37","4","13149","10.81"
"Henry","10","810","Georgia","6/11/20","742","68","13151","9.16"
"Houston","4","415","Georgia","6/11/20","390","25","13153","6.41"
"Irwin","0","34","Georgia","6/11/20","33","1","13155","3.03"
"Jackson","5","247","Georgia","6/11/20","210","37","13157","17.62"
"Jasper","1","55","Georgia","6/11/20","45","10","13159","22.22"
"Jeff Davis","2","51","Georgia","6/11/20","38","13","13161","34.21"
"Jefferson","1","52","Georgia","6/11/20","47","5","13163","10.64"
"Jenkins","3","44","Georgia","6/11/20","22","22","13165","100"
"Johnson","0","83","Georgia","6/11/20","83","0","13167","0"
"Jones","0","50","Georgia","6/11/20","48","2","13169","4.17"
"Lamar","1","79","Georgia","6/11/20","75","4","13171","5.33"
"Lanier","1","36","Georgia","6/11/20","27","9","13173","33.33"
"Laurens","1","116","Georgia","6/11/20","108","8","13175","7.41"
"Lee","1","370","Georgia","6/11/20","361","9","13177","2.49"
"Liberty","0","86","Georgia","6/11/20","85","1","13179","1.18"
"Lincoln","0","17","Georgia","6/11/20","16","1","13181","6.25"
"Long","0","19","Georgia","6/11/20","16","3","13183","18.75"
"Lowndes","25","531","Georgia","6/11/20","356","175","13185","49.16"
"Lumpkin","1","106","Georgia","6/11/20","101","5","13187","4.95"
"Macon","0","106","Georgia","6/11/20","104","2","13193","1.92"
"Madison","1","68","Georgia","6/11/20","61","7","13195","11.48"
"Marion","0","61","Georgia","6/11/20","59","2","13197","3.39"
"McDuffie","0","73","Georgia","6/11/20","70","3","13189","4.29"
"McIntosh","0","16","Georgia","6/11/20","16","0","13191","0"
"Meriwether","3","119","Georgia","6/11/20","99","20","13199","20.2"
"Miller","0","45","Georgia","6/11/20","42","3","13201","7.14"
"Mitchell","2","427","Georgia","6/11/20","416","11","13205","2.64"
"Monroe","0","126","Georgia","6/11/20","124","2","13207","1.61"
"Montgomery","1","19","Georgia","6/11/20","13","6","13209","46.15"
"Morgan","0","40","Georgia","6/11/20","38","2","13211","5.26"
"Murray","4","127","Georgia","6/11/20","100","27","13213","27"
"Muscogee","32","919","Georgia","6/11/20","697","222","13215","31.85"
"Newton","4","407","Georgia","6/11/20","382","25","13217","6.54"
"Oconee","1","129","Georgia","6/11/20","120","9","13219","7.5"
"Oglethorpe","1","71","Georgia","6/11/20","63","8","13221","12.7"
"Out of GA","46","2641","Georgia","6/11/20","2319","322","80013","13.89"
"Paulding","8","397","Georgia","6/11/20","340","57","13223","16.76"
"Peach","1","80","Georgia","6/11/20","76","4","13225","5.26"
"Pickens","1","59","Georgia","6/11/20","50","9","13227","18"
"Pierce","2","125","Georgia","6/11/20","109","16","13229","14.68"
"Pike","1","65","Georgia","6/11/20","57","8","13231","14.04"
"Polk","3","157","Georgia","6/11/20","138","19","13233","13.77"
"Pulaski","0","46","Georgia","6/11/20","43","3","13235","6.98"
"Putnam","1","104","Georgia","6/11/20","97","7","13237","7.22"
"Quitman","0","15","Georgia","6/11/20","14","1","13239","7.14"
"Rabun","1","30","Georgia","6/11/20","25","5","13241","20"
"Randolph","1","188","Georgia","6/11/20","181","7","13243","3.87"
"Richmond","7","658","Georgia","6/11/20","609","49","13245","8.05"
"Rockdale","4","329","Georgia","6/11/20","302","27","13247","8.94"
"Schley","0","18","Georgia","6/11/20","17","1","13249","5.88"
"Screven","1","60","Georgia","6/11/20","56","4","13251","7.14"
"Seminole","0","47","Georgia","6/11/20","45","2","13253","4.44"
"Spalding","4","308","Georgia","6/11/20","281","27","13255","9.61"
"Stephens","0","148","Georgia","6/11/20","147","1","13257","0.68"
"Stewart","1","60","Georgia","6/11/20","54","6","13259","11.11"
"Sumter","2","502","Georgia","6/11/20","490","12","13261","2.45"
"Talbot","1","45","Georgia","6/11/20","40","5","13263","12.5"
"Taliaferro","0","1","Georgia","6/11/20","1","0","13265","0"
"Tattnall","1","37","Georgia","6/11/20","29","8","13267","27.59"
"Taylor","0","25","Georgia","6/11/20","23","2","13269","8.7"
"Telfair","1","45","Georgia","6/11/20","38","7","13271","18.42"
"Terrell","0","218","Georgia","6/11/20","217","1","13273","0.46"
"Thomas","1","358","Georgia","6/11/20","349","9","13275","2.58"
"Tift","11","357","Georgia","6/11/20","277","80","13277","28.88"
"Toombs","4","91","Georgia","6/11/20","60","31","13279","51.67"
"Towns","1","32","Georgia","6/11/20","27","5","13281","18.52"
"Treutlen","1","17","Georgia","6/11/20","13","4","13283","30.77"
"Troup","36","613","Georgia","6/11/20","363","250","13285","68.87"
"Turner","2","145","Georgia","6/11/20","134","11","13287","8.21"
"Twiggs","0","20","Georgia","6/11/20","18","2","13289","11.11"
"Union","1","53","Georgia","6/11/20","48","5","13291","10.42"
"Upson","1","295","Georgia","6/11/20","290","5","13293","1.72"
"Walker","5","211","Georgia","6/11/20","178","33","13295","18.54"
"Walton","4","317","Georgia","6/11/20","288","29","13297","10.07"
"Ware","2","254","Georgia","6/11/20","238","16","13299","6.72"
"Warren","0","19","Georgia","6/11/20","18","1","13301","5.56"
"Washington","0","75","Georgia","6/11/20","74","1","13303","1.35"
"Wayne","2","33","Georgia","6/11/20","22","11","13305","50"
"Webster","0","14","Georgia","6/11/20","13","1","13307","7.69"
"Wheeler","0","15","Georgia","6/11/20","13","2","13309","15.38"
"White","2","122","Georgia","6/11/20","110","12","13311","10.91"
"Whitfield","16","539","Georgia","6/11/20","427","112","13313","26.23"
"Wilcox","0","118","Georgia","6/11/20","117","1","13315","0.85"
"Wilkes","0","35","Georgia","6/11/20","34","1","13317","2.94"
"Wilkinson","0","73","Georgia","6/11/20","70","3","13319","4.29"
"Worth","4","255","Georgia","6/11/20","228","27","13321","11.84"
"","0","103","Grand Princess","6/11/20","103","0",,"0"
"","1","183","Guam","6/11/20","179","4",,"2.23"
"Hawaii","0","81","Hawaii","6/11/20","81","0","15001","0"
"Honolulu","5","458","Hawaii","6/11/20","424","34","15003","8.02"
"Kauai","0","21","Hawaii","6/11/20","20","1","15007","5"
"Maui","0","120","Hawaii","6/11/20","119","1","15009","0.84"
"Out of HI","0","12","Hawaii","6/11/20","11","1","80015","9.09"
"Ada","4","854","Idaho","6/11/20","823","31","16001","3.77"
"Adams","0","3","Idaho","6/11/20","3","0","16003","0"
"Bannock","2","52","Idaho","6/11/20","37","15","16005","40.54"
"Benewah","1","19","Idaho","6/11/20","14","5","16009","35.71"
"Bingham","2","23","Idaho","6/11/20","11","12","16011","109.09"
"Blaine","0","515","Idaho","6/11/20","514","1","16013","0.19"
"Bonner","0","7","Idaho","6/11/20","6","1","16017","16.67"
"Bonneville","2","68","Idaho","6/11/20","56","12","16019","21.43"
"Camas","0","1","Idaho","6/11/20","1","0","16025","0"
"Canyon","5","351","Idaho","6/11/20","315","36","16027","11.43"
"Caribou","0","3","Idaho","6/11/20","3","0","16029","0"
"Cassia","5","123","Idaho","6/11/20","89","34","16031","38.2"
"Custer","0","2","Idaho","6/11/20","2","0","16037","0"
"Elmore","0","33","Idaho","6/11/20","32","1","16039","3.12"
"Franklin","0","10","Idaho","6/11/20","9","1","16041","11.11"
"Fremont","0","4","Idaho","6/11/20","4","0","16043","0"
"Gem","0","17","Idaho","6/11/20","17","0","16045","0"
"Gooding","1","57","Idaho","6/11/20","50","7","16047","14"
"Idaho","0","3","Idaho","6/11/20","3","0","16049","0"
"Jefferson","0","9","Idaho","6/11/20","9","0","16051","0"
"Jerome","3","202","Idaho","6/11/20","180","22","16053","12.22"
"Kootenai","2","91","Idaho","6/11/20","74","17","16055","22.97"
"Latah","0","7","Idaho","6/11/20","7","0","16057","0"
"Lemhi","0","1","Idaho","6/11/20","1","0","16059","0"
"Lincoln","0","34","Idaho","6/11/20","33","1","16063","3.03"
"Madison","0","27","Idaho","6/11/20","25","2","16065","8"
"Minidoka","3","85","Idaho","6/11/20","61","24","16067","39.34"
"Nez Perce","0","84","Idaho","6/11/20","83","1","16069","1.2"
"Owyhee","0","8","Idaho","6/11/20","8","0","16073","0"
"Payette","0","26","Idaho","6/11/20","25","1","16075","4"
"Power","0","9","Idaho","6/11/20","6","3","16077","50"
"Teton","0","11","Idaho","6/11/20","11","0","16081","0"
"Twin Falls","5","469","Idaho","6/11/20","432","37","16083","8.56"
"Valley","0","3","Idaho","6/11/20","2","1","16085","50"
"Washington","1","49","Idaho","6/11/20","44","5","16087","11.36"
"Adams","0","45","Illinois","6/11/20","44","1","17001","2.27"
"Alexander","1","16","Illinois","6/11/20","12","4","17003","33.33"
"Bond","0","12","Illinois","6/11/20","12","0","17005","0"
"Boone","4","515","Illinois","6/11/20","488","27","17007","5.53"
"Brown","0","10","Illinois","6/11/20","10","0","17009","0"
"Bureau","1","22","Illinois","6/11/20","17","5","17011","29.41"
"Calhoun","0","1","Illinois","6/11/20","1","0","17013","0"
"Carroll","0","18","Illinois","6/11/20","15","3","17015","20"
"Cass","0","75","Illinois","6/11/20","74","1","17017","1.35"
"Champaign","5","704","Illinois","6/11/20","671","33","17019","4.92"
"Christian","0","35","Illinois","6/11/20","35","0","17021","0"
"Clark","0","12","Illinois","6/11/20","11","1","17023","9.09"
"Clay","0","2","Illinois","6/11/20","2","0","17025","0"
"Clinton","1","198","Illinois","6/11/20","189","9","17027","4.76"
"Coles","2","142","Illinois","6/11/20","129","13","17029","10.08"
"Cook","466","83978","Illinois","6/11/20","80713","3265","17031","4.05"
"Crawford","0","11","Illinois","6/11/20","11","0","17033","0"
"Cumberland","0","10","Illinois","6/11/20","10","0","17035","0"
"De Witt","0","4","Illinois","6/11/20","4","0","17039","0"
"DeKalb","3","466","Illinois","6/11/20","443","23","17037","5.19"
"Douglas","0","30","Illinois","6/11/20","28","2","17041","7.14"
"DuPage","53","8311","Illinois","6/11/20","7939","372","17043","4.69"
"Edgar","0","1","Illinois","6/11/20","1","0","17045","0"
"Edwards","0","2","Illinois","6/11/20","2","0","17047","0"
"Effingham","0","8","Illinois","6/11/20","7","1","17049","14.29"
"Fayette","0","22","Illinois","6/11/20","21","1","17051","4.76"
"Ford","0","22","Illinois","6/11/20","20","2","17053","10"
"Franklin","0","12","Illinois","6/11/20","12","0","17055","0"
"Fulton","0","12","Illinois","6/11/20","12","0","17057","0"
"Gallatin","0","2","Illinois","6/11/20","2","0","17059","0"
"Greene","0","7","Illinois","6/11/20","6","1","17061","16.67"
"Grundy","3","126","Illinois","6/11/20","107","19","17063","17.76"
"Hamilton","0","2","Illinois","6/11/20","2","0","17065","0"
"Hancock","0","18","Illinois","6/11/20","17","1","17067","5.88"
"Hardin","0","1","Illinois","6/11/20","1","0","17069","0"
"Henderson","0","8","Illinois","6/11/20","8","0","17071","0"
"Henry","0","72","Illinois","6/11/20","70","2","17073","2.86"
"Iroquois","0","136","Illinois","6/11/20","133","3","17075","2.26"
"Jackson","2","307","Illinois","6/11/20","296","11","17077","3.72"
"Jasper","0","46","Illinois","6/11/20","46","0","17079","0"
"Jefferson","0","101","Illinois","6/11/20","101","0","17081","0"
"Jersey","1","28","Illinois","6/11/20","24","4","17083","16.67"
"Jo Daviess","0","34","Illinois","6/11/20","32","2","17085","6.25"
"Johnson","0","14","Illinois","6/11/20","11","3","17087","27.27"
"Kane","59","6992","Illinois","6/11/20","6581","411","17089","6.25"
"Kankakee","11","1051","Illinois","6/11/20","975","76","17091","7.79"
"Kendall","5","867","Illinois","6/11/20","833","34","17093","4.08"
"Knox","1","107","Illinois","6/11/20","102","5","17095","4.9"
"Lake","50","8934","Illinois","6/11/20","8584","350","17097","4.08"
"LaSalle","2","175","Illinois","6/11/20","159","16","17099","10.06"
"Lawrence","0","4","Illinois","6/11/20","4","0","17101","0"
"Lee","1","88","Illinois","6/11/20","82","6","17103","7.32"
"Livingston","0","36","Illinois","6/11/20","36","0","17105","0"
"Logan","0","10","Illinois","6/11/20","11","-1","17107","-9.09"
"Macon","1","206","Illinois","6/11/20","199","7","17115","3.52"
"Macoupin","0","46","Illinois","6/11/20","46","0","17117","0"
"Madison","10","681","Illinois","6/11/20","612","69","17119","11.27"
"Marion","1","55","Illinois","6/11/20","51","4","17121","7.84"
"Marshall","0","5","Illinois","6/11/20","5","0","17123","0"
"Mason","0","18","Illinois","6/11/20","18","0","17125","0"
"Massac","0","7","Illinois","6/11/20","7","0","17127","0"
"McDonough","1","97","Illinois","6/11/20","93","4","17109","4.3"
"McHenry","18","1788","Illinois","6/11/20","1660","128","17111","7.71"
"McLean","2","235","Illinois","6/11/20","224","11","17113","4.91"
"Menard","0","22","Illinois","6/11/20","20","2","17129","10"
"Mercer","0","18","Illinois","6/11/20","18","0","17131","0"
"Monroe","1","105","Illinois","6/11/20","98","7","17133","7.14"
"Montgomery","0","41","Illinois","6/11/20","41","0","17135","0"
"Morgan","8","100","Illinois","6/11/20","42","58","17137","138.1"
"Moultrie","0","13","Illinois","6/11/20","12","1","17139","8.33"
"Ogle","0","224","Illinois","6/11/20","223","1","17141","0.45"
"Out of IL","0","118","Illinois","6/11/20","119","-1","80017","-0.84"
"Peoria","10","354","Illinois","6/11/20","286","68","17143","23.78"
"Perry","0","43","Illinois","6/11/20","42","1","17145","2.38"
"Piatt","0","11","Illinois","6/11/20","11","0","17147","0"
"Pike","0","1","Illinois","6/11/20","1","0","17149","0"
"Pope","0","1","Illinois","6/11/20","1","0","17151","0"
"Pulaski","0","59","Illinois","6/11/20","57","2","17153","3.51"
"Putnam","0","1","Illinois","6/11/20","1","0","17155","0"
"Randolph","0","276","Illinois","6/11/20","273","3","17157","1.1"
"Richland","0","4","Illinois","6/11/20","4","0","17159","0"
"Rock Island","5","728","Illinois","6/11/20","694","34","17161","4.9"
"Saline","0","7","Illinois","6/11/20","7","0","17165","0"
"Sangamon","2","375","Illinois","6/11/20","359","16","17167","4.46"
"Schuyler","0","13","Illinois","6/11/20","13","0","17169","0"
"Shelby","0","16","Illinois","6/11/20","16","0","17173","0"
"St. Clair","20","1368","Illinois","6/11/20","1227","141","17163","11.49"
"Stark","0","3","Illinois","6/11/20","3","0","17175","0"
"Stephenson","2","223","Illinois","6/11/20","209","14","17177","6.7"
"Tazewell","1","82","Illinois","6/11/20","78","4","17179","5.13"
"Union","0","172","Illinois","6/11/20","171","1","17181","0.58"
"Vermilion","0","44","Illinois","6/11/20","41","3","17183","7.32"
"Wabash","1","12","Illinois","6/11/20","6","6","17185","100"
"Warren","1","127","Illinois","6/11/20","120","7","17187","5.83"
"Washington","0","19","Illinois","6/11/20","19","0","17189","0"
"Wayne","0","9","Illinois","6/11/20","9","0","17191","0"
"White","0","2","Illinois","6/11/20","2","0","17193","0"
"Whiteside","2","158","Illinois","6/11/20","147","11","17195","7.48"
"Will","44","6051","Illinois","6/11/20","5742","309","17197","5.38"
"Williamson","1","81","Illinois","6/11/20","74","7","17199","9.46"
"Winnebago","36","2652","Illinois","6/11/20","2397","255","17201","10.64"
"Woodford","0","22","Illinois","6/11/20","21","1","17203","4.76"
"Adams","0","24","Indiana","6/11/20","21","3","18001","14.29"
"Allen","48","2089","Indiana","6/11/20","1753","336","18003","19.17"
"Bartholomew","2","542","Indiana","6/11/20","527","15","18005","2.85"
"Benton","1","37","Indiana","6/11/20","32","5","18007","15.62"
"Blackford","0","29","Indiana","6/11/20","27","2","18009","7.41"
"Boone","3","347","Indiana","6/11/20","324","23","18011","7.1"
"Brown","0","35","Indiana","6/11/20","33","2","18013","6.06"
"Carroll","0","97","Indiana","6/11/20","94","3","18015","3.19"
"Cass","0","1592","Indiana","6/11/20","1592","0","18017","0"
"Clark","3","552","Indiana","6/11/20","530","22","18019","4.15"
"Clay","0","56","Indiana","6/11/20","53","3","18021","5.66"
"Clinton","1","251","Indiana","6/11/20","246","5","18023","2.03"
"Crawford","0","27","Indiana","6/11/20","24","3","18025","12.5"
"Daviess","2","116","Indiana","6/11/20","99","17","18027","17.17"
"Dearborn","1","177","Indiana","6/11/20","170","7","18029","4.12"
"Decatur","1","235","Indiana","6/11/20","231","4","18031","1.73"
"DeKalb","7","94","Indiana","6/11/20","44","50","18033","113.64"
"Delaware","1","399","Indiana","6/11/20","389","10","18035","2.57"
"Dubois","3","233","Indiana","6/11/20","209","24","18037","11.48"
"Elkhart","54","1876","Indiana","6/11/20","1495","381","18039","25.48"
"Fayette","0","80","Indiana","6/11/20","79","1","18041","1.27"
"Floyd","1","332","Indiana","6/11/20","323","9","18043","2.79"
"Fountain","0","23","Indiana","6/11/20","22","1","18045","4.55"
"Franklin","0","119","Indiana","6/11/20","116","3","18047","2.59"
"Fulton","0","52","Indiana","6/11/20","50","2","18049","4"
"Gibson","0","22","Indiana","6/11/20","19","3","18051","15.79"
"Grant","4","250","Indiana","6/11/20","225","25","18053","11.11"
"Greene","1","177","Indiana","6/11/20","172","5","18055","2.91"
"Hamilton","9","1245","Indiana","6/11/20","1183","62","18057","5.24"
"Hancock","2","367","Indiana","6/11/20","351","16","18059","4.56"
"Harrison","0","198","Indiana","6/11/20","195","3","18061","1.54"
"Hendricks","8","1246","Indiana","6/11/20","1192","54","18063","4.53"
"Henry","2","200","Indiana","6/11/20","184","16","18065","8.7"
"Howard","2","454","Indiana","6/11/20","440","14","18067","3.18"
"Huntington","2","49","Indiana","6/11/20","38","11","18069","28.95"
"Jackson","2","413","Indiana","6/11/20","399","14","18071","3.51"
"Jasper","1","81","Indiana","6/11/20","73","8","18073","10.96"
"Jay","1","60","Indiana","6/11/20","54","6","18075","11.11"
"Jefferson","0","51","Indiana","6/11/20","49","2","18077","4.08"
"Jennings","1","136","Indiana","6/11/20","132","4","18079","3.03"
"Johnson","5","1157","Indiana","6/11/20","1121","36","18081","3.21"
"Knox","0","34","Indiana","6/11/20","31","3","18083","9.68"
"Kosciusko","13","271","Indiana","6/11/20","179","92","18085","51.4"
"LaGrange","15","219","Indiana","6/11/20","116","103","18087","88.79"
"Lake","32","4057","Indiana","6/11/20","3833","224","18089","5.84"
"LaPorte","3","465","Indiana","6/11/20","446","19","18091","4.26"
"Lawrence","1","172","Indiana","6/11/20","167","5","18093","2.99"
"Madison","2","610","Indiana","6/11/20","599","11","18095","1.84"
"Marion","57","10492","Indiana","6/11/20","10095","397","18097","3.93"
"Marshall","12","261","Indiana","6/11/20","178","83","18099","46.63"
"Martin","0","15","Indiana","6/11/20","13","2","18101","15.38"
"Miami","1","153","Indiana","6/11/20","144","9","18103","6.25"
"Monroe","2","184","Indiana","6/11/20","170","14","18105","8.24"
"Montgomery","2","260","Indiana","6/11/20","248","12","18107","4.84"
"Morgan","1","294","Indiana","6/11/20","284","10","18109","3.52"
"Newton","1","86","Indiana","6/11/20","78","8","18111","10.26"
"Noble","6","311","Indiana","6/11/20","268","43","18113","16.04"
"Ohio","0","13","Indiana","6/11/20","13","0","18115","0"
"Orange","0","132","Indiana","6/11/20","131","1","18117","0.76"
"Owen","0","37","Indiana","6/11/20","34","3","18119","8.82"
"Parke","0","19","Indiana","6/11/20","18","1","18121","5.56"
"Perry","2","55","Indiana","6/11/20","39","16","18123","41.03"
"Pike","0","6","Indiana","6/11/20","6","0","18125","0"
"Porter","3","582","Indiana","6/11/20","558","24","18127","4.3"
"Posey","0","18","Indiana","6/11/20","16","2","18129","12.5"
"Pulaski","0","52","Indiana","6/11/20","50","2","18131","4"
"Putnam","1","149","Indiana","6/11/20","142","7","18133","4.93"
"Randolph","1","62","Indiana","6/11/20","52","10","18135","19.23"
"Ripley","0","109","Indiana","6/11/20","108","1","18137","0.93"
"Rush","0","50","Indiana","6/11/20","51","-1","18139","-1.96"
"Scott","2","140","Indiana","6/11/20","126","14","18143","11.11"
"Shelby","1","406","Indiana","6/11/20","397","9","18145","2.27"
"Spencer","0","22","Indiana","6/11/20","21","1","18147","4.76"
"St. Joseph","21","1481","Indiana","6/11/20","1337","144","18141","10.77"
"Starke","1","48","Indiana","6/11/20","39","9","18149","23.08"
"Steuben","2","100","Indiana","6/11/20","88","12","18151","13.64"
"Sullivan","1","41","Indiana","6/11/20","37","4","18153","10.81"
"Switzerland","0","21","Indiana","6/11/20","21","0","18155","0"
"Tippecanoe","5","466","Indiana","6/11/20","429","37","18157","8.62"
"Tipton","0","27","Indiana","6/11/20","26","1","18159","3.85"
"Union","0","12","Indiana","6/11/20","9","3","18161","33.33"
"Vanderburgh","4","316","Indiana","6/11/20","289","27","18163","9.34"
"Vermillion","0","10","Indiana","6/11/20","10","0","18165","0"
"Vigo","3","198","Indiana","6/11/20","178","20","18167","11.24"
"Wabash","1","88","Indiana","6/11/20","80","8","18169","10"
"Warren","0","14","Indiana","6/11/20","12","2","18171","16.67"
"Warrick","0","170","Indiana","6/11/20","167","3","18173","1.8"
"Washington","1","56","Indiana","6/11/20","50","6","18175","12"
"Wayne","1","94","Indiana","6/11/20","86","8","18177","9.3"
"Wells","2","47","Indiana","6/11/20","34","13","18179","38.24"
"White","0","241","Indiana","6/11/20","238","3","18181","1.26"
"Whitley","2","62","Indiana","6/11/20","45","17","18183","37.78"
"Adair","0","10","Iowa","6/11/20","9","1","19001","11.11"
"Adams","0","7","Iowa","6/11/20","7","0","19003","0"
"Allamakee","0","121","Iowa","6/11/20","120","1","19005","0.83"
"Appanoose","0","16","Iowa","6/11/20","17","-1","19007","-5.88"
"Audubon","0","13","Iowa","6/11/20","13","0","19009","0"
"Benton","0","46","Iowa","6/11/20","43","3","19011","6.98"
"Black Hawk","6","1817","Iowa","6/11/20","1775","42","19013","2.37"
"Boone","2","81","Iowa","6/11/20","70","11","19015","15.71"
"Bremer","1","74","Iowa","6/11/20","70","4","19017","5.71"
"Buchanan","0","34","Iowa","6/11/20","33","1","19019","3.03"
"Buena Vista","60","1415","Iowa","6/11/20","997","418","19021","41.93"
"Butler","0","19","Iowa","6/11/20","16","3","19023","18.75"
"Calhoun","2","17","Iowa","6/11/20","6","11","19025","183.33"
"Carroll","1","20","Iowa","6/11/20","13","7","19027","53.85"
"Cass","0","14","Iowa","6/11/20","12","2","19029","16.67"
"Cedar","0","52","Iowa","6/11/20","49","3","19031","6.12"
"Cerro Gordo","1","39","Iowa","6/11/20","33","6","19033","18.18"
"Cherokee","2","54","Iowa","6/11/20","37","17","19035","45.95"
"Chickasaw","0","15","Iowa","6/11/20","13","2","19037","15.38"
"Clarke","3","85","Iowa","6/11/20","66","19","19039","28.79"
"Clay","4","50","Iowa","6/11/20","25","25","19041","100"
"Clayton","0","35","Iowa","6/11/20","34","1","19043","2.94"
"Clinton","0","67","Iowa","6/11/20","65","2","19045","3.08"
"Crawford","6","592","Iowa","6/11/20","547","45","19047","8.23"
"Dallas","6","980","Iowa","6/11/20","940","40","19049","4.26"
"Davis","0","31","Iowa","6/11/20","28","3","19051","10.71"
"Decatur","0","3","Iowa","6/11/20","1","2","19053","200"
"Delaware","1","26","Iowa","6/11/20","19","7","19055","36.84"
"Des Moines","0","67","Iowa","6/11/20","67","0","19057","0"
"Dickinson","10","101","Iowa","6/11/20","33","68","19059","206.06"
"Dubuque","3","377","Iowa","6/11/20","355","22","19061","6.2"
"Emmet","1","34","Iowa","6/11/20","24","10","19063","41.67"
"Fayette","0","28","Iowa","6/11/20","28","0","19065","0"
"Floyd","0","20","Iowa","6/11/20","19","1","19067","5.26"
"Franklin","4","42","Iowa","6/11/20","17","25","19069","147.06"
"Fremont","0","4","Iowa","6/11/20","4","0","19071","0"
"Greene","0","16","Iowa","6/11/20","15","1","19073","6.67"
"Grundy","0","23","Iowa","6/11/20","20","3","19075","15"
"Guthrie","0","55","Iowa","6/11/20","54","1","19077","1.85"
"Hamilton","7","108","Iowa","6/11/20","61","47","19079","77.05"
"Hancock","1","25","Iowa","6/11/20","16","9","19081","56.25"
"Hardin","3","40","Iowa","6/11/20","21","19","19083","90.48"
"Harrison","1","32","Iowa","6/11/20","26","6","19085","23.08"
"Henry","0","73","Iowa","6/11/20","72","1","19087","1.39"
"Howard","0","12","Iowa","6/11/20","12","0","19089","0"
"Humboldt","1","27","Iowa","6/11/20","19","8","19091","42.11"
"Ida","0","17","Iowa","6/11/20","15","2","19093","13.33"
"Iowa","0","34","Iowa","6/11/20","33","1","19095","3.03"
"Jackson","0","14","Iowa","6/11/20","13","1","19097","7.69"
"Jasper","1","278","Iowa","6/11/20","269","9","19099","3.35"
"Jefferson","1","42","Iowa","6/11/20","35","7","19101","20"
"Johnson","2","629","Iowa","6/11/20","618","11","19103","1.78"
"Jones","0","38","Iowa","6/11/20","37","1","19105","2.7"
"Keokuk","0","16","Iowa","6/11/20","14","2","19107","14.29"
"Kossuth","0","16","Iowa","6/11/20","14","2","19109","14.29"
"Lee","1","37","Iowa","6/11/20","29","8","19111","27.59"
"Linn","5","1007","Iowa","6/11/20","971","36","19113","3.71"
"Louisa","1","355","Iowa","6/11/20","349","6","19115","1.72"
"Lucas","0","22","Iowa","6/11/20","22","0","19117","0"
"Lyon","0","26","Iowa","6/11/20","24","2","19119","8.33"
"Madison","0","30","Iowa","6/11/20","29","1","19121","3.45"
"Mahaska","1","107","Iowa","6/11/20","99","8","19123","8.08"
"Marion","1","39","Iowa","6/11/20","35","4","19125","11.43"
"Marshall","4","937","Iowa","6/11/20","912","25","19127","2.74"
"Mills","0","22","Iowa","6/11/20","20","2","19129","10"
"Mitchell","0","6","Iowa","6/11/20","4","2","19131","50"
"Monona","1","29","Iowa","6/11/20","25","4","19133","16"
"Monroe","1","46","Iowa","6/11/20","41","5","19135","12.2"
"Montgomery","0","9","Iowa","6/11/20","9","0","19137","0"
"Muscatine","1","569","Iowa","6/11/20","565","4","19139","0.71"
"O'Brien","3","61","Iowa","6/11/20","39","22","19141","56.41"
"Osceola","2","49","Iowa","6/11/20","34","15","19143","44.12"
"Page","0","16","Iowa","6/11/20","14","2","19145","14.29"
"Palo Alto","1","12","Iowa","6/11/20","7","5","19147","71.43"
"Plymouth","6","186","Iowa","6/11/20","146","40","19149","27.4"
"Pocahontas","2","29","Iowa","6/11/20","15","14","19151","93.33"
"Polk","61","4969","Iowa","6/11/20","4541","428","19153","9.43"
"Pottawattamie","20","454","Iowa","6/11/20","311","143","19155","45.98"
"Poweshiek","0","95","Iowa","6/11/20","92","3","19157","3.26"
"Ringgold","1","8","Iowa","6/11/20","4","4","19159","100"
"Sac","1","36","Iowa","6/11/20","28","8","19161","28.57"
"Scott","3","399","Iowa","6/11/20","380","19","19163","5"
"Shelby","1","45","Iowa","6/11/20","37","8","19165","21.62"
"Sioux","6","341","Iowa","6/11/20","298","43","19167","14.43"
"Story","9","187","Iowa","6/11/20","126","61","19169","48.41"
"Tama","1","419","Iowa","6/11/20","410","9","19171","2.2"
"Taylor","1","70","Iowa","6/11/20","64","6","19173","9.38"
"Union","0","10","Iowa","6/11/20","9","1","19175","11.11"
"Van Buren","0","11","Iowa","6/11/20","9","2","19177","22.22"
"Wapello","6","667","Iowa","6/11/20","628","39","19179","6.21"
"Warren","3","187","Iowa","6/11/20","166","21","19181","12.65"
"Washington","1","205","Iowa","6/11/20","195","10","19183","5.13"
"Wayne","0","4","Iowa","6/11/20","1","3","19185","300"
"Webster","4","90","Iowa","6/11/20","62","28","19187","45.16"
"Winnebago","0","12","Iowa","6/11/20","11","1","19189","9.09"
"Winneshiek","0","25","Iowa","6/11/20","24","1","19191","4.17"
"Woodbury","18","2965","Iowa","6/11/20","2837","128","19193","4.51"
"Worth","0","4","Iowa","6/11/20","3","1","19195","33.33"
"Wright","8","267","Iowa","6/11/20","212","55","19197","25.94"
"Allen","0","1","Kansas","6/11/20","1","0","20001","0"
"Anderson","0","1","Kansas","6/11/20","1","0","20003","0"
"Atchison","0","26","Kansas","6/11/20","23","3","20005","13.04"
"Barber","0","1","Kansas","6/11/20","1","0","20007","0"
"Barton","0","47","Kansas","6/11/20","44","3","20009","6.82"
"Bourbon","0","8","Kansas","6/11/20","8","0","20011","0"
"Brown","0","9","Kansas","6/11/20","6","3","20013","50"
"Butler","0","37","Kansas","6/11/20","37","0","20015","0"
"Chase","0","3","Kansas","6/11/20","4","-1","20017","-25"
"Chautauqua","0","4","Kansas","6/11/20","4","0","20019","0"
"Cherokee","1","16","Kansas","6/11/20","10","6","20021","60"
"Cheyenne","0","2","Kansas","6/11/20","2","0","20023","0"
"Clark","0","33","Kansas","6/11/20","33","0","20025","0"
"Clay","0","6","Kansas","6/11/20","5","1","20027","20"
"Cloud","0","5","Kansas","6/11/20","5","0","20029","0"
"Coffey","0","52","Kansas","6/11/20","51","1","20031","1.96"
"Comanche","0","2","Kansas","6/11/20","2","0","20033","0"
"Cowley","2","32","Kansas","6/11/20","15","17","20035","113.33"
"Crawford","1","14","Kansas","6/11/20","8","6","20037","75"
"Dickinson","0","6","Kansas","6/11/20","4","2","20041","50"
"Doniphan","0","20","Kansas","6/11/20","18","2","20043","11.11"
"Douglas","2","78","Kansas","6/11/20","67","11","20045","16.42"
"Edwards","0","5","Kansas","6/11/20","5","0","20047","0"
"Ellis","0","12","Kansas","6/11/20","9","3","20051","33.33"
"Ellsworth","0","3","Kansas","6/11/20","2","1","20053","50"
"Finney","2","1537","Kansas","6/11/20","1522","15","20055","0.99"
"Ford","6","1837","Kansas","6/11/20","1794","43","20057","2.4"
"Franklin","2","49","Kansas","6/11/20","35","14","20059","40"
"Geary","1","29","Kansas","6/11/20","23","6","20061","26.09"
"Gove","0","1","Kansas","6/11/20","1","0","20063","0"
"Grant","0","18","Kansas","6/11/20","18","0","20067","0"
"Gray","0","23","Kansas","6/11/20","23","0","20069","0"
"Greenwood","0","10","Kansas","6/11/20","9","1","20073","11.11"
"Hamilton","1","25","Kansas","6/11/20","20","5","20075","25"
"Harper","0","2","Kansas","6/11/20","2","0","20077","0"
"Harvey","0","12","Kansas","6/11/20","11","1","20079","9.09"
"Haskell","0","22","Kansas","6/11/20","22","0","20081","0"
"Hodgeman","0","5","Kansas","6/11/20","5","0","20083","0"
"Jackson","0","102","Kansas","6/11/20","102","0","20085","0"
"Jefferson","0","23","Kansas","6/11/20","22","1","20087","4.55"
"Jewell","0","4","Kansas","6/11/20","4","0","20089","0"
"Johnson","15","992","Kansas","6/11/20","887","105","20091","11.84"
"Kearny","0","46","Kansas","6/11/20","45","1","20093","2.22"
"Kiowa","0","3","Kansas","6/11/20","3","0","20097","0"
"Labette","1","27","Kansas","6/11/20","22","5","20099","22.73"
"Lane","0","4","Kansas","6/11/20","4","0","20101","0"
"Leavenworth","1","1105","Kansas","6/11/20","1099","6","20103","0.55"
"Linn","0","11","Kansas","6/11/20","11","0","20107","0"
"Lyon","4","405","Kansas","6/11/20","377","28","20111","7.43"
"Marion","0","5","Kansas","6/11/20","5","0","20115","0"
"McPherson","1","38","Kansas","6/11/20","30","8","20113","26.67"
"Meade","0","30","Kansas","6/11/20","31","-1","20119","-3.23"
"Miami","0","10","Kansas","6/11/20","8","2","20121","25"
"Mitchell","0","4","Kansas","6/11/20","4","0","20123","0"
"Montgomery","0","22","Kansas","6/11/20","20","2","20125","10"
"Morris","0","5","Kansas","6/11/20","5","0","20127","0"
"Morton","0","6","Kansas","6/11/20","6","0","20129","0"
"Nemaha","0","20","Kansas","6/11/20","19","1","20131","5.26"
"Neosho","0","4","Kansas","6/11/20","2","2","20133","100"
"Ness","0","4","Kansas","6/11/20","3","1","20135","33.33"
"Norton","0","3","Kansas","6/11/20","2","1","20137","50"
"Osage","0","10","Kansas","6/11/20","8","2","20139","25"
"Osborne","0","2","Kansas","6/11/20","2","0","20141","0"
"Ottawa","0","4","Kansas","6/11/20","4","0","20143","0"
"Pawnee","0","3","Kansas","6/11/20","1","2","20145","200"
"Phillips","0","2","Kansas","6/11/20","2","0","20147","0"
"Pottawatomie","0","29","Kansas","6/11/20","26","3","20149","11.54"
"Pratt","0","2","Kansas","6/11/20","2","0","20151","0"
"Reno","0","47","Kansas","6/11/20","44","3","20155","6.82"
"Republic","0","4","Kansas","6/11/20","4","0","20157","0"
"Rice","0","4","Kansas","6/11/20","4","0","20159","0"
"Riley","1","71","Kansas","6/11/20","67","4","20161","5.97"
"Rooks","0","6","Kansas","6/11/20","6","0","20163","0"
"Saline","0","27","Kansas","6/11/20","25","2","20169","8"
"Scott","0","15","Kansas","6/11/20","14","1","20171","7.14"
"Sedgwick","13","717","Kansas","6/11/20","625","92","20173","14.72"
"Seward","4","917","Kansas","6/11/20","891","26","20175","2.92"
"Shawnee","10","420","Kansas","6/11/20","348","72","20177","20.69"
"Sheridan","0","2","Kansas","6/11/20","2","0","20179","0"
"Sherman","0","7","Kansas","6/11/20","7","0","20181","0"
"Smith","0","2","Kansas","6/11/20","2","0","20183","0"
"Stafford","0","1","Kansas","6/11/20","1","0","20185","0"
"Stanton","0","9","Kansas","6/11/20","10","-1","20187","-10"
"Stevens","0","31","Kansas","6/11/20","30","1","20189","3.33"
"Sumner","0","10","Kansas","6/11/20","8","2","20191","25"
"Trego","0","1","Kansas","6/11/20","1","0","20195","0"
"Wabaunsee","0","31","Kansas","6/11/20","31","0","20197","0"
"Washington","0","1","Kansas","6/11/20","0","1","20201","1"
"Wilson","0","1","Kansas","6/11/20","1","0","20205","0"
"Woodson","0","6","Kansas","6/11/20","6","0","20207","0"
"Wyandotte","20","1575","Kansas","6/11/20","1434","141","20209","9.83"
"Adair","1","101","Kentucky","6/11/20","97","4","21001","4.12"
"Allen","3","123","Kentucky","6/11/20","100","23","21003","23"
"Anderson","1","25","Kentucky","6/11/20","21","4","21005","19.05"
"Ballard","0","13","Kentucky","6/11/20","12","1","21007","8.33"
"Barren","1","59","Kentucky","6/11/20","50","9","21009","18"
"Bath","0","9","Kentucky","6/11/20","9","0","21011","0"
"Bell","0","3","Kentucky","6/11/20","2","1","21013","50"
"Boone","4","535","Kentucky","6/11/20","505","30","21015","5.94"
"Bourbon","1","21","Kentucky","6/11/20","12","9","21017","75"
"Boyd","0","43","Kentucky","6/11/20","41","2","21019","4.88"
"Boyle","0","28","Kentucky","6/11/20","28","0","21021","0"
"Bracken","0","14","Kentucky","6/11/20","13","1","21023","7.69"
"Breathitt","0","3","Kentucky","6/11/20","3","0","21025","0"
"Breckinridge","0","20","Kentucky","6/11/20","17","3","21027","17.65"
"Bullitt","1","127","Kentucky","6/11/20","119","8","21029","6.72"
"Butler","1","240","Kentucky","6/11/20","235","5","21031","2.13"
"Caldwell","0","12","Kentucky","6/11/20","12","0","21033","0"
"Calloway","1","57","Kentucky","6/11/20","53","4","21035","7.55"
"Campbell","1","201","Kentucky","6/11/20","194","7","21037","3.61"
"Carlisle","0","5","Kentucky","6/11/20","5","0","21039","0"
"Carroll","0","16","Kentucky","6/11/20","15","1","21041","6.67"
"Carter","0","17","Kentucky","6/11/20","14","3","21043","21.43"
"Casey","1","9","Kentucky","6/11/20","5","4","21045","80"
"Christian","3","136","Kentucky","6/11/20","118","18","21047","15.25"
"Clark","1","63","Kentucky","6/11/20","53","10","21049","18.87"
"Clay","1","12","Kentucky","6/11/20","7","5","21051","71.43"
"Clinton","0","5","Kentucky","6/11/20","5","0","21053","0"
"Crittenden","0","7","Kentucky","6/11/20","7","0","21055","0"
"Cumberland","0","5","Kentucky","6/11/20","5","0","21057","0"
"Daviess","1","347","Kentucky","6/11/20","337","10","21059","2.97"
"Edmonson","1","63","Kentucky","6/11/20","57","6","21061","10.53"
"Elliott","0","1","Kentucky","6/11/20","1","0","21063","0"
"Estill","0","2","Kentucky","6/11/20","1","1","21065","100"
"Fayette","23","970","Kentucky","6/11/20","808","162","21067","20.05"
"Fleming","0","2","Kentucky","6/11/20","2","0","21069","0"
"Floyd","0","17","Kentucky","6/11/20","17","0","21071","0"
"Franklin","3","88","Kentucky","6/11/20","68","20","21073","29.41"
"Fulton","1","12","Kentucky","6/11/20","8","4","21075","50"
"Gallatin","1","51","Kentucky","6/11/20","46","5","21077","10.87"
"Garrard","1","9","Kentucky","6/11/20","5","4","21079","80"
"Grant","1","51","Kentucky","6/11/20","47","4","21081","8.51"
"Graves","0","167","Kentucky","6/11/20","166","1","21083","0.6"
"Grayson","0","135","Kentucky","6/11/20","132","3","21085","2.27"
"Green","0","2","Kentucky","6/11/20","2","0","21087","0"
"Greenup","0","14","Kentucky","6/11/20","14","0","21089","0"
"Hancock","0","7","Kentucky","6/11/20","7","0","21091","0"
"Hardin","2","127","Kentucky","6/11/20","111","16","21093","14.41"
"Harlan","1","8","Kentucky","6/11/20","4","4","21095","100"
"Harrison","1","32","Kentucky","6/11/20","27","5","21097","18.52"
"Hart","0","26","Kentucky","6/11/20","23","3","21099","13.04"
"Henderson","1","121","Kentucky","6/11/20","117","4","21101","3.42"
"Henry","0","24","Kentucky","6/11/20","22","2","21103","9.09"
"Hickman","0","5","Kentucky","6/11/20","5","0","21105","0"
"Hopkins","0","225","Kentucky","6/11/20","224","1","21107","0.45"
"Jackson","0","62","Kentucky","6/11/20","61","1","21109","1.64"
"Jefferson","67","3229","Kentucky","6/11/20","2760","469","21111","16.99"
"Jessamine","2","79","Kentucky","6/11/20","67","12","21113","17.91"
"Johnson","0","5","Kentucky","6/11/20","5","0","21115","0"
"Kenton","4","683","Kentucky","6/11/20","653","30","21117","4.59"
"Knott","0","4","Kentucky","6/11/20","4","0","21119","0"
"Knox","0","10","Kentucky","6/11/20","10","0","21121","0"
"Larue","0","11","Kentucky","6/11/20","9","2","21123","22.22"
"Laurel","0","22","Kentucky","6/11/20","21","1","21125","4.76"
"Lawrence","0","5","Kentucky","6/11/20","4","1","21127","25"
"Lee","0","1","Kentucky","6/11/20","1","0","21129","0"
"Leslie","0","6","Kentucky","6/11/20","6","0","21131","0"
"Letcher","0","3","Kentucky","6/11/20","3","0","21133","0"
"Lewis","0","8","Kentucky","6/11/20","7","1","21135","14.29"
"Lincoln","1","14","Kentucky","6/11/20","9","5","21137","55.56"
"Livingston","0","9","Kentucky","6/11/20","9","0","21139","0"
"Logan","3","178","Kentucky","6/11/20","158","20","21141","12.66"
"Lyon","0","17","Kentucky","6/11/20","15","2","21143","13.33"
"Madison","2","71","Kentucky","6/11/20","57","14","21151","24.56"
"Magoffin","0","2","Kentucky","6/11/20","2","0","21153","0"
"Marion","2","38","Kentucky","6/11/20","27","11","21155","40.74"
"Marshall","0","40","Kentucky","6/11/20","37","3","21157","8.11"
"Martin","0","3","Kentucky","6/11/20","3","0","21159","0"
"Mason","1","15","Kentucky","6/11/20","10","5","21161","50"
"McCracken","1","113","Kentucky","6/11/20","107","6","21145","5.61"
"McCreary","0","13","Kentucky","6/11/20","13","0","21147","0"
"McLean","0","23","Kentucky","6/11/20","22","1","21149","4.55"
"Meade","0","23","Kentucky","6/11/20","23","0","21163","0"
"Menifee","0","10","Kentucky","6/11/20","10","0","21165","0"
"Mercer","0","16","Kentucky","6/11/20","14","2","21167","14.29"
"Metcalfe","0","7","Kentucky","6/11/20","7","0","21169","0"
"Monroe","0","27","Kentucky","6/11/20","25","2","21171","8"
"Montgomery","1","31","Kentucky","6/11/20","25","6","21173","24"
"Morgan","0","4","Kentucky","6/11/20","3","1","21175","33.33"
"Muhlenberg","1","484","Kentucky","6/11/20","479","5","21177","1.04"
"Nelson","0","47","Kentucky","6/11/20","44","3","21179","6.82"
"Nicholas","0","4","Kentucky","6/11/20","3","1","21181","33.33"
"Ohio","1","158","Kentucky","6/11/20","150","8","21183","5.33"
"Oldham","1","113","Kentucky","6/11/20","105","8","21185","7.62"
"Owen","0","4","Kentucky","6/11/20","3","1","21187","33.33"
"Owsley","0","2","Kentucky","6/11/20","2","0","21189","0"
"Pendleton","0","14","Kentucky","6/11/20","11","3","21191","27.27"
"Perry","0","22","Kentucky","6/11/20","22","0","21193","0"
"Pike","1","38","Kentucky","6/11/20","32","6","21195","18.75"
"Powell","0","3","Kentucky","6/11/20","1","2","21197","200"
"Pulaski","1","68","Kentucky","6/11/20","60","8","21199","13.33"
"Rockcastle","0","13","Kentucky","6/11/20","13","0","21203","0"
"Rowan","1","11","Kentucky","6/11/20","7","4","21205","57.14"
"Russell","1","36","Kentucky","6/11/20","26","10","21207","38.46"
"Scott","0","39","Kentucky","6/11/20","37","2","21209","5.41"
"Shelby","7","233","Kentucky","6/11/20","184","49","21211","26.63"
"Simpson","0","57","Kentucky","6/11/20","55","2","21213","3.64"
"Spencer","0","25","Kentucky","6/11/20","24","1","21215","4.17"
"Taylor","0","15","Kentucky","6/11/20","13","2","21217","15.38"
"Todd","0","23","Kentucky","6/11/20","23","0","21219","0"
"Trigg","0","14","Kentucky","6/11/20","11","3","21221","27.27"
"Trimble","0","5","Kentucky","6/11/20","6","-1","21223","-16.67"
"Union","0","15","Kentucky","6/11/20","15","0","21225","0"
"Warren","15","1184","Kentucky","6/11/20","1081","103","21227","9.53"
"Washington","0","8","Kentucky","6/11/20","7","1","21229","14.29"
"Wayne","0","10","Kentucky","6/11/20","8","2","21231","25"
"Webster","0","34","Kentucky","6/11/20","34","0","21233","0"
"Whitley","0","15","Kentucky","6/11/20","13","2","21235","15.38"
"Wolfe","0","1","Kentucky","6/11/20","1","0","21237","0"
"Woodford","2","46","Kentucky","6/11/20","31","15","21239","48.39"
"Acadia","10","529","Louisiana","6/11/20","462","67","22001","14.5"
"Allen","0","189","Louisiana","6/11/20","186","3","22003","1.61"
"Ascension","7","912","Louisiana","6/11/20","861","51","22005","5.92"
"Assumption","1","258","Louisiana","6/11/20","252","6","22007","2.38"
"Avoyelles","4","178","Louisiana","6/11/20","149","29","22009","19.46"
"Beauregard","4","117","Louisiana","6/11/20","90","27","22011","30"
"Bienville","3","167","Louisiana","6/11/20","149","18","22013","12.08"
"Bossier","7","484","Louisiana","6/11/20","438","46","22015","10.5"
"Caddo","17","2794","Louisiana","6/11/20","2676","118","22017","4.41"
"Calcasieu","9","684","Louisiana","6/11/20","621","63","22019","10.14"
"Caldwell","2","76","Louisiana","6/11/20","65","11","22021","16.92"
"Cameron","0","11","Louisiana","6/11/20","8","3","22023","37.5"
"Catahoula","1","123","Louisiana","6/11/20","119","4","22025","3.36"
"Claiborne","1","72","Louisiana","6/11/20","66","6","22027","9.09"
"Concordia","0","97","Louisiana","6/11/20","94","3","22029","3.19"
"De Soto","1","266","Louisiana","6/11/20","260","6","22031","2.31"
"East Baton Rouge","38","4088","Louisiana","6/11/20","3820","268","22033","7.02"
"East Carroll","5","212","Louisiana","6/11/20","179","33","22035","18.44"
"East Feliciana","2","210","Louisiana","6/11/20","199","11","22037","5.53"
"Evangeline","1","85","Louisiana","6/11/20","81","4","22039","4.94"
"Franklin","2","395","Louisiana","6/11/20","378","17","22041","4.5"
"Grant","3","51","Louisiana","6/11/20","33","18","22043","54.55"
"Iberia","2","430","Louisiana","6/11/20","419","11","22045","2.63"
"Iberville","3","607","Louisiana","6/11/20","584","23","22047","3.94"
"Jackson","5","149","Louisiana","6/11/20","117","32","22049","27.35"
"Jefferson","38","8032","Louisiana","6/11/20","7763","269","22051","3.47"
"Jefferson Davis","3","106","Louisiana","6/11/20","84","22","22053","26.19"
"Lafayette","18","957","Louisiana","6/11/20","834","123","22055","14.75"
"Lafourche","8","937","Louisiana","6/11/20","882","55","22057","6.24"
"LaSalle","2","68","Louisiana","6/11/20","56","12","22059","21.43"
"Lincoln","5","196","Louisiana","6/11/20","163","33","22061","20.25"
"Livingston","6","495","Louisiana","6/11/20","453","42","22063","9.27"
"Madison","19","249","Louisiana","6/11/20","116","133","22065","114.66"
"Morehouse","1","138","Louisiana","6/11/20","132","6","22067","4.55"
"Natchitoches","1","182","Louisiana","6/11/20","173","9","22069","5.2"
"Orleans","15","7294","Louisiana","6/11/20","7192","102","22071","1.42"
"Ouachita","41","1631","Louisiana","6/11/20","1346","285","22073","21.17"
"Plaquemines","1","222","Louisiana","6/11/20","217","5","22075","2.3"
"Pointe Coupee","1","217","Louisiana","6/11/20","207","10","22077","4.83"
"Rapides","32","1074","Louisiana","6/11/20","850","224","22079","26.35"
"Red River","0","52","Louisiana","6/11/20","51","1","22081","1.96"
"Richland","2","159","Louisiana","6/11/20","148","11","22083","7.43"
"Sabine","0","53","Louisiana","6/11/20","50","3","22085","6"
"St. Bernard","2","559","Louisiana","6/11/20","546","13","22087","2.38"
"St. Charles","1","654","Louisiana","6/11/20","647","7","22089","1.08"
"St. Helena","1","56","Louisiana","6/11/20","52","4","22091","7.69"
"St. James","0","306","Louisiana","6/11/20","303","3","22093","0.99"
"St. John the Baptist","2","883","Louisiana","6/11/20","872","11","22095","1.26"
"St. Landry","7","324","Louisiana","6/11/20","272","52","22097","19.12"
"St. Martin","-1","307","Louisiana","6/11/20","311","-4","22099","-1.29"
"St. Mary","2","346","Louisiana","6/11/20","331","15","22101","4.53"
"St. Tammany","12","1885","Louisiana","6/11/20","1799","86","22103","4.78"
"Tangipahoa","12","984","Louisiana","6/11/20","898","86","22105","9.58"
"Tensas","1","21","Louisiana","6/11/20","16","5","22107","31.25"
"Terrebonne","7","771","Louisiana","6/11/20","719","52","22109","7.23"
"Union","7","383","Louisiana","6/11/20","333","50","22111","15.02"
"Vermilion","1","65","Louisiana","6/11/20","59","6","22113","10.17"
"Vernon","1","39","Louisiana","6/11/20","29","10","22115","34.48"
"Washington","8","509","Louisiana","6/11/20","451","58","22117","12.86"
"Webster","5","204","Louisiana","6/11/20","171","33","22119","19.3"
"West Baton Rouge","2","197","Louisiana","6/11/20","180","17","22121","9.44"
"West Carroll","4","99","Louisiana","6/11/20","68","31","22123","45.59"
"West Feliciana","1","225","Louisiana","6/11/20","216","9","22125","4.17"
"Winn","2","195","Louisiana","6/11/20","178","17","22127","9.55"
"Androscoggin","9","397","Maine","6/11/20","334","63","23001","18.86"
"Aroostook","0","10","Maine","6/11/20","10","0","23003","0"
"Cumberland","17","1361","Maine","6/11/20","1244","117","23005","9.41"
"Franklin","0","36","Maine","6/11/20","36","0","23007","0"
"Hancock","0","12","Maine","6/11/20","11","1","23009","9.09"
"Kennebec","1","133","Maine","6/11/20","128","5","23011","3.91"
"Knox","0","21","Maine","6/11/20","21","0","23013","0"
"Lincoln","0","20","Maine","6/11/20","20","0","23015","0"
"Oxford","0","31","Maine","6/11/20","32","-1","23017","-3.12"
"Penobscot","0","101","Maine","6/11/20","100","1","23019","1"
"Piscataquis","0","1","Maine","6/11/20","1","0","23021","0"
"Sagadahoc","0","30","Maine","6/11/20","30","0","23023","0"
"Somerset","0","25","Maine","6/11/20","22","3","23025","13.64"
"Waldo","1","55","Maine","6/11/20","51","4","23027","7.84"
"Washington","0","1","Maine","6/11/20","1","0","23029","0"
"York","4","431","Maine","6/11/20","401","30","23031","7.48"
"Allegany","0","185","Maryland","6/11/20","182","3","24001","1.65"
"Anne Arundel","49","4421","Maryland","6/11/20","4080","341","24003","8.36"
"Baltimore","73","6985","Maryland","6/11/20","6476","509","24005","7.86"
"Baltimore City","86","6509","Maryland","6/11/20","5906","603","24510","10.21"
"Calvert","2","366","Maryland","6/11/20","352","14","24009","3.98"
"Caroline","1","278","Maryland","6/11/20","268","10","24011","3.73"
"Carroll","4","976","Maryland","6/11/20","947","29","24013","3.06"
"Cecil","6","429","Maryland","6/11/20","388","41","24015","10.57"
"Charles","9","1235","Maryland","6/11/20","1174","61","24017","5.2"
"Dorchester","1","159","Maryland","6/11/20","152","7","24019","4.61"
"Frederick","23","2202","Maryland","6/11/20","2041","161","24021","7.89"
"Garrett","0","10","Maryland","6/11/20","10","0","24023","0"
"Harford","10","990","Maryland","6/11/20","920","70","24025","7.61"
"Howard","40","2311","Maryland","6/11/20","2033","278","24027","13.67"
"Kent","1","188","Maryland","6/11/20","180","8","24029","4.44"
"Montgomery","150","13276","Maryland","6/11/20","12226","1050","24031","8.59"
"Prince George's","143","16940","Maryland","6/11/20","15940","1000","24033","6.27"
"Queen Anne's","2","178","Maryland","6/11/20","161","17","24035","10.56"
"Somerset","0","78","Maryland","6/11/20","76","2","24039","2.63"
"St. Mary's","4","573","Maryland","6/11/20","542","31","24037","5.72"
"Talbot","0","107","Maryland","6/11/20","106","1","24041","0.94"
"Washington","6","560","Maryland","6/11/20","516","44","24043","8.53"
"Wicomico","6","998","Maryland","6/11/20","959","39","24045","4.07"
"Worcester","3","243","Maryland","6/11/20","223","20","24047","8.97"
"Barnstable","4","1474","Massachusetts","6/11/20","1443","31","25001","2.15"
"Berkshire","1","575","Massachusetts","6/11/20","568","7","25003","1.23"
"Bristol","41","7793","Massachusetts","6/11/20","7508","285","25005","3.8"
"Dukes and Nantucket","0","55","Massachusetts","6/11/20","55","0","00000","0"
"Essex","71","15465","Massachusetts","6/11/20","14969","496","25009","3.31"
"Franklin","2","348","Massachusetts","6/11/20","337","11","25011","3.26"
"Hampden","21","6415","Massachusetts","6/11/20","6268","147","25013","2.35"
"Hampshire","3","913","Massachusetts","6/11/20","894","19","25015","2.13"
"Middlesex","73","22996","Massachusetts","6/11/20","22485","511","25017","2.27"
"Norfolk","26","8809","Massachusetts","6/11/20","8625","184","25021","2.13"
"Plymouth","23","8440","Massachusetts","6/11/20","8282","158","25023","1.91"
"Suffolk","58","19195","Massachusetts","6/11/20","18790","405","25025","2.16"
"Worcester","51","11885","Massachusetts","6/11/20","11529","356","25027","3.09"
"Alcona","0","20","Michigan","6/11/20","20","0","26001","0"
"Alger","0","1","Michigan","6/11/20","0","1","26003","1"
"Allegan","2","277","Michigan","6/11/20","262","15","26005","5.73"
"Alpena","2","114","Michigan","6/11/20","103","11","26007","10.68"
"Antrim","0","14","Michigan","6/11/20","13","1","26009","7.69"
"Arenac","0","38","Michigan","6/11/20","38","0","26011","0"
"Baraga","0","1","Michigan","6/11/20","1","0","26013","0"
"Barry","1","90","Michigan","6/11/20","83","7","26015","8.43"
"Bay","3","385","Michigan","6/11/20","364","21","26017","5.77"
"Benzie","0","5","Michigan","6/11/20","4","1","26019","25"
"Berrien","4","816","Michigan","6/11/20","790","26","26021","3.29"
"Branch","3","160","Michigan","6/11/20","138","22","26023","15.94"
"Calhoun","4","477","Michigan","6/11/20","446","31","26025","6.95"
"Cass","2","112","Michigan","6/11/20","98","14","26027","14.29"
"Charlevoix","0","19","Michigan","6/11/20","18","1","26029","5.56"
"Cheboygan","0","26","Michigan","6/11/20","26","0","26031","0"
"Chippewa","0","3","Michigan","6/11/20","3","0","26033","0"
"Clare","1","24","Michigan","6/11/20","20","4","26035","20"
"Clinton","1","188","Michigan","6/11/20","181","7","26037","3.87"
"Crawford","0","63","Michigan","6/11/20","63","0","26039","0"
"Delta","0","20","Michigan","6/11/20","20","0","26041","0"
"Dickinson","0","6","Michigan","6/11/20","5","1","26043","20"
"Eaton","1","255","Michigan","6/11/20","249","6","26045","2.41"
"Emmet","0","26","Michigan","6/11/20","26","0","26047","0"
"Federal Correctional Institution (FCI)","1","161","Michigan","6/11/20","152","9","00000","5.92"
"Genesee","6","2564","Michigan","6/11/20","2524","40","26049","1.58"
"Gladwin","0","20","Michigan","6/11/20","18","2","26051","11.11"
"Gogebic","0","5","Michigan","6/11/20","5","0","26053","0"
"Grand Traverse","1","35","Michigan","6/11/20","29","6","26055","20.69"
"Gratiot","1","89","Michigan","6/11/20","85","4","26057","4.71"
"Hillsdale","0","179","Michigan","6/11/20","177","2","26059","1.13"
"Houghton","0","8","Michigan","6/11/20","7","1","26061","14.29"
"Huron","1","60","Michigan","6/11/20","56","4","26063","7.14"
"Ingham","6","832","Michigan","6/11/20","792","40","26065","5.05"
"Ionia","1","177","Michigan","6/11/20","172","5","26067","2.91"
"Iosco","0","110","Michigan","6/11/20","110","0","26069","0"
"Iron","0","2","Michigan","6/11/20","1","1","26071","100"
"Isabella","0","95","Michigan","6/11/20","94","1","26073","1.06"
"Jackson","1","488","Michigan","6/11/20","481","7","26075","1.46"
"Kalamazoo","4","943","Michigan","6/11/20","912","31","26077","3.4"
"Kalkaska","0","30","Michigan","6/11/20","30","0","26079","0"
"Kent","27","4291","Michigan","6/11/20","4104","187","26081","4.56"
"Keweenaw","0","1","Michigan","6/11/20","0","1","26083","1"
"Lake","0","7","Michigan","6/11/20","7","0","26085","0"
"Lapeer","0","226","Michigan","6/11/20","225","1","26087","0.44"
"Leelanau","0","12","Michigan","6/11/20","11","1","26089","9.09"
"Lenawee","1","193","Michigan","6/11/20","188","5","26091","2.66"
"Livingston","1","520","Michigan","6/11/20","510","10","26093","1.96"
"Luce","0","3","Michigan","6/11/20","3","0","26095","0"
"Mackinac","0","8","Michigan","6/11/20","8","0","26097","0"
"Macomb","8","7006","Michigan","6/11/20","6949","57","26099","0.82"
"Manistee","0","12","Michigan","6/11/20","12","0","26101","0"
"Marquette","0","59","Michigan","6/11/20","56","3","26103","5.36"
"Mason","0","38","Michigan","6/11/20","38","0","26105","0"
"Mecosta","0","24","Michigan","6/11/20","24","0","26107","0"
"Menominee","0","9","Michigan","6/11/20","8","1","26109","12.5"
"Michigan Department of Corrections (MDOC)","8","4144","Michigan","6/11/20","4091","53","00000","1.3"
"Midland","3","140","Michigan","6/11/20","121","19","26111","15.7"
"Missaukee","0","23","Michigan","6/11/20","22","1","26113","4.55"
"Monroe","3","561","Michigan","6/11/20","537","24","26115","4.47"
"Montcalm","1","81","Michigan","6/11/20","75","6","26117","8"
"Montmorency","0","5","Michigan","6/11/20","5","0","26119","0"
"Muskegon","6","730","Michigan","6/11/20","686","44","26121","6.41"
"Newaygo","1","125","Michigan","6/11/20","116","9","26123","7.76"
"Oakland","27","11283","Michigan","6/11/20","11095","188","26125","1.69"
"Oceana","0","103","Michigan","6/11/20","102","1","26127","0.98"
"Ogemaw","0","31","Michigan","6/11/20","31","0","26129","0"
"Osceola","0","18","Michigan","6/11/20","16","2","26133","12.5"
"Oscoda","0","8","Michigan","6/11/20","8","0","26135","0"
"Otsego","0","120","Michigan","6/11/20","120","0","26137","0"
"Ottawa","5","908","Michigan","6/11/20","876","32","26139","3.65"
"Out of MI","0","30","Michigan","6/11/20","30","0","80026","0"
"Presque Isle","0","12","Michigan","6/11/20","11","1","26141","9.09"
"Roscommon","0","24","Michigan","6/11/20","24","0","26143","0"
"Saginaw","8","1148","Michigan","6/11/20","1092","56","26145","5.13"
"Sanilac","0","42","Michigan","6/11/20","43","-1","26151","-2.33"
"Schoolcraft","0","4","Michigan","6/11/20","4","0","26153","0"
"Shiawassee","0","263","Michigan","6/11/20","261","2","26155","0.77"
"St. Clair","0","514","Michigan","6/11/20","514","0","26147","0"
"St. Joseph","4","166","Michigan","6/11/20","137","29","26149","21.17"
"Tuscola","2","207","Michigan","6/11/20","191","16","26157","8.38"
"Van Buren","3","195","Michigan","6/11/20","171","24","26159","14.04"
"Washtenaw","5","1569","Michigan","6/11/20","1534","35","26161","2.28"
"Wayne","50","21629","Michigan","6/11/20","21281","348","26163","1.64"
"Wexford","0","14","Michigan","6/11/20","14","0","26165","0"
"Aitkin","0","13","Minnesota","6/11/20","11","2","27001","18.18"
"Anoka","27","1674","Minnesota","6/11/20","1488","186","27003","12.5"
"Becker","0","45","Minnesota","6/11/20","43","2","27005","4.65"
"Beltrami","0","21","Minnesota","6/11/20","18","3","27007","16.67"
"Benton","1","190","Minnesota","6/11/20","182","8","27009","4.4"
"Big Stone","1","13","Minnesota","6/11/20","8","5","27011","62.5"
"Blue Earth","1","157","Minnesota","6/11/20","148","9","27013","6.08"
"Brown","0","18","Minnesota","6/11/20","16","2","27015","12.5"
"Carlton","1","79","Minnesota","6/11/20","75","4","27017","5.33"
"Carver","5","266","Minnesota","6/11/20","232","34","27019","14.66"
"Cass","0","11","Minnesota","6/11/20","11","0","27021","0"
"Chippewa","0","54","Minnesota","6/11/20","52","2","27023","3.85"
"Chisago","1","74","Minnesota","6/11/20","64","10","27025","15.62"
"Clay","8","499","Minnesota","6/11/20","441","58","27027","13.15"
"Clearwater","0","3","Minnesota","6/11/20","3","0","27029","0"
"Cottonwood","2","96","Minnesota","6/11/20","79","17","27033","21.52"
"Crow Wing","2","88","Minnesota","6/11/20","77","11","27035","14.29"
"Dakota","30","1623","Minnesota","6/11/20","1414","209","27037","14.78"
"Dodge","1","57","Minnesota","6/11/20","53","4","27039","7.55"
"Douglas","0","48","Minnesota","6/11/20","45","3","27041","6.67"
"Faribault","1","25","Minnesota","6/11/20","20","5","27043","25"
"Fillmore","0","20","Minnesota","6/11/20","17","3","27045","17.65"
"Freeborn","8","200","Minnesota","6/11/20","142","58","27047","40.85"
"Goodhue","2","86","Minnesota","6/11/20","71","15","27049","21.13"
"Grant","0","6","Minnesota","6/11/20","4","2","27051","50"
"Hennepin","135","9815","Minnesota","6/11/20","8867","948","27053","10.69"
"Houston","0","5","Minnesota","6/11/20","2","3","27055","150"
"Hubbard","0","5","Minnesota","6/11/20","3","2","27057","66.67"
"Isanti","2","48","Minnesota","6/11/20","36","12","27059","33.33"
"Itasca","0","58","Minnesota","6/11/20","56","2","27061","3.57"
"Jackson","0","43","Minnesota","6/11/20","42","1","27063","2.38"
"Kanabec","0","13","Minnesota","6/11/20","12","1","27065","8.33"
"Kandiyohi","4","540","Minnesota","6/11/20","511","29","27067","5.68"
"Kittson","0","1","Minnesota","6/11/20","1","0","27069","0"
"Koochiching","0","9","Minnesota","6/11/20","9","0","27071","0"
"Lac qui Parle","0","3","Minnesota","6/11/20","3","0","27073","0"
"Lake","0","1","Minnesota","6/11/20","1","0","27075","0"
"Le Sueur","1","50","Minnesota","6/11/20","46","4","27079","8.7"
"Lincoln","0","6","Minnesota","6/11/20","6","0","27081","0"
"Lyon","13","174","Minnesota","6/11/20","81","93","27083","114.81"
"Mahnomen","0","6","Minnesota","6/11/20","6","0","27087","0"
"Marshall","0","12","Minnesota","6/11/20","12","0","27089","0"
"Martin","2","143","Minnesota","6/11/20","132","11","27091","8.33"
"McLeod","2","52","Minnesota","6/11/20","39","13","27085","33.33"
"Meeker","1","50","Minnesota","6/11/20","46","4","27093","8.7"
"Mille Lacs","0","26","Minnesota","6/11/20","23","3","27095","13.04"
"Morrison","1","53","Minnesota","6/11/20","48","5","27097","10.42"
"Mower","28","604","Minnesota","6/11/20","406","198","27099","48.77"
"Murray","0","42","Minnesota","6/11/20","40","2","27101","5"
"Nicollet","1","93","Minnesota","6/11/20","88","5","27103","5.68"
"Nobles","6","1602","Minnesota","6/11/20","1562","40","27105","2.56"
"Norman","0","17","Minnesota","6/11/20","15","2","27107","13.33"
"Olmsted","11","752","Minnesota","6/11/20","672","80","27109","11.9"
"Otter Tail","1","80","Minnesota","6/11/20","73","7","27111","9.59"
"Pennington","2","37","Minnesota","6/11/20","23","14","27113","60.87"
"Pine","0","95","Minnesota","6/11/20","93","2","27115","2.15"
"Pipestone","0","15","Minnesota","6/11/20","12","3","27117","25"
"Polk","1","67","Minnesota","6/11/20","61","6","27119","9.84"
"Pope","0","10","Minnesota","6/11/20","10","0","27121","0"
"Ramsey","70","3740","Minnesota","6/11/20","3252","488","27123","15.01"
"Red Lake","0","4","Minnesota","6/11/20","4","0","27125","0"
"Redwood","0","8","Minnesota","6/11/20","7","1","27127","14.29"
"Renville","0","8","Minnesota","6/11/20","7","1","27129","14.29"
"Rice","17","604","Minnesota","6/11/20","483","121","27131","25.05"
"Rock","0","23","Minnesota","6/11/20","23","0","27133","0"
"Roseau","0","6","Minnesota","6/11/20","3","3","27135","100"
"Scott","8","517","Minnesota","6/11/20","460","57","27139","12.39"
"Sherburne","2","261","Minnesota","6/11/20","248","13","27141","5.24"
"Sibley","1","25","Minnesota","6/11/20","16","9","27143","56.25"
"St. Louis","1","123","Minnesota","6/11/20","118","5","27137","4.24"
"Stearns","5","2088","Minnesota","6/11/20","2050","38","27145","1.85"
"Steele","1","173","Minnesota","6/11/20","167","6","27147","3.59"
"Stevens","0","1","Minnesota","6/11/20","1","0","27149","0"
"Swift","0","19","Minnesota","6/11/20","19","0","27151","0"
"Todd","5","368","Minnesota","6/11/20","336","32","27153","9.52"
"Traverse","0","5","Minnesota","6/11/20","4","1","27155","25"
"Wabasha","0","20","Minnesota","6/11/20","18","2","27157","11.11"
"Wadena","0","10","Minnesota","6/11/20","10","0","27159","0"
"Waseca","1","32","Minnesota","6/11/20","27","5","27161","18.52"
"Washington","10","748","Minnesota","6/11/20","680","68","27163","10"
"Watonwan","1","86","Minnesota","6/11/20","78","8","27165","10.26"
"Wilkin","0","12","Minnesota","6/11/20","11","1","27167","9.09"
"Winona","1","84","Minnesota","6/11/20","80","4","27169","5"
"Wright","4","367","Minnesota","6/11/20","339","28","27171","8.26"
"Yellow Medicine","0","8","Minnesota","6/11/20","6","2","27173","33.33"
"Adams","3","222","Mississippi","6/11/20","203","19","28001","9.36"
"Alcorn","1","26","Mississippi","6/11/20","19","7","28003","36.84"
"Amite","0","67","Mississippi","6/11/20","66","1","28005","1.52"
"Attala","2","323","Mississippi","6/11/20","311","12","28007","3.86"
"Benton","0","17","Mississippi","6/11/20","14","3","28009","21.43"
"Bolivar","2","180","Mississippi","6/11/20","169","11","28011","6.51"
"Calhoun","1","75","Mississippi","6/11/20","67","8","28013","11.94"
"Carroll","1","123","Mississippi","6/11/20","119","4","28015","3.36"
"Chickasaw","3","158","Mississippi","6/11/20","140","18","28017","12.86"
"Choctaw","2","62","Mississippi","6/11/20","50","12","28019","24"
"Claiborne","2","131","Mississippi","6/11/20","115","16","28021","13.91"
"Clarke","1","164","Mississippi","6/11/20","156","8","28023","5.13"
"Clay","3","145","Mississippi","6/11/20","125","20","28025","16"
"Coahoma","1","141","Mississippi","6/11/20","131","10","28027","7.63"
"Copiah","5","366","Mississippi","6/11/20","329","37","28029","11.25"
"Covington","3","200","Mississippi","6/11/20","179","21","28031","11.73"
"DeSoto","13","664","Mississippi","6/11/20","575","89","28033","15.48"
"Forrest","10","667","Mississippi","6/11/20","595","72","28035","12.1"
"Franklin","0","29","Mississippi","6/11/20","29","0","28037","0"
"George","0","32","Mississippi","6/11/20","29","3","28039","10.34"
"Greene","2","45","Mississippi","6/11/20","33","12","28041","36.36"
"Grenada","4","138","Mississippi","6/11/20","107","31","28043","28.97"
"Hancock","1","94","Mississippi","6/11/20","90","4","28045","4.44"
"Harrison","6","311","Mississippi","6/11/20","269","42","28047","15.61"
"Hinds","19","1206","Mississippi","6/11/20","1074","132","28049","12.29"
"Holmes","2","460","Mississippi","6/11/20","443","17","28051","3.84"
"Humphreys","2","78","Mississippi","6/11/20","63","15","28053","23.81"
"Itawamba","1","96","Mississippi","6/11/20","89","7","28057","7.87"
"Jackson","4","339","Mississippi","6/11/20","314","25","28059","7.96"
"Jasper","3","189","Mississippi","6/11/20","167","22","28061","13.17"
"Jefferson","1","50","Mississippi","6/11/20","42","8","28063","19.05"
"Jefferson Davis","0","84","Mississippi","6/11/20","82","2","28065","2.44"
"Jones","16","812","Mississippi","6/11/20","701","111","28067","15.83"
"Kemper","2","166","Mississippi","6/11/20","155","11","28069","7.1"
"Lafayette","1","161","Mississippi","6/11/20","154","7","28071","4.55"
"Lamar","4","278","Mississippi","6/11/20","250","28","28073","11.2"
"Lauderdale","5","795","Mississippi","6/11/20","759","36","28075","4.74"
"Lawrence","1","113","Mississippi","6/11/20","107","6","28077","5.61"
"Leake","3","472","Mississippi","6/11/20","452","20","28079","4.42"
"Lee","10","261","Mississippi","6/11/20","194","67","28081","34.54"
"Leflore","8","330","Mississippi","6/11/20","277","53","28083","19.13"
"Lincoln","5","314","Mississippi","6/11/20","280","34","28085","12.14"
"Lowndes","6","290","Mississippi","6/11/20","247","43","28087","17.41"
"Madison","11","843","Mississippi","6/11/20","767","76","28089","9.91"
"Marion","2","132","Mississippi","6/11/20","116","16","28091","13.79"
"Marshall","2","98","Mississippi","6/11/20","87","11","28093","12.64"
"Monroe","3","290","Mississippi","6/11/20","269","21","28095","7.81"
"Montgomery","1","88","Mississippi","6/11/20","84","4","28097","4.76"
"Neshoba","13","821","Mississippi","6/11/20","728","93","28099","12.77"
"Newton","4","313","Mississippi","6/11/20","288","25","28101","8.68"
"Noxubee","2","209","Mississippi","6/11/20","193","16","28103","8.29"
"Oktibbeha","8","327","Mississippi","6/11/20","273","54","28105","19.78"
"Panola","4","110","Mississippi","6/11/20","84","26","28107","30.95"
"Pearl River","1","221","Mississippi","6/11/20","212","9","28109","4.25"
"Perry","0","52","Mississippi","6/11/20","51","1","28111","1.96"
"Pike","1","213","Mississippi","6/11/20","204","9","28113","4.41"
"Pontotoc","2","64","Mississippi","6/11/20","47","17","28115","36.17"
"Prentiss","1","63","Mississippi","6/11/20","53","10","28117","18.87"
"Quitman","0","34","Mississippi","6/11/20","32","2","28119","6.25"
"Rankin","7","505","Mississippi","6/11/20","456","49","28121","10.75"
"Scott","3","682","Mississippi","6/11/20","663","19","28123","2.87"
"Sharkey","0","7","Mississippi","6/11/20","7","0","28125","0"
"Simpson","2","117","Mississippi","6/11/20","104","13","28127","12.5"
"Smith","3","173","Mississippi","6/11/20","155","18","28129","11.61"
"Stone","0","33","Mississippi","6/11/20","32","1","28131","3.12"
"Sunflower","2","109","Mississippi","6/11/20","92","17","28133","18.48"
"Tallahatchie","1","35","Mississippi","6/11/20","30","5","28135","16.67"
"Tate","4","118","Mississippi","6/11/20","91","27","28137","29.67"
"Tippah","2","90","Mississippi","6/11/20","76","14","28139","18.42"
"Tishomingo","1","43","Mississippi","6/11/20","36","7","28141","19.44"
"Tunica","0","61","Mississippi","6/11/20","58","3","28143","5.17"
"Union","1","93","Mississippi","6/11/20","89","4","28145","4.49"
"Walthall","3","85","Mississippi","6/11/20","64","21","28147","32.81"
"Warren","5","232","Mississippi","6/11/20","196","36","28149","18.37"
"Washington","3","222","Mississippi","6/11/20","198","24","28151","12.12"
"Wayne","12","346","Mississippi","6/11/20","262","84","28153","32.06"
"Webster","2","99","Mississippi","6/11/20","84","15","28155","17.86"
"Wilkinson","0","85","Mississippi","6/11/20","85","0","28157","0"
"Winston","2","139","Mississippi","6/11/20","124","15","28159","12.1"
"Yalobusha","3","128","Mississippi","6/11/20","104","24","28161","23.08"
"Yazoo","5","329","Mississippi","6/11/20","296","33","28163","11.15"
"Adair","2","74","Missouri","6/11/20","62","12","29001","19.35"
"Andrew","0","34","Missouri","6/11/20","31","3","29003","9.68"
"Atchison","0","3","Missouri","6/11/20","3","0","29005","0"
"Audrain","3","120","Missouri","6/11/20","102","18","29007","17.65"
"Barry","0","9","Missouri","6/11/20","9","0","29009","0"
"Bates","0","12","Missouri","6/11/20","12","0","29013","0"
"Benton","0","13","Missouri","6/11/20","12","1","29015","8.33"
"Bollinger","0","8","Missouri","6/11/20","7","1","29017","14.29"
"Boone","5","204","Missouri","6/11/20","169","35","29019","20.71"
"Buchanan","5","768","Missouri","6/11/20","736","32","29021","4.35"
"Butler","1","51","Missouri","6/11/20","45","6","29023","13.33"
"Caldwell","0","8","Missouri","6/11/20","6","2","29025","33.33"
"Callaway","0","34","Missouri","6/11/20","32","2","29027","6.25"
"Camden","0","38","Missouri","6/11/20","38","0","29029","0"
"Cape Girardeau","3","98","Missouri","6/11/20","77","21","29031","27.27"
"Carroll","0","9","Missouri","6/11/20","9","0","29033","0"
"Carter","0","5","Missouri","6/11/20","5","0","29035","0"
"Cass","1","110","Missouri","6/11/20","100","10","29037","10"
"Cedar","0","9","Missouri","6/11/20","9","0","29039","0"
"Chariton","0","6","Missouri","6/11/20","6","0","29041","0"
"Christian","0","29","Missouri","6/11/20","29","0","29043","0"
"Clark","0","2","Missouri","6/11/20","1","1","29045","100"
"Clay","12","262","Missouri","6/11/20","181","81","29047","44.75"
"Clinton","0","20","Missouri","6/11/20","20","0","29049","0"
"Cole","0","61","Missouri","6/11/20","61","0","29051","0"
"Cooper","0","9","Missouri","6/11/20","9","0","29053","0"
"Crawford","0","9","Missouri","6/11/20","9","0","29055","0"
"Dallas","0","6","Missouri","6/11/20","4","2","29059","50"
"Daviess","0","7","Missouri","6/11/20","4","3","29061","75"
"DeKalb","0","7","Missouri","6/11/20","6","1","29063","16.67"
"Dunklin","1","54","Missouri","6/11/20","47","7","29069","14.89"
"Franklin","2","164","Missouri","6/11/20","149","15","29071","10.07"
"Gasconade","0","2","Missouri","6/11/20","2","0","29073","0"
"Gentry","2","54","Missouri","6/11/20","43","11","29075","25.58"
"Greene","2","184","Missouri","6/11/20","167","17","29077","10.18"
"Harrison","0","9","Missouri","6/11/20","9","0","29081","0"
"Henry","0","15","Missouri","6/11/20","12","3","29083","25"
"Holt","0","2","Missouri","6/11/20","2","0","29087","0"
"Howard","0","3","Missouri","6/11/20","3","0","29089","0"
"Howell","1","18","Missouri","6/11/20","10","8","29091","80"
"Iron","0","3","Missouri","6/11/20","3","0","29093","0"
"Jackson","15","782","Missouri","6/11/20","676","106","29095","15.68"
"Jasper","6","87","Missouri","6/11/20","44","43","29097","97.73"
"Jefferson","4","427","Missouri","6/11/20","396","31","29099","7.83"
"Johnson","0","79","Missouri","6/11/20","77","2","29101","2.6"
"Kansas City","31","1654","Missouri","6/11/20","1437","217","00000","15.1"
"Laclede","0","8","Missouri","6/11/20","7","1","29105","14.29"
"Lafayette","0","83","Missouri","6/11/20","80","3","29107","3.75"
"Lawrence","0","8","Missouri","6/11/20","8","0","29109","0"
"Lewis","0","7","Missouri","6/11/20","7","0","29111","0"
"Lincoln","0","121","Missouri","6/11/20","118","3","29113","2.54"
"Linn","0","11","Missouri","6/11/20","10","1","29115","10"
"Livingston","0","5","Missouri","6/11/20","3","2","29117","66.67"
"Macon","0","6","Missouri","6/11/20","6","0","29121","0"
"Madison","0","3","Missouri","6/11/20","3","0","29123","0"
"Maries","0","2","Missouri","6/11/20","2","0","29125","0"
"Marion","0","7","Missouri","6/11/20","5","2","29127","40"
"McDonald","3","46","Missouri","6/11/20","22","24","29119","109.09"
"Miller","0","5","Missouri","6/11/20","4","1","29131","25"
"Mississippi","1","68","Missouri","6/11/20","61","7","29133","11.48"
"Moniteau","0","49","Missouri","6/11/20","49","0","29135","0"
"Montgomery","0","13","Missouri","6/11/20","10","3","29139","30"
"Morgan","0","9","Missouri","6/11/20","9","0","29141","0"
"New Madrid","1","28","Missouri","6/11/20","21","7","29143","33.33"
"Newton","4","47","Missouri","6/11/20","21","26","29145","123.81"
"Nodaway","0","15","Missouri","6/11/20","14","1","29147","7.14"
"Oregon","0","3","Missouri","6/11/20","2","1","29149","50"
"Osage","0","6","Missouri","6/11/20","5","1","29151","20"
"Pemiscot","1","99","Missouri","6/11/20","90","9","29155","10"
"Perry","2","79","Missouri","6/11/20","65","14","29157","21.54"
"Pettis","1","84","Missouri","6/11/20","79","5","29159","6.33"
"Phelps","0","6","Missouri","6/11/20","5","1","29161","20"
"Pike","0","29","Missouri","6/11/20","27","2","29163","7.41"
"Platte","1","84","Missouri","6/11/20","74","10","29165","13.51"
"Polk","0","7","Missouri","6/11/20","4","3","29167","75"
"Pulaski","10","109","Missouri","6/11/20","39","70","29169","179.49"
"Ralls","0","5","Missouri","6/11/20","5","0","29173","0"
"Randolph","0","10","Missouri","6/11/20","10","0","29175","0"
"Ray","0","24","Missouri","6/11/20","23","1","29177","4.35"
"Reynolds","0","2","Missouri","6/11/20","2","0","29179","0"
"Ripley","0","11","Missouri","6/11/20","10","1","29181","10"
"Saline","0","283","Missouri","6/11/20","280","3","29195","1.07"
"Scotland","0","9","Missouri","6/11/20","8","1","29199","12.5"
"Scott","2","132","Missouri","6/11/20","117","15","29201","12.82"
"Shelby","0","1","Missouri","6/11/20","1","0","29205","0"
"St. Charles","8","879","Missouri","6/11/20","820","59","29183","7.2"
"St. Clair","0","3","Missouri","6/11/20","3","0","29185","0"
"St. Francois","0","41","Missouri","6/11/20","38","3","29187","7.89"
"St. Louis","33","5460","Missouri","6/11/20","5229","231","29189","4.42"
"St. Louis City","18","2162","Missouri","6/11/20","2034","128","29510","6.29"
"Ste. Genevieve","0","13","Missouri","6/11/20","12","1","29186","8.33"
"Stoddard","1","109","Missouri","6/11/20","99","10","29207","10.1"
"Stone","0","10","Missouri","6/11/20","10","0","29209","0"
"Sullivan","1","71","Missouri","6/11/20","63","8","29211","12.7"
"Taney","0","15","Missouri","6/11/20","14","1","29213","7.14"
"Texas","0","1","Missouri","6/11/20","1","0","29215","0"
"Vernon","0","12","Missouri","6/11/20","10","2","29217","20"
"Warren","0","31","Missouri","6/11/20","28","3","29219","10.71"
"Washington","0","13","Missouri","6/11/20","12","1","29221","8.33"
"Webster","0","18","Missouri","6/11/20","18","0","29225","0"
"Worth","0","4","Missouri","6/11/20","4","0","29227","0"
"Wright","0","14","Missouri","6/11/20","11","3","29229","27.27"
"Beaverhead","0","1","Montana","6/11/20","1","0","30001","0"
"Big Horn","1","42","Montana","6/11/20","36","6","30003","16.67"
"Broadwater","0","4","Montana","6/11/20","4","0","30007","0"
"Carbon","0","6","Montana","6/11/20","6","0","30009","0"
"Cascade","0","17","Montana","6/11/20","17","0","30013","0"
"Deer Lodge","0","3","Montana","6/11/20","3","0","30023","0"
"Flathead","0","37","Montana","6/11/20","37","0","30029","0"
"Gallatin","2","176","Montana","6/11/20","163","13","30031","7.98"
"Glacier","0","6","Montana","6/11/20","6","0","30035","0"
"Golden Valley","0","3","Montana","6/11/20","3","0","30037","0"
"Hill","0","1","Montana","6/11/20","1","0","30041","0"
"Jefferson","0","3","Montana","6/11/20","3","0","30043","0"
"Lake","0","5","Montana","6/11/20","5","0","30047","0"
"Lewis and Clark","0","18","Montana","6/11/20","16","2","30049","12.5"
"Liberty","0","1","Montana","6/11/20","1","0","30051","0"
"Lincoln","0","7","Montana","6/11/20","7","0","30053","0"
"Madison","0","8","Montana","6/11/20","8","0","30057","0"
"Meagher","0","1","Montana","6/11/20","1","0","30059","0"
"Missoula","0","39","Montana","6/11/20","40","-1","30063","-2.5"
"Musselshell","0","1","Montana","6/11/20","1","0","30065","0"
"Park","0","8","Montana","6/11/20","8","0","30067","0"
"Pondera","0","2","Montana","6/11/20","2","0","30073","0"
"Ravalli","0","14","Montana","6/11/20","14","0","30081","0"
"Richland","0","3","Montana","6/11/20","3","0","30083","0"
"Roosevelt","0","7","Montana","6/11/20","7","0","30085","0"
"Rosebud","0","1","Montana","6/11/20","1","0","30087","0"
"Silver Bow","0","11","Montana","6/11/20","11","0","30093","0"
"Stillwater","0","2","Montana","6/11/20","1","1","30095","100"
"Toole","0","29","Montana","6/11/20","29","0","30101","0"
"Wheatland","0","1","Montana","6/11/20","1","0","30107","0"
"Yellowstone","0","106","Montana","6/11/20","103","3","30111","2.91"
"Adams","0","277","Nebraska","6/11/20","275","2","31001","0.73"
"Antelope","0","8","Nebraska","6/11/20","8","0","31003","0"
"Banner","0","1","Nebraska","6/11/20","0","1","31007","1"
"Boone","0","7","Nebraska","6/11/20","7","0","31011","0"
"Box Butte","0","3","Nebraska","6/11/20","2","1","31013","50"
"Boyd","0","1","Nebraska","6/11/20","1","0","31015","0"
"Buffalo","1","177","Nebraska","6/11/20","171","6","31019","3.51"
"Burt","0","9","Nebraska","6/11/20","9","0","31021","0"
"Butler","0","50","Nebraska","6/11/20","50","0","31023","0"
"Cass","1","59","Nebraska","6/11/20","53","6","31025","11.32"
"Cedar","0","8","Nebraska","6/11/20","8","0","31027","0"
"Chase","0","1","Nebraska","6/11/20","1","0","31029","0"
"Cherry","0","1","Nebraska","6/11/20","1","0","31031","0"
"Cheyenne","0","10","Nebraska","6/11/20","9","1","31033","11.11"
"Clay","0","24","Nebraska","6/11/20","24","0","31035","0"
"Colfax","2","643","Nebraska","6/11/20","626","17","31037","2.72"
"Cuming","0","34","Nebraska","6/11/20","34","0","31039","0"
"Custer","0","34","Nebraska","6/11/20","33","1","31041","3.03"
"Dakota","4","1719","Nebraska","6/11/20","1692","27","31043","1.6"
"Dawes","0","1","Nebraska","6/11/20","1","0","31045","0"
"Dawson","0","844","Nebraska","6/11/20","841","3","31047","0.36"
"Dixon","1","35","Nebraska","6/11/20","29","6","31051","20.69"
"Dodge","11","611","Nebraska","6/11/20","531","80","31053","15.07"
"Douglas","91","5403","Nebraska","6/11/20","4769","634","31055","13.29"
"Fillmore","0","9","Nebraska","6/11/20","7","2","31059","28.57"
"Franklin","0","6","Nebraska","6/11/20","6","0","31061","0"
"Frontier","0","1","Nebraska","6/11/20","1","0","31063","0"
"Furnas","0","9","Nebraska","6/11/20","9","0","31065","0"
"Gage","0","45","Nebraska","6/11/20","45","0","31067","0"
"Garden","0","4","Nebraska","6/11/20","4","0","31069","0"
"Garfield","0","1","Nebraska","6/11/20","0","1","31071","1"
"Gosper","0","13","Nebraska","6/11/20","13","0","31073","0"
"Greeley","0","3","Nebraska","6/11/20","2","1","31077","50"
"Hall","4","1559","Nebraska","6/11/20","1532","27","31079","1.76"
"Hamilton","0","56","Nebraska","6/11/20","55","1","31081","1.82"
"Hitchcock","0","1","Nebraska","6/11/20","1","0","31087","0"
"Holt","0","1","Nebraska","6/11/20","1","0","31089","0"
"Howard","0","44","Nebraska","6/11/20","42","2","31093","4.76"
"Jefferson","0","9","Nebraska","6/11/20","7","2","31095","28.57"
"Johnson","0","6","Nebraska","6/11/20","6","0","31097","0"
"Kearney","0","12","Nebraska","6/11/20","12","0","31099","0"
"Keith","0","2","Nebraska","6/11/20","2","0","31101","0"
"Kimball","0","8","Nebraska","6/11/20","8","0","31105","0"
"Knox","0","11","Nebraska","6/11/20","10","1","31107","10"
"Lancaster","21","1428","Nebraska","6/11/20","1278","150","31109","11.74"
"Lincoln","1","52","Nebraska","6/11/20","47","5","31111","10.64"
"Madison","2","331","Nebraska","6/11/20","320","11","31119","3.44"
"Merrick","1","37","Nebraska","6/11/20","33","4","31121","12.12"
"Morrill","0","11","Nebraska","6/11/20","11","0","31123","0"
"Nance","0","4","Nebraska","6/11/20","4","0","31125","0"
"Nemaha","0","4","Nebraska","6/11/20","4","0","31127","0"
"Nuckolls","0","1","Nebraska","6/11/20","1","0","31129","0"
"Otoe","1","11","Nebraska","6/11/20","7","4","31131","57.14"
"Phelps","0","20","Nebraska","6/11/20","20","0","31137","0"
"Pierce","0","6","Nebraska","6/11/20","6","0","31139","0"
"Platte","3","639","Nebraska","6/11/20","617","22","31141","3.57"
"Polk","0","12","Nebraska","6/11/20","11","1","31143","9.09"
"Red Willow","0","5","Nebraska","6/11/20","5","0","31145","0"
"Richardson","0","1","Nebraska","6/11/20","1","0","31147","0"
"Saline","1","518","Nebraska","6/11/20","510","8","31151","1.57"
"Sarpy","15","842","Nebraska","6/11/20","736","106","31153","14.4"
"Saunders","1","56","Nebraska","6/11/20","46","10","31155","21.74"
"Scotts Bluff","5","162","Nebraska","6/11/20","124","38","31157","30.65"
"Seward","0","30","Nebraska","6/11/20","29","1","31159","3.45"
"Sherman","0","4","Nebraska","6/11/20","4","0","31163","0"
"Sioux","0","1","Nebraska","6/11/20","0","1","31165","1"
"Stanton","0","21","Nebraska","6/11/20","21","0","31167","0"
"Thayer","0","1","Nebraska","6/11/20","1","0","31169","0"
"Thomas","0","1","Nebraska","6/11/20","1","0","31171","0"
"Thurston","2","63","Nebraska","6/11/20","50","13","31173","26"
"Valley","0","7","Nebraska","6/11/20","5","2","31175","40"
"Washington","1","38","Nebraska","6/11/20","33","5","31177","15.15"
"Wayne","1","26","Nebraska","6/11/20","18","8","31179","44.44"
"Webster","0","6","Nebraska","6/11/20","5","1","31181","20"
"York","0","37","Nebraska","6/11/20","36","1","31185","2.78"
"Carson City","2","115","Nevada","6/11/20","102","13","32510","12.75"
"Churchill","0","10","Nevada","6/11/20","8","2","32001","25"
"Clark","149","8100","Nevada","6/11/20","7056","1044","32003","14.8"
"Douglas","0","39","Nevada","6/11/20","37","2","32005","5.41"
"Elko","2","39","Nevada","6/11/20","26","13","32007","50"
"Humboldt","0","78","Nevada","6/11/20","78","0","32013","0"
"Lander","0","24","Nevada","6/11/20","21","3","32015","14.29"
"Lincoln","0","2","Nevada","6/11/20","2","0","32017","0"
"Lyon","1","89","Nevada","6/11/20","80","9","32019","11.25"
"Mineral","0","4","Nevada","6/11/20","4","0","32021","0"
"Nye","1","72","Nevada","6/11/20","64","8","32023","12.5"
"Pershing","0","4","Nevada","6/11/20","2","2","32027","100"
"Storey","0","1","Nevada","6/11/20","1","0","32029","0"
"Washoe","35","1893","Nevada","6/11/20","1645","248","32031","15.08"
"White Pine","0","3","Nevada","6/11/20","3","0","32033","0"
"Belknap","1","72","New Hampshire","6/11/20","64","8","33001","12.5"
"Carroll","0","49","New Hampshire","6/11/20","48","1","33003","2.08"
"Cheshire","0","60","New Hampshire","6/11/20","57","3","33005","5.26"
"Coos","0","6","New Hampshire","6/11/20","5","1","33007","20"
"Grafton","0","76","New Hampshire","6/11/20","76","0","33009","0"
"Hillsborough","34","2853","New Hampshire","6/11/20","2614","239","33011","9.14"
"Merrimack","4","386","New Hampshire","6/11/20","359","27","33013","7.52"
"Rockingham","8","1400","New Hampshire","6/11/20","1347","53","33015","3.93"
"Strafford","0","278","New Hampshire","6/11/20","278","0","33017","0"
"Sullivan","1","25","New Hampshire","6/11/20","20","5","33019","25"
"Atlantic","21","2431","New Jersey","6/11/20","2286","145","34001","6.34"
"Bergen","44","18719","New Jersey","6/11/20","18408","311","34003","1.69"
"Burlington","15","4832","New Jersey","6/11/20","4725","107","34005","2.26"
"Camden","39","6938","New Jersey","6/11/20","6663","275","34007","4.13"
"Cape May","5","663","New Jersey","6/11/20","630","33","34009","5.24"
"Cumberland","23","2627","New Jersey","6/11/20","2469","158","34011","6.4"
"Essex","46","18234","New Jersey","6/11/20","17912","322","34013","1.8"
"Gloucester","11","2367","New Jersey","6/11/20","2290","77","34015","3.36"
"Hudson","27","19066","New Jersey","6/11/20","18875","191","34017","1.01"
"Hunterdon","3","1032","New Jersey","6/11/20","1009","23","34019","2.28"
"Mercer","29","7275","New Jersey","6/11/20","7072","203","34021","2.87"
"Middlesex","36","16327","New Jersey","6/11/20","16072","255","34023","1.59"
"Monmouth","35","8627","New Jersey","6/11/20","8379","248","34025","2.96"
"Morris","8","6601","New Jersey","6/11/20","6548","53","34027","0.81"
"Ocean","38","9166","New Jersey","6/11/20","8900","266","34029","2.99"
"Passaic","35","16555","New Jersey","6/11/20","16311","244","34031","1.5"
"Salem","4","689","New Jersey","6/11/20","659","30","34033","4.55"
"Somerset","14","4721","New Jersey","6/11/20","4626","95","34035","2.05"
"Sussex","7","1179","New Jersey","6/11/20","1131","48","34037","4.24"
"Union","55","16337","New Jersey","6/11/20","15953","384","34039","2.41"
"Warren","2","1198","New Jersey","6/11/20","1186","12","34041","1.01"
"Bernalillo","16","1652","New Mexico","6/11/20","1543","109","35001","7.06"
"Catron","0","2","New Mexico","6/11/20","2","0","35003","0"
"Chaves","0","52","New Mexico","6/11/20","51","1","35005","1.96"
"Cibola","3","172","New Mexico","6/11/20","148","24","35006","16.22"
"Colfax","0","6","New Mexico","6/11/20","5","1","35007","20"
"Curry","2","68","New Mexico","6/11/20","57","11","35009","19.3"
"Dona Ana","18","632","New Mexico","6/11/20","509","123","35013","24.17"
"Eddy","3","45","New Mexico","6/11/20","26","19","35015","73.08"
"Grant","0","16","New Mexico","6/11/20","15","1","35017","6.67"
"Guadalupe","0","20","New Mexico","6/11/20","20","0","35019","0"
"Harding","0","1","New Mexico","6/11/20","1","0","35021","0"
"Hidalgo","0","1","New Mexico","6/11/20","1","0","35023","0"
"Lea","1","35","New Mexico","6/11/20","26","9","35025","34.62"
"Lincoln","0","5","New Mexico","6/11/20","5","0","35027","0"
"Los Alamos","0","6","New Mexico","6/11/20","6","0","35028","0"
"Luna","2","20","New Mexico","6/11/20","9","11","35029","122.22"
"McKinley","40","2822","New Mexico","6/11/20","2542","280","35031","11.01"
"Otero","1","28","New Mexico","6/11/20","23","5","35035","21.74"
"Quay","0","4","New Mexico","6/11/20","5","-1","35037","-20"
"Rio Arriba","1","60","New Mexico","6/11/20","52","8","35039","15.38"
"Roosevelt","1","51","New Mexico","6/11/20","42","9","35041","21.43"
"San Juan","29","2043","New Mexico","6/11/20","1842","201","35045","10.91"
"San Miguel","0","16","New Mexico","6/11/20","15","1","35047","6.67"
"Sandoval","4","607","New Mexico","6/11/20","578","29","35043","5.02"
"Santa Fe","2","161","New Mexico","6/11/20","150","11","35049","7.33"
"Sierra","0","3","New Mexico","6/11/20","1","2","35051","200"
"Socorro","0","55","New Mexico","6/11/20","54","1","35053","1.85"
"Taos","0","31","New Mexico","6/11/20","31","0","35055","0"
"Torrance","0","35","New Mexico","6/11/20","33","2","35057","6.06"
"Union","0","5","New Mexico","6/11/20","4","1","35059","25"
"Valencia","1","86","New Mexico","6/11/20","80","6","35061","7.5"
"Albany","9","1996","New York","6/11/20","1930","66","36001","3.42"
"Allegany","1","53","New York","6/11/20","49","4","36003","8.16"
"Broome","7","641","New York","6/11/20","593","48","36007","8.09"
"Cattaraugus","1","98","New York","6/11/20","91","7","36009","7.69"
"Cayuga","1","102","New York","6/11/20","96","6","36011","6.25"
"Chautauqua","2","106","New York","6/11/20","95","11","36013","11.58"
"Chemung","0","138","New York","6/11/20","137","1","36015","0.73"
"Chenango","1","137","New York","6/11/20","133","4","36017","3.01"
"Clinton","0","98","New York","6/11/20","97","1","36019","1.03"
"Columbia","3","424","New York","6/11/20","400","24","36021","6"
"Cortland","0","42","New York","6/11/20","41","1","36023","2.44"
"Delaware","1","88","New York","6/11/20","82","6","36025","7.32"
"Dutchess","9","4027","New York","6/11/20","3962","65","36027","1.64"
"Erie","50","6659","New York","6/11/20","6308","351","36029","5.56"
"Essex","0","40","New York","6/11/20","38","2","36031","5.26"
"Franklin","0","23","New York","6/11/20","23","0","36033","0"
"Fulton","2","230","New York","6/11/20","215","15","36035","6.98"
"Genesee","1","212","New York","6/11/20","205","7","36037","3.41"
"Greene","1","249","New York","6/11/20","241","8","36039","3.32"
"Hamilton","0","5","New York","6/11/20","5","0","36041","0"
"Herkimer","2","125","New York","6/11/20","113","12","36043","10.62"
"Jefferson","1","79","New York","6/11/20","74","5","36045","6.76"
"Lewis","0","20","New York","6/11/20","20","0","36049","0"
"Livingston","0","121","New York","6/11/20","120","1","36051","0.83"
"Madison","2","333","New York","6/11/20","319","14","36053","4.39"
"Monroe","30","3293","New York","6/11/20","3081","212","36055","6.88"
"Montgomery","1","101","New York","6/11/20","96","5","36057","5.21"
"Nassau","50","41060","New York","6/11/20","40713","347","36059","0.85"
"New York","444","208517","New York","6/11/20","205406","3111","36061","1.51"
"Niagara","7","1136","New York","6/11/20","1085","51","36063","4.7"
"Oneida","21","1216","New York","6/11/20","1069","147","36065","13.75"
"Onondaga","23","2454","New York","6/11/20","2295","159","36067","6.93"
"Ontario","2","229","New York","6/11/20","218","11","36069","5.05"
"Orange","11","10550","New York","6/11/20","10471","79","36071","0.75"
"Orleans","2","260","New York","6/11/20","247","13","36073","5.26"
"Oswego","1","119","New York","6/11/20","112","7","36075","6.25"
"Otsego","1","78","New York","6/11/20","73","5","36077","6.85"
"Putnam","2","1282","New York","6/11/20","1268","14","36079","1.1"
"Rensselaer","2","508","New York","6/11/20","495","13","36083","2.63"
"Rockland","15","13385","New York","6/11/20","13280","105","36087","0.79"
"Saratoga","3","513","New York","6/11/20","493","20","36091","4.06"
"Schenectady","2","717","New York","6/11/20","701","16","36093","2.28"
"Schoharie","0","54","New York","6/11/20","51","3","36095","5.88"
"Schuyler","0","12","New York","6/11/20","12","0","36097","0"
"Seneca","0","62","New York","6/11/20","60","2","36099","3.33"
"St. Lawrence","1","212","New York","6/11/20","207","5","36089","2.42"
"Steuben","1","254","New York","6/11/20","245","9","36101","3.67"
"Suffolk","51","40512","New York","6/11/20","40153","359","36103","0.89"
"Sullivan","3","1426","New York","6/11/20","1405","21","36105","1.49"
"Tioga","0","135","New York","6/11/20","133","2","36107","1.5"
"Tompkins","1","171","New York","6/11/20","165","6","36109","3.64"
"Ulster","4","1729","New York","6/11/20","1704","25","36111","1.47"
"Warren","0","257","New York","6/11/20","256","1","36113","0.39"
"Washington","0","241","New York","6/11/20","238","3","36115","1.26"
"Wayne","1","127","New York","6/11/20","121","6","36117","4.96"
"Westchester","48","34106","New York","6/11/20","33767","339","36119","1"
"Wyoming","1","91","New York","6/11/20","87","4","36121","4.6"
"Yates","0","39","New York","6/11/20","39","0","36123","0"
"Alamance","24","581","North Carolina","6/11/20","413","168","37001","40.68"
"Alexander","1","43","North Carolina","6/11/20","38","5","37003","13.16"
"Alleghany","1","30","North Carolina","6/11/20","24","6","37005","25"
"Anson","2","81","North Carolina","6/11/20","68","13","37007","19.12"
"Ashe","0","42","North Carolina","6/11/20","39","3","37009","7.69"
"Avery","1","6","North Carolina","6/11/20","2","4","37011","200"
"Beaufort","1","45","North Carolina","6/11/20","39","6","37013","15.38"
"Bertie","1","135","North Carolina","6/11/20","127","8","37015","6.3"
"Bladen","6","173","North Carolina","6/11/20","132","41","37017","31.06"
"Brunswick","10","183","North Carolina","6/11/20","115","68","37019","59.13"
"Buncombe","6","417","North Carolina","6/11/20","374","43","37021","11.5"
"Burke","30","710","North Carolina","6/11/20","497","213","37023","42.86"
"Cabarrus","19","662","North Carolina","6/11/20","530","132","37025","24.91"
"Caldwell","8","228","North Carolina","6/11/20","173","55","37027","31.79"
"Camden","0","3","North Carolina","6/11/20","3","0","37029","0"
"Carteret","1","43","North Carolina","6/11/20","39","4","37031","10.26"
"Caswell","1","101","North Carolina","6/11/20","94","7","37033","7.45"
"Catawba","12","341","North Carolina","6/11/20","258","83","37035","32.17"
"Chatham","12","759","North Carolina","6/11/20","677","82","37037","12.11"
"Cherokee","0","30","North Carolina","6/11/20","30","0","37039","0"
"Chowan","0","19","North Carolina","6/11/20","17","2","37041","11.76"
"Clay","0","8","North Carolina","6/11/20","8","0","37043","0"
"Cleveland","4","134","North Carolina","6/11/20","109","25","37045","22.94"
"Columbus","6","388","North Carolina","6/11/20","349","39","37047","11.17"
"Craven","4","243","North Carolina","6/11/20","216","27","37049","12.5"
"Cumberland","14","828","North Carolina","6/11/20","733","95","37051","12.96"
"Currituck","0","15","North Carolina","6/11/20","15","0","37053","0"
"Dare","0","25","North Carolina","6/11/20","22","3","37055","13.64"
"Davidson","11","556","North Carolina","6/11/20","477","79","37057","16.56"
"Davie","3","131","North Carolina","6/11/20","107","24","37059","22.43"
"Duplin","26","1096","North Carolina","6/11/20","915","181","37061","19.78"
"Durham","77","2370","North Carolina","6/11/20","1830","540","37063","29.51"
"Edgecombe","3","234","North Carolina","6/11/20","214","20","37065","9.35"
"Forsyth","58","1967","North Carolina","6/11/20","1560","407","37067","26.09"
"Franklin","5","202","North Carolina","6/11/20","169","33","37069","19.53"
"Gaston","15","406","North Carolina","6/11/20","301","105","37071","34.88"
"Gates","0","24","North Carolina","6/11/20","24","0","37073","0"
"Graham","1","6","North Carolina","6/11/20","2","4","37075","200"
"Granville","44","631","North Carolina","6/11/20","324","307","37077","94.75"
"Greene","3","107","North Carolina","6/11/20","84","23","37079","27.38"
"Guilford","58","1853","North Carolina","6/11/20","1445","408","37081","28.24"
"Halifax","5","231","North Carolina","6/11/20","197","34","37083","17.26"
"Harnett","8","363","North Carolina","6/11/20","309","54","37085","17.48"
"Haywood","1","63","North Carolina","6/11/20","55","8","37087","14.55"
"Henderson","6","399","North Carolina","6/11/20","354","45","37089","12.71"
"Hertford","1","140","North Carolina","6/11/20","132","8","37091","6.06"
"Hoke","5","291","North Carolina","6/11/20","259","32","37093","12.36"
"Hyde","0","2","North Carolina","6/11/20","1","1","37095","100"
"Iredell","13","378","North Carolina","6/11/20","289","89","37097","30.8"
"Jackson","2","55","North Carolina","6/11/20","38","17","37099","44.74"
"Johnston","26","699","North Carolina","6/11/20","519","180","37101","34.68"
"Jones","0","28","North Carolina","6/11/20","28","0","37103","0"
"Lee","10","561","North Carolina","6/11/20","490","71","37105","14.49"
"Lenoir","6","266","North Carolina","6/11/20","222","44","37107","19.82"
"Lincoln","4","113","North Carolina","6/11/20","87","26","37109","29.89"
"Macon","9","159","North Carolina","6/11/20","98","61","37113","62.24"
"Madison","0","4","North Carolina","6/11/20","4","0","37115","0"
"Martin","1","82","North Carolina","6/11/20","74","8","37117","10.81"
"McDowell","6","121","North Carolina","6/11/20","82","39","37111","47.56"
"Mecklenburg","188","6155","North Carolina","6/11/20","4842","1313","37119","27.12"
"Mitchell","0","17","North Carolina","6/11/20","16","1","37121","6.25"
"Montgomery","6","205","North Carolina","6/11/20","162","43","37123","26.54"
"Moore","7","288","North Carolina","6/11/20","241","47","37125","19.5"
"Nash","5","255","North Carolina","6/11/20","218","37","37127","16.97"
"New Hanover","11","304","North Carolina","6/11/20","225","79","37129","35.11"
"Northampton","1","170","North Carolina","6/11/20","165","5","37131","3.03"
"Onslow","4","145","North Carolina","6/11/20","117","28","37133","23.93"
"Orange","8","427","North Carolina","6/11/20","370","57","37135","15.41"
"Pamlico","1","14","North Carolina","6/11/20","10","4","37137","40"
"Pasquotank","1","125","North Carolina","6/11/20","115","10","37139","8.7"
"Pender","4","122","North Carolina","6/11/20","93","29","37141","31.18"
"Perquimans","0","28","North Carolina","6/11/20","25","3","37143","12"
"Person","2","70","North Carolina","6/11/20","55","15","37145","27.27"
"Pitt","15","432","North Carolina","6/11/20","326","106","37147","32.52"
"Polk","1","51","North Carolina","6/11/20","43","8","37149","18.6"
"Randolph","19","866","North Carolina","6/11/20","730","136","37151","18.63"
"Richmond","3","190","North Carolina","6/11/20","171","19","37153","11.11"
"Robeson","14","1001","North Carolina","6/11/20","905","96","37155","10.61"
"Rockingham","3","123","North Carolina","6/11/20","103","20","37157","19.42"
"Rowan","14","808","North Carolina","6/11/20","707","101","37159","14.29"
"Rutherford","2","200","North Carolina","6/11/20","188","12","37161","6.38"
"Sampson","16","642","North Carolina","6/11/20","531","111","37163","20.9"
"Scotland","2","102","North Carolina","6/11/20","89","13","37165","14.61"
"Stanly","5","130","North Carolina","6/11/20","96","34","37167","35.42"
"Stokes","2","90","North Carolina","6/11/20","79","11","37169","13.92"
"Surry","7","300","North Carolina","6/11/20","251","49","37171","19.52"
"Swain","2","33","North Carolina","6/11/20","21","12","37173","57.14"
"Transylvania","0","16","North Carolina","6/11/20","15","1","37175","6.67"
"Tyrrell","0","4","North Carolina","6/11/20","4","0","37177","0"
"Union","16","647","North Carolina","6/11/20","533","114","37179","21.39"
"Vance","7","390","North Carolina","6/11/20","344","46","37181","13.37"
"Wake","89","2601","North Carolina","6/11/20","1977","624","37183","31.56"
"Warren","7","118","North Carolina","6/11/20","72","46","37185","63.89"
"Washington","0","32","North Carolina","6/11/20","32","0","37187","0"
"Watauga","1","41","North Carolina","6/11/20","35","6","37189","17.14"
"Wayne","27","1403","North Carolina","6/11/20","1212","191","37191","15.76"
"Wilkes","2","516","North Carolina","6/11/20","502","14","37193","2.79"
"Wilson","9","464","North Carolina","6/11/20","403","61","37195","15.14"
"Yadkin","3","225","North Carolina","6/11/20","203","22","37197","10.84"
"Yancey","1","23","North Carolina","6/11/20","18","5","37199","27.78"
"Barnes","0","9","North Dakota","6/11/20","6","3","38003","50"
"Benson","0","3","North Dakota","6/11/20","1","2","38005","200"
"Bottineau","0","4","North Dakota","6/11/20","3","1","38009","33.33"
"Bowman","0","1","North Dakota","6/11/20","1","0","38011","0"
"Burke","0","5","North Dakota","6/11/20","5","0","38013","0"
"Burleigh","2","150","North Dakota","6/11/20","134","16","38015","11.94"
"Cass","26","1984","North Dakota","6/11/20","1803","181","38017","10.04"
"Dickey","0","2","North Dakota","6/11/20","1","1","38021","100"
"Divide","0","1","North Dakota","6/11/20","1","0","38023","0"
"Dunn","0","11","North Dakota","6/11/20","11","0","38025","0"
"Eddy","0","5","North Dakota","6/11/20","4","1","38027","25"
"Emmons","0","4","North Dakota","6/11/20","4","0","38029","0"
"Foster","0","1","North Dakota","6/11/20","1","0","38031","0"
"Grand Forks","0","339","North Dakota","6/11/20","336","3","38035","0.89"
"Grant","0","2","North Dakota","6/11/20","2","0","38037","0"
"Griggs","0","1","North Dakota","6/11/20","1","0","38039","0"
"Kidder","0","2","North Dakota","6/11/20","0","2","38043","1"
"LaMoure","1","6","North Dakota","6/11/20","0","6","38045","1"
"McHenry","0","2","North Dakota","6/11/20","2","0","38049","0"
"McIntosh","0","1","North Dakota","6/11/20","1","0","38051","0"
"McKenzie","1","21","North Dakota","6/11/20","17","4","38053","23.53"
"McLean","0","8","North Dakota","6/11/20","7","1","38055","14.29"
"Mercer","0","6","North Dakota","6/11/20","5","1","38057","20"
"Morton","0","61","North Dakota","6/11/20","60","1","38059","1.67"
"Mountrail","0","43","North Dakota","6/11/20","42","1","38061","2.38"
"Nelson","0","1","North Dakota","6/11/20","1","0","38063","0"
"Oliver","0","1","North Dakota","6/11/20","1","0","38065","0"
"Pembina","0","6","North Dakota","6/11/20","6","0","38067","0"
"Pierce","0","3","North Dakota","6/11/20","3","0","38069","0"
"Ramsey","0","8","North Dakota","6/11/20","8","0","38071","0"
"Ransom","0","12","North Dakota","6/11/20","11","1","38073","9.09"
"Renville","0","3","North Dakota","6/11/20","3","0","38075","0"
"Richland","1","32","North Dakota","6/11/20","23","9","38077","39.13"
"Rolette","0","7","North Dakota","6/11/20","6","1","38079","16.67"
"Sargent","0","4","North Dakota","6/11/20","4","0","38081","0"
"Sheridan","0","1","North Dakota","6/11/20","0","1","38083","1"
"Sioux","0","2","North Dakota","6/11/20","1","1","38085","100"
"Slope","0","3","North Dakota","6/11/20","3","0","38087","0"
"Stark","0","63","North Dakota","6/11/20","62","1","38089","1.61"
"Steele","0","1","North Dakota","6/11/20","1","0","38091","0"
"Stutsman","3","51","North Dakota","6/11/20","29","22","38093","75.86"
"Traill","0","15","North Dakota","6/11/20","14","1","38097","7.14"
"Walsh","0","16","North Dakota","6/11/20","15","1","38099","6.67"
"Ward","1","45","North Dakota","6/11/20","39","6","38101","15.38"
"Wells","1","8","North Dakota","6/11/20","3","5","38103","166.67"
"Williams","0","26","North Dakota","6/11/20","25","1","38105","4"
"","1","30","Northern Mariana Islands","6/11/20","26","4",,"15.38"
"Adams","0","12","Ohio","6/11/20","11","1","39001","9.09"
"Allen","2","233","Ohio","6/11/20","219","14","39003","6.39"
"Ashland","1","26","Ohio","6/11/20","21","5","39005","23.81"
"Ashtabula","5","382","Ohio","6/11/20","347","35","39007","10.09"
"Athens","1","23","Ohio","6/11/20","18","5","39009","27.78"
"Auglaize","1","82","Ohio","6/11/20","77","5","39011","6.49"
"Belmont","2","462","Ohio","6/11/20","447","15","39013","3.36"
"Brown","1","36","Ohio","6/11/20","30","6","39015","20"
"Butler","14","1048","Ohio","6/11/20","948","100","39017","10.55"
"Carroll","0","36","Ohio","6/11/20","34","2","39019","5.88"
"Champaign","1","34","Ohio","6/11/20","28","6","39021","21.43"
"Clark","12","394","Ohio","6/11/20","313","81","39023","25.88"
"Clermont","2","235","Ohio","6/11/20","218","17","39025","7.8"
"Clinton","1","50","Ohio","6/11/20","45","5","39027","11.11"
"Columbiana","3","911","Ohio","6/11/20","891","20","39029","2.24"
"Coshocton","1","49","Ohio","6/11/20","45","4","39031","8.89"
"Crawford","1","123","Ohio","6/11/20","118","5","39033","4.24"
"Cuyahoga","46","5057","Ohio","6/11/20","4732","325","39035","6.87"
"Darke","3","210","Ohio","6/11/20","189","21","39037","11.11"
"Defiance","1","40","Ohio","6/11/20","34","6","39039","17.65"
"Delaware","5","387","Ohio","6/11/20","355","32","39041","9.01"
"Erie","1","191","Ohio","6/11/20","185","6","39043","3.24"
"Fairfield","5","348","Ohio","6/11/20","314","34","39045","10.83"
"Fayette","0","44","Ohio","6/11/20","41","3","39047","7.32"
"Franklin","90","6844","Ohio","6/11/20","6216","628","39049","10.1"
"Fulton","1","52","Ohio","6/11/20","45","7","39051","15.56"
"Gallia","0","9","Ohio","6/11/20","8","1","39053","12.5"
"Geauga","4","331","Ohio","6/11/20","300","31","39055","10.33"
"Greene","3","129","Ohio","6/11/20","105","24","39057","22.86"
"Guernsey","1","44","Ohio","6/11/20","38","6","39059","15.79"
"Hamilton","35","3011","Ohio","6/11/20","2767","244","39061","8.82"
"Hancock","1","61","Ohio","6/11/20","53","8","39063","15.09"
"Hardin","2","87","Ohio","6/11/20","71","16","39065","22.54"
"Harrison","0","10","Ohio","6/11/20","10","0","39067","0"
"Henry","0","19","Ohio","6/11/20","17","2","39069","11.76"
"Highland","1","33","Ohio","6/11/20","26","7","39071","26.92"
"Hocking","0","73","Ohio","6/11/20","70","3","39073","4.29"
"Holmes","3","74","Ohio","6/11/20","54","20","39075","37.04"
"Huron","1","71","Ohio","6/11/20","61","10","39077","16.39"
"Jackson","0","16","Ohio","6/11/20","14","2","39079","14.29"
"Jefferson","0","69","Ohio","6/11/20","67","2","39081","2.99"
"Knox","1","30","Ohio","6/11/20","25","5","39083","20"
"Lake","3","338","Ohio","6/11/20","320","18","39085","5.62"
"Lawrence","0","32","Ohio","6/11/20","31","1","39087","3.23"
"Licking","3","287","Ohio","6/11/20","267","20","39089","7.49"
"Logan","1","47","Ohio","6/11/20","43","4","39091","9.3"
"Lorain","7","772","Ohio","6/11/20","722","50","39093","6.93"
"Lucas","12","2394","Ohio","6/11/20","2313","81","39095","3.5"
"Madison","1","167","Ohio","6/11/20","163","4","39097","2.45"
"Mahoning","14","1563","Ohio","6/11/20","1466","97","39099","6.62"
"Marion","2","2699","Ohio","6/11/20","2686","13","39101","0.48"
"Medina","3","394","Ohio","6/11/20","376","18","39103","4.79"
"Meigs","0","6","Ohio","6/11/20","6","0","39105","0"
"Mercer","3","242","Ohio","6/11/20","223","19","39107","8.52"
"Miami","2","380","Ohio","6/11/20","366","14","39109","3.83"
"Monroe","0","83","Ohio","6/11/20","80","3","39111","3.75"
"Montgomery","22","874","Ohio","6/11/20","720","154","39113","21.39"
"Morgan","0","6","Ohio","6/11/20","5","1","39115","20"
"Morrow","0","110","Ohio","6/11/20","108","2","39117","1.85"
"Muskingum","0","55","Ohio","6/11/20","54","1","39119","1.85"
"Noble","0","6","Ohio","6/11/20","6","0","39121","0"
"Ottawa","1","111","Ohio","6/11/20","104","7","39123","6.73"
"Paulding","0","14","Ohio","6/11/20","14","0","39125","0"
"Perry","0","22","Ohio","6/11/20","19","3","39127","15.79"
"Pickaway","4","2121","Ohio","6/11/20","2096","25","39129","1.19"
"Pike","0","10","Ohio","6/11/20","9","1","39131","11.11"
"Portage","2","348","Ohio","6/11/20","333","15","39133","4.5"
"Preble","0","40","Ohio","6/11/20","39","1","39135","2.56"
"Putnam","1","100","Ohio","6/11/20","95","5","39137","5.26"
"Richland","3","238","Ohio","6/11/20","216","22","39139","10.19"
"Ross","1","78","Ohio","6/11/20","73","5","39141","6.85"
"Sandusky","2","102","Ohio","6/11/20","85","17","39143","20"
"Scioto","0","19","Ohio","6/11/20","17","2","39145","11.76"
"Seneca","0","29","Ohio","6/11/20","26","3","39147","11.54"
"Shelby","0","49","Ohio","6/11/20","46","3","39149","6.52"
"Stark","9","845","Ohio","6/11/20","782","63","39151","8.06"
"Summit","17","1623","Ohio","6/11/20","1505","118","39153","7.84"
"Trumbull","4","625","Ohio","6/11/20","594","31","39155","5.22"
"Tuscarawas","4","392","Ohio","6/11/20","367","25","39157","6.81"
"Union","1","62","Ohio","6/11/20","55","7","39159","12.73"
"Van Wert","0","9","Ohio","6/11/20","7","2","39161","28.57"
"Vinton","0","21","Ohio","6/11/20","21","0","39163","0"
"Warren","11","473","Ohio","6/11/20","398","75","39165","18.84"
"Washington","0","117","Ohio","6/11/20","118","-1","39167","-0.85"
"Wayne","2","304","Ohio","6/11/20","293","11","39169","3.75"
"Williams","0","58","Ohio","6/11/20","56","2","39171","3.57"
"Wood","1","314","Ohio","6/11/20","304","10","39173","3.29"
"Wyandot","0","49","Ohio","6/11/20","48","1","39175","2.08"
"Adair","0","95","Oklahoma","6/11/20","93","2","40001","2.15"
"Alfalfa","0","1","Oklahoma","6/11/20","1","0","40003","0"
"Atoka","0","5","Oklahoma","6/11/20","4","1","40005","25"
"Beaver","1","29","Oklahoma","6/11/20","24","5","40007","20.83"
"Beckham","0","7","Oklahoma","6/11/20","7","0","40009","0"
"Blaine","0","9","Oklahoma","6/11/20","8","1","40011","12.5"
"Bryan","2","47","Oklahoma","6/11/20","33","14","40013","42.42"
"Caddo","1","173","Oklahoma","6/11/20","168","5","40015","2.98"
"Canadian","1","144","Oklahoma","6/11/20","137","7","40017","5.11"
"Carter","1","57","Oklahoma","6/11/20","51","6","40019","11.76"
"Cherokee","1","39","Oklahoma","6/11/20","31","8","40021","25.81"
"Choctaw","2","101","Oklahoma","6/11/20","90","11","40023","12.22"
"Cimarron","0","1","Oklahoma","6/11/20","1","0","40025","0"
"Cleveland","3","533","Oklahoma","6/11/20","514","19","40027","3.7"
"Coal","0","6","Oklahoma","6/11/20","3","3","40029","100"
"Comanche","3","317","Oklahoma","6/11/20","293","24","40031","8.19"
"Cotton","0","5","Oklahoma","6/11/20","5","0","40033","0"
"Craig","0","16","Oklahoma","6/11/20","15","1","40035","6.67"
"Creek","0","101","Oklahoma","6/11/20","98","3","40037","3.06"
"Custer","1","38","Oklahoma","6/11/20","31","7","40039","22.58"
"Delaware","1","104","Oklahoma","6/11/20","100","4","40041","4"
"Dewey","0","2","Oklahoma","6/11/20","3","-1","40043","-33.33"
"Garfield","0","31","Oklahoma","6/11/20","28","3","40047","10.71"
"Garvin","0","20","Oklahoma","6/11/20","18","2","40049","11.11"
"Grady","2","115","Oklahoma","6/11/20","104","11","40051","10.58"
"Grant","0","2","Oklahoma","6/11/20","2","0","40053","0"
"Greer","0","66","Oklahoma","6/11/20","66","0","40055","0"
"Harper","0","1","Oklahoma","6/11/20","1","0","40059","0"
"Haskell","0","6","Oklahoma","6/11/20","6","0","40061","0"
"Hughes","0","3","Oklahoma","6/11/20","3","0","40063","0"
"Jackson","0","30","Oklahoma","6/11/20","27","3","40065","11.11"
"Jefferson","0","4","Oklahoma","6/11/20","4","0","40067","0"
"Johnston","0","4","Oklahoma","6/11/20","3","1","40069","33.33"
"Kay","1","64","Oklahoma","6/11/20","57","7","40071","12.28"
"Kingfisher","0","12","Oklahoma","6/11/20","12","0","40073","0"
"Kiowa","0","6","Oklahoma","6/11/20","6","0","40075","0"
"Latimer","0","5","Oklahoma","6/11/20","5","0","40077","0"
"Le Flore","0","17","Oklahoma","6/11/20","14","3","40079","21.43"
"Lincoln","0","22","Oklahoma","6/11/20","22","0","40081","0"
"Logan","0","22","Oklahoma","6/11/20","19","3","40083","15.79"
"Love","1","20","Oklahoma","6/11/20","16","4","40085","25"
"Major","0","6","Oklahoma","6/11/20","6","0","40093","0"
"Marshall","0","13","Oklahoma","6/11/20","10","3","40095","30"
"Mayes","2","46","Oklahoma","6/11/20","31","15","40097","48.39"
"McClain","1","112","Oklahoma","6/11/20","107","5","40087","4.67"
"McCurtain","6","122","Oklahoma","6/11/20","77","45","40089","58.44"
"McIntosh","0","14","Oklahoma","6/11/20","14","0","40091","0"
"Murray","0","6","Oklahoma","6/11/20","5","1","40099","20"
"Muskogee","1","69","Oklahoma","6/11/20","60","9","40101","15"
"Noble","0","7","Oklahoma","6/11/20","7","0","40103","0"
"Nowata","0","24","Oklahoma","6/11/20","23","1","40105","4.35"
"Okfuskee","0","6","Oklahoma","6/11/20","5","1","40107","20"
"Oklahoma","19","1461","Oklahoma","6/11/20","1328","133","40109","10.02"
"Okmulgee","1","29","Oklahoma","6/11/20","25","4","40111","16"
"Osage","0","104","Oklahoma","6/11/20","102","2","40113","1.96"
"Ottawa","0","36","Oklahoma","6/11/20","35","1","40115","2.86"
"Pawnee","0","35","Oklahoma","6/11/20","32","3","40117","9.38"
"Payne","2","60","Oklahoma","6/11/20","48","12","40119","25"
"Pittsburg","0","44","Oklahoma","6/11/20","41","3","40121","7.32"
"Pontotoc","1","20","Oklahoma","6/11/20","15","5","40123","33.33"
"Pottawatomie","0","66","Oklahoma","6/11/20","63","3","40125","4.76"
"Pushmataha","0","6","Oklahoma","6/11/20","5","1","40127","20"
"Rogers","1","92","Oklahoma","6/11/20","83","9","40131","10.84"
"Seminole","0","30","Oklahoma","6/11/20","30","0","40133","0"
"Sequoyah","0","19","Oklahoma","6/11/20","16","3","40135","18.75"
"Stephens","0","44","Oklahoma","6/11/20","41","3","40137","7.32"
"Texas","2","956","Oklahoma","6/11/20","944","12","40139","1.27"
"Tillman","0","23","Oklahoma","6/11/20","23","0","40141","0"
"Tulsa","38","1372","Oklahoma","6/11/20","1109","263","40143","23.72"
"Wagoner","2","164","Oklahoma","6/11/20","151","13","40145","8.61"
"Washington","1","344","Oklahoma","6/11/20","338","6","40147","1.78"
"Washita","0","2","Oklahoma","6/11/20","2","0","40149","0"
"Woods","0","5","Oklahoma","6/11/20","3","2","40151","66.67"
"Woodward","1","9","Oklahoma","6/11/20","5","4","40153","80"
"Baker","0","1","Oregon","6/11/20","1","0","41001","0"
"Benton","1","63","Oregon","6/11/20","57","6","41003","10.53"
"Clackamas","16","446","Oregon","6/11/20","333","113","41005","33.93"
"Clatsop","0","46","Oregon","6/11/20","45","1","41007","2.22"
"Columbia","0","17","Oregon","6/11/20","16","1","41009","6.25"
"Coos","0","32","Oregon","6/11/20","32","0","41011","0"
"Crook","0","8","Oregon","6/11/20","7","1","41013","14.29"
"Curry","0","7","Oregon","6/11/20","7","0","41015","0"
"Deschutes","0","135","Oregon","6/11/20","133","2","41017","1.5"
"Douglas","0","29","Oregon","6/11/20","28","1","41019","3.57"
"Grant","0","1","Oregon","6/11/20","1","0","41023","0"
"Harney","0","1","Oregon","6/11/20","1","0","41025","0"
"Hood River","6","68","Oregon","6/11/20","28","40","41027","142.86"
"Jackson","1","76","Oregon","6/11/20","69","7","41029","10.14"
"Jefferson","3","67","Oregon","6/11/20","46","21","41031","45.65"
"Josephine","0","23","Oregon","6/11/20","23","0","41033","0"
"Klamath","0","46","Oregon","6/11/20","44","2","41035","4.55"
"Lake","0","4","Oregon","6/11/20","2","2","41037","100"
"Lane","1","85","Oregon","6/11/20","80","5","41039","6.25"
"Lincoln","21","170","Oregon","6/11/20","23","147","41041","639.13"
"Linn","0","124","Oregon","6/11/20","121","3","41043","2.48"
"Malheur","0","33","Oregon","6/11/20","32","1","41045","3.12"
"Marion","13","1105","Oregon","6/11/20","1011","94","41047","9.3"
"Morrow","0","13","Oregon","6/11/20","12","1","41049","8.33"
"Multnomah","26","1404","Oregon","6/11/20","1224","180","41051","14.71"
"Polk","1","108","Oregon","6/11/20","100","8","41053","8"
"Sherman","0","1","Oregon","6/11/20","1","0","41055","0"
"Tillamook","0","6","Oregon","6/11/20","6","0","41057","0"
"Umatilla","4","152","Oregon","6/11/20","124","28","41059","22.58"
"Union","0","8","Oregon","6/11/20","6","2","41061","33.33"
"Wallowa","0","4","Oregon","6/11/20","2","2","41063","100"
"Wasco","1","35","Oregon","6/11/20","29","6","41065","20.69"
"Washington","10","828","Oregon","6/11/20","755","73","41067","9.67"
"Yamhill","2","91","Oregon","6/11/20","75","16","41071","21.33"
"Adams","2","279","Pennsylvania","6/11/20","263","16","42001","6.08"
"Allegheny","13","2055","Pennsylvania","6/11/20","1965","90","42003","4.58"
"Armstrong","0","65","Pennsylvania","6/11/20","64","1","42005","1.56"
"Beaver","2","610","Pennsylvania","6/11/20","599","11","42007","1.84"
"Bedford","1","46","Pennsylvania","6/11/20","42","4","42009","9.52"
"Berks","16","4262","Pennsylvania","6/11/20","4152","110","42011","2.65"
"Blair","0","53","Pennsylvania","6/11/20","52","1","42013","1.92"
"Bradford","0","46","Pennsylvania","6/11/20","46","0","42015","0"
"Bucks","30","5365","Pennsylvania","6/11/20","5158","207","42017","4.01"
"Butler","2","255","Pennsylvania","6/11/20","240","15","42019","6.25"
"Cambria","0","61","Pennsylvania","6/11/20","59","2","42021","3.39"
"Cameron","0","2","Pennsylvania","6/11/20","2","0","42023","0"
"Carbon","1","255","Pennsylvania","6/11/20","250","5","42025","2"
"Centre","1","158","Pennsylvania","6/11/20","154","4","42027","2.6"
"Chester","41","3189","Pennsylvania","6/11/20","2902","287","42029","9.89"
"Clarion","0","30","Pennsylvania","6/11/20","27","3","42031","11.11"
"Clearfield","1","49","Pennsylvania","6/11/20","42","7","42033","16.67"
"Clinton","0","61","Pennsylvania","6/11/20","60","1","42035","1.67"
"Columbia","2","369","Pennsylvania","6/11/20","352","17","42037","4.83"
"Crawford","0","32","Pennsylvania","6/11/20","30","2","42039","6.67"
"Cumberland","5","692","Pennsylvania","6/11/20","657","35","42041","5.33"
"Dauphin","22","1561","Pennsylvania","6/11/20","1404","157","42043","11.18"
"Delaware","31","6805","Pennsylvania","6/11/20","6587","218","42045","3.31"
"Elk","0","6","Pennsylvania","6/11/20","6","0","42047","0"
"Erie","14","427","Pennsylvania","6/11/20","327","100","42049","30.58"
"Fayette","0","96","Pennsylvania","6/11/20","95","1","42051","1.05"
"Forest","0","7","Pennsylvania","6/11/20","7","0","42053","0"
"Franklin","6","827","Pennsylvania","6/11/20","785","42","42055","5.35"
"Fulton","0","16","Pennsylvania","6/11/20","16","0","42057","0"
"Greene","0","30","Pennsylvania","6/11/20","27","3","42059","11.11"
"Huntingdon","0","237","Pennsylvania","6/11/20","234","3","42061","1.28"
"Indiana","0","92","Pennsylvania","6/11/20","91","1","42063","1.1"
"Jefferson","0","16","Pennsylvania","6/11/20","14","2","42065","14.29"
"Juniata","1","105","Pennsylvania","6/11/20","95","10","42067","10.53"
"Lackawanna","4","1595","Pennsylvania","6/11/20","1569","26","42069","1.66"
"Lancaster","47","3632","Pennsylvania","6/11/20","3301","331","42071","10.03"
"Lawrence","1","86","Pennsylvania","6/11/20","82","4","42073","4.88"
"Lebanon","16","1106","Pennsylvania","6/11/20","997","109","42075","10.93"
"Lehigh","13","3907","Pennsylvania","6/11/20","3817","90","42077","2.36"
"Luzerne","6","2813","Pennsylvania","6/11/20","2773","40","42079","1.44"
"Lycoming","0","168","Pennsylvania","6/11/20","166","2","42081","1.2"
"McKean","0","13","Pennsylvania","6/11/20","13","0","42083","0"
"Mercer","1","114","Pennsylvania","6/11/20","110","4","42085","3.64"
"Mifflin","0","59","Pennsylvania","6/11/20","59","0","42087","0"
"Monroe","2","1346","Pennsylvania","6/11/20","1333","13","42089","0.98"
"Montgomery","58","7754","Pennsylvania","6/11/20","7351","403","42091","5.48"
"Montour","0","55","Pennsylvania","6/11/20","53","2","42093","3.77"
"Northampton","11","3202","Pennsylvania","6/11/20","3124","78","42095","2.5"
"Northumberland","2","213","Pennsylvania","6/11/20","201","12","42097","5.97"
"Perry","1","69","Pennsylvania","6/11/20","64","5","42099","7.81"
"Philadelphia","118","24107","Pennsylvania","6/11/20","23281","826","42101","3.55"
"Pike","1","482","Pennsylvania","6/11/20","478","4","42103","0.84"
"Potter","1","12","Pennsylvania","6/11/20","6","6","42105","100"
"Schuylkill","2","668","Pennsylvania","6/11/20","651","17","42107","2.61"
"Snyder","1","59","Pennsylvania","6/11/20","51","8","42109","15.69"
"Somerset","0","39","Pennsylvania","6/11/20","38","1","42111","2.63"
"Sullivan","0","3","Pennsylvania","6/11/20","3","0","42113","0"
"Susquehanna","6","164","Pennsylvania","6/11/20","123","41","42115","33.33"
"Tioga","0","20","Pennsylvania","6/11/20","19","1","42117","5.26"
"Union","2","79","Pennsylvania","6/11/20","65","14","42119","21.54"
"Venango","1","16","Pennsylvania","6/11/20","10","6","42121","60"
"Warren","0","5","Pennsylvania","6/11/20","5","0","42123","0"
"Washington","2","151","Pennsylvania","6/11/20","140","11","42125","7.86"
"Wayne","1","125","Pennsylvania","6/11/20","121","4","42127","3.31"
"Westmoreland","3","474","Pennsylvania","6/11/20","455","19","42129","4.18"
"Wyoming","0","36","Pennsylvania","6/11/20","34","2","42131","5.88"
"York","11","1117","Pennsylvania","6/11/20","1038","79","42133","7.61"
"","121","5352","Puerto Rico","6/11/20","4508","844",,"18.72"
"Bristol","1","231","Rhode Island","6/11/20","224","7","44001","3.12"
"Kent","8","1105","Rhode Island","6/11/20","1052","53","44003","5.04"
"Newport","4","269","Rhode Island","6/11/20","244","25","44005","10.25"
"Providence","130","11959","Rhode Island","6/11/20","11052","907","44007","8.21"
"Washington","2","513","Rhode Island","6/11/20","499","14","44009","2.81"
"Abbeville","2","63","South Carolina","6/11/20","46","17","45001","36.96"
"Aiken","2","222","South Carolina","6/11/20","208","14","45003","6.73"
"Allendale","0","40","South Carolina","6/11/20","38","2","45005","5.26"
"Anderson","7","295","South Carolina","6/11/20","244","51","45007","20.9"
"Bamberg","2","39","South Carolina","6/11/20","23","16","45009","69.57"
"Barnwell","1","54","South Carolina","6/11/20","48","6","45011","12.5"
"Beaufort","16","507","South Carolina","6/11/20","398","109","45013","27.39"
"Berkeley","13","335","South Carolina","6/11/20","242","93","45015","38.43"
"Calhoun","1","24","South Carolina","6/11/20","15","9","45017","60"
"Charleston","38","910","South Carolina","6/11/20","646","264","45019","40.87"
"Cherokee","5","78","South Carolina","6/11/20","43","35","45021","81.4"
"Chester","4","113","South Carolina","6/11/20","87","26","45023","29.89"
"Chesterfield","10","272","South Carolina","6/11/20","203","69","45025","33.99"
"Clarendon","3","320","South Carolina","6/11/20","302","18","45027","5.96"
"Colleton","7","165","South Carolina","6/11/20","114","51","45029","44.74"
"Darlington","5","342","South Carolina","6/11/20","308","34","45031","11.04"
"Dillon","3","192","South Carolina","6/11/20","170","22","45033","12.94"
"Dorchester","8","223","South Carolina","6/11/20","165","58","45035","35.15"
"Edgefield","1","57","South Carolina","6/11/20","51","6","45037","11.76"
"Fairfield","6","224","South Carolina","6/11/20","181","43","45039","23.76"
"Florence","10","751","South Carolina","6/11/20","678","73","45041","10.77"
"Georgetown","6","117","South Carolina","6/11/20","78","39","45043","50"
"Greenville","106","2492","South Carolina","6/11/20","1751","741","45045","42.32"
"Greenwood","12","235","South Carolina","6/11/20","148","87","45047","58.78"
"Hampton","2","50","South Carolina","6/11/20","38","12","45049","31.58"
"Horry","54","849","South Carolina","6/11/20","472","377","45051","79.87"
"Jasper","1","52","South Carolina","6/11/20","43","9","45053","20.93"
"Kershaw","9","404","South Carolina","6/11/20","339","65","45055","19.17"
"Lancaster","9","232","South Carolina","6/11/20","166","66","45057","39.76"
"Laurens","6","109","South Carolina","6/11/20","69","40","45059","57.97"
"Lee","2","232","South Carolina","6/11/20","221","11","45061","4.98"
"Lexington","45","992","South Carolina","6/11/20","677","315","45063","46.53"
"Marion","2","86","South Carolina","6/11/20","72","14","45067","19.44"
"Marlboro","5","221","South Carolina","6/11/20","183","38","45069","20.77"
"McCormick","0","11","South Carolina","6/11/20","9","2","45065","22.22"
"Newberry","4","90","South Carolina","6/11/20","63","27","45071","42.86"
"Oconee","2","70","South Carolina","6/11/20","55","15","45073","27.27"
"Orangeburg","13","301","South Carolina","6/11/20","210","91","45075","43.33"
"Pickens","10","242","South Carolina","6/11/20","174","68","45077","39.08"
"Richland","66","2006","South Carolina","6/11/20","1542","464","45079","30.09"
"Saluda","1","156","South Carolina","6/11/20","148","8","45081","5.41"
"Spartanburg","28","843","South Carolina","6/11/20","645","198","45083","30.7"
"Sumter","23","556","South Carolina","6/11/20","396","160","45085","40.4"
"Union","0","42","South Carolina","6/11/20","40","2","45087","5"
"Williamsburg","4","270","South Carolina","6/11/20","245","25","45089","10.2"
"York","19","557","South Carolina","6/11/20","421","136","45091","32.3"
"Aurora","0","29","South Dakota","6/11/20","27","2","46003","7.41"
"Beadle","10","411","South Dakota","6/11/20","341","70","46005","20.53"
"Bon Homme","0","8","South Dakota","6/11/20","8","0","46009","0"
"Brookings","1","26","South Dakota","6/11/20","20","6","46011","30"
"Brown","2","305","South Dakota","6/11/20","290","15","46013","5.17"
"Brule","0","3","South Dakota","6/11/20","2","1","46015","50"
"Buffalo","1","31","South Dakota","6/11/20","21","10","46017","47.62"
"Charles Mix","0","21","South Dakota","6/11/20","18","3","46023","16.67"
"Clark","0","6","South Dakota","6/11/20","4","2","46025","50"
"Clay","5","50","South Dakota","6/11/20","18","32","46027","177.78"
"Codington","1","44","South Dakota","6/11/20","39","5","46029","12.82"
"Corson","1","8","South Dakota","6/11/20","4","4","46031","100"
"Custer","0","1","South Dakota","6/11/20","1","0","46033","0"
"Davison","1","30","South Dakota","6/11/20","20","10","46035","50"
"Day","0","13","South Dakota","6/11/20","14","-1","46037","-7.14"
"Deuel","0","1","South Dakota","6/11/20","1","0","46039","0"
"Dewey","0","2","South Dakota","6/11/20","0","2","46041","1"
"Douglas","0","4","South Dakota","6/11/20","3","1","46043","33.33"
"Edmunds","0","4","South Dakota","6/11/20","3","1","46045","33.33"
"Fall River","0","6","South Dakota","6/11/20","6","0","46047","0"
"Faulk","2","15","South Dakota","6/11/20","1","14","46049","1400"
"Grant","0","13","South Dakota","6/11/20","13","0","46051","0"
"Gregory","0","1","South Dakota","6/11/20","1","0","46053","0"
"Hamlin","1","9","South Dakota","6/11/20","5","4","46057","80"
"Hand","0","5","South Dakota","6/11/20","3","2","46059","66.67"
"Hanson","0","3","South Dakota","6/11/20","1","2","46061","200"
"Hughes","0","21","South Dakota","6/11/20","19","2","46065","10.53"
"Hutchinson","0","8","South Dakota","6/11/20","6","2","46067","33.33"
"Hyde","0","3","South Dakota","6/11/20","1","2","46069","200"
"Jackson","0","4","South Dakota","6/11/20","4","0","46071","0"
"Jerauld","0","40","South Dakota","6/11/20","39","1","46073","2.56"
"Kingsbury","0","5","South Dakota","6/11/20","3","2","46077","66.67"
"Lake","0","13","South Dakota","6/11/20","12","1","46079","8.33"
"Lawrence","0","12","South Dakota","6/11/20","11","1","46081","9.09"
"Lincoln","2","259","South Dakota","6/11/20","243","16","46083","6.58"
"Lyman","2","32","South Dakota","6/11/20","16","16","46085","100"
"Marshall","0","4","South Dakota","6/11/20","4","0","46091","0"
"McCook","0","7","South Dakota","6/11/20","6","1","46087","16.67"
"McPherson","0","3","South Dakota","6/11/20","1","2","46089","200"
"Meade","1","28","South Dakota","6/11/20","24","4","46093","16.67"
"Miner","0","3","South Dakota","6/11/20","2","1","46097","50"
"Minnehaha","8","3444","South Dakota","6/11/20","3385","59","46099","1.74"
"Moody","0","19","South Dakota","6/11/20","19","0","46101","0"
"Oglala Lakota","2","45","South Dakota","6/11/20","34","11","46102","32.35"
"Pennington","11","351","South Dakota","6/11/20","275","76","46103","27.64"
"Roberts","0","39","South Dakota","6/11/20","37","2","46109","5.41"
"Sanborn","0","13","South Dakota","6/11/20","13","0","46111","0"
"Spink","0","5","South Dakota","6/11/20","5","0","46115","0"
"Stanley","0","11","South Dakota","6/11/20","10","1","46117","10"
"Sully","0","1","South Dakota","6/11/20","1","0","46119","0"
"Todd","2","45","South Dakota","6/11/20","31","14","46121","45.16"
"Tripp","0","6","South Dakota","6/11/20","6","0","46123","0"
"Turner","0","25","South Dakota","6/11/20","25","0","46125","0"
"Union","2","105","South Dakota","6/11/20","93","12","46127","12.9"
"Walworth","0","5","South Dakota","6/11/20","5","0","46129","0"
"Yankton","1","58","South Dakota","6/11/20","51","7","46135","13.73"
"Ziebach","0","2","South Dakota","6/11/20","2","0","46137","0"
"Anderson","2","55","Tennessee","6/11/20","42","13","47001","30.95"
"Bedford","11","372","Tennessee","6/11/20","297","75","47003","25.25"
"Benton","0","8","Tennessee","6/11/20","7","1","47005","14.29"
"Bledsoe","1","614","Tennessee","6/11/20","610","4","47007","0.66"
"Blount","1","97","Tennessee","6/11/20","93","4","47009","4.3"
"Bradley","11","241","Tennessee","6/11/20","166","75","47011","45.18"
"Campbell","0","18","Tennessee","6/11/20","18","0","47013","0"
"Cannon","0","34","Tennessee","6/11/20","32","2","47015","6.25"
"Carroll","0","29","Tennessee","6/11/20","28","1","47017","3.57"
"Carter","0","19","Tennessee","6/11/20","19","0","47019","0"
"Cheatham","2","151","Tennessee","6/11/20","135","16","47021","11.85"
"Chester","0","12","Tennessee","6/11/20","12","0","47023","0"
"Claiborne","0","15","Tennessee","6/11/20","12","3","47025","25"
"Clay","0","9","Tennessee","6/11/20","8","1","47027","12.5"
"Cocke","0","23","Tennessee","6/11/20","21","2","47029","9.52"
"Coffee","1","88","Tennessee","6/11/20","78","10","47031","12.82"
"Crockett","0","16","Tennessee","6/11/20","16","0","47033","0"
"Cumberland","1","129","Tennessee","6/11/20","120","9","47035","7.5"
"Davidson","111","6290","Tennessee","6/11/20","5516","774","47037","14.03"
"Decatur","1","14","Tennessee","6/11/20","5","9","47039","180"
"DeKalb","0","41","Tennessee","6/11/20","38","3","47041","7.89"
"Dickson","1","129","Tennessee","6/11/20","120","9","47043","7.5"
"Dyer","2","73","Tennessee","6/11/20","57","16","47045","28.07"
"Fayette","4","163","Tennessee","6/11/20","136","27","47047","19.85"
"Fentress","0","13","Tennessee","6/11/20","12","1","47049","8.33"
"Franklin","0","55","Tennessee","6/11/20","54","1","47051","1.85"
"Gibson","0","64","Tennessee","6/11/20","63","1","47053","1.59"
"Giles","1","19","Tennessee","6/11/20","13","6","47055","46.15"
"Grainger","0","16","Tennessee","6/11/20","13","3","47057","23.08"
"Greene","0","52","Tennessee","6/11/20","52","0","47059","0"
"Grundy","0","32","Tennessee","6/11/20","31","1","47061","3.23"
"Hamblen","3","65","Tennessee","6/11/20","42","23","47063","54.76"
"Hamilton","35","1210","Tennessee","6/11/20","964","246","47065","25.52"
"Hancock","0","1","Tennessee","6/11/20","1","0","47067","0"
"Hardeman","2","214","Tennessee","6/11/20","202","12","47069","5.94"
"Hardin","1","30","Tennessee","6/11/20","22","8","47071","36.36"
"Hawkins","0","34","Tennessee","6/11/20","34","0","47073","0"
"Haywood","0","35","Tennessee","6/11/20","33","2","47075","6.06"
"Henderson","0","17","Tennessee","6/11/20","15","2","47077","13.33"
"Henry","0","34","Tennessee","6/11/20","32","2","47079","6.25"
"Hickman","0","60","Tennessee","6/11/20","58","2","47081","3.45"
"Houston","0","9","Tennessee","6/11/20","8","1","47083","12.5"
"Humphreys","0","17","Tennessee","6/11/20","15","2","47085","13.33"
"Jackson","0","19","Tennessee","6/11/20","19","0","47087","0"
"Jefferson","1","36","Tennessee","6/11/20","29","7","47089","24.14"
"Johnson","1","24","Tennessee","6/11/20","19","5","47091","26.32"
"Knox","11","511","Tennessee","6/11/20","435","76","47093","17.47"
"Lake","-21","688","Tennessee","6/11/20","835","-147","47095","-17.6"
"Lauderdale","0","60","Tennessee","6/11/20","59","1","47097","1.69"
"Lawrence","3","52","Tennessee","6/11/20","33","19","47099","57.58"
"Lewis","0","5","Tennessee","6/11/20","3","2","47101","66.67"
"Lincoln","1","36","Tennessee","6/11/20","29","7","47103","24.14"
"Loudon","2","174","Tennessee","6/11/20","161","13","47105","8.07"
"Macon","4","191","Tennessee","6/11/20","166","25","47111","15.06"
"Madison","1","182","Tennessee","6/11/20","173","9","47113","5.2"
"Marion","0","47","Tennessee","6/11/20","44","3","47115","6.82"
"Marshall","1","39","Tennessee","6/11/20","33","6","47117","18.18"
"Maury","5","139","Tennessee","6/11/20","107","32","47119","29.91"
"McMinn","2","161","Tennessee","6/11/20","146","15","47107","10.27"
"McNairy","1","25","Tennessee","6/11/20","15","10","47109","66.67"
"Meigs","0","28","Tennessee","6/11/20","27","1","47121","3.7"
"Monroe","1","75","Tennessee","6/11/20","71","4","47123","5.63"
"Montgomery","4","312","Tennessee","6/11/20","286","26","47125","9.09"
"Moore","0","5","Tennessee","6/11/20","5","0","47127","0"
"Morgan","0","18","Tennessee","6/11/20","17","1","47129","5.88"
"Obion","1","53","Tennessee","6/11/20","45","8","47131","17.78"
"Out of TN","4","457","Tennessee","6/11/20","426","31","80047","7.28"
"Overton","1","36","Tennessee","6/11/20","32","4","47133","12.5"
"Perry","0","24","Tennessee","6/11/20","24","0","47135","0"
"Pickett","0","4","Tennessee","6/11/20","3","1","47137","33.33"
"Polk","1","24","Tennessee","6/11/20","19","5","47139","26.32"
"Putnam","7","572","Tennessee","6/11/20","524","48","47141","9.16"
"Rhea","0","220","Tennessee","6/11/20","217","3","47143","1.38"
"Roane","1","23","Tennessee","6/11/20","16","7","47145","43.75"
"Robertson","10","594","Tennessee","6/11/20","523","71","47147","13.58"
"Rutherford","40","1620","Tennessee","6/11/20","1343","277","47149","20.63"
"Scott","0","14","Tennessee","6/11/20","12","2","47151","16.67"
"Sequatchie","0","21","Tennessee","6/11/20","20","1","47153","5"
"Sevier","12","184","Tennessee","6/11/20","97","87","47155","89.69"
"Shelby","117","6365","Tennessee","6/11/20","5546","819","47157","14.77"
"Smith","0","37","Tennessee","6/11/20","36","1","47159","2.78"
"Stewart","0","14","Tennessee","6/11/20","13","1","47161","7.69"
"Sullivan","1","67","Tennessee","6/11/20","60","7","47163","11.67"
"Sumner","16","1049","Tennessee","6/11/20","938","111","47165","11.83"
"Tipton","4","491","Tennessee","6/11/20","461","30","47167","6.51"
"Trousdale","1","1399","Tennessee","6/11/20","1394","5","47169","0.36"
"Unicoi","1","52","Tennessee","6/11/20","48","4","47171","8.33"
"Union","0","6","Tennessee","6/11/20","4","2","47173","50"
"Van Buren","0","4","Tennessee","6/11/20","4","0","47175","0"
"Warren","1","32","Tennessee","6/11/20","26","6","47177","23.08"
"Washington","2","88","Tennessee","6/11/20","75","13","47179","17.33"
"Wayne","0","64","Tennessee","6/11/20","64","0","47181","0"
"Weakley","0","27","Tennessee","6/11/20","26","1","47183","3.85"
"White","2","44","Tennessee","6/11/20","33","11","47185","33.33"
"Williamson","10","662","Tennessee","6/11/20","589","73","47187","12.39"
"Wilson","7","501","Tennessee","6/11/20","449","52","47189","11.58"
"Anderson","1","95","Texas","6/11/20","85","10","48001","11.76"
"Andrews","0","27","Texas","6/11/20","27","0","48003","0"
"Angelina","7","281","Texas","6/11/20","232","49","48005","21.12"
"Aransas","0","5","Texas","6/11/20","5","0","48007","0"
"Archer","0","3","Texas","6/11/20","1","2","48009","200"
"Armstrong","0","3","Texas","6/11/20","3","0","48011","0"
"Atascosa","1","43","Texas","6/11/20","38","5","48013","13.16"
"Austin","1","31","Texas","6/11/20","27","4","48015","14.81"
"Bailey","1","29","Texas","6/11/20","19","10","48017","52.63"
"Bandera","0","6","Texas","6/11/20","6","0","48019","0"
"Bastrop","6","285","Texas","6/11/20","240","45","48021","18.75"
"Baylor","0","1","Texas","6/11/20","0","1","48023","1"
"Bee","2","27","Texas","6/11/20","11","16","48025","145.45"
"Bell","15","530","Texas","6/11/20","423","107","48027","25.3"
"Bexar","109","3648","Texas","6/11/20","2882","766","48029","26.58"
"Blanco","0","11","Texas","6/11/20","11","0","48031","0"
"Bosque","0","7","Texas","6/11/20","7","0","48035","0"
"Bowie","10","363","Texas","6/11/20","296","67","48037","22.64"
"Brazoria","-24","790","Texas","6/11/20","957","-167","48039","-17.45"
"Brazos","24","684","Texas","6/11/20","517","167","48041","32.3"
"Brewster","0","1","Texas","6/11/20","1","0","48043","0"
"Briscoe","0","1","Texas","6/11/20","1","0","48045","0"
"Brooks","0","1","Texas","6/11/20","1","0","48047","0"
"Brown","0","60","Texas","6/11/20","59","1","48049","1.69"
"Burleson","2","39","Texas","6/11/20","28","11","48051","39.29"
"Burnet","1","56","Texas","6/11/20","49","7","48053","14.29"
"Caldwell","2","85","Texas","6/11/20","73","12","48055","16.44"
"Calhoun","1","45","Texas","6/11/20","37","8","48057","21.62"
"Callahan","0","12","Texas","6/11/20","10","2","48059","20"
"Cameron","24","990","Texas","6/11/20","820","170","48061","20.73"
"Camp","2","98","Texas","6/11/20","85","13","48063","15.29"
"Carson","0","6","Texas","6/11/20","6","0","48065","0"
"Cass","0","33","Texas","6/11/20","30","3","48067","10"
"Castro","0","37","Texas","6/11/20","34","3","48069","8.82"
"Chambers","2","88","Texas","6/11/20","73","15","48071","20.55"
"Cherokee","1","54","Texas","6/11/20","49","5","48073","10.2"
"Childress","1","6","Texas","6/11/20","2","4","48075","200"
"Clay","0","5","Texas","6/11/20","5","0","48077","0"
"Cochran","0","1","Texas","6/11/20","1","0","48079","0"
"Coke","0","2","Texas","6/11/20","1","1","48081","100"
"Coleman","0","3","Texas","6/11/20","4","-1","48083","-25"
"Collin","24","1553","Texas","6/11/20","1388","165","48085","11.89"
"Collingsworth","0","5","Texas","6/11/20","5","0","48087","0"
"Colorado","1","28","Texas","6/11/20","24","4","48089","16.67"
"Comal","4","137","Texas","6/11/20","111","26","48091","23.42"
"Comanche","0","12","Texas","6/11/20","12","0","48093","0"
"Concho","0","1","Texas","6/11/20","1","0","48095","0"
"Cooke","1","23","Texas","6/11/20","19","4","48097","21.05"
"Coryell","1","296","Texas","6/11/20","289","7","48099","2.42"
"Cottle","0","4","Texas","6/11/20","4","0","48101","0"
"Crane","1","32","Texas","6/11/20","25","7","48103","28"
"Crockett","1","5","Texas","6/11/20","0","5","48105","1"
"Crosby","0","4","Texas","6/11/20","3","1","48107","33.33"
"Dallam","1","35","Texas","6/11/20","27","8","48111","29.63"
"Dallas","288","13257","Texas","6/11/20","11243","2014","48113","17.91"
"Dawson","0","45","Texas","6/11/20","45","0","48115","0"
"Deaf Smith","4","192","Texas","6/11/20","166","26","48117","15.66"
"Delta","0","2","Texas","6/11/20","2","0","48119","0"
"Denton","23","1599","Texas","6/11/20","1435","164","48121","11.43"
"DeWitt","1","25","Texas","6/11/20","17","8","48123","47.06"
"Dickens","0","1","Texas","6/11/20","1","0","48125","0"
"Dimmit","0","1","Texas","6/11/20","1","0","48127","0"
"Donley","0","27","Texas","6/11/20","27","0","48129","0"
"Duval","0","5","Texas","6/11/20","5","0","48131","0"
"Eastland","0","7","Texas","6/11/20","7","0","48133","0"
"Ector","7","221","Texas","6/11/20","175","46","48135","26.29"
"El Paso","83","3650","Texas","6/11/20","3069","581","48141","18.93"
"Ellis","13","429","Texas","6/11/20","338","91","48139","26.92"
"Erath","2","30","Texas","6/11/20","17","13","48143","76.47"
"Falls","1","14","Texas","6/11/20","10","4","48145","40"
"Fannin","1","51","Texas","6/11/20","41","10","48147","24.39"
"Fayette","1","43","Texas","6/11/20","38","5","48149","13.16"
"Fisher","0","2","Texas","6/11/20","2","0","48151","0"
"Floyd","0","16","Texas","6/11/20","15","1","48153","6.67"
"Fort Bend","50","2299","Texas","6/11/20","1951","348","48157","17.84"
"Franklin","1","24","Texas","6/11/20","18","6","48159","33.33"
"Freestone","0","12","Texas","6/11/20","10","2","48161","20"
"Frio","2","54","Texas","6/11/20","37","17","48163","45.95"
"Gaines","0","9","Texas","6/11/20","7","2","48165","28.57"
"Galveston","30","1084","Texas","6/11/20","876","208","48167","23.74"
"Garza","0","6","Texas","6/11/20","6","0","48169","0"
"Gillespie","0","5","Texas","6/11/20","5","0","48171","0"
"Glasscock","0","1","Texas","6/11/20","1","0","48173","0"
"Goliad","0","7","Texas","6/11/20","7","0","48175","0"
"Gonzales","2","157","Texas","6/11/20","144","13","48177","9.03"
"Gray","1","107","Texas","6/11/20","101","6","48179","5.94"
"Grayson","7","403","Texas","6/11/20","355","48","48181","13.52"
"Gregg","4","274","Texas","6/11/20","249","25","48183","10.04"
"Grimes","4","252","Texas","6/11/20","226","26","48185","11.5"
"Guadalupe","2","154","Texas","6/11/20","142","12","48187","8.45"
"Hale","1","67","Texas","6/11/20","60","7","48189","11.67"
"Hall","0","2","Texas","6/11/20","2","0","48191","0"
"Hamilton","0","10","Texas","6/11/20","9","1","48193","11.11"
"Hansford","0","21","Texas","6/11/20","20","1","48195","5"
"Hardeman","0","4","Texas","6/11/20","2","2","48197","100"
"Hardin","0","144","Texas","6/11/20","142","2","48199","1.41"
"Harris","323","15864","Texas","6/11/20","13603","2261","48201","16.62"
"Harrison","1","261","Texas","6/11/20","255","6","48203","2.35"
"Hartley","0","12","Texas","6/11/20","12","0","48205","0"
"Haskell","0","3","Texas","6/11/20","3","0","48207","0"
"Hays","15","492","Texas","6/11/20","385","107","48209","27.79"
"Hemphill","0","1","Texas","6/11/20","1","0","48211","0"
"Henderson","1","74","Texas","6/11/20","65","9","48213","13.85"
"Hidalgo","30","842","Texas","6/11/20","634","208","48215","32.81"
"Hill","1","33","Texas","6/11/20","25","8","48217","32"
"Hockley","0","28","Texas","6/11/20","27","1","48219","3.7"
"Hood","1","31","Texas","6/11/20","27","4","48221","14.81"
"Hopkins","2","41","Texas","6/11/20","27","14","48223","51.85"
"Houston","1","153","Texas","6/11/20","145","8","48225","5.52"
"Howard","1","18","Texas","6/11/20","9","9","48227","100"
"Hudspeth","1","11","Texas","6/11/20","3","8","48229","266.67"
"Hunt","7","147","Texas","6/11/20","96","51","48231","53.12"
"Hutchinson","0","44","Texas","6/11/20","44","0","48233","0"
"Irion","0","1","Texas","6/11/20","1","0","48235","0"
"Jack","0","4","Texas","6/11/20","4","0","48237","0"
"Jackson","0","20","Texas","6/11/20","19","1","48239","5.26"
"Jasper","0","32","Texas","6/11/20","29","3","48241","10.34"
"Jefferson","86","1187","Texas","6/11/20","585","602","48245","102.91"
"Jim Hogg","0","4","Texas","6/11/20","4","0","48247","0"
"Jim Wells","0","15","Texas","6/11/20","12","3","48249","25"
"Johnson","6","220","Texas","6/11/20","178","42","48251","23.6"
"Jones","0","633","Texas","6/11/20","636","-3","48253","-0.47"
"Karnes","0","4","Texas","6/11/20","4","0","48255","0"
"Kaufman","11","316","Texas","6/11/20","240","76","48257","31.67"
"Kendall","1","35","Texas","6/11/20","31","4","48259","12.9"
"Kerr","0","20","Texas","6/11/20","20","0","48265","0"
"Kimble","0","1","Texas","6/11/20","1","0","48267","0"
"Kinney","0","1","Texas","6/11/20","1","0","48271","0"
"Kleberg","0","20","Texas","6/11/20","17","3","48273","17.65"
"Knox","0","1","Texas","6/11/20","1","0","48275","0"
"La Salle","0","4","Texas","6/11/20","4","0","48283","0"
"Lamar","1","160","Texas","6/11/20","152","8","48277","5.26"
"Lamb","0","18","Texas","6/11/20","16","2","48279","12.5"
"Lampasas","0","9","Texas","6/11/20","9","0","48281","0"
"Lavaca","1","21","Texas","6/11/20","17","4","48285","23.53"
"Lee","1","32","Texas","6/11/20","25","7","48287","28"
"Leon","0","11","Texas","6/11/20","10","1","48289","10"
"Liberty","3","115","Texas","6/11/20","97","18","48291","18.56"
"Limestone","1","36","Texas","6/11/20","30","6","48293","20"
"Lipscomb","0","7","Texas","6/11/20","4","3","48295","75"
"Live Oak","0","9","Texas","6/11/20","9","0","48297","0"
"Llano","0","4","Texas","6/11/20","3","1","48299","33.33"
"Lubbock","10","775","Texas","6/11/20","707","68","48303","9.62"
"Lynn","1","14","Texas","6/11/20","8","6","48305","75"
"Madison","1","19","Texas","6/11/20","9","10","48313","111.11"
"Marion","0","18","Texas","6/11/20","17","1","48315","5.88"
"Martin","0","3","Texas","6/11/20","3","0","48317","0"
"Mason","0","33","Texas","6/11/20","32","1","48319","3.12"
"Matagorda","1","77","Texas","6/11/20","70","7","48321","10"
"Maverick","3","153","Texas","6/11/20","129","24","48323","18.6"
"McCulloch","0","3","Texas","6/11/20","3","0","48307","0"
"McLennan","3","141","Texas","6/11/20","123","18","48309","14.63"
"Medina","20","218","Texas","6/11/20","76","142","48325","186.84"
"Midland","6","180","Texas","6/11/20","141","39","48329","27.66"
"Milam","1","38","Texas","6/11/20","29","9","48331","31.03"
"Mills","0","1","Texas","6/11/20","1","0","48333","0"
"Mitchell","0","2","Texas","6/11/20","1","1","48335","100"
"Montague","0","9","Texas","6/11/20","9","0","48337","0"
"Montgomery","21","1197","Texas","6/11/20","1053","144","48339","13.68"
"Moore","3","866","Texas","6/11/20","844","22","48341","2.61"
"Morris","0","28","Texas","6/11/20","27","1","48343","3.7"
"Motley","0","1","Texas","6/11/20","1","0","48345","0"
"Nacogdoches","3","317","Texas","6/11/20","298","19","48347","6.38"
"Navarro","2","74","Texas","6/11/20","61","13","48349","21.31"
"Newton","0","6","Texas","6/11/20","5","1","48351","20"
"Nolan","-1","3","Texas","6/11/20","8","-5","48353","-62.5"
"Nueces","4","310","Texas","6/11/20","285","25","48355","8.77"
"Ochiltree","0","52","Texas","6/11/20","51","1","48357","1.96"
"Oldham","0","4","Texas","6/11/20","4","0","48359","0"
"Orange","0","102","Texas","6/11/20","101","1","48361","0.99"
"Palo Pinto","0","14","Texas","6/11/20","13","1","48363","7.69"
"Panola","0","214","Texas","6/11/20","213","1","48365","0.47"
"Parker","3","105","Texas","6/11/20","81","24","48367","29.63"
"Parmer","4","100","Texas","6/11/20","71","29","48369","40.85"
"Pecos","1","107","Texas","6/11/20","103","4","48371","3.88"
"Polk","0","62","Texas","6/11/20","60","2","48373","3.33"
"Potter","41","2778","Texas","6/11/20","2488","290","48375","11.66"
"Presidio","0","2","Texas","6/11/20","1","1","48377","100"
"Rains","0","4","Texas","6/11/20","4","0","48379","0"
"Randall","5","747","Texas","6/11/20","715","32","48381","4.48"
"Reagan","0","2","Texas","6/11/20","2","0","48383","0"
"Real","0","1","Texas","6/11/20","0","1","48385","1"
"Red River","1","86","Texas","6/11/20","76","10","48387","13.16"
"Reeves","1","11","Texas","6/11/20","7","4","48389","57.14"
"Refugio","0","5","Texas","6/11/20","3","2","48391","66.67"
"Roberts","0","2","Texas","6/11/20","2","0","48393","0"
"Robertson","1","18","Texas","6/11/20","11","7","48395","63.64"
"Rockwall","8","230","Texas","6/11/20","176","54","48397","30.68"
"Runnels","0","2","Texas","6/11/20","2","0","48399","0"
"Rusk","1","68","Texas","6/11/20","59","9","48401","15.25"
"Sabine","0","15","Texas","6/11/20","15","0","48403","0"
"San Augustine","1","49","Texas","6/11/20","44","5","48405","11.36"
"San Jacinto","1","20","Texas","6/11/20","16","4","48407","25"
"San Patricio","1","41","Texas","6/11/20","36","5","48409","13.89"
"San Saba","0","1","Texas","6/11/20","1","0","48411","0"
"Scurry","-1","27","Texas","6/11/20","33","-6","48415","-18.18"
"Shackelford","0","1","Texas","6/11/20","1","0","48417","0"
"Shelby","2","224","Texas","6/11/20","213","11","48419","5.16"
"Sherman","0","28","Texas","6/11/20","27","1","48421","3.7"
"Smith","4","244","Texas","6/11/20","215","29","48423","13.49"
"Somervell","0","2","Texas","6/11/20","0","2","48425","1"
"Starr","4","72","Texas","6/11/20","42","30","48427","71.43"
"Stephens","0","4","Texas","6/11/20","4","0","48429","0"
"Swisher","0","19","Texas","6/11/20","18","1","48437","5.56"
"Tarrant","152","6824","Texas","6/11/20","5761","1063","48439","18.45"
"Taylor","1","249","Texas","6/11/20","242","7","48441","2.89"
"Terry","0","13","Texas","6/11/20","13","0","48445","0"
"Throckmorton","0","1","Texas","6/11/20","0","1","48447","1"
"Titus","19","645","Texas","6/11/20","511","134","48449","26.22"
"Tom Green","2","122","Texas","6/11/20","109","13","48451","11.93"
"Travis","87","4109","Texas","6/11/20","3501","608","48453","17.37"
"Trinity","0","22","Texas","6/11/20","20","2","48455","10"
"Tyler","0","16","Texas","6/11/20","14","2","48457","14.29"
"Upshur","1","35","Texas","6/11/20","28","7","48459","25"
"Uvalde","1","22","Texas","6/11/20","18","4","48463","22.22"
"Val Verde","2","32","Texas","6/11/20","21","11","48465","52.38"
"Van Zandt","1","44","Texas","6/11/20","35","9","48467","25.71"
"Victoria","2","184","Texas","6/11/20","167","17","48469","10.18"
"Walker","9","1866","Texas","6/11/20","1801","65","48471","3.61"
"Waller","3","86","Texas","6/11/20","64","22","48473","34.38"
"Ward","0","2","Texas","6/11/20","1","1","48475","100"
"Washington","1","214","Texas","6/11/20","206","8","48477","3.88"
"Webb","12","652","Texas","6/11/20","565","87","48479","15.4"
"Wharton","2","87","Texas","6/11/20","70","17","48481","24.29"
"Wheeler","0","15","Texas","6/11/20","15","0","48483","0"
"Wichita","1","92","Texas","6/11/20","85","7","48485","8.24"
"Wilbarger","0","7","Texas","6/11/20","7","0","48487","0"
"Willacy","4","48","Texas","6/11/20","21","27","48489","128.57"
"Williamson","18","787","Texas","6/11/20","660","127","48491","19.24"
"Wilson","1","46","Texas","6/11/20","41","5","48493","12.2"
"Winkler","0","3","Texas","6/11/20","3","0","48495","0"
"Wise","1","55","Texas","6/11/20","50","5","48497","10"
"Wood","2","51","Texas","6/11/20","40","11","48499","27.5"
"Yoakum","1","8","Texas","6/11/20","3","5","48501","166.67"
"Young","1","13","Texas","6/11/20","4","9","48503","225"
"Zapata","0","12","Texas","6/11/20","11","1","48505","9.09"
"Zavala","0","12","Texas","6/11/20","12","0","48507","0"
"Bear River","78","878","Utah","6/11/20","333","545","00000","163.66"
"Central Utah","2","54","Utah","6/11/20","39","15","00000","38.46"
"Davis","15","620","Utah","6/11/20","513","107","49011","20.86"
"Salt Lake","146","6776","Utah","6/11/20","5756","1020","49035","17.72"
"San Juan","4","343","Utah","6/11/20","312","31","49037","9.94"
"Southeast Utah","0","28","Utah","6/11/20","26","2","00000","7.69"
"Southwest Utah","28","718","Utah","6/11/20","524","194","00000","37.02"
"Summit","3","442","Utah","6/11/20","419","23","49043","5.49"
"Tooele","3","158","Utah","6/11/20","140","18","49045","12.86"
"TriCounty","1","27","Utah","6/11/20","20","7","00000","35"
"Utah","51","2444","Utah","6/11/20","2088","356","49049","17.05"
"Wasatch","4","341","Utah","6/11/20","313","28","49051","8.95"
"Weber-Morgan","13","423","Utah","6/11/20","330","93","00000","28.18"
"Addison","0","66","Vermont","6/11/20","64","2","50001","3.12"
"Bennington","0","67","Vermont","6/11/20","65","2","50003","3.08"
"Caledonia","0","16","Vermont","6/11/20","16","0","50005","0"
"Chittenden","10","559","Vermont","6/11/20","491","68","50007","13.85"
"Essex","0","3","Vermont","6/11/20","3","0","50009","0"
"Franklin","0","101","Vermont","6/11/20","99","2","50011","2.02"
"Grand Isle","0","8","Vermont","6/11/20","7","1","50013","14.29"
"Lamoille","0","29","Vermont","6/11/20","29","0","50015","0"
"Orange","0","9","Vermont","6/11/20","9","0","50017","0"
"Orleans","0","13","Vermont","6/11/20","10","3","50019","30"
"Rutland","0","57","Vermont","6/11/20","56","1","50021","1.79"
"Washington","0","39","Vermont","6/11/20","39","0","50023","0"
"Windham","0","83","Vermont","6/11/20","81","2","50025","2.47"
"Windsor","0","55","Vermont","6/11/20","52","3","50027","5.77"
"","0","72","Virgin Islands","6/11/20","71","1",,"1.41"
"Accomack","3","984","Virginia","6/11/20","966","18","51001","1.86"
"Albemarle","8","269","Virginia","6/11/20","213","56","51003","26.29"
"Alexandria","14","2127","Virginia","6/11/20","2031","96","51510","4.73"
"Alleghany","0","26","Virginia","6/11/20","24","2","51005","8.33"
"Amelia","1","34","Virginia","6/11/20","28","6","51007","21.43"
"Amherst","0","27","Virginia","6/11/20","27","0","51009","0"
"Appomattox","0","33","Virginia","6/11/20","31","2","51011","6.45"
"Arlington","21","2299","Virginia","6/11/20","2150","149","51013","6.93"
"Augusta","2","139","Virginia","6/11/20","122","17","51015","13.93"
"Bedford","3","82","Virginia","6/11/20","63","19","51019","30.16"
"Botetourt","1","44","Virginia","6/11/20","34","10","51023","29.41"
"Bristol","0","4","Virginia","6/11/20","4","0","51520","0"
"Brunswick","2","44","Virginia","6/11/20","31","13","51025","41.94"
"Buchanan","0","18","Virginia","6/11/20","18","0","51027","0"
"Buckingham","7","517","Virginia","6/11/20","469","48","51029","10.23"
"Buena Vista","0","12","Virginia","6/11/20","13","-1","51530","-7.69"
"Campbell","1","22","Virginia","6/11/20","18","4","51031","22.22"
"Caroline","3","100","Virginia","6/11/20","76","24","51033","31.58"
"Carroll","5","158","Virginia","6/11/20","122","36","51035","29.51"
"Charles City","0","28","Virginia","6/11/20","27","1","51036","3.7"
"Charlotte","0","29","Virginia","6/11/20","28","1","51037","3.57"
"Charlottesville","2","144","Virginia","6/11/20","131","13","51540","9.92"
"Chesapeake","10","622","Virginia","6/11/20","554","68","51550","12.27"
"Chesterfield","46","2041","Virginia","6/11/20","1721","320","51041","18.59"
"Clarke","1","36","Virginia","6/11/20","31","5","51043","16.13"
"Colonial Heights","1","106","Virginia","6/11/20","97","9","51570","9.28"
"Covington","0","4","Virginia","6/11/20","4","0","51580","0"
"Craig","0","6","Virginia","6/11/20","5","1","51045","20"
"Culpeper","6","774","Virginia","6/11/20","732","42","51047","5.74"
"Cumberland","1","46","Virginia","6/11/20","39","7","51049","17.95"
"Danville","0","61","Virginia","6/11/20","58","3","51590","5.17"
"Dinwiddie","2","101","Virginia","6/11/20","90","11","51053","12.22"
"Emporia","1","94","Virginia","6/11/20","89","5","51595","5.62"
"Essex","0","52","Virginia","6/11/20","52","0","51057","0"
"Fairfax","142","12812","Virginia","6/11/20","11815","997","51059","8.44"
"Fairfax City","0","68","Virginia","6/11/20","67","1","51600","1.49"
"Falls Church","0","56","Virginia","6/11/20","56","0","51610","0"
"Fauquier","6","374","Virginia","6/11/20","334","40","51061","11.98"
"Floyd","0","8","Virginia","6/11/20","6","2","51063","33.33"
"Fluvanna","1","98","Virginia","6/11/20","94","4","51065","4.26"
"Franklin","1","42","Virginia","6/11/20","37","5","51067","13.51"
"Franklin City","0","43","Virginia","6/11/20","42","1","51620","2.38"
"Frederick","5","416","Virginia","6/11/20","384","32","51069","8.33"
"Fredericksburg","3","197","Virginia","6/11/20","178","19","51630","10.67"
"Galax","4","165","Virginia","6/11/20","140","25","51640","17.86"
"Giles","0","5","Virginia","6/11/20","5","0","51071","0"
"Gloucester","0","34","Virginia","6/11/20","31","3","51073","9.68"
"Goochland","1","109","Virginia","6/11/20","103","6","51075","5.83"
"Grayson","2","63","Virginia","6/11/20","46","17","51077","36.96"
"Greene","2","45","Virginia","6/11/20","34","11","51079","32.35"
"Greensville","13","303","Virginia","6/11/20","213","90","51081","42.25"
"Halifax","0","32","Virginia","6/11/20","31","1","51083","3.23"
"Hampton","3","233","Virginia","6/11/20","214","19","51650","8.88"
"Hanover","3","357","Virginia","6/11/20","336","21","51085","6.25"
"Harrisonburg","5","846","Virginia","6/11/20","814","32","51660","3.93"
"Henrico","32","2170","Virginia","6/11/20","1946","224","51087","11.51"
"Henry","5","188","Virginia","6/11/20","152","36","51089","23.68"
"Highland","0","2","Virginia","6/11/20","3","-1","51091","-33.33"
"Hopewell","2","120","Virginia","6/11/20","103","17","51670","16.5"
"Isle of Wight","2","150","Virginia","6/11/20","133","17","51093","12.78"
"James City","2","225","Virginia","6/11/20","211","14","51095","6.64"
"King and Queen","0","24","Virginia","6/11/20","21","3","51097","14.29"
"King George","2","83","Virginia","6/11/20","72","11","51099","15.28"
"King William","0","32","Virginia","6/11/20","31","1","51101","3.23"
"Lancaster","0","11","Virginia","6/11/20","10","1","51103","10"
"Lee","0","9","Virginia","6/11/20","9","0","51105","0"
"Lexington","0","8","Virginia","6/11/20","7","1","51678","14.29"
"Loudoun","62","3229","Virginia","6/11/20","2794","435","51107","15.57"
"Louisa","2","95","Virginia","6/11/20","84","11","51109","13.1"
"Lunenburg","0","18","Virginia","6/11/20","16","2","51111","12.5"
"Lynchburg","1","89","Virginia","6/11/20","80","9","51680","11.25"
"Madison","0","41","Virginia","6/11/20","41","0","51113","0"
"Manassas","15","1271","Virginia","6/11/20","1166","105","51683","9.01"
"Manassas Park","3","361","Virginia","6/11/20","339","22","51685","6.49"
"Martinsville","2","53","Virginia","6/11/20","39","14","51690","35.9"
"Mathews","0","5","Virginia","6/11/20","5","0","51115","0"
"Mecklenburg","1","225","Virginia","6/11/20","219","6","51117","2.74"
"Middlesex","0","14","Virginia","6/11/20","15","-1","51119","-6.67"
"Montgomery","2","96","Virginia","6/11/20","82","14","51121","17.07"
"Nelson","0","18","Virginia","6/11/20","17","1","51125","5.88"
"New Kent","1","45","Virginia","6/11/20","39","6","51127","15.38"
"Newport News","5","337","Virginia","6/11/20","299","38","51700","12.71"
"Norfolk","10","619","Virginia","6/11/20","552","67","51710","12.14"
"Northampton","2","259","Virginia","6/11/20","247","12","51131","4.86"
"Northumberland","0","25","Virginia","6/11/20","25","0","51133","0"
"Norton","0","2","Virginia","6/11/20","2","0","51720","0"
"Nottoway","3","58","Virginia","6/11/20","40","18","51135","45"
"Orange","1","119","Virginia","6/11/20","115","4","51137","3.48"
"Page","3","249","Virginia","6/11/20","231","18","51139","7.79"
"Patrick","1","29","Virginia","6/11/20","22","7","51141","31.82"
"Petersburg","3","176","Virginia","6/11/20","152","24","51730","15.79"
"Pittsylvania","2","56","Virginia","6/11/20","45","11","51143","24.44"
"Poquoson","0","10","Virginia","6/11/20","8","2","51735","25"
"Portsmouth","6","364","Virginia","6/11/20","325","39","51740","12"
"Powhatan","2","48","Virginia","6/11/20","36","12","51145","33.33"
"Prince Edward","1","155","Virginia","6/11/20","146","9","51147","6.16"
"Prince George","2","158","Virginia","6/11/20","142","16","51149","11.27"
"Prince William","66","6396","Virginia","6/11/20","5932","464","51153","7.82"
"Pulaski","1","30","Virginia","6/11/20","21","9","51155","42.86"
"Radford","0","7","Virginia","6/11/20","6","1","51750","16.67"
"Rappahannock","0","16","Virginia","6/11/20","15","1","51157","6.67"
"Richmond","0","290","Virginia","6/11/20","287","3","51159","1.05"
"Richmond City","32","1709","Virginia","6/11/20","1488","221","51760","14.85"
"Roanoke","2","128","Virginia","6/11/20","113","15","51161","13.27"
"Roanoke City","7","222","Virginia","6/11/20","176","46","51770","26.14"
"Rockbridge","0","19","Virginia","6/11/20","18","1","51163","5.56"
"Rockingham","7","606","Virginia","6/11/20","555","51","51165","9.19"
"Russell","0","8","Virginia","6/11/20","8","0","51167","0"
"Salem","1","42","Virginia","6/11/20","36","6","51775","16.67"
"Scott","0","7","Virginia","6/11/20","7","0","51169","0"
"Shenandoah","4","499","Virginia","6/11/20","470","29","51171","6.17"
"Smyth","0","16","Virginia","6/11/20","15","1","51173","6.67"
"Southampton","1","155","Virginia","6/11/20","150","5","51175","3.33"
"Spotsylvania","19","729","Virginia","6/11/20","593","136","51177","22.93"
"Stafford","14","841","Virginia","6/11/20","742","99","51179","13.34"
"Staunton","0","55","Virginia","6/11/20","52","3","51790","5.77"
"Suffolk","2","333","Virginia","6/11/20","320","13","51800","4.06"
"Surry","0","11","Virginia","6/11/20","10","1","51181","10"
"Sussex","0","176","Virginia","6/11/20","173","3","51183","1.73"
"Tazewell","0","9","Virginia","6/11/20","9","0","51185","0"
"Virginia Beach","9","832","Virginia","6/11/20","770","62","51810","8.05"
"Warren","1","225","Virginia","6/11/20","217","8","51187","3.69"
"Washington","1","58","Virginia","6/11/20","53","5","51191","9.43"
"Waynesboro","1","53","Virginia","6/11/20","47","6","51820","12.77"
"Westmoreland","0","83","Virginia","6/11/20","80","3","51193","3.75"
"Williamsburg","1","49","Virginia","6/11/20","45","4","51830","8.89"
"Winchester","5","250","Virginia","6/11/20","215","35","51840","16.28"
"Wise","0","27","Virginia","6/11/20","27","0","51195","0"
"Wythe","2","42","Virginia","6/11/20","30","12","51197","40"
"York","2","89","Virginia","6/11/20","77","12","51199","15.58"
"Adams","2","89","Washington","6/11/20","77","12","53001","15.58"
"Asotin","0","19","Washington","6/11/20","19","0","53003","0"
"Benton","27","1041","Washington","6/11/20","852","189","53005","22.18"
"Chelan","2","268","Washington","6/11/20","255","13","53007","5.1"
"Clallam","0","28","Washington","6/11/20","27","1","53009","3.7"
"Clark","6","595","Washington","6/11/20","550","45","53011","8.18"
"Columbia","0","1","Washington","6/11/20","1","0","53013","0"
"Cowlitz","4","101","Washington","6/11/20","76","25","53015","32.89"
"Douglas","1","178","Washington","6/11/20","173","5","53017","2.89"
"Ferry","0","1","Washington","6/11/20","1","0","53019","0"
"Franklin","26","826","Washington","6/11/20","642","184","53021","28.66"
"Grant","3","235","Washington","6/11/20","212","23","53025","10.85"
"Grays Harbor","0","19","Washington","6/11/20","18","1","53027","5.56"
"Island","0","182","Washington","6/11/20","181","1","53029","0.55"
"Jefferson","0","31","Washington","6/11/20","31","0","53031","0"
"King","33","8550","Washington","6/11/20","8318","232","53033","2.79"
"Kitsap","1","170","Washington","6/11/20","163","7","53035","4.29"
"Kittitas","0","90","Washington","6/11/20","88","2","53037","2.27"
"Klickitat","2","42","Washington","6/11/20","29","13","53039","44.83"
"Lewis","0","37","Washington","6/11/20","37","0","53041","0"
"Lincoln","0","2","Washington","6/11/20","2","0","53043","0"
"Mason","0","39","Washington","6/11/20","36","3","53045","8.33"
"Okanogan","0","56","Washington","6/11/20","53","3","53047","5.66"
"Pacific","0","10","Washington","6/11/20","9","1","53049","11.11"
"Pend Oreille","0","3","Washington","6/11/20","3","0","53051","0"
"Pierce","12","2078","Washington","6/11/20","1991","87","53053","4.37"
"San Juan","0","14","Washington","6/11/20","15","-1","53055","-6.67"
"Skagit","1","452","Washington","6/11/20","446","6","53057","1.35"
"Skamania","0","3","Washington","6/11/20","3","0","53059","0"
"Snohomish","11","3075","Washington","6/11/20","2999","76","53061","2.53"
"Spokane","19","778","Washington","6/11/20","648","130","53063","20.06"
"Stevens","0","15","Washington","6/11/20","13","2","53065","15.38"
"Thurston","3","172","Washington","6/11/20","154","18","53067","11.69"
"Wahkiakum","0","4","Washington","6/11/20","4","0","53069","0"
"Walla Walla","1","118","Washington","6/11/20","111","7","53071","6.31"
"Whatcom","3","428","Washington","6/11/20","404","24","53073","5.94"
"Whitman","0","21","Washington","6/11/20","20","1","53075","5"
"Yakima","137","4988","Washington","6/11/20","4031","957","53077","23.74"
"Barbour","0","10","West Virginia","6/11/20","8","2","54001","25"
"Berkeley","5","369","West Virginia","6/11/20","336","33","54003","9.82"
"Boone","1","17","West Virginia","6/11/20","11","6","54005","54.55"
"Braxton","0","3","West Virginia","6/11/20","2","1","54007","50"
"Brooke","0","5","West Virginia","6/11/20","5","0","54009","0"
"Cabell","0","71","West Virginia","6/11/20","69","2","54011","2.9"
"Calhoun","0","2","West Virginia","6/11/20","2","0","54013","0"
"Clay","0","7","West Virginia","6/11/20","6","1","54015","16.67"
"Fayette","0","54","West Virginia","6/11/20","52","2","54019","3.85"
"Gilmer","0","10","West Virginia","6/11/20","10","0","54021","0"
"Grant","1","16","West Virginia","6/11/20","12","4","54023","33.33"
"Greenbrier","0","9","West Virginia","6/11/20","9","0","54025","0"
"Hampshire","1","35","West Virginia","6/11/20","31","4","54027","12.9"
"Hancock","0","20","West Virginia","6/11/20","20","0","54029","0"
"Hardy","0","40","West Virginia","6/11/20","39","1","54031","2.56"
"Harrison","0","43","West Virginia","6/11/20","40","3","54033","7.5"
"Jackson","0","141","West Virginia","6/11/20","138","3","54035","2.17"
"Jefferson","0","205","West Virginia","6/11/20","204","1","54037","0.49"
"Kanawha","2","244","West Virginia","6/11/20","231","13","54039","5.63"
"Lewis","0","8","West Virginia","6/11/20","9","-1","54041","-11.11"
"Lincoln","0","5","West Virginia","6/11/20","5","0","54043","0"
"Logan","0","21","West Virginia","6/11/20","19","2","54045","10.53"
"Marion","0","53","West Virginia","6/11/20","51","2","54049","3.92"
"Marshall","1","34","West Virginia","6/11/20","30","4","54051","13.33"
"Mason","0","15","West Virginia","6/11/20","15","0","54053","0"
"McDowell","0","6","West Virginia","6/11/20","6","0","54047","0"
"Mercer","0","13","West Virginia","6/11/20","13","0","54055","0"
"Mineral","0","51","West Virginia","6/11/20","48","3","54057","6.25"
"Mingo","0","11","West Virginia","6/11/20","8","3","54059","37.5"
"Monongalia","1","142","West Virginia","6/11/20","135","7","54061","5.19"
"Monroe","0","8","West Virginia","6/11/20","8","0","54063","0"
"Morgan","0","19","West Virginia","6/11/20","19","0","54065","0"
"Nicholas","0","7","West Virginia","6/11/20","9","-2","54067","-22.22"
"Ohio","1","53","West Virginia","6/11/20","47","6","54069","12.77"
"Pendleton","0","13","West Virginia","6/11/20","13","0","54071","0"
"Pleasants","0","4","West Virginia","6/11/20","4","0","54073","0"
"Pocahontas","0","21","West Virginia","6/11/20","21","0","54075","0"
"Preston","0","24","West Virginia","6/11/20","24","0","54077","0"
"Putnam","0","41","West Virginia","6/11/20","38","3","54079","7.89"
"Raleigh","0","19","West Virginia","6/11/20","17","2","54081","11.76"
"Randolph","1","138","West Virginia","6/11/20","132","6","54083","4.55"
"Ritchie","0","2","West Virginia","6/11/20","1","1","54085","100"
"Roane","0","9","West Virginia","6/11/20","9","0","54087","0"
"Summers","0","1","West Virginia","6/11/20","1","0","54089","0"
"Taylor","0","10","West Virginia","6/11/20","10","0","54091","0"
"Tucker","0","4","West Virginia","6/11/20","4","0","54093","0"
"Tyler","0","3","West Virginia","6/11/20","3","0","54095","0"
"Upshur","0","7","West Virginia","6/11/20","7","0","54097","0"
"Wayne","0","103","West Virginia","6/11/20","103","0","54099","0"
"Wetzel","0","9","West Virginia","6/11/20","9","0","54103","0"
"Wirt","0","4","West Virginia","6/11/20","4","0","54105","0"
"Wood","0","53","West Virginia","6/11/20","53","0","54107","0"
"Wyoming","0","5","West Virginia","6/11/20","2","3","54109","150"
"Adams","0","6","Wisconsin","6/11/20","4","2","55001","50"
"Ashland","0","3","Wisconsin","6/11/20","2","1","55003","50"
"Barron","0","21","Wisconsin","6/11/20","20","1","55005","5"
"Bayfield","0","3","Wisconsin","6/11/20","3","0","55007","0"
"Brown","9","2421","Wisconsin","6/11/20","2361","60","55009","2.54"
"Buffalo","0","7","Wisconsin","6/11/20","6","1","55011","16.67"
"Burnett","0","1","Wisconsin","6/11/20","1","0","55013","0"
"Calumet","1","83","Wisconsin","6/11/20","79","4","55015","5.06"
"Chippewa","0","61","Wisconsin","6/11/20","58","3","55017","5.17"
"Clark","1","45","Wisconsin","6/11/20","37","8","55019","21.62"
"Columbia","1","50","Wisconsin","6/11/20","44","6","55021","13.64"
"Crawford","0","26","Wisconsin","6/11/20","26","0","55023","0"
"Dane","15","896","Wisconsin","6/11/20","789","107","55025","13.56"
"Dodge","4","414","Wisconsin","6/11/20","386","28","55027","7.25"
"Door","0","39","Wisconsin","6/11/20","40","-1","55029","-2.5"
"Douglas","0","20","Wisconsin","6/11/20","19","1","55031","5.26"
"Dunn","0","29","Wisconsin","6/11/20","26","3","55033","11.54"
"Eau Claire","1","126","Wisconsin","6/11/20","116","10","55035","8.62"
"Florence","0","2","Wisconsin","6/11/20","2","0","55037","0"
"Fond du Lac","4","251","Wisconsin","6/11/20","225","26","55039","11.56"
"Forest","1","34","Wisconsin","6/11/20","29","5","55041","17.24"
"Grant","0","101","Wisconsin","6/11/20","98","3","55043","3.06"
"Green","0","72","Wisconsin","6/11/20","70","2","55045","2.86"
"Green Lake","0","23","Wisconsin","6/11/20","22","1","55047","4.55"
"Iowa","0","16","Wisconsin","6/11/20","16","0","55049","0"
"Iron","0","2","Wisconsin","6/11/20","2","0","55051","0"
"Jackson","0","22","Wisconsin","6/11/20","19","3","55053","15.79"
"Jefferson","4","142","Wisconsin","6/11/20","116","26","55055","22.41"
"Juneau","0","24","Wisconsin","6/11/20","22","2","55057","9.09"
"Kenosha","10","1319","Wisconsin","6/11/20","1246","73","55059","5.86"
"Kewaunee","0","37","Wisconsin","6/11/20","36","1","55061","2.78"
"La Crosse","4","94","Wisconsin","6/11/20","64","30","55063","46.88"
"Lafayette","1","36","Wisconsin","6/11/20","28","8","55065","28.57"
"Langlade","0","6","Wisconsin","6/11/20","4","2","55067","50"
"Lincoln","0","7","Wisconsin","6/11/20","7","0","55069","0"
"Manitowoc","0","40","Wisconsin","6/11/20","38","2","55071","5.26"
"Marathon","2","70","Wisconsin","6/11/20","55","15","55073","27.27"
"Marinette","1","37","Wisconsin","6/11/20","33","4","55075","12.12"
"Marquette","1","9","Wisconsin","6/11/20","5","4","55077","80"
"Menominee","0","4","Wisconsin","6/11/20","3","1","55078","33.33"
"Milwaukee","119","9220","Wisconsin","6/11/20","8388","832","55079","9.92"
"Monroe","1","26","Wisconsin","6/11/20","18","8","55081","44.44"
"Oconto","1","43","Wisconsin","6/11/20","39","4","55083","10.26"
"Oneida","0","14","Wisconsin","6/11/20","11","3","55085","27.27"
"Outagamie","9","306","Wisconsin","6/11/20","246","60","55087","24.39"
"Ozaukee","2","185","Wisconsin","6/11/20","174","11","55089","6.32"
"Pepin","0","1","Wisconsin","6/11/20","1","0","55091","0"
"Pierce","0","51","Wisconsin","6/11/20","49","2","55093","4.08"
"Polk","1","37","Wisconsin","6/11/20","28","9","55095","32.14"
"Portage","7","66","Wisconsin","6/11/20","14","52","55097","371.43"
"Price","0","2","Wisconsin","6/11/20","2","0","55099","0"
"Racine","18","1966","Wisconsin","6/11/20","1838","128","55101","6.96"
"Richland","0","14","Wisconsin","6/11/20","14","0","55103","0"
"Rock","8","729","Wisconsin","6/11/20","671","58","55105","8.64"
"Rusk","0","7","Wisconsin","6/11/20","5","2","55107","40"
"Sauk","0","84","Wisconsin","6/11/20","81","3","55111","3.7"
"Sawyer","0","9","Wisconsin","6/11/20","8","1","55113","12.5"
"Shawano","1","60","Wisconsin","6/11/20","53","7","55115","13.21"
"Sheboygan","4","129","Wisconsin","6/11/20","101","28","55117","27.72"
"St. Croix","1","108","Wisconsin","6/11/20","100","8","55109","8"
"Taylor","0","2","Wisconsin","6/11/20","2","0","55119","0"
"Trempealeau","3","49","Wisconsin","6/11/20","30","19","55121","63.33"
"Vernon","0","23","Wisconsin","6/11/20","21","2","55123","9.52"
"Vilas","0","8","Wisconsin","6/11/20","8","0","55125","0"
"Walworth","6","468","Wisconsin","6/11/20","424","44","55127","10.38"
"Washburn","0","3","Wisconsin","6/11/20","2","1","55129","50"
"Washington","3","287","Wisconsin","6/11/20","266","21","55131","7.89"
"Waukesha","14","865","Wisconsin","6/11/20","765","100","55133","13.07"
"Waupaca","2","63","Wisconsin","6/11/20","47","16","55135","34.04"
"Waushara","1","14","Wisconsin","6/11/20","9","5","55137","55.56"
"Winnebago","23","473","Wisconsin","6/11/20","309","164","55139","53.07"
"Wood","1","15","Wisconsin","6/11/20","11","4","55141","36.36"
"Albany","0","26","Wyoming","6/11/20","25","1","56001","4"
"Big Horn","1","10","Wyoming","6/11/20","6","4","56003","66.67"
"Campbell","1","39","Wyoming","6/11/20","32","7","56005","21.88"
"Carbon","1","20","Wyoming","6/11/20","16","4","56007","25"
"Converse","0","24","Wyoming","6/11/20","24","0","56009","0"
"Crook","0","5","Wyoming","6/11/20","5","0","56011","0"
"Fremont","2","302","Wyoming","6/11/20","287","15","56013","5.23"
"Goshen","0","5","Wyoming","6/11/20","5","0","56015","0"
"Hot Springs","0","12","Wyoming","6/11/20","12","0","56017","0"
"Johnson","0","18","Wyoming","6/11/20","18","0","56019","0"
"Laramie","0","188","Wyoming","6/11/20","188","0","56021","0"
"Lincoln","0","15","Wyoming","6/11/20","15","0","56023","0"
"Natrona","1","87","Wyoming","6/11/20","79","8","56025","10.13"
"Niobrara","0","2","Wyoming","6/11/20","2","0","56027","0"
"Park","0","2","Wyoming","6/11/20","2","0","56029","0"
"Platte","0","1","Wyoming","6/11/20","1","0","56031","0"
"Sheridan","0","19","Wyoming","6/11/20","16","3","56033","18.75"
"Sublette","0","3","Wyoming","6/11/20","3","0","56035","0"
"Sweetwater","1","36","Wyoming","6/11/20","32","4","56037","12.5"
"Teton","0","102","Wyoming","6/11/20","100","2","56039","2"
"Uinta","6","53","Wyoming","6/11/20","13","40","56041","307.69"
"Washakie","0","39","Wyoming","6/11/20","39","0","56043","0"
"Weston","0","1","Wyoming","6/11/20","1","0","56045","0"
