"Locality","DailyAvgNewCasesPast7Days","TotalCases","State","Date","TotalCases7DaysAgo","NewCasesPast7Days","FIPS-Code","PercentIncreaseTotalCasesPast7Days"
"Autauga","11","323","Alabama","6/12/20","248","75","01001","30.24"
"Baldwin","8","353","Alabama","6/12/20","296","57","01003","19.26"
"Barbour","5","221","Alabama","6/12/20","183","38","01005","20.77"
"Bibb","3","97","Alabama","6/12/20","76","21","01007","27.63"
"Blount","4","95","Alabama","6/12/20","64","31","01009","48.44"
"Bullock","6","258","Alabama","6/12/20","219","39","01011","17.81"
"Butler","10","499","Alabama","6/12/20","431","68","01013","15.78"
"Calhoun","3","188","Alabama","6/12/20","169","19","01015","11.24"
"Chambers","9","427","Alabama","6/12/20","363","64","01017","17.63"
"Cherokee","1","46","Alabama","6/12/20","38","8","01019","21.05"
"Chilton","2","122","Alabama","6/12/20","108","14","01021","12.96"
"Choctaw","2","166","Alabama","6/12/20","153","13","01023","8.5"
"Clarke","4","175","Alabama","6/12/20","149","26","01025","17.45"
"Clay","0","30","Alabama","6/12/20","28","2","01027","7.14"
"Cleburne","1","20","Alabama","6/12/20","15","5","01029","33.33"
"Coffee","4","265","Alabama","6/12/20","240","25","01031","10.42"
"Colbert","6","241","Alabama","6/12/20","197","44","01033","22.34"
"Conecuh","5","76","Alabama","6/12/20","42","34","01035","80.95"
"Coosa","0","43","Alabama","6/12/20","40","3","01037","7.5"
"Covington","3","106","Alabama","6/12/20","83","23","01039","27.71"
"Crenshaw","4","105","Alabama","6/12/20","80","25","01041","31.25"
"Cullman","11","239","Alabama","6/12/20","163","76","01043","46.63"
"Dale","6","164","Alabama","6/12/20","125","39","01045","31.2"
"Dallas","18","421","Alabama","6/12/20","296","125","01047","42.23"
"DeKalb","6","303","Alabama","6/12/20","260","43","01049","16.54"
"Elmore","15","485","Alabama","6/12/20","381","104","01051","27.3"
"Escambia","3","99","Alabama","6/12/20","79","20","01053","25.32"
"Etowah","5","298","Alabama","6/12/20","265","33","01055","12.45"
"Fayette","1","26","Alabama","6/12/20","16","10","01057","62.5"
"Franklin","10","665","Alabama","6/12/20","593","72","01059","12.14"
"Geneva","0","46","Alabama","6/12/20","45","1","01061","2.22"
"Greene","3","117","Alabama","6/12/20","95","22","01063","23.16"
"Hale","4","223","Alabama","6/12/20","192","31","01065","16.15"
"Henry","2","97","Alabama","6/12/20","84","13","01067","15.48"
"Houston","7","279","Alabama","6/12/20","227","52","01069","22.91"
"Jackson","4","113","Alabama","6/12/20","86","27","01071","31.4"
"Jefferson","59","2339","Alabama","6/12/20","1927","412","01073","21.38"
"Lamar","1","34","Alabama","6/12/20","28","6","01075","21.43"
"Lauderdale","6","216","Alabama","6/12/20","175","41","01077","23.43"
"Lawrence","1","60","Alabama","6/12/20","51","9","01079","17.65"
"Lee","11","642","Alabama","6/12/20","563","79","01081","14.03"
"Limestone","9","175","Alabama","6/12/20","110","65","01083","59.09"
"Lowndes","10","336","Alabama","6/12/20","269","67","01085","24.91"
"Macon","3","117","Alabama","6/12/20","94","23","01087","24.47"
"Madison","14","456","Alabama","6/12/20","359","97","01089","27.02"
"Marengo","4","204","Alabama","6/12/20","179","25","01091","13.97"
"Marion","1","132","Alabama","6/12/20","125","7","01093","5.6"
"Marshall","14","811","Alabama","6/12/20","714","97","01095","13.59"
"Mobile","40","2623","Alabama","6/12/20","2341","282","01097","12.05"
"Monroe","8","107","Alabama","6/12/20","49","58","01099","118.37"
"Montgomery","91","2543","Alabama","6/12/20","1905","638","01101","33.49"
"Morgan","29","516","Alabama","6/12/20","314","202","01103","64.33"
"Perry","3","62","Alabama","6/12/20","43","19","01105","44.19"
"Pickens","2","137","Alabama","6/12/20","121","16","01107","13.22"
"Pike","11","298","Alabama","6/12/20","223","75","01109","33.63"
"Randolph","1","138","Alabama","6/12/20","128","10","01111","7.81"
"Russell","11","265","Alabama","6/12/20","187","78","01113","41.71"
"Shelby","9","596","Alabama","6/12/20","536","60","01117","11.19"
"St. Clair","3","158","Alabama","6/12/20","137","21","01115","15.33"
"Sumter","3","257","Alabama","6/12/20","236","21","01119","8.9"
"Talladega","4","149","Alabama","6/12/20","121","28","01121","23.14"
"Tallapoosa","3","455","Alabama","6/12/20","435","20","01123","4.6"
"Tuscaloosa","43","1156","Alabama","6/12/20","853","303","01125","35.52"
"Walker","18","523","Alabama","6/12/20","397","126","01127","31.74"
"Washington","2","86","Alabama","6/12/20","74","12","01129","16.22"
"Wilcox","6","200","Alabama","6/12/20","158","42","01131","26.58"
"Winston","3","111","Alabama","6/12/20","92","19","01133","20.65"
"Anchorage","6","307","Alaska","6/12/20","264","43","02020","16.29"
"Bethel","0","3","Alaska","6/12/20","3","0","02050","0"
"Fairbanks North Star","1","89","Alaska","6/12/20","85","4","02090","4.71"
"Haines","0","1","Alaska","6/12/20","0","1","02100","1"
"Juneau","1","37","Alaska","6/12/20","33","4","02110","12.12"
"Kenai Peninsula","5","102","Alaska","6/12/20","68","34","02122","50"
"Ketchikan Gateway","0","16","Alaska","6/12/20","16","0","02130","0"
"Kodiak Island","0","2","Alaska","6/12/20","1","1","02150","100"
"Matanuska-Susitna","1","41","Alaska","6/12/20","35","6","02170","17.14"
"Nome","0","4","Alaska","6/12/20","3","1","02180","33.33"
"North Slope","0","1","Alaska","6/12/20","1","0","02185","0"
"Northwest Arctic","0","4","Alaska","6/12/20","2","2","02188","100"
"Petersburg","0","4","Alaska","6/12/20","4","0","02195","0"
"Prince of Wales-Hyder","0","2","Alaska","6/12/20","2","0","02198","0"
"Sitka","1","6","Alaska","6/12/20","2","4","02220","200"
"Southeast Fairbanks","0","3","Alaska","6/12/20","3","0","02240","0"
"Wrangell","0","1","Alaska","6/12/20","0","1","02275","1"
"Yukon-Koyukuk","0","1","Alaska","6/12/20","1","0","02290","0"
"Apache","39","1927","Arizona","6/12/20","1656","271","04001","16.36"
"Cochise","8","178","Arizona","6/12/20","120","58","04003","48.33"
"Coconino","14","1345","Arizona","6/12/20","1248","97","04005","7.77"
"Gila","2","54","Arizona","6/12/20","42","12","04007","28.57"
"Graham","1","48","Arizona","6/12/20","40","8","04009","20"
"Greenlee","0","11","Arizona","6/12/20","9","2","04011","22.22"
"La Paz","10","217","Arizona","6/12/20","149","68","04012","45.64"
"Maricopa","703","17010","Arizona","6/12/20","12091","4919","04013","40.68"
"Mohave","20","584","Arizona","6/12/20","447","137","04015","30.65"
"Navajo","58","2512","Arizona","6/12/20","2104","408","04017","19.39"
"Pima","106","3628","Arizona","6/12/20","2883","745","04019","25.84"
"Pinal","49","1363","Arizona","6/12/20","1018","345","04021","33.89"
"Santa Cruz","47","833","Arizona","6/12/20","503","330","04023","65.61"
"Yavapai","8","367","Arizona","6/12/20","314","53","04025","16.88"
"Yuma","164","2962","Arizona","6/12/20","1815","1147","04027","63.2"
"Arkansas","0","7","Arkansas","6/12/20","7","0","05001","0"
"Ashley","1","38","Arkansas","6/12/20","29","9","05003","31.03"
"Baxter","0","14","Arkansas","6/12/20","12","2","05005","16.67"
"Benton","69","1306","Arkansas","6/12/20","826","480","05007","58.11"
"Boone","0","9","Arkansas","6/12/20","7","2","05009","28.57"
"Bradley","1","34","Arkansas","6/12/20","26","8","05011","30.77"
"Carroll","5","66","Arkansas","6/12/20","33","33","05015","100"
"Chicot","3","40","Arkansas","6/12/20","19","21","05017","110.53"
"Clark","1","45","Arkansas","6/12/20","40","5","05019","12.5"
"Clay","1","9","Arkansas","6/12/20","5","4","05021","80"
"Cleburne","0","74","Arkansas","6/12/20","74","0","05023","0"
"Cleveland","0","19","Arkansas","6/12/20","19","0","05025","0"
"Columbia","1","27","Arkansas","6/12/20","23","4","05027","17.39"
"Conway","1","19","Arkansas","6/12/20","15","4","05029","26.67"
"Craighead","10","346","Arkansas","6/12/20","279","67","05031","24.01"
"Crawford","2","51","Arkansas","6/12/20","35","16","05033","45.71"
"Crittenden","10","508","Arkansas","6/12/20","436","72","05035","16.51"
"Cross","2","74","Arkansas","6/12/20","60","14","05037","23.33"
"Dallas","0","3","Arkansas","6/12/20","3","0","05039","0"
"Desha","0","20","Arkansas","6/12/20","19","1","05041","5.26"
"Drew","1","25","Arkansas","6/12/20","21","4","05043","19.05"
"Faulkner","5","142","Arkansas","6/12/20","108","34","05045","31.48"
"Franklin","0","6","Arkansas","6/12/20","5","1","05047","20"
"Fulton","0","9","Arkansas","6/12/20","7","2","05049","28.57"
"Garland","2","154","Arkansas","6/12/20","138","16","05051","11.59"
"Grant","1","23","Arkansas","6/12/20","18","5","05053","27.78"
"Greene","0","69","Arkansas","6/12/20","67","2","05055","2.99"
"Hempstead","1","33","Arkansas","6/12/20","23","10","05057","43.48"
"Hot Spring","0","37","Arkansas","6/12/20","34","3","05059","8.82"
"Howard","2","38","Arkansas","6/12/20","27","11","05061","40.74"
"Independence","1","39","Arkansas","6/12/20","33","6","05063","18.18"
"Izard","0","17","Arkansas","6/12/20","17","0","05065","0"
"Jackson","1","15","Arkansas","6/12/20","5","10","05067","200"
"Jefferson","11","625","Arkansas","6/12/20","545","80","05069","14.68"
"Johnson","3","78","Arkansas","6/12/20","55","23","05071","41.82"
"Lafayette","0","10","Arkansas","6/12/20","9","1","05073","11.11"
"Lawrence","0","90","Arkansas","6/12/20","87","3","05075","3.45"
"Lee","41","317","Arkansas","6/12/20","30","287","05077","956.67"
"Lincoln","0","986","Arkansas","6/12/20","985","1","05079","0.1"
"Little River","3","33","Arkansas","6/12/20","14","19","05081","135.71"
"Logan","1","17","Arkansas","6/12/20","12","5","05083","41.67"
"Lonoke","2","69","Arkansas","6/12/20","57","12","05085","21.05"
"Madison","8","99","Arkansas","6/12/20","43","56","05087","130.23"
"Marion","0","2","Arkansas","6/12/20","2","0","05089","0"
"Miller","2","66","Arkansas","6/12/20","52","14","05091","26.92"
"Mississippi","1","89","Arkansas","6/12/20","79","10","05093","12.66"
"Monroe","0","5","Arkansas","6/12/20","5","0","05095","0"
"Montgomery","0","2","Arkansas","6/12/20","2","0","05097","0"
"Nevada","9","73","Arkansas","6/12/20","10","63","05099","630"
"Newton","0","3","Arkansas","6/12/20","3","0","05101","0"
"Ouachita","0","13","Arkansas","6/12/20","12","1","05103","8.33"
"Perry","0","15","Arkansas","6/12/20","14","1","05105","7.14"
"Phillips","1","32","Arkansas","6/12/20","25","7","05107","28"
"Pike","0","6","Arkansas","6/12/20","6","0","05109","0"
"Poinsett","1","50","Arkansas","6/12/20","41","9","05111","21.95"
"Polk","3","48","Arkansas","6/12/20","29","19","05113","65.52"
"Pope","7","234","Arkansas","6/12/20","184","50","05115","27.17"
"Prairie","0","6","Arkansas","6/12/20","3","3","05117","100"
"Pulaski","25","1241","Arkansas","6/12/20","1065","176","05119","16.53"
"Randolph","0","28","Arkansas","6/12/20","26","2","05121","7.69"
"Saline","6","166","Arkansas","6/12/20","123","43","05125","34.96"
"Scott","0","2","Arkansas","6/12/20","1","1","05127","100"
"Searcy","0","7","Arkansas","6/12/20","7","0","05129","0"
"Sebastian","9","133","Arkansas","6/12/20","69","64","05131","92.75"
"Sevier","13","393","Arkansas","6/12/20","301","92","05133","30.56"
"Sharp","0","51","Arkansas","6/12/20","48","3","05135","6.25"
"St. Francis","10","767","Arkansas","6/12/20","694","73","05123","10.52"
"Stone","0","11","Arkansas","6/12/20","10","1","05137","10"
"Union","2","199","Arkansas","6/12/20","185","14","05139","7.57"
"Van Buren","0","30","Arkansas","6/12/20","29","1","05141","3.45"
"Washington","112","1605","Arkansas","6/12/20","824","781","05143","94.78"
"White","1","54","Arkansas","6/12/20","48","6","05145","12.5"
"Woodruff","0","1","Arkansas","6/12/20","1","0","05147","0"
"Yell","10","275","Arkansas","6/12/20","202","73","05149","36.14"
"Alameda","70","4216","California","6/12/20","3725","491","06001","13.18"
"Alpine","0","2","California","6/12/20","2","0","06003","0"
"Amador","0","10","California","6/12/20","10","0","06005","0"
"Butte","1","74","California","6/12/20","65","9","06007","13.85"
"Calaveras","1","25","California","6/12/20","19","6","06009","31.58"
"Colusa","0","7","California","6/12/20","7","0","06011","0"
"Contra Costa","43","1877","California","6/12/20","1577","300","06013","19.02"
"Del Norte","0","47","California","6/12/20","47","0","06015","0"
"El Dorado","2","113","California","6/12/20","102","11","06017","10.78"
"Fresno","54","2395","California","6/12/20","2014","381","06019","18.92"
"Glenn","1","24","California","6/12/20","17","7","06021","41.18"
"Humboldt","0","105","California","6/12/20","104","1","06023","0.96"
"Imperial","165","3724","California","6/12/20","2568","1156","06025","45.02"
"Inyo","0","22","California","6/12/20","20","2","06027","10"
"Kern","85","3130","California","6/12/20","2534","596","06029","23.52"
"Kings","39","1724","California","6/12/20","1452","272","06031","18.73"
"Lake","0","32","California","6/12/20","30","2","06033","6.67"
"Lassen","0","9","California","6/12/20","6","3","06035","50"
"Los Angeles","1352","70529","California","6/12/20","61068","9461","06037","15.49"
"Madera","7","188","California","6/12/20","141","47","06039","33.33"
"Marin","19","664","California","6/12/20","530","134","06041","25.28"
"Mariposa","0","16","California","6/12/20","16","0","06043","0"
"Mendocino","1","38","California","6/12/20","33","5","06045","15.15"
"Merced","10","391","California","6/12/20","320","71","06047","22.19"
"Mono","0","37","California","6/12/20","37","0","06051","0"
"Monterey","32","865","California","6/12/20","640","225","06053","35.16"
"Napa","6","168","California","6/12/20","129","39","06055","30.23"
"Nevada","0","52","California","6/12/20","49","3","06057","6.12"
"Orange","156","8153","California","6/12/20","7064","1089","06059","15.42"
"Placer","11","344","California","6/12/20","265","79","06061","29.81"
"Plumas","0","4","California","6/12/20","4","0","06063","0"
"Riverside","245","10490","California","6/12/20","8777","1713","06065","19.52"
"Sacramento","26","1704","California","6/12/20","1519","185","06067","12.18"
"San Benito","1","112","California","6/12/20","102","10","06069","9.8"
"San Bernardino","149","6976","California","6/12/20","5930","1046","06071","17.64"
"San Diego","151","8998","California","6/12/20","7940","1058","06073","13.32"
"San Francisco","26","2878","California","6/12/20","2698","180","06075","6.67"
"San Joaquin","56","1444","California","6/12/20","1050","394","06077","37.52"
"San Luis Obispo","5","324","California","6/12/20","291","33","06079","11.34"
"San Mateo","33","2533","California","6/12/20","2299","234","06081","10.18"
"Santa Barbara","25","1910","California","6/12/20","1737","173","06083","9.96"
"Santa Clara","32","3117","California","6/12/20","2892","225","06085","7.78"
"Santa Cruz","5","254","California","6/12/20","221","33","06087","14.93"
"Shasta","1","48","California","6/12/20","42","6","06089","14.29"
"Sierra","0","1","California","6/12/20","1","0","06091","0"
"Siskiyou","1","14","California","6/12/20","9","5","06093","55.56"
"Solano","11","643","California","6/12/20","565","78","06095","13.81"
"Sonoma","13","701","California","6/12/20","610","91","06097","14.92"
"Stanislaus","37","1072","California","6/12/20","816","256","06099","31.37"
"Sutter","3","69","California","6/12/20","51","18","06101","35.29"
"Tehama","2","20","California","6/12/20","7","13","06103","185.71"
"Trinity","0","2","California","6/12/20","2","0","06105","0"
"Tulare","64","2564","California","6/12/20","2116","448","06107","21.17"
"Tuolumne","0","8","California","6/12/20","5","3","06109","60"
"Ventura","43","1518","California","6/12/20","1216","302","06111","24.84"
"Yolo","3","240","California","6/12/20","216","24","06113","11.11"
"Yuba","0","34","California","6/12/20","31","3","06115","9.68"
"Adams","26","3698","Colorado","6/12/20","3515","183","08001","5.21"
"Alamosa","4","114","Colorado","6/12/20","87","27","08003","31.03"
"Arapahoe","23","4754","Colorado","6/12/20","4591","163","08005","3.55"
"Archuleta","0","8","Colorado","6/12/20","8","0","08007","0"
"Baca","0","12","Colorado","6/12/20","12","0","08009","0"
"Bent","0","3","Colorado","6/12/20","2","1","08011","50"
"Boulder","6","1049","Colorado","6/12/20","1008","41","08013","4.07"
"Broomfield","1","261","Colorado","6/12/20","252","9","08014","3.57"
"Chaffee","0","78","Colorado","6/12/20","77","1","08015","1.3"
"Cheyenne","0","5","Colorado","6/12/20","5","0","08017","0"
"Clear Creek","0","17","Colorado","6/12/20","17","0","08019","0"
"Conejos","0","5","Colorado","6/12/20","4","1","08021","25"
"Costilla","1","12","Colorado","6/12/20","6","6","08023","100"
"Crowley","0","66","Colorado","6/12/20","66","0","08025","0"
"Custer","0","2","Colorado","6/12/20","2","0","08027","0"
"Delta","1","76","Colorado","6/12/20","72","4","08029","5.56"
"Denver","31","6257","Colorado","6/12/20","6041","216","08031","3.58"
"Douglas","6","790","Colorado","6/12/20","751","39","08035","5.19"
"Eagle","3","621","Colorado","6/12/20","603","18","08037","2.99"
"El Paso","17","1920","Colorado","6/12/20","1802","118","08041","6.55"
"Elbert","0","54","Colorado","6/12/20","53","1","08039","1.89"
"Fremont","0","26","Colorado","6/12/20","26","0","08043","0"
"Garfield","3","177","Colorado","6/12/20","158","19","08045","12.03"
"Gilpin","0","6","Colorado","6/12/20","4","2","08047","50"
"Grand","0","15","Colorado","6/12/20","15","0","08049","0"
"Gunnison","0","181","Colorado","6/12/20","178","3","08051","1.69"
"Hinsdale","0","3","Colorado","6/12/20","3","0","08053","0"
"Huerfano","0","3","Colorado","6/12/20","3","0","08055","0"
"Jefferson","15","2445","Colorado","6/12/20","2343","102","08059","4.35"
"Kit Carson","0","30","Colorado","6/12/20","30","0","08063","0"
"La Plata","0","84","Colorado","6/12/20","82","2","08067","2.44"
"Lake","0","38","Colorado","6/12/20","35","3","08065","8.57"
"Larimer","3","637","Colorado","6/12/20","613","24","08069","3.92"
"Las Animas","0","6","Colorado","6/12/20","5","1","08071","20"
"Lincoln","0","3","Colorado","6/12/20","3","0","08073","0"
"Logan","1","632","Colorado","6/12/20","627","5","08075","0.8"
"Mesa","1","66","Colorado","6/12/20","60","6","08077","10"
"Mineral","0","2","Colorado","6/12/20","2","0","08079","0"
"Moffat","0","8","Colorado","6/12/20","8","0","08081","0"
"Montezuma","2","59","Colorado","6/12/20","46","13","08083","28.26"
"Montrose","1","191","Colorado","6/12/20","183","8","08085","4.37"
"Morgan","1","645","Colorado","6/12/20","641","4","08087","0.62"
"Otero","0","22","Colorado","6/12/20","21","1","08089","4.76"
"Ouray","0","8","Colorado","6/12/20","8","0","08091","0"
"Park","0","23","Colorado","6/12/20","23","0","08093","0"
"Phillips","0","15","Colorado","6/12/20","14","1","08095","7.14"
"Pitkin","1","63","Colorado","6/12/20","59","4","08097","6.78"
"Prowers","0","17","Colorado","6/12/20","15","2","08099","13.33"
"Pueblo","4","332","Colorado","6/12/20","306","26","08101","8.5"
"Rio Blanco","0","1","Colorado","6/12/20","1","0","08103","0"
"Rio Grande","2","53","Colorado","6/12/20","40","13","08105","32.5"
"Routt","0","64","Colorado","6/12/20","62","2","08107","3.23"
"Saguache","1","97","Colorado","6/12/20","92","5","08109","5.43"
"San Juan","0","1","Colorado","6/12/20","1","0","08111","0"
"San Miguel","0","23","Colorado","6/12/20","23","0","08113","0"
"Summit","2","254","Colorado","6/12/20","239","15","08117","6.28"
"Teller","1","38","Colorado","6/12/20","33","5","08119","15.15"
"Washington","0","44","Colorado","6/12/20","42","2","08121","4.76"
"Weld","15","2646","Colorado","6/12/20","2540","106","08123","4.17"
"Yuma","1","47","Colorado","6/12/20","43","4","08125","9.3"
"Fairfield","38","16178","Connecticut","6/12/20","15914","264","09001","1.66"
"Hartford","61","11103","Connecticut","6/12/20","10677","426","09003","3.99"
"Litchfield","4","1435","Connecticut","6/12/20","1409","26","09005","1.85"
"Middlesex","7","1216","Connecticut","6/12/20","1170","46","09007","3.93"
"New Haven","44","11979","Connecticut","6/12/20","11673","306","09009","2.62"
"New London","6","1150","Connecticut","6/12/20","1108","42","09011","3.79"
"Tolland","4","886","Connecticut","6/12/20","859","27","09013","3.14"
"Windham","7","453","Connecticut","6/12/20","405","48","09015","11.85"
"Kent","11","1544","Delaware","6/12/20","1465","79","10001","5.39"
"New Castle","41","4224","Delaware","6/12/20","3937","287","10003","7.29"
"Sussex","10","4389","Delaware","6/12/20","4322","67","10005","1.55"
"","0","49","Diamond Princess","6/12/20","49","0",,"0"
"District of Columbia","65","9654","District of Columbia","6/12/20","9199","455","11001","4.95"
"Alachua","16","506","Florida","6/12/20","392","114","12001","29.08"
"Baker","0","30","Florida","6/12/20","29","1","12003","3.45"
"Bay","3","139","Florida","6/12/20","115","24","12005","20.87"
"Bradford","0","52","Florida","6/12/20","52","0","12007","0"
"Brevard","11","519","Florida","6/12/20","439","80","12009","18.22"
"Broward","145","8589","Florida","6/12/20","7572","1017","12011","13.43"
"Calhoun","0","65","Florida","6/12/20","64","1","12013","1.56"
"Charlotte","6","522","Florida","6/12/20","481","41","12015","8.52"
"Citrus","1","135","Florida","6/12/20","125","10","12017","8"
"Clay","5","429","Florida","6/12/20","393","36","12019","9.16"
"Collier","70","2364","Florida","6/12/20","1874","490","12021","26.15"
"Columbia","1","177","Florida","6/12/20","167","10","12023","5.99"
"DeSoto","12","329","Florida","6/12/20","245","84","12027","34.29"
"Dixie","0","60","Florida","6/12/20","58","2","12029","3.45"
"Duval","27","1923","Florida","6/12/20","1736","187","12031","10.77"
"Escambia","12","956","Florida","6/12/20","871","85","12033","9.76"
"Flagler","1","202","Florida","6/12/20","195","7","12035","3.59"
"Franklin","0","2","Florida","6/12/20","2","0","12037","0"
"Gadsden","2","302","Florida","6/12/20","289","13","12039","4.5"
"Gilchrist","0","22","Florida","6/12/20","19","3","12041","15.79"
"Glades","4","109","Florida","6/12/20","81","28","12043","34.57"
"Gulf","1","8","Florida","6/12/20","3","5","12045","166.67"
"Hamilton","1","268","Florida","6/12/20","261","7","12047","2.68"
"Hardee","7","177","Florida","6/12/20","131","46","12049","35.11"
"Hendry","11","597","Florida","6/12/20","521","76","12051","14.59"
"Hernando","1","132","Florida","6/12/20","122","10","12053","8.2"
"Highlands","4","169","Florida","6/12/20","141","28","12055","19.86"
"Hillsborough","106","3295","Florida","6/12/20","2554","741","12057","29.01"
"Holmes","0","31","Florida","6/12/20","30","1","12059","3.33"
"Indian River","5","190","Florida","6/12/20","154","36","12061","23.38"
"Jackson","3","316","Florida","6/12/20","298","18","12063","6.04"
"Jefferson","0","31","Florida","6/12/20","30","1","12065","3.33"
"Lafayette","0","12","Florida","6/12/20","10","2","12067","20"
"Lake","9","383","Florida","6/12/20","317","66","12069","20.82"
"Lee","52","2563","Florida","6/12/20","2200","363","12071","16.5"
"Leon","4","464","Florida","6/12/20","434","30","12073","6.91"
"Levy","6","98","Florida","6/12/20","55","43","12075","78.18"
"Liberty","0","218","Florida","6/12/20","218","0","12077","0"
"Madison","0","75","Florida","6/12/20","72","3","12079","4.17"
"Manatee","21","1309","Florida","6/12/20","1162","147","12081","12.65"
"Marion","4","299","Florida","6/12/20","272","27","12083","9.93"
"Martin","35","1056","Florida","6/12/20","810","246","12085","30.37"
"Miami-Dade","259","20872","Florida","6/12/20","19056","1816","12086","9.53"
"Monroe","2","121","Florida","6/12/20","110","11","12087","10"
"Nassau","1","87","Florida","6/12/20","82","5","12089","6.1"
"Okaloosa","9","312","Florida","6/12/20","250","62","12091","24.8"
"Okeechobee","5","158","Florida","6/12/20","122","36","12093","29.51"
"Orange","80","2773","Florida","6/12/20","2210","563","12095","25.48"
"Osceola","9","796","Florida","6/12/20","732","64","12097","8.74"
"Palm Beach","193","8209","Florida","6/12/20","6859","1350","12099","19.68"
"Pasco","10","484","Florida","6/12/20","416","68","12101","16.35"
"Pinellas","66","1941","Florida","6/12/20","1478","463","12103","31.33"
"Polk","35","1373","Florida","6/12/20","1127","246","12105","21.83"
"Putnam","2","183","Florida","6/12/20","172","11","12107","6.4"
"Santa Rosa","3","275","Florida","6/12/20","256","19","12113","7.42"
"Sarasota","9","724","Florida","6/12/20","658","66","12115","10.03"
"Seminole","21","663","Florida","6/12/20","515","148","12117","28.74"
"St. Johns","3","292","Florida","6/12/20","270","22","12109","8.15"
"St. Lucie","33","793","Florida","6/12/20","561","232","12111","41.35"
"Sumter","1","266","Florida","6/12/20","261","5","12119","1.92"
"Suwannee","2","185","Florida","6/12/20","174","11","12121","6.32"
"Taylor","4","52","Florida","6/12/20","27","25","12123","92.59"
"Union","1","38","Florida","6/12/20","34","4","12125","11.76"
"Volusia","13","884","Florida","6/12/20","791","93","12127","11.76"
"Wakulla","0","35","Florida","6/12/20","35","0","12129","0"
"Walton","3","145","Florida","6/12/20","124","21","12131","16.94"
"Washington","1","87","Florida","6/12/20","79","8","12133","10.13"
"Appling","3","199","Georgia","6/12/20","180","19","13001","10.56"
"Atkinson","2","70","Georgia","6/12/20","55","15","13003","27.27"
"Bacon","3","165","Georgia","6/12/20","141","24","13005","17.02"
"Baker","0","37","Georgia","6/12/20","35","2","13007","5.71"
"Baldwin","5","421","Georgia","6/12/20","387","34","13009","8.79"
"Banks","3","107","Georgia","6/12/20","88","19","13011","21.59"
"Barrow","5","378","Georgia","6/12/20","341","37","13013","10.85"
"Bartow","4","539","Georgia","6/12/20","514","25","13015","4.86"
"Ben Hill","2","98","Georgia","6/12/20","87","11","13017","12.64"
"Berrien","1","62","Georgia","6/12/20","54","8","13019","14.81"
"Bibb","4","530","Georgia","6/12/20","502","28","13021","5.58"
"Bleckley","0","53","Georgia","6/12/20","50","3","13023","6"
"Brantley","1","68","Georgia","6/12/20","62","6","13025","9.68"
"Brooks","2","93","Georgia","6/12/20","78","15","13027","19.23"
"Bryan","1","83","Georgia","6/12/20","77","6","13029","7.79"
"Bulloch","2","92","Georgia","6/12/20","81","11","13031","13.58"
"Burke","1","125","Georgia","6/12/20","121","4","13033","3.31"
"Butts","0","242","Georgia","6/12/20","242","0","13035","0"
"Calhoun","1","146","Georgia","6/12/20","139","7","13037","5.04"
"Camden","0","71","Georgia","6/12/20","69","2","13039","2.9"
"Candler","1","17","Georgia","6/12/20","13","4","13043","30.77"
"Carroll","3","602","Georgia","6/12/20","578","24","13045","4.15"
"Catoosa","10","217","Georgia","6/12/20","147","70","13047","47.62"
"Charlton","1","38","Georgia","6/12/20","32","6","13049","18.75"
"Chatham","8","597","Georgia","6/12/20","542","55","13051","10.15"
"Chattahoochee","11","246","Georgia","6/12/20","172","74","13053","43.02"
"Chattooga","1","32","Georgia","6/12/20","25","7","13055","28"
"Cherokee","10","1014","Georgia","6/12/20","944","70","13057","7.42"
"Clarke","3","338","Georgia","6/12/20","315","23","13059","7.3"
"Clay","1","51","Georgia","6/12/20","44","7","13061","15.91"
"Clayton","15","1413","Georgia","6/12/20","1310","103","13063","7.86"
"Clinch","1","75","Georgia","6/12/20","67","8","13065","11.94"
"Cobb","43","3522","Georgia","6/12/20","3223","299","13067","9.28"
"Coffee","5","328","Georgia","6/12/20","292","36","13069","12.33"
"Colquitt","13","634","Georgia","6/12/20","545","89","13071","16.33"
"Columbia","4","295","Georgia","6/12/20","270","25","13073","9.26"
"Cook","2","67","Georgia","6/12/20","51","16","13075","31.37"
"Coweta","7","507","Georgia","6/12/20","458","49","13077","10.7"
"Crawford","0","31","Georgia","6/12/20","29","2","13079","6.9"
"Crisp","0","241","Georgia","6/12/20","238","3","13081","1.26"
"Dade","1","47","Georgia","6/12/20","41","6","13083","14.63"
"Dawson","1","118","Georgia","6/12/20","112","6","13085","5.36"
"Decatur","2","222","Georgia","6/12/20","207","15","13087","7.25"
"DeKalb","42","4282","Georgia","6/12/20","3986","296","13089","7.43"
"Dodge","0","54","Georgia","6/12/20","52","2","13091","3.85"
"Dooly","1","197","Georgia","6/12/20","189","8","13093","4.23"
"Dougherty","5","1828","Georgia","6/12/20","1796","32","13095","1.78"
"Douglas","8","641","Georgia","6/12/20","583","58","13097","9.95"
"Early","1","254","Georgia","6/12/20","247","7","13099","2.83"
"Echols","2","153","Georgia","6/12/20","136","17","13101","12.5"
"Effingham","1","83","Georgia","6/12/20","78","5","13103","6.41"
"Elbert","1","84","Georgia","6/12/20","77","7","13105","9.09"
"Emanuel","1","38","Georgia","6/12/20","30","8","13107","26.67"
"Evans","0","7","Georgia","6/12/20","6","1","13109","16.67"
"Fannin","2","65","Georgia","6/12/20","49","16","13111","32.65"
"Fayette","2","259","Georgia","6/12/20","244","15","13113","6.15"
"Floyd","8","365","Georgia","6/12/20","311","54","13115","17.36"
"Forsyth","7","589","Georgia","6/12/20","541","48","13117","8.87"
"Franklin","1","137","Georgia","6/12/20","132","5","13119","3.79"
"Fulton","40","5069","Georgia","6/12/20","4790","279","13121","5.82"
"Gilmer","1","169","Georgia","6/12/20","159","10","13123","6.29"
"Glascock","0","1","Georgia","6/12/20","1","0","13125","0"
"Glynn","4","177","Georgia","6/12/20","147","30","13127","20.41"
"Gordon","7","240","Georgia","6/12/20","194","46","13129","23.71"
"Grady","3","137","Georgia","6/12/20","119","18","13131","15.13"
"Greene","1","86","Georgia","6/12/20","76","10","13133","13.16"
"Gwinnett","102","5089","Georgia","6/12/20","4372","717","13135","16.4"
"Habersham","5","581","Georgia","6/12/20","549","32","13137","5.83"
"Hall","19","2727","Georgia","6/12/20","2596","131","13139","5.05"
"Hancock","1","201","Georgia","6/12/20","196","5","13141","2.55"
"Haralson","1","57","Georgia","6/12/20","51","6","13143","11.76"
"Harris","10","190","Georgia","6/12/20","119","71","13145","59.66"
"Hart","0","41","Georgia","6/12/20","39","2","13147","5.13"
"Heard","1","42","Georgia","6/12/20","36","6","13149","16.67"
"Henry","11","829","Georgia","6/12/20","751","78","13151","10.39"
"Houston","4","421","Georgia","6/12/20","393","28","13153","7.12"
"Irwin","0","34","Georgia","6/12/20","34","0","13155","0"
"Jackson","5","256","Georgia","6/12/20","221","35","13157","15.84"
"Jasper","1","56","Georgia","6/12/20","46","10","13159","21.74"
"Jeff Davis","2","52","Georgia","6/12/20","38","14","13161","36.84"
"Jefferson","0","52","Georgia","6/12/20","49","3","13163","6.12"
"Jenkins","3","44","Georgia","6/12/20","26","18","13165","69.23"
"Johnson","-1","77","Georgia","6/12/20","82","-5","13167","-6.1"
"Jones","0","50","Georgia","6/12/20","49","1","13169","2.04"
"Lamar","0","79","Georgia","6/12/20","76","3","13171","3.95"
"Lanier","1","37","Georgia","6/12/20","27","10","13173","37.04"
"Laurens","1","113","Georgia","6/12/20","108","5","13175","4.63"
"Lee","1","371","Georgia","6/12/20","361","10","13177","2.77"
"Liberty","0","90","Georgia","6/12/20","87","3","13179","3.45"
"Lincoln","0","17","Georgia","6/12/20","16","1","13181","6.25"
"Long","0","19","Georgia","6/12/20","16","3","13183","18.75"
"Lowndes","26","567","Georgia","6/12/20","385","182","13185","47.27"
"Lumpkin","1","107","Georgia","6/12/20","102","5","13187","4.9"
"Macon","0","106","Georgia","6/12/20","106","0","13193","0"
"Madison","1","72","Georgia","6/12/20","65","7","13195","10.77"
"Marion","0","61","Georgia","6/12/20","59","2","13197","3.39"
"McDuffie","0","73","Georgia","6/12/20","72","1","13189","1.39"
"McIntosh","0","17","Georgia","6/12/20","15","2","13191","13.33"
"Meriwether","3","123","Georgia","6/12/20","105","18","13199","17.14"
"Miller","0","45","Georgia","6/12/20","42","3","13201","7.14"
"Mitchell","2","427","Georgia","6/12/20","416","11","13205","2.64"
"Monroe","1","127","Georgia","6/12/20","123","4","13207","3.25"
"Montgomery","1","19","Georgia","6/12/20","12","7","13209","58.33"
"Morgan","0","40","Georgia","6/12/20","39","1","13211","2.56"
"Murray","4","130","Georgia","6/12/20","100","30","13213","30"
"Muscogee","29","955","Georgia","6/12/20","750","205","13215","27.33"
"Newton","3","412","Georgia","6/12/20","388","24","13217","6.19"
"Oconee","1","128","Georgia","6/12/20","123","5","13219","4.07"
"Oglethorpe","1","71","Georgia","6/12/20","66","5","13221","7.58"
"Out of GA","34","2582","Georgia","6/12/20","2341","241","80013","10.29"
"Paulding","8","401","Georgia","6/12/20","347","54","13223","15.56"
"Peach","1","86","Georgia","6/12/20","76","10","13225","13.16"
"Pickens","1","59","Georgia","6/12/20","50","9","13227","18"
"Pierce","2","126","Georgia","6/12/20","114","12","13229","10.53"
"Pike","1","66","Georgia","6/12/20","59","7","13231","11.86"
"Polk","3","162","Georgia","6/12/20","139","23","13233","16.55"
"Pulaski","0","46","Georgia","6/12/20","43","3","13235","6.98"
"Putnam","1","104","Georgia","6/12/20","99","5","13237","5.05"
"Quitman","0","14","Georgia","6/12/20","14","0","13239","0"
"Rabun","1","30","Georgia","6/12/20","26","4","13241","15.38"
"Randolph","1","190","Georgia","6/12/20","181","9","13243","4.97"
"Richmond","6","664","Georgia","6/12/20","619","45","13245","7.27"
"Rockdale","4","333","Georgia","6/12/20","304","29","13247","9.54"
"Schley","0","18","Georgia","6/12/20","18","0","13249","0"
"Screven","1","61","Georgia","6/12/20","57","4","13251","7.02"
"Seminole","0","48","Georgia","6/12/20","46","2","13253","4.35"
"Spalding","2","309","Georgia","6/12/20","292","17","13255","5.82"
"Stephens","1","152","Georgia","6/12/20","143","9","13257","6.29"
"Stewart","1","60","Georgia","6/12/20","55","5","13259","9.09"
"Sumter","2","506","Georgia","6/12/20","493","13","13261","2.64"
"Talbot","1","45","Georgia","6/12/20","40","5","13263","12.5"
"Taliaferro","0","2","Georgia","6/12/20","1","1","13265","100"
"Tattnall","1","38","Georgia","6/12/20","30","8","13267","26.67"
"Taylor","0","25","Georgia","6/12/20","23","2","13269","8.7"
"Telfair","1","47","Georgia","6/12/20","38","9","13271","23.68"
"Terrell","0","218","Georgia","6/12/20","217","1","13273","0.46"
"Thomas","1","359","Georgia","6/12/20","350","9","13275","2.57"
"Tift","12","372","Georgia","6/12/20","291","81","13277","27.84"
"Toombs","5","96","Georgia","6/12/20","62","34","13279","54.84"
"Towns","0","32","Georgia","6/12/20","29","3","13281","10.34"
"Treutlen","0","17","Georgia","6/12/20","14","3","13283","21.43"
"Troup","44","701","Georgia","6/12/20","395","306","13285","77.47"
"Turner","1","148","Georgia","6/12/20","139","9","13287","6.47"
"Twiggs","0","21","Georgia","6/12/20","18","3","13289","16.67"
"Union","1","53","Georgia","6/12/20","48","5","13291","10.42"
"Upson","1","295","Georgia","6/12/20","290","5","13293","1.72"
"Walker","4","216","Georgia","6/12/20","189","27","13295","14.29"
"Walton","3","321","Georgia","6/12/20","297","24","13297","8.08"
"Ware","3","263","Georgia","6/12/20","240","23","13299","9.58"
"Warren","0","19","Georgia","6/12/20","18","1","13301","5.56"
"Washington","0","76","Georgia","6/12/20","74","2","13303","2.7"
"Wayne","1","33","Georgia","6/12/20","23","10","13305","43.48"
"Webster","0","14","Georgia","6/12/20","14","0","13307","0"
"Wheeler","0","16","Georgia","6/12/20","13","3","13309","23.08"
"White","2","124","Georgia","6/12/20","111","13","13311","11.71"
"Whitfield","18","562","Georgia","6/12/20","438","124","13313","28.31"
"Wilcox","0","117","Georgia","6/12/20","117","0","13315","0"
"Wilkes","0","35","Georgia","6/12/20","34","1","13317","2.94"
"Wilkinson","0","73","Georgia","6/12/20","71","2","13319","2.82"
"Worth","4","256","Georgia","6/12/20","231","25","13321","10.82"
"","0","103","Grand Princess","6/12/20","103","0",,"0"
"","1","183","Guam","6/12/20","179","4",,"2.23"
"Hawaii","0","81","Hawaii","6/12/20","81","0","15001","0"
"Honolulu","6","472","Hawaii","6/12/20","431","41","15003","9.51"
"Kauai","0","21","Hawaii","6/12/20","21","0","15007","0"
"Maui","0","120","Hawaii","6/12/20","120","0","15009","0"
"Out of HI","0","12","Hawaii","6/12/20","11","1","80015","9.09"
"Ada","6","877","Idaho","6/12/20","833","44","16001","5.28"
"Adams","0","4","Idaho","6/12/20","3","1","16003","33.33"
"Bannock","2","59","Idaho","6/12/20","45","14","16005","31.11"
"Benewah","0","19","Idaho","6/12/20","17","2","16009","11.76"
"Bingham","0","23","Idaho","6/12/20","20","3","16011","15"
"Blaine","0","515","Idaho","6/12/20","514","1","16013","0.19"
"Bonner","0","7","Idaho","6/12/20","6","1","16017","16.67"
"Bonneville","2","73","Idaho","6/12/20","60","13","16019","21.67"
"Camas","0","1","Idaho","6/12/20","1","0","16025","0"
"Canyon","3","356","Idaho","6/12/20","336","20","16027","5.95"
"Caribou","0","3","Idaho","6/12/20","3","0","16029","0"
"Cassia","3","131","Idaho","6/12/20","109","22","16031","20.18"
"Custer","0","2","Idaho","6/12/20","2","0","16037","0"
"Elmore","0","34","Idaho","6/12/20","32","2","16039","6.25"
"Franklin","1","12","Idaho","6/12/20","8","4","16041","50"
"Fremont","0","4","Idaho","6/12/20","4","0","16043","0"
"Gem","0","17","Idaho","6/12/20","17","0","16045","0"
"Gooding","0","58","Idaho","6/12/20","55","3","16047","5.45"
"Idaho","0","3","Idaho","6/12/20","3","0","16049","0"
"Jefferson","0","10","Idaho","6/12/20","9","1","16051","11.11"
"Jerome","2","205","Idaho","6/12/20","194","11","16053","5.67"
"Kootenai","2","98","Idaho","6/12/20","81","17","16055","20.99"
"Latah","0","7","Idaho","6/12/20","7","0","16057","0"
"Lemhi","0","1","Idaho","6/12/20","1","0","16059","0"
"Lincoln","0","35","Idaho","6/12/20","33","2","16063","6.06"
"Madison","0","29","Idaho","6/12/20","27","2","16065","7.41"
"Minidoka","4","98","Idaho","6/12/20","71","27","16067","38.03"
"Nez Perce","0","84","Idaho","6/12/20","83","1","16069","1.2"
"Owyhee","0","8","Idaho","6/12/20","8","0","16073","0"
"Payette","0","27","Idaho","6/12/20","26","1","16075","3.85"
"Power","0","9","Idaho","6/12/20","7","2","16077","28.57"
"Teton","0","11","Idaho","6/12/20","11","0","16081","0"
"Twin Falls","6","480","Idaho","6/12/20","437","43","16083","9.84"
"Valley","0","3","Idaho","6/12/20","2","1","16085","50"
"Washington","1","50","Idaho","6/12/20","46","4","16087","8.7"
"Adams","0","45","Illinois","6/12/20","44","1","17001","2.27"
"Alexander","0","16","Illinois","6/12/20","14","2","17003","14.29"
"Bond","0","12","Illinois","6/12/20","12","0","17005","0"
"Boone","3","518","Illinois","6/12/20","498","20","17007","4.02"
"Brown","0","10","Illinois","6/12/20","10","0","17009","0"
"Bureau","0","22","Illinois","6/12/20","21","1","17011","4.76"
"Calhoun","0","1","Illinois","6/12/20","1","0","17013","0"
"Carroll","0","18","Illinois","6/12/20","17","1","17015","5.88"
"Cass","0","77","Illinois","6/12/20","76","1","17017","1.32"
"Champaign","7","724","Illinois","6/12/20","677","47","17019","6.94"
"Christian","0","35","Illinois","6/12/20","35","0","17021","0"
"Clark","0","12","Illinois","6/12/20","11","1","17023","9.09"
"Clay","0","2","Illinois","6/12/20","2","0","17025","0"
"Clinton","2","203","Illinois","6/12/20","190","13","17027","6.84"
"Coles","1","142","Illinois","6/12/20","138","4","17029","2.9"
"Cook","415","84249","Illinois","6/12/20","81344","2905","17031","3.57"
"Crawford","0","13","Illinois","6/12/20","11","2","17033","18.18"
"Cumberland","0","10","Illinois","6/12/20","10","0","17035","0"
"De Witt","0","4","Illinois","6/12/20","4","0","17039","0"
"DeKalb","3","471","Illinois","6/12/20","450","21","17037","4.67"
"Douglas","1","33","Illinois","6/12/20","28","5","17041","17.86"
"DuPage","51","8355","Illinois","6/12/20","7997","358","17043","4.48"
"Edgar","0","1","Illinois","6/12/20","1","0","17045","0"
"Edwards","0","2","Illinois","6/12/20","2","0","17047","0"
"Effingham","0","8","Illinois","6/12/20","8","0","17049","0"
"Fayette","0","22","Illinois","6/12/20","21","1","17051","4.76"
"Ford","0","21","Illinois","6/12/20","21","0","17053","0"
"Franklin","0","12","Illinois","6/12/20","12","0","17055","0"
"Fulton","0","12","Illinois","6/12/20","12","0","17057","0"
"Gallatin","0","2","Illinois","6/12/20","2","0","17059","0"
"Greene","0","7","Illinois","6/12/20","6","1","17061","16.67"
"Grundy","2","128","Illinois","6/12/20","111","17","17063","15.32"
"Hamilton","0","2","Illinois","6/12/20","2","0","17065","0"
"Hancock","0","18","Illinois","6/12/20","17","1","17067","5.88"
"Hardin","0","1","Illinois","6/12/20","1","0","17069","0"
"Henderson","0","8","Illinois","6/12/20","8","0","17071","0"
"Henry","0","72","Illinois","6/12/20","70","2","17073","2.86"
"Iroquois","0","136","Illinois","6/12/20","135","1","17075","0.74"
"Jackson","2","311","Illinois","6/12/20","300","11","17077","3.67"
"Jasper","0","46","Illinois","6/12/20","46","0","17079","0"
"Jefferson","0","103","Illinois","6/12/20","101","2","17081","1.98"
"Jersey","1","28","Illinois","6/12/20","24","4","17083","16.67"
"Jo Daviess","0","34","Illinois","6/12/20","32","2","17085","6.25"
"Johnson","0","14","Illinois","6/12/20","11","3","17087","27.27"
"Kane","51","7030","Illinois","6/12/20","6672","358","17089","5.37"
"Kankakee","10","1059","Illinois","6/12/20","989","70","17091","7.08"
"Kendall","4","869","Illinois","6/12/20","839","30","17093","3.58"
"Knox","1","111","Illinois","6/12/20","102","9","17095","8.82"
"Lake","48","8980","Illinois","6/12/20","8647","333","17097","3.85"
"LaSalle","2","177","Illinois","6/12/20","160","17","17099","10.62"
"Lawrence","0","4","Illinois","6/12/20","4","0","17101","0"
"Lee","1","88","Illinois","6/12/20","82","6","17103","7.32"
"Livingston","0","36","Illinois","6/12/20","36","0","17105","0"
"Logan","0","10","Illinois","6/12/20","11","-1","17107","-9.09"
"Macon","1","206","Illinois","6/12/20","200","6","17115","3"
"Macoupin","0","46","Illinois","6/12/20","46","0","17117","0"
"Madison","8","683","Illinois","6/12/20","624","59","17119","9.46"
"Marion","0","55","Illinois","6/12/20","52","3","17121","5.77"
"Marshall","0","5","Illinois","6/12/20","5","0","17123","0"
"Mason","0","18","Illinois","6/12/20","18","0","17125","0"
"Massac","0","7","Illinois","6/12/20","7","0","17127","0"
"McDonough","2","102","Illinois","6/12/20","91","11","17109","12.09"
"McHenry","19","1810","Illinois","6/12/20","1677","133","17111","7.93"
"McLean","2","238","Illinois","6/12/20","226","12","17113","5.31"
"Menard","0","22","Illinois","6/12/20","22","0","17129","0"
"Mercer","0","18","Illinois","6/12/20","18","0","17131","0"
"Monroe","1","106","Illinois","6/12/20","100","6","17133","6"
"Montgomery","0","41","Illinois","6/12/20","41","0","17135","0"
"Morgan","9","105","Illinois","6/12/20","42","63","17137","150"
"Moultrie","0","13","Illinois","6/12/20","12","1","17139","8.33"
"Ogle","0","224","Illinois","6/12/20","225","-1","17141","-0.44"
"Out of IL","-1","111","Illinois","6/12/20","116","-5","80017","-4.31"
"Peoria","9","367","Illinois","6/12/20","301","66","17143","21.93"
"Perry","0","43","Illinois","6/12/20","42","1","17145","2.38"
"Piatt","0","11","Illinois","6/12/20","11","0","17147","0"
"Pike","0","2","Illinois","6/12/20","1","1","17149","100"
"Pope","0","1","Illinois","6/12/20","1","0","17151","0"
"Pulaski","0","59","Illinois","6/12/20","58","1","17153","1.72"
"Putnam","0","1","Illinois","6/12/20","1","0","17155","0"
"Randolph","0","276","Illinois","6/12/20","273","3","17157","1.1"
"Richland","0","4","Illinois","6/12/20","4","0","17159","0"
"Rock Island","5","737","Illinois","6/12/20","703","34","17161","4.84"
"Saline","0","7","Illinois","6/12/20","7","0","17165","0"
"Sangamon","2","377","Illinois","6/12/20","360","17","17167","4.72"
"Schuyler","0","13","Illinois","6/12/20","13","0","17169","0"
"Shelby","0","16","Illinois","6/12/20","16","0","17173","0"
"St. Clair","19","1392","Illinois","6/12/20","1262","130","17163","10.3"
"Stark","0","3","Illinois","6/12/20","3","0","17175","0"
"Stephenson","2","226","Illinois","6/12/20","211","15","17177","7.11"
"Tazewell","1","85","Illinois","6/12/20","81","4","17179","4.94"
"Union","0","172","Illinois","6/12/20","171","1","17181","0.58"
"Vermilion","0","44","Illinois","6/12/20","42","2","17183","4.76"
"Wabash","1","12","Illinois","6/12/20","6","6","17185","100"
"Warren","1","127","Illinois","6/12/20","122","5","17187","4.1"
"Washington","0","19","Illinois","6/12/20","19","0","17189","0"
"Wayne","0","9","Illinois","6/12/20","9","0","17191","0"
"White","0","2","Illinois","6/12/20","2","0","17193","0"
"Whiteside","2","161","Illinois","6/12/20","149","12","17195","8.05"
"Will","41","6086","Illinois","6/12/20","5799","287","17197","4.95"
"Williamson","1","80","Illinois","6/12/20","75","5","17199","6.67"
"Winnebago","29","2667","Illinois","6/12/20","2465","202","17201","8.19"
"Woodford","0","22","Illinois","6/12/20","21","1","17203","4.76"
"Adams","0","24","Indiana","6/12/20","23","1","18001","4.35"
"Allen","45","2127","Indiana","6/12/20","1810","317","18003","17.51"
"Bartholomew","2","547","Indiana","6/12/20","531","16","18005","3.01"
"Benton","1","37","Indiana","6/12/20","32","5","18007","15.62"
"Blackford","0","29","Indiana","6/12/20","27","2","18009","7.41"
"Boone","5","357","Indiana","6/12/20","324","33","18011","10.19"
"Brown","0","36","Indiana","6/12/20","33","3","18013","9.09"
"Carroll","0","98","Indiana","6/12/20","95","3","18015","3.16"
"Cass","1","1596","Indiana","6/12/20","1591","5","18017","0.31"
"Clark","3","559","Indiana","6/12/20","539","20","18019","3.71"
"Clay","0","56","Indiana","6/12/20","53","3","18021","5.66"
"Clinton","1","253","Indiana","6/12/20","247","6","18023","2.43"
"Crawford","0","27","Indiana","6/12/20","25","2","18025","8"
"Daviess","2","117","Indiana","6/12/20","104","13","18027","12.5"
"Dearborn","1","179","Indiana","6/12/20","171","8","18029","4.68"
"Decatur","1","235","Indiana","6/12/20","231","4","18031","1.73"
"DeKalb","7","95","Indiana","6/12/20","45","50","18033","111.11"
"Delaware","0","399","Indiana","6/12/20","397","2","18035","0.5"
"Dubois","4","236","Indiana","6/12/20","211","25","18037","11.85"
"Elkhart","49","1929","Indiana","6/12/20","1585","344","18039","21.7"
"Fayette","0","81","Indiana","6/12/20","79","2","18041","2.53"
"Floyd","2","333","Indiana","6/12/20","319","14","18043","4.39"
"Fountain","0","23","Indiana","6/12/20","22","1","18045","4.55"
"Franklin","0","119","Indiana","6/12/20","116","3","18047","2.59"
"Fulton","0","53","Indiana","6/12/20","51","2","18049","3.92"
"Gibson","0","22","Indiana","6/12/20","20","2","18051","10"
"Grant","3","253","Indiana","6/12/20","229","24","18053","10.48"
"Greene","1","177","Indiana","6/12/20","172","5","18055","2.91"
"Hamilton","8","1250","Indiana","6/12/20","1191","59","18057","4.95"
"Hancock","2","371","Indiana","6/12/20","354","17","18059","4.8"
"Harrison","0","198","Indiana","6/12/20","196","2","18061","1.02"
"Hendricks","8","1261","Indiana","6/12/20","1204","57","18063","4.73"
"Henry","2","201","Indiana","6/12/20","185","16","18065","8.65"
"Howard","2","458","Indiana","6/12/20","442","16","18067","3.62"
"Huntington","2","49","Indiana","6/12/20","38","11","18069","28.95"
"Jackson","2","414","Indiana","6/12/20","401","13","18071","3.24"
"Jasper","1","81","Indiana","6/12/20","74","7","18073","9.46"
"Jay","0","60","Indiana","6/12/20","58","2","18075","3.45"
"Jefferson","0","52","Indiana","6/12/20","49","3","18077","6.12"
"Jennings","1","139","Indiana","6/12/20","132","7","18079","5.3"
"Johnson","5","1160","Indiana","6/12/20","1125","35","18081","3.11"
"Knox","0","34","Indiana","6/12/20","31","3","18083","9.68"
"Kosciusko","10","277","Indiana","6/12/20","205","72","18085","35.12"
"LaGrange","15","235","Indiana","6/12/20","128","107","18087","83.59"
"Lake","29","4081","Indiana","6/12/20","3876","205","18089","5.29"
"LaPorte","2","465","Indiana","6/12/20","448","17","18091","3.79"
"Lawrence","1","176","Indiana","6/12/20","171","5","18093","2.92"
"Madison","2","612","Indiana","6/12/20","600","12","18095","2"
"Marion","56","10577","Indiana","6/12/20","10188","389","18097","3.82"
"Marshall","13","276","Indiana","6/12/20","187","89","18099","47.59"
"Martin","0","15","Indiana","6/12/20","14","1","18101","7.14"
"Miami","2","161","Indiana","6/12/20","146","15","18103","10.27"
"Monroe","2","185","Indiana","6/12/20","171","14","18105","8.19"
"Montgomery","2","262","Indiana","6/12/20","249","13","18107","5.22"
"Morgan","1","296","Indiana","6/12/20","286","10","18109","3.5"
"Newton","1","87","Indiana","6/12/20","80","7","18111","8.75"
"Noble","6","318","Indiana","6/12/20","278","40","18113","14.39"
"Ohio","0","13","Indiana","6/12/20","13","0","18115","0"
"Orange","0","132","Indiana","6/12/20","131","1","18117","0.76"
"Owen","0","37","Indiana","6/12/20","34","3","18119","8.82"
"Parke","0","20","Indiana","6/12/20","18","2","18121","11.11"
"Perry","4","68","Indiana","6/12/20","39","29","18123","74.36"
"Pike","0","6","Indiana","6/12/20","6","0","18125","0"
"Porter","3","585","Indiana","6/12/20","562","23","18127","4.09"
"Posey","0","18","Indiana","6/12/20","16","2","18129","12.5"
"Pulaski","0","52","Indiana","6/12/20","50","2","18131","4"
"Putnam","1","152","Indiana","6/12/20","142","10","18133","7.04"
"Randolph","2","64","Indiana","6/12/20","52","12","18135","23.08"
"Ripley","0","109","Indiana","6/12/20","108","1","18137","0.93"
"Rush","0","49","Indiana","6/12/20","51","-2","18139","-3.92"
"Scott","2","142","Indiana","6/12/20","126","16","18143","12.7"
"Shelby","1","405","Indiana","6/12/20","397","8","18145","2.02"
"Spencer","0","22","Indiana","6/12/20","22","0","18147","0"
"St. Joseph","20","1496","Indiana","6/12/20","1358","138","18141","10.16"
"Starke","1","48","Indiana","6/12/20","42","6","18149","14.29"
"Steuben","2","102","Indiana","6/12/20","90","12","18151","13.33"
"Sullivan","1","41","Indiana","6/12/20","37","4","18153","10.81"
"Switzerland","0","22","Indiana","6/12/20","22","0","18155","0"
"Tippecanoe","5","472","Indiana","6/12/20","434","38","18157","8.76"
"Tipton","0","27","Indiana","6/12/20","26","1","18159","3.85"
"Union","0","12","Indiana","6/12/20","10","2","18161","20"
"Vanderburgh","4","321","Indiana","6/12/20","291","30","18163","10.31"
"Vermillion","0","11","Indiana","6/12/20","10","1","18165","10"
"Vigo","2","198","Indiana","6/12/20","182","16","18167","8.79"
"Wabash","1","88","Indiana","6/12/20","81","7","18169","8.64"
"Warren","0","14","Indiana","6/12/20","13","1","18171","7.69"
"Warrick","1","171","Indiana","6/12/20","167","4","18173","2.4"
"Washington","1","56","Indiana","6/12/20","50","6","18175","12"
"Wayne","1","96","Indiana","6/12/20","90","6","18177","6.67"
"Wells","2","49","Indiana","6/12/20","35","14","18179","40"
"White","0","240","Indiana","6/12/20","239","1","18181","0.42"
"Whitley","2","60","Indiana","6/12/20","45","15","18183","33.33"
"Adair","0","11","Iowa","6/12/20","9","2","19001","22.22"
"Adams","0","7","Iowa","6/12/20","7","0","19003","0"
"Allamakee","0","121","Iowa","6/12/20","120","1","19005","0.83"
"Appanoose","0","16","Iowa","6/12/20","17","-1","19007","-5.88"
"Audubon","0","13","Iowa","6/12/20","13","0","19009","0"
"Benton","0","46","Iowa","6/12/20","43","3","19011","6.98"
"Black Hawk","5","1824","Iowa","6/12/20","1788","36","19013","2.01"
"Boone","3","93","Iowa","6/12/20","72","21","19015","29.17"
"Bremer","0","74","Iowa","6/12/20","71","3","19017","4.23"
"Buchanan","0","34","Iowa","6/12/20","34","0","19019","0"
"Buena Vista","58","1475","Iowa","6/12/20","1067","408","19021","38.24"
"Butler","0","19","Iowa","6/12/20","16","3","19023","18.75"
"Calhoun","1","19","Iowa","6/12/20","10","9","19025","90"
"Carroll","3","33","Iowa","6/12/20","15","18","19027","120"
"Cass","0","13","Iowa","6/12/20","13","0","19029","0"
"Cedar","0","53","Iowa","6/12/20","50","3","19031","6"
"Cerro Gordo","1","40","Iowa","6/12/20","33","7","19033","21.21"
"Cherokee","2","56","Iowa","6/12/20","41","15","19035","36.59"
"Chickasaw","0","15","Iowa","6/12/20","13","2","19037","15.38"
"Clarke","2","86","Iowa","6/12/20","69","17","19039","24.64"
"Clay","5","59","Iowa","6/12/20","27","32","19041","118.52"
"Clayton","0","35","Iowa","6/12/20","34","1","19043","2.94"
"Clinton","0","68","Iowa","6/12/20","65","3","19045","4.62"
"Crawford","6","593","Iowa","6/12/20","551","42","19047","7.62"
"Dallas","6","995","Iowa","6/12/20","952","43","19049","4.52"
"Davis","1","33","Iowa","6/12/20","28","5","19051","17.86"
"Decatur","0","4","Iowa","6/12/20","1","3","19053","300"
"Delaware","1","27","Iowa","6/12/20","19","8","19055","42.11"
"Des Moines","0","68","Iowa","6/12/20","68","0","19057","0"
"Dickinson","12","119","Iowa","6/12/20","35","84","19059","240"
"Dubuque","3","381","Iowa","6/12/20","359","22","19061","6.13"
"Emmet","2","38","Iowa","6/12/20","27","11","19063","40.74"
"Fayette","0","28","Iowa","6/12/20","27","1","19065","3.7"
"Floyd","0","20","Iowa","6/12/20","19","1","19067","5.26"
"Franklin","3","41","Iowa","6/12/20","20","21","19069","105"
"Fremont","0","4","Iowa","6/12/20","4","0","19071","0"
"Greene","1","20","Iowa","6/12/20","15","5","19073","33.33"
"Grundy","0","23","Iowa","6/12/20","20","3","19075","15"
"Guthrie","0","57","Iowa","6/12/20","55","2","19077","3.64"
"Hamilton","5","112","Iowa","6/12/20","76","36","19079","47.37"
"Hancock","1","26","Iowa","6/12/20","18","8","19081","44.44"
"Hardin","3","42","Iowa","6/12/20","24","18","19083","75"
"Harrison","1","33","Iowa","6/12/20","26","7","19085","26.92"
"Henry","0","73","Iowa","6/12/20","73","0","19087","0"
"Howard","0","12","Iowa","6/12/20","12","0","19089","0"
"Humboldt","1","30","Iowa","6/12/20","20","10","19091","50"
"Ida","0","17","Iowa","6/12/20","15","2","19093","13.33"
"Iowa","0","34","Iowa","6/12/20","34","0","19095","0"
"Jackson","0","14","Iowa","6/12/20","14","0","19097","0"
"Jasper","1","279","Iowa","6/12/20","269","10","19099","3.72"
"Jefferson","1","44","Iowa","6/12/20","36","8","19101","22.22"
"Johnson","2","635","Iowa","6/12/20","619","16","19103","2.58"
"Jones","0","40","Iowa","6/12/20","37","3","19105","8.11"
"Keokuk","0","15","Iowa","6/12/20","14","1","19107","7.14"
"Kossuth","0","16","Iowa","6/12/20","16","0","19109","0"
"Lee","1","37","Iowa","6/12/20","29","8","19111","27.59"
"Linn","5","1012","Iowa","6/12/20","978","34","19113","3.48"
"Louisa","1","355","Iowa","6/12/20","350","5","19115","1.43"
"Lucas","0","23","Iowa","6/12/20","22","1","19117","4.55"
"Lyon","1","29","Iowa","6/12/20","24","5","19119","20.83"
"Madison","0","31","Iowa","6/12/20","29","2","19121","6.9"
"Mahaska","1","107","Iowa","6/12/20","99","8","19123","8.08"
"Marion","1","40","Iowa","6/12/20","35","5","19125","14.29"
"Marshall","4","940","Iowa","6/12/20","914","26","19127","2.84"
"Mills","0","22","Iowa","6/12/20","20","2","19129","10"
"Mitchell","0","6","Iowa","6/12/20","4","2","19131","50"
"Monona","1","31","Iowa","6/12/20","26","5","19133","19.23"
"Monroe","1","47","Iowa","6/12/20","41","6","19135","14.63"
"Montgomery","0","9","Iowa","6/12/20","9","0","19137","0"
"Muscatine","1","571","Iowa","6/12/20","567","4","19139","0.71"
"O'Brien","3","64","Iowa","6/12/20","40","24","19141","60"
"Osceola","2","49","Iowa","6/12/20","36","13","19143","36.11"
"Page","0","16","Iowa","6/12/20","14","2","19145","14.29"
"Palo Alto","1","13","Iowa","6/12/20","7","6","19147","85.71"
"Plymouth","5","190","Iowa","6/12/20","152","38","19149","25"
"Pocahontas","1","30","Iowa","6/12/20","20","10","19151","50"
"Polk","59","5026","Iowa","6/12/20","4614","412","19153","8.93"
"Pottawattamie","23","482","Iowa","6/12/20","319","163","19155","51.1"
"Poweshiek","0","95","Iowa","6/12/20","92","3","19157","3.26"
"Ringgold","1","8","Iowa","6/12/20","4","4","19159","100"
"Sac","1","37","Iowa","6/12/20","28","9","19161","32.14"
"Scott","2","401","Iowa","6/12/20","385","16","19163","4.16"
"Shelby","1","43","Iowa","6/12/20","37","6","19165","16.22"
"Sioux","6","349","Iowa","6/12/20","306","43","19167","14.05"
"Story","11","210","Iowa","6/12/20","131","79","19169","60.31"
"Tama","2","426","Iowa","6/12/20","411","15","19171","3.65"
"Taylor","1","71","Iowa","6/12/20","66","5","19173","7.58"
"Union","0","10","Iowa","6/12/20","10","0","19175","0"
"Van Buren","0","11","Iowa","6/12/20","9","2","19177","22.22"
"Wapello","5","672","Iowa","6/12/20","636","36","19179","5.66"
"Warren","3","191","Iowa","6/12/20","167","24","19181","14.37"
"Washington","1","206","Iowa","6/12/20","196","10","19183","5.1"
"Wayne","0","4","Iowa","6/12/20","1","3","19185","300"
"Webster","3","94","Iowa","6/12/20","74","20","19187","27.03"
"Winnebago","0","12","Iowa","6/12/20","11","1","19189","9.09"
"Winneshiek","0","24","Iowa","6/12/20","24","0","19191","0"
"Woodbury","18","2987","Iowa","6/12/20","2861","126","19193","4.4"
"Worth","0","4","Iowa","6/12/20","3","1","19195","33.33"
"Wright","8","278","Iowa","6/12/20","221","57","19197","25.79"
"Allen","0","2","Kansas","6/12/20","1","1","20001","100"
"Anderson","0","1","Kansas","6/12/20","1","0","20003","0"
"Atchison","0","26","Kansas","6/12/20","23","3","20005","13.04"
"Barber","0","1","Kansas","6/12/20","1","0","20007","0"
"Barton","1","48","Kansas","6/12/20","44","4","20009","9.09"
"Bourbon","0","8","Kansas","6/12/20","8","0","20011","0"
"Brown","0","10","Kansas","6/12/20","7","3","20013","42.86"
"Butler","0","37","Kansas","6/12/20","37","0","20015","0"
"Chase","0","3","Kansas","6/12/20","4","-1","20017","-25"
"Chautauqua","0","4","Kansas","6/12/20","4","0","20019","0"
"Cherokee","1","16","Kansas","6/12/20","10","6","20021","60"
"Cheyenne","0","2","Kansas","6/12/20","2","0","20023","0"
"Clark","0","33","Kansas","6/12/20","33","0","20025","0"
"Clay","0","6","Kansas","6/12/20","5","1","20027","20"
"Cloud","0","5","Kansas","6/12/20","5","0","20029","0"
"Coffey","0","52","Kansas","6/12/20","51","1","20031","1.96"
"Comanche","0","2","Kansas","6/12/20","2","0","20033","0"
"Cowley","3","39","Kansas","6/12/20","17","22","20035","129.41"
"Crawford","2","20","Kansas","6/12/20","8","12","20037","150"
"Dickinson","0","6","Kansas","6/12/20","5","1","20041","20"
"Doniphan","0","20","Kansas","6/12/20","18","2","20043","11.11"
"Douglas","1","79","Kansas","6/12/20","69","10","20045","14.49"
"Edwards","0","5","Kansas","6/12/20","5","0","20047","0"
"Ellis","0","12","Kansas","6/12/20","10","2","20051","20"
"Ellsworth","0","3","Kansas","6/12/20","2","1","20053","50"
"Finney","2","1538","Kansas","6/12/20","1526","12","20055","0.79"
"Ford","4","1842","Kansas","6/12/20","1813","29","20057","1.6"
"Franklin","2","49","Kansas","6/12/20","35","14","20059","40"
"Geary","0","29","Kansas","6/12/20","26","3","20061","11.54"
"Gove","0","1","Kansas","6/12/20","1","0","20063","0"
"Grant","0","18","Kansas","6/12/20","18","0","20067","0"
"Gray","0","23","Kansas","6/12/20","23","0","20069","0"
"Greenwood","0","11","Kansas","6/12/20","9","2","20073","22.22"
"Hamilton","1","27","Kansas","6/12/20","20","7","20075","35"
"Harper","0","2","Kansas","6/12/20","2","0","20077","0"
"Harvey","0","12","Kansas","6/12/20","11","1","20079","9.09"
"Haskell","0","22","Kansas","6/12/20","22","0","20081","0"
"Hodgeman","0","5","Kansas","6/12/20","5","0","20083","0"
"Jackson","0","102","Kansas","6/12/20","103","-1","20085","-0.97"
"Jefferson","0","22","Kansas","6/12/20","22","0","20087","0"
"Jewell","0","4","Kansas","6/12/20","4","0","20089","0"
"Johnson","15","1015","Kansas","6/12/20","910","105","20091","11.54"
"Kearny","0","46","Kansas","6/12/20","45","1","20093","2.22"
"Kiowa","0","3","Kansas","6/12/20","3","0","20097","0"
"Labette","1","27","Kansas","6/12/20","22","5","20099","22.73"
"Lane","0","4","Kansas","6/12/20","4","0","20101","0"
"Leavenworth","1","1106","Kansas","6/12/20","1100","6","20103","0.55"
"Linn","0","11","Kansas","6/12/20","11","0","20107","0"
"Lyon","3","406","Kansas","6/12/20","387","19","20111","4.91"
"Marion","0","5","Kansas","6/12/20","5","0","20115","0"
"McPherson","1","38","Kansas","6/12/20","30","8","20113","26.67"
"Meade","0","30","Kansas","6/12/20","30","0","20119","0"
"Miami","1","16","Kansas","6/12/20","7","9","20121","128.57"
"Mitchell","0","4","Kansas","6/12/20","4","0","20123","0"
"Montgomery","0","22","Kansas","6/12/20","20","2","20125","10"
"Morris","0","5","Kansas","6/12/20","5","0","20127","0"
"Morton","0","6","Kansas","6/12/20","6","0","20129","0"
"Nemaha","0","20","Kansas","6/12/20","19","1","20131","5.26"
"Neosho","1","6","Kansas","6/12/20","2","4","20133","200"
"Ness","0","4","Kansas","6/12/20","4","0","20135","0"
"Norton","0","3","Kansas","6/12/20","2","1","20137","50"
"Osage","0","10","Kansas","6/12/20","9","1","20139","11.11"
"Osborne","0","2","Kansas","6/12/20","2","0","20141","0"
"Ottawa","0","4","Kansas","6/12/20","4","0","20143","0"
"Pawnee","0","3","Kansas","6/12/20","2","1","20145","50"
"Phillips","0","2","Kansas","6/12/20","2","0","20147","0"
"Pottawatomie","1","32","Kansas","6/12/20","27","5","20149","18.52"
"Pratt","0","2","Kansas","6/12/20","2","0","20151","0"
"Reno","0","48","Kansas","6/12/20","45","3","20155","6.67"
"Republic","0","4","Kansas","6/12/20","4","0","20157","0"
"Rice","0","4","Kansas","6/12/20","4","0","20159","0"
"Riley","1","74","Kansas","6/12/20","68","6","20161","8.82"
"Rooks","0","6","Kansas","6/12/20","7","-1","20163","-14.29"
"Saline","0","28","Kansas","6/12/20","25","3","20169","12"
"Scott","0","16","Kansas","6/12/20","14","2","20171","14.29"
"Sedgwick","13","728","Kansas","6/12/20","635","93","20173","14.65"
"Seward","5","924","Kansas","6/12/20","891","33","20175","3.7"
"Shawnee","10","435","Kansas","6/12/20","367","68","20177","18.53"
"Sheridan","0","2","Kansas","6/12/20","2","0","20179","0"
"Sherman","0","7","Kansas","6/12/20","7","0","20181","0"
"Smith","0","2","Kansas","6/12/20","2","0","20183","0"
"Stafford","0","1","Kansas","6/12/20","1","0","20185","0"
"Stanton","0","9","Kansas","6/12/20","10","-1","20187","-10"
"Stevens","0","31","Kansas","6/12/20","30","1","20189","3.33"
"Sumner","0","9","Kansas","6/12/20","8","1","20191","12.5"
"Trego","0","1","Kansas","6/12/20","1","0","20195","0"
"Wabaunsee","0","31","Kansas","6/12/20","31","0","20197","0"
"Washington","0","1","Kansas","6/12/20","0","1","20201","1"
"Wilson","0","1","Kansas","6/12/20","1","0","20205","0"
"Woodson","0","6","Kansas","6/12/20","6","0","20207","0"
"Wyandotte","22","1626","Kansas","6/12/20","1471","155","20209","10.54"
"Adair","0","101","Kentucky","6/12/20","98","3","21001","3.06"
"Allen","4","127","Kentucky","6/12/20","102","25","21003","24.51"
"Anderson","0","25","Kentucky","6/12/20","22","3","21005","13.64"
"Ballard","0","14","Kentucky","6/12/20","12","2","21007","16.67"
"Barren","1","61","Kentucky","6/12/20","53","8","21009","15.09"
"Bath","0","10","Kentucky","6/12/20","9","1","21011","11.11"
"Bell","0","3","Kentucky","6/12/20","2","1","21013","50"
"Boone","4","538","Kentucky","6/12/20","508","30","21015","5.91"
"Bourbon","1","22","Kentucky","6/12/20","12","10","21017","83.33"
"Boyd","0","43","Kentucky","6/12/20","42","1","21019","2.38"
"Boyle","0","28","Kentucky","6/12/20","28","0","21021","0"
"Bracken","0","14","Kentucky","6/12/20","14","0","21023","0"
"Breathitt","0","3","Kentucky","6/12/20","3","0","21025","0"
"Breckinridge","0","21","Kentucky","6/12/20","19","2","21027","10.53"
"Bullitt","1","128","Kentucky","6/12/20","119","9","21029","7.56"
"Butler","1","243","Kentucky","6/12/20","236","7","21031","2.97"
"Caldwell","0","12","Kentucky","6/12/20","12","0","21033","0"
"Calloway","0","57","Kentucky","6/12/20","54","3","21035","5.56"
"Campbell","1","201","Kentucky","6/12/20","194","7","21037","3.61"
"Carlisle","0","5","Kentucky","6/12/20","5","0","21039","0"
"Carroll","0","16","Kentucky","6/12/20","15","1","21041","6.67"
"Carter","0","17","Kentucky","6/12/20","14","3","21043","21.43"
"Casey","0","10","Kentucky","6/12/20","8","2","21045","25"
"Christian","2","137","Kentucky","6/12/20","123","14","21047","11.38"
"Clark","1","68","Kentucky","6/12/20","58","10","21049","17.24"
"Clay","1","12","Kentucky","6/12/20","8","4","21051","50"
"Clinton","0","5","Kentucky","6/12/20","5","0","21053","0"
"Crittenden","0","7","Kentucky","6/12/20","7","0","21055","0"
"Cumberland","0","5","Kentucky","6/12/20","5","0","21057","0"
"Daviess","2","350","Kentucky","6/12/20","339","11","21059","3.24"
"Edmonson","1","63","Kentucky","6/12/20","58","5","21061","8.62"
"Elliott","0","1","Kentucky","6/12/20","1","0","21063","0"
"Estill","0","3","Kentucky","6/12/20","1","2","21065","200"
"Fayette","22","995","Kentucky","6/12/20","840","155","21067","18.45"
"Fleming","0","4","Kentucky","6/12/20","2","2","21069","100"
"Floyd","0","17","Kentucky","6/12/20","17","0","21071","0"
"Franklin","3","92","Kentucky","6/12/20","73","19","21073","26.03"
"Fulton","0","12","Kentucky","6/12/20","10","2","21075","20"
"Gallatin","1","51","Kentucky","6/12/20","46","5","21077","10.87"
"Garrard","1","9","Kentucky","6/12/20","5","4","21079","80"
"Grant","1","52","Kentucky","6/12/20","47","5","21081","10.64"
"Graves","0","168","Kentucky","6/12/20","166","2","21083","1.2"
"Grayson","0","136","Kentucky","6/12/20","134","2","21085","1.49"
"Green","0","2","Kentucky","6/12/20","2","0","21087","0"
"Greenup","0","14","Kentucky","6/12/20","14","0","21089","0"
"Hancock","0","9","Kentucky","6/12/20","7","2","21091","28.57"
"Hardin","2","133","Kentucky","6/12/20","119","14","21093","11.76"
"Harlan","1","8","Kentucky","6/12/20","4","4","21095","100"
"Harrison","1","32","Kentucky","6/12/20","28","4","21097","14.29"
"Hart","1","30","Kentucky","6/12/20","24","6","21099","25"
"Henderson","1","124","Kentucky","6/12/20","118","6","21101","5.08"
"Henry","0","25","Kentucky","6/12/20","23","2","21103","8.7"
"Hickman","0","5","Kentucky","6/12/20","5","0","21105","0"
"Hopkins","0","225","Kentucky","6/12/20","224","1","21107","0.45"
"Jackson","0","63","Kentucky","6/12/20","61","2","21109","3.28"
"Jefferson","62","3278","Kentucky","6/12/20","2843","435","21111","15.3"
"Jessamine","1","79","Kentucky","6/12/20","69","10","21113","14.49"
"Johnson","0","5","Kentucky","6/12/20","5","0","21115","0"
"Kenton","3","681","Kentucky","6/12/20","663","18","21117","2.71"
"Knott","0","4","Kentucky","6/12/20","4","0","21119","0"
"Knox","0","10","Kentucky","6/12/20","10","0","21121","0"
"Larue","0","11","Kentucky","6/12/20","9","2","21123","22.22"
"Laurel","1","25","Kentucky","6/12/20","21","4","21125","19.05"
"Lawrence","0","5","Kentucky","6/12/20","5","0","21127","0"
"Lee","0","1","Kentucky","6/12/20","1","0","21129","0"
"Leslie","0","6","Kentucky","6/12/20","6","0","21131","0"
"Letcher","0","3","Kentucky","6/12/20","3","0","21133","0"
"Lewis","0","9","Kentucky","6/12/20","7","2","21135","28.57"
"Lincoln","1","15","Kentucky","6/12/20","11","4","21137","36.36"
"Livingston","0","9","Kentucky","6/12/20","9","0","21139","0"
"Logan","3","187","Kentucky","6/12/20","164","23","21141","14.02"
"Lyon","0","17","Kentucky","6/12/20","15","2","21143","13.33"
"Madison","2","72","Kentucky","6/12/20","57","15","21151","26.32"
"Magoffin","0","4","Kentucky","6/12/20","2","2","21153","100"
"Marion","1","41","Kentucky","6/12/20","31","10","21155","32.26"
"Marshall","1","41","Kentucky","6/12/20","37","4","21157","10.81"
"Martin","0","3","Kentucky","6/12/20","3","0","21159","0"
"Mason","1","16","Kentucky","6/12/20","12","4","21161","33.33"
"McCracken","1","116","Kentucky","6/12/20","111","5","21145","4.5"
"McCreary","0","13","Kentucky","6/12/20","13","0","21147","0"
"McLean","0","23","Kentucky","6/12/20","22","1","21149","4.55"
"Meade","0","23","Kentucky","6/12/20","23","0","21163","0"
"Menifee","0","10","Kentucky","6/12/20","10","0","21165","0"
"Mercer","0","16","Kentucky","6/12/20","15","1","21167","6.67"
"Metcalfe","0","7","Kentucky","6/12/20","7","0","21169","0"
"Monroe","0","27","Kentucky","6/12/20","25","2","21171","8"
"Montgomery","1","33","Kentucky","6/12/20","25","8","21173","32"
"Morgan","0","6","Kentucky","6/12/20","3","3","21175","100"
"Muhlenberg","0","482","Kentucky","6/12/20","480","2","21177","0.42"
"Nelson","0","47","Kentucky","6/12/20","44","3","21179","6.82"
"Nicholas","0","4","Kentucky","6/12/20","4","0","21181","0"
"Ohio","2","162","Kentucky","6/12/20","151","11","21183","7.28"
"Oldham","0","112","Kentucky","6/12/20","109","3","21185","2.75"
"Owen","0","4","Kentucky","6/12/20","3","1","21187","33.33"
"Owsley","0","2","Kentucky","6/12/20","2","0","21189","0"
"Pendleton","0","14","Kentucky","6/12/20","14","0","21191","0"
"Perry","0","23","Kentucky","6/12/20","22","1","21193","4.55"
"Pike","1","38","Kentucky","6/12/20","34","4","21195","11.76"
"Powell","0","4","Kentucky","6/12/20","1","3","21197","300"
"Pulaski","1","71","Kentucky","6/12/20","64","7","21199","10.94"
"Rockcastle","0","14","Kentucky","6/12/20","13","1","21203","7.69"
"Rowan","1","13","Kentucky","6/12/20","7","6","21205","85.71"
"Russell","1","37","Kentucky","6/12/20","30","7","21207","23.33"
"Scott","0","40","Kentucky","6/12/20","37","3","21209","8.11"
"Shelby","6","256","Kentucky","6/12/20","214","42","21211","19.63"
"Simpson","0","57","Kentucky","6/12/20","55","2","21213","3.64"
"Spencer","0","25","Kentucky","6/12/20","24","1","21215","4.17"
"Taylor","0","16","Kentucky","6/12/20","13","3","21217","23.08"
"Todd","0","23","Kentucky","6/12/20","23","0","21219","0"
"Trigg","1","16","Kentucky","6/12/20","11","5","21221","45.45"
"Trimble","0","4","Kentucky","6/12/20","6","-2","21223","-33.33"
"Union","0","16","Kentucky","6/12/20","15","1","21225","6.67"
"Warren","16","1208","Kentucky","6/12/20","1099","109","21227","9.92"
"Washington","0","10","Kentucky","6/12/20","8","2","21229","25"
"Wayne","0","10","Kentucky","6/12/20","9","1","21231","11.11"
"Webster","0","34","Kentucky","6/12/20","34","0","21233","0"
"Whitley","1","17","Kentucky","6/12/20","13","4","21235","30.77"
"Wolfe","0","1","Kentucky","6/12/20","1","0","21237","0"
"Woodford","2","45","Kentucky","6/12/20","32","13","21239","40.62"
"Acadia","10","535","Louisiana","6/12/20","467","68","22001","14.56"
"Allen","1","193","Louisiana","6/12/20","186","7","22003","3.76"
"Ascension","8","918","Louisiana","6/12/20","865","53","22005","6.13"
"Assumption","1","258","Louisiana","6/12/20","253","5","22007","1.98"
"Avoyelles","4","181","Louisiana","6/12/20","151","30","22009","19.87"
"Beauregard","4","127","Louisiana","6/12/20","99","28","22011","28.28"
"Bienville","3","170","Louisiana","6/12/20","151","19","22013","12.58"
"Bossier","5","488","Louisiana","6/12/20","450","38","22015","8.44"
"Caddo","15","2803","Louisiana","6/12/20","2699","104","22017","3.85"
"Calcasieu","11","701","Louisiana","6/12/20","625","76","22019","12.16"
"Caldwell","1","76","Louisiana","6/12/20","70","6","22021","8.57"
"Cameron","0","11","Louisiana","6/12/20","8","3","22023","37.5"
"Catahoula","1","124","Louisiana","6/12/20","120","4","22025","3.33"
"Claiborne","1","73","Louisiana","6/12/20","66","7","22027","10.61"
"Concordia","0","97","Louisiana","6/12/20","95","2","22029","2.11"
"De Soto","1","269","Louisiana","6/12/20","262","7","22031","2.67"
"East Baton Rouge","39","4150","Louisiana","6/12/20","3874","276","22033","7.12"
"East Carroll","5","216","Louisiana","6/12/20","184","32","22035","17.39"
"East Feliciana","2","216","Louisiana","6/12/20","199","17","22037","8.54"
"Evangeline","1","87","Louisiana","6/12/20","81","6","22039","7.41"
"Franklin","2","395","Louisiana","6/12/20","383","12","22041","3.13"
"Grant","3","54","Louisiana","6/12/20","34","20","22043","58.82"
"Iberia","2","435","Louisiana","6/12/20","422","13","22045","3.08"
"Iberville","3","610","Louisiana","6/12/20","588","22","22047","3.74"
"Jackson","5","154","Louisiana","6/12/20","120","34","22049","28.33"
"Jefferson","41","8091","Louisiana","6/12/20","7803","288","22051","3.69"
"Jefferson Davis","4","114","Louisiana","6/12/20","87","27","22053","31.03"
"Lafayette","19","988","Louisiana","6/12/20","854","134","22055","15.69"
"Lafourche","8","945","Louisiana","6/12/20","886","59","22057","6.66"
"LaSalle","2","72","Louisiana","6/12/20","58","14","22059","24.14"
"Lincoln","5","202","Louisiana","6/12/20","165","37","22061","22.42"
"Livingston","8","514","Louisiana","6/12/20","458","56","22063","12.23"
"Madison","19","251","Louisiana","6/12/20","121","130","22065","107.44"
"Morehouse","1","138","Louisiana","6/12/20","132","6","22067","4.55"
"Natchitoches","2","188","Louisiana","6/12/20","173","15","22069","8.67"
"Orleans","16","7319","Louisiana","6/12/20","7206","113","22071","1.57"
"Ouachita","40","1679","Louisiana","6/12/20","1396","283","22073","20.27"
"Plaquemines","1","223","Louisiana","6/12/20","218","5","22075","2.29"
"Pointe Coupee","1","217","Louisiana","6/12/20","208","9","22077","4.33"
"Rapides","30","1098","Louisiana","6/12/20","890","208","22079","23.37"
"Red River","0","52","Louisiana","6/12/20","51","1","22081","1.96"
"Richland","2","160","Louisiana","6/12/20","148","12","22083","8.11"
"Sabine","0","53","Louisiana","6/12/20","50","3","22085","6"
"St. Bernard","2","562","Louisiana","6/12/20","548","14","22087","2.55"
"St. Charles","1","655","Louisiana","6/12/20","647","8","22089","1.24"
"St. Helena","0","56","Louisiana","6/12/20","53","3","22091","5.66"
"St. James","1","308","Louisiana","6/12/20","304","4","22093","1.32"
"St. John the Baptist","2","886","Louisiana","6/12/20","873","13","22095","1.49"
"St. Landry","3","326","Louisiana","6/12/20","308","18","22097","5.84"
"St. Martin","5","316","Louisiana","6/12/20","281","35","22099","12.46"
"St. Mary","2","348","Louisiana","6/12/20","333","15","22101","4.5"
"St. Tammany","12","1906","Louisiana","6/12/20","1823","83","22103","4.55"
"Tangipahoa","12","1001","Louisiana","6/12/20","916","85","22105","9.28"
"Tensas","0","21","Louisiana","6/12/20","20","1","22107","5"
"Terrebonne","8","780","Louisiana","6/12/20","724","56","22109","7.73"
"Union","6","385","Louisiana","6/12/20","343","42","22111","12.24"
"Vermilion","1","69","Louisiana","6/12/20","59","10","22113","16.95"
"Vernon","2","43","Louisiana","6/12/20","31","12","22115","38.71"
"Washington","9","520","Louisiana","6/12/20","457","63","22117","13.79"
"Webster","4","206","Louisiana","6/12/20","175","31","22119","17.71"
"West Baton Rouge","3","200","Louisiana","6/12/20","180","20","22121","11.11"
"West Carroll","4","99","Louisiana","6/12/20","68","31","22123","45.59"
"West Feliciana","1","226","Louisiana","6/12/20","220","6","22125","2.73"
"Winn","2","197","Louisiana","6/12/20","182","15","22127","8.24"
"Androscoggin","11","415","Maine","6/12/20","338","77","23001","22.78"
"Aroostook","0","10","Maine","6/12/20","10","0","23003","0"
"Cumberland","18","1388","Maine","6/12/20","1265","123","23005","9.72"
"Franklin","0","37","Maine","6/12/20","36","1","23007","2.78"
"Hancock","0","13","Maine","6/12/20","12","1","23009","8.33"
"Kennebec","1","134","Maine","6/12/20","129","5","23011","3.88"
"Knox","0","21","Maine","6/12/20","21","0","23013","0"
"Lincoln","0","21","Maine","6/12/20","20","1","23015","5"
"Oxford","0","31","Maine","6/12/20","32","-1","23017","-3.12"
"Penobscot","0","102","Maine","6/12/20","101","1","23019","0.99"
"Piscataquis","0","1","Maine","6/12/20","1","0","23021","0"
"Sagadahoc","0","30","Maine","6/12/20","30","0","23023","0"
"Somerset","0","25","Maine","6/12/20","22","3","23025","13.64"
"Waldo","0","55","Maine","6/12/20","52","3","23027","5.77"
"Washington","0","1","Maine","6/12/20","1","0","23029","0"
"York","4","433","Maine","6/12/20","408","25","23031","6.13"
"Allegany","1","187","Maryland","6/12/20","183","4","24001","2.19"
"Anne Arundel","43","4453","Maryland","6/12/20","4150","303","24003","7.3"
"Baltimore","66","7051","Maryland","6/12/20","6590","461","24005","7"
"Baltimore City","74","6559","Maryland","6/12/20","6038","521","24510","8.63"
"Calvert","2","370","Maryland","6/12/20","353","17","24009","4.82"
"Caroline","2","279","Maryland","6/12/20","268","11","24011","4.1"
"Carroll","2","977","Maryland","6/12/20","960","17","24013","1.77"
"Cecil","6","435","Maryland","6/12/20","393","42","24015","10.69"
"Charles","9","1248","Maryland","6/12/20","1185","63","24017","5.32"
"Dorchester","1","160","Maryland","6/12/20","153","7","24019","4.58"
"Frederick","22","2225","Maryland","6/12/20","2069","156","24021","7.54"
"Garrett","0","10","Maryland","6/12/20","10","0","24023","0"
"Harford","7","991","Maryland","6/12/20","939","52","24025","5.54"
"Howard","37","2332","Maryland","6/12/20","2074","258","24027","12.44"
"Kent","1","189","Maryland","6/12/20","184","5","24029","2.72"
"Montgomery","131","13348","Maryland","6/12/20","12434","914","24031","7.35"
"Prince George's","125","17042","Maryland","6/12/20","16169","873","24033","5.4"
"Queen Anne's","2","179","Maryland","6/12/20","163","16","24035","9.82"
"Somerset","0","78","Maryland","6/12/20","76","2","24039","2.63"
"St. Mary's","4","575","Maryland","6/12/20","547","28","24037","5.12"
"Talbot","0","107","Maryland","6/12/20","106","1","24041","0.94"
"Washington","6","568","Maryland","6/12/20","529","39","24043","7.37"
"Wicomico","5","1004","Maryland","6/12/20","967","37","24045","3.83"
"Worcester","2","246","Maryland","6/12/20","230","16","24047","6.96"
"Barnstable","5","1479","Massachusetts","6/12/20","1446","33","25001","2.28"
"Berkshire","1","575","Massachusetts","6/12/20","571","4","25003","0.7"
"Bristol","43","7872","Massachusetts","6/12/20","7573","299","25005","3.95"
"Dukes and Nantucket","0","55","Massachusetts","6/12/20","56","-1","00000","-1.79"
"Essex","65","15518","Massachusetts","6/12/20","15064","454","25009","3.01"
"Franklin","2","348","Massachusetts","6/12/20","337","11","25011","3.26"
"Hampden","19","6431","Massachusetts","6/12/20","6297","134","25013","2.13"
"Hampshire","3","918","Massachusetts","6/12/20","900","18","25015","2"
"Middlesex","70","23075","Massachusetts","6/12/20","22583","492","25017","2.18"
"Norfolk","28","8842","Massachusetts","6/12/20","8646","196","25021","2.27"
"Plymouth","21","8462","Massachusetts","6/12/20","8313","149","25023","1.79"
"Suffolk","56","19249","Massachusetts","6/12/20","18858","391","25025","2.07"
"Worcester","48","11937","Massachusetts","6/12/20","11600","337","25027","2.91"
"Alcona","0","20","Michigan","6/12/20","20","0","26001","0"
"Alger","0","1","Michigan","6/12/20","0","1","26003","1"
"Allegan","1","280","Michigan","6/12/20","271","9","26005","3.32"
"Alpena","0","113","Michigan","6/12/20","112","1","26007","0.89"
"Antrim","0","14","Michigan","6/12/20","14","0","26009","0"
"Arenac","0","38","Michigan","6/12/20","38","0","26011","0"
"Baraga","0","1","Michigan","6/12/20","1","0","26013","0"
"Barry","1","91","Michigan","6/12/20","87","4","26015","4.6"
"Bay","2","381","Michigan","6/12/20","369","12","26017","3.25"
"Benzie","0","5","Michigan","6/12/20","5","0","26019","0"
"Berrien","2","816","Michigan","6/12/20","800","16","26021","2"
"Branch","1","161","Michigan","6/12/20","153","8","26023","5.23"
"Calhoun","2","481","Michigan","6/12/20","465","16","26025","3.44"
"Cass","1","114","Michigan","6/12/20","109","5","26027","4.59"
"Charlevoix","0","20","Michigan","6/12/20","19","1","26029","5.26"
"Cheboygan","0","26","Michigan","6/12/20","26","0","26031","0"
"Chippewa","0","3","Michigan","6/12/20","3","0","26033","0"
"Clare","0","24","Michigan","6/12/20","24","0","26035","0"
"Clinton","1","188","Michigan","6/12/20","184","4","26037","2.17"
"Crawford","0","63","Michigan","6/12/20","63","0","26039","0"
"Delta","0","21","Michigan","6/12/20","20","1","26041","5"
"Dickinson","0","7","Michigan","6/12/20","6","1","26043","16.67"
"Eaton","1","256","Michigan","6/12/20","251","5","26045","1.99"
"Emmet","0","26","Michigan","6/12/20","26","0","26047","0"
"Federal Correctional Institution (FCI)","1","163","Michigan","6/12/20","156","7","00000","4.49"
"Genesee","2","2566","Michigan","6/12/20","2549","17","26049","0.67"
"Gladwin","0","20","Michigan","6/12/20","19","1","26051","5.26"
"Gogebic","0","5","Michigan","6/12/20","5","0","26053","0"
"Grand Traverse","0","36","Michigan","6/12/20","34","2","26055","5.88"
"Gratiot","0","88","Michigan","6/12/20","88","0","26057","0"
"Hillsdale","0","179","Michigan","6/12/20","178","1","26059","0.56"
"Houghton","0","8","Michigan","6/12/20","7","1","26061","14.29"
"Huron","0","60","Michigan","6/12/20","58","2","26063","3.45"
"Ingham","2","815","Michigan","6/12/20","804","11","26065","1.37"
"Ionia","1","179","Michigan","6/12/20","175","4","26067","2.29"
"Iosco","0","111","Michigan","6/12/20","110","1","26069","0.91"
"Iron","0","2","Michigan","6/12/20","2","0","26071","0"
"Isabella","0","95","Michigan","6/12/20","94","1","26073","1.06"
"Jackson","0","484","Michigan","6/12/20","482","2","26075","0.41"
"Kalamazoo","3","949","Michigan","6/12/20","931","18","26077","1.93"
"Kalkaska","0","30","Michigan","6/12/20","30","0","26079","0"
"Kent","29","4420","Michigan","6/12/20","4215","205","26081","4.86"
"Keweenaw","0","1","Michigan","6/12/20","0","1","26083","1"
"Lake","0","7","Michigan","6/12/20","7","0","26085","0"
"Lapeer","0","226","Michigan","6/12/20","225","1","26087","0.44"
"Leelanau","0","12","Michigan","6/12/20","11","1","26089","9.09"
"Lenawee","1","195","Michigan","6/12/20","191","4","26091","2.09"
"Livingston","1","520","Michigan","6/12/20","516","4","26093","0.78"
"Luce","0","3","Michigan","6/12/20","3","0","26095","0"
"Mackinac","0","8","Michigan","6/12/20","8","0","26097","0"
"Macomb","4","7016","Michigan","6/12/20","6985","31","26099","0.44"
"Manistee","0","12","Michigan","6/12/20","12","0","26101","0"
"Marquette","0","59","Michigan","6/12/20","59","0","26103","0"
"Mason","0","38","Michigan","6/12/20","38","0","26105","0"
"Mecosta","0","24","Michigan","6/12/20","24","0","26107","0"
"Menominee","0","9","Michigan","6/12/20","9","0","26109","0"
"Michigan Department of Corrections (MDOC)","5","4154","Michigan","6/12/20","4118","36","00000","0.87"
"Midland","2","145","Michigan","6/12/20","128","17","26111","13.28"
"Missaukee","0","23","Michigan","6/12/20","22","1","26113","4.55"
"Monroe","0","562","Michigan","6/12/20","559","3","26115","0.54"
"Montcalm","0","80","Michigan","6/12/20","77","3","26117","3.9"
"Montmorency","0","5","Michigan","6/12/20","5","0","26119","0"
"Muskegon","3","733","Michigan","6/12/20","714","19","26121","2.66"
"Newaygo","0","125","Michigan","6/12/20","122","3","26123","2.46"
"Oakland","12","11286","Michigan","6/12/20","11205","81","26125","0.72"
"Oceana","1","105","Michigan","6/12/20","101","4","26127","3.96"
"Ogemaw","0","32","Michigan","6/12/20","31","1","26129","3.23"
"Osceola","0","18","Michigan","6/12/20","17","1","26133","5.88"
"Oscoda","0","8","Michigan","6/12/20","8","0","26135","0"
"Otsego","0","120","Michigan","6/12/20","120","0","26137","0"
"Ottawa","4","922","Michigan","6/12/20","895","27","26139","3.02"
"Out of MI","2","36","Michigan","6/12/20","22","14","80026","63.64"
"Presque Isle","0","12","Michigan","6/12/20","11","1","26141","9.09"
"Roscommon","0","25","Michigan","6/12/20","24","1","26143","4.17"
"Saginaw","2","1147","Michigan","6/12/20","1135","12","26145","1.06"
"Sanilac","0","43","Michigan","6/12/20","42","1","26151","2.38"
"Schoolcraft","0","4","Michigan","6/12/20","4","0","26153","0"
"Shiawassee","0","264","Michigan","6/12/20","261","3","26155","1.15"
"St. Clair","0","513","Michigan","6/12/20","513","0","26147","0"
"St. Joseph","2","171","Michigan","6/12/20","154","17","26149","11.04"
"Tuscola","0","208","Michigan","6/12/20","205","3","26157","1.46"
"Van Buren","3","200","Michigan","6/12/20","177","23","26159","12.99"
"Washtenaw","3","1560","Michigan","6/12/20","1541","19","26161","1.23"
"Wayne","23","21660","Michigan","6/12/20","21499","161","26163","0.75"
"Wexford","0","15","Michigan","6/12/20","14","1","26165","7.14"
"Aitkin","0","13","Minnesota","6/12/20","12","1","27001","8.33"
"Anoka","23","1691","Minnesota","6/12/20","1527","164","27003","10.74"
"Becker","0","47","Minnesota","6/12/20","44","3","27005","6.82"
"Beltrami","0","21","Minnesota","6/12/20","18","3","27007","16.67"
"Benton","1","190","Minnesota","6/12/20","185","5","27009","2.7"
"Big Stone","0","12","Minnesota","6/12/20","11","1","27011","9.09"
"Blue Earth","1","159","Minnesota","6/12/20","149","10","27013","6.71"
"Brown","0","18","Minnesota","6/12/20","17","1","27015","5.88"
"Carlton","1","80","Minnesota","6/12/20","75","5","27017","6.67"
"Carver","4","268","Minnesota","6/12/20","240","28","27019","11.67"
"Cass","0","11","Minnesota","6/12/20","11","0","27021","0"
"Chippewa","0","55","Minnesota","6/12/20","52","3","27023","5.77"
"Chisago","1","77","Minnesota","6/12/20","69","8","27025","11.59"
"Clay","8","503","Minnesota","6/12/20","449","54","27027","12.03"
"Clearwater","0","3","Minnesota","6/12/20","3","0","27029","0"
"Cottonwood","3","101","Minnesota","6/12/20","82","19","27033","23.17"
"Crow Wing","1","88","Minnesota","6/12/20","81","7","27035","8.64"
"Dakota","29","1648","Minnesota","6/12/20","1446","202","27037","13.97"
"Dodge","1","58","Minnesota","6/12/20","54","4","27039","7.41"
"Douglas","0","49","Minnesota","6/12/20","46","3","27041","6.52"
"Faribault","0","25","Minnesota","6/12/20","22","3","27043","13.64"
"Fillmore","0","20","Minnesota","6/12/20","17","3","27045","17.65"
"Freeborn","8","217","Minnesota","6/12/20","159","58","27047","36.48"
"Goodhue","3","92","Minnesota","6/12/20","73","19","27049","26.03"
"Grant","0","6","Minnesota","6/12/20","4","2","27051","50"
"Hennepin","119","9934","Minnesota","6/12/20","9099","835","27053","9.18"
"Houston","0","5","Minnesota","6/12/20","3","2","27055","66.67"
"Hubbard","0","5","Minnesota","6/12/20","3","2","27057","66.67"
"Isanti","2","48","Minnesota","6/12/20","36","12","27059","33.33"
"Itasca","0","58","Minnesota","6/12/20","56","2","27061","3.57"
"Jackson","0","43","Minnesota","6/12/20","42","1","27063","2.38"
"Kanabec","0","13","Minnesota","6/12/20","12","1","27065","8.33"
"Kandiyohi","4","541","Minnesota","6/12/20","514","27","27067","5.25"
"Kittson","0","1","Minnesota","6/12/20","1","0","27069","0"
"Koochiching","0","9","Minnesota","6/12/20","9","0","27071","0"
"Lac qui Parle","0","3","Minnesota","6/12/20","3","0","27073","0"
"Lake","0","1","Minnesota","6/12/20","1","0","27075","0"
"Le Sueur","1","51","Minnesota","6/12/20","47","4","27079","8.51"
"Lincoln","0","6","Minnesota","6/12/20","6","0","27081","0"
"Lyon","12","183","Minnesota","6/12/20","101","82","27083","81.19"
"Mahnomen","0","6","Minnesota","6/12/20","6","0","27087","0"
"Marshall","0","12","Minnesota","6/12/20","12","0","27089","0"
"Martin","1","143","Minnesota","6/12/20","135","8","27091","5.93"
"McLeod","2","52","Minnesota","6/12/20","41","11","27085","26.83"
"Meeker","0","49","Minnesota","6/12/20","46","3","27093","6.52"
"Mille Lacs","0","26","Minnesota","6/12/20","24","2","27095","8.33"
"Morrison","1","54","Minnesota","6/12/20","48","6","27097","12.5"
"Mower","27","638","Minnesota","6/12/20","446","192","27099","43.05"
"Murray","0","42","Minnesota","6/12/20","41","1","27101","2.44"
"Nicollet","1","95","Minnesota","6/12/20","88","7","27103","7.95"
"Nobles","4","1607","Minnesota","6/12/20","1577","30","27105","1.9"
"Norman","0","17","Minnesota","6/12/20","15","2","27107","13.33"
"Olmsted","11","765","Minnesota","6/12/20","689","76","27109","11.03"
"Otter Tail","1","80","Minnesota","6/12/20","73","7","27111","9.59"
"Pennington","3","50","Minnesota","6/12/20","30","20","27113","66.67"
"Pine","0","95","Minnesota","6/12/20","93","2","27115","2.15"
"Pipestone","0","15","Minnesota","6/12/20","13","2","27117","15.38"
"Polk","1","67","Minnesota","6/12/20","63","4","27119","6.35"
"Pope","0","10","Minnesota","6/12/20","10","0","27121","0"
"Ramsey","66","3813","Minnesota","6/12/20","3351","462","27123","13.79"
"Red Lake","0","4","Minnesota","6/12/20","4","0","27125","0"
"Redwood","0","10","Minnesota","6/12/20","7","3","27127","42.86"
"Renville","0","9","Minnesota","6/12/20","7","2","27129","28.57"
"Rice","23","685","Minnesota","6/12/20","524","161","27131","30.73"
"Rock","0","23","Minnesota","6/12/20","23","0","27133","0"
"Roseau","0","6","Minnesota","6/12/20","3","3","27135","100"
"Scott","8","525","Minnesota","6/12/20","471","54","27139","11.46"
"Sherburne","2","262","Minnesota","6/12/20","249","13","27141","5.22"
"Sibley","1","25","Minnesota","6/12/20","17","8","27143","47.06"
"St. Louis","1","123","Minnesota","6/12/20","119","4","27137","3.36"
"Stearns","6","2096","Minnesota","6/12/20","2056","40","27145","1.95"
"Steele","1","175","Minnesota","6/12/20","170","5","27147","2.94"
"Stevens","0","1","Minnesota","6/12/20","1","0","27149","0"
"Swift","0","19","Minnesota","6/12/20","19","0","27151","0"
"Todd","4","371","Minnesota","6/12/20","344","27","27153","7.85"
"Traverse","0","5","Minnesota","6/12/20","4","1","27155","25"
"Wabasha","0","21","Minnesota","6/12/20","20","1","27157","5"
"Wadena","0","10","Minnesota","6/12/20","10","0","27159","0"
"Waseca","1","33","Minnesota","6/12/20","29","4","27161","13.79"
"Washington","9","766","Minnesota","6/12/20","700","66","27163","9.43"
"Watonwan","2","96","Minnesota","6/12/20","79","17","27165","21.52"
"Wilkin","0","12","Minnesota","6/12/20","11","1","27167","9.09"
"Winona","0","84","Minnesota","6/12/20","81","3","27169","3.7"
"Wright","3","372","Minnesota","6/12/20","349","23","27171","6.59"
"Yellow Medicine","0","8","Minnesota","6/12/20","7","1","27173","14.29"
"Adams","3","225","Mississippi","6/12/20","204","21","28001","10.29"
"Alcorn","1","28","Mississippi","6/12/20","19","9","28003","47.37"
"Amite","0","67","Mississippi","6/12/20","65","2","28005","3.08"
"Attala","2","328","Mississippi","6/12/20","312","16","28007","5.13"
"Benton","0","17","Mississippi","6/12/20","14","3","28009","21.43"
"Bolivar","2","185","Mississippi","6/12/20","169","16","28011","9.47"
"Calhoun","1","77","Mississippi","6/12/20","68","9","28013","13.24"
"Carroll","0","122","Mississippi","6/12/20","119","3","28015","2.52"
"Chickasaw","3","163","Mississippi","6/12/20","143","20","28017","13.99"
"Choctaw","1","62","Mississippi","6/12/20","52","10","28019","19.23"
"Claiborne","3","138","Mississippi","6/12/20","116","22","28021","18.97"
"Clarke","1","165","Mississippi","6/12/20","156","9","28023","5.77"
"Clay","6","169","Mississippi","6/12/20","125","44","28025","35.2"
"Coahoma","2","145","Mississippi","6/12/20","132","13","28027","9.85"
"Copiah","8","388","Mississippi","6/12/20","334","54","28029","16.17"
"Covington","3","201","Mississippi","6/12/20","183","18","28031","9.84"
"DeSoto","14","694","Mississippi","6/12/20","593","101","28033","17.03"
"Forrest","10","672","Mississippi","6/12/20","600","72","28035","12"
"Franklin","0","30","Mississippi","6/12/20","29","1","28037","3.45"
"George","1","35","Mississippi","6/12/20","30","5","28039","16.67"
"Greene","3","49","Mississippi","6/12/20","30","19","28041","63.33"
"Grenada","6","153","Mississippi","6/12/20","110","43","28043","39.09"
"Hancock","1","98","Mississippi","6/12/20","90","8","28045","8.89"
"Harrison","7","319","Mississippi","6/12/20","268","51","28047","19.03"
"Hinds","20","1245","Mississippi","6/12/20","1104","141","28049","12.77"
"Holmes","3","463","Mississippi","6/12/20","444","19","28051","4.28"
"Humphreys","2","80","Mississippi","6/12/20","64","16","28053","25"
"Itawamba","1","99","Mississippi","6/12/20","89","10","28057","11.24"
"Jackson","4","344","Mississippi","6/12/20","314","30","28059","9.55"
"Jasper","3","190","Mississippi","6/12/20","168","22","28061","13.1"
"Jefferson","1","52","Mississippi","6/12/20","42","10","28063","23.81"
"Jefferson Davis","0","84","Mississippi","6/12/20","82","2","28065","2.44"
"Jones","19","845","Mississippi","6/12/20","709","136","28067","19.18"
"Kemper","2","167","Mississippi","6/12/20","156","11","28069","7.05"
"Lafayette","2","169","Mississippi","6/12/20","156","13","28071","8.33"
"Lamar","5","287","Mississippi","6/12/20","252","35","28073","13.89"
"Lauderdale","5","801","Mississippi","6/12/20","765","36","28075","4.71"
"Lawrence","1","115","Mississippi","6/12/20","107","8","28077","7.48"
"Leake","3","478","Mississippi","6/12/20","455","23","28079","5.05"
"Lee","13","287","Mississippi","6/12/20","197","90","28081","45.69"
"Leflore","10","350","Mississippi","6/12/20","282","68","28083","24.11"
"Lincoln","5","316","Mississippi","6/12/20","281","35","28085","12.46"
"Lowndes","8","311","Mississippi","6/12/20","252","59","28087","23.41"
"Madison","12","864","Mississippi","6/12/20","778","86","28089","11.05"
"Marion","3","137","Mississippi","6/12/20","116","21","28091","18.1"
"Marshall","1","98","Mississippi","6/12/20","89","9","28093","10.11"
"Monroe","3","291","Mississippi","6/12/20","269","22","28095","8.18"
"Montgomery","1","93","Mississippi","6/12/20","84","9","28097","10.71"
"Neshoba","17","855","Mississippi","6/12/20","739","116","28099","15.7"
"Newton","4","320","Mississippi","6/12/20","292","28","28101","9.59"
"Noxubee","2","212","Mississippi","6/12/20","195","17","28103","8.72"
"Oktibbeha","9","348","Mississippi","6/12/20","283","65","28105","22.97"
"Panola","4","118","Mississippi","6/12/20","87","31","28107","35.63"
"Pearl River","1","219","Mississippi","6/12/20","212","7","28109","3.3"
"Perry","0","53","Mississippi","6/12/20","51","2","28111","3.92"
"Pike","2","220","Mississippi","6/12/20","204","16","28113","7.84"
"Pontotoc","3","70","Mississippi","6/12/20","49","21","28115","42.86"
"Prentiss","2","65","Mississippi","6/12/20","53","12","28117","22.64"
"Quitman","1","39","Mississippi","6/12/20","32","7","28119","21.88"
"Rankin","9","529","Mississippi","6/12/20","463","66","28121","14.25"
"Scott","3","685","Mississippi","6/12/20","663","22","28123","3.32"
"Sharkey","0","8","Mississippi","6/12/20","7","1","28125","14.29"
"Simpson","2","117","Mississippi","6/12/20","105","12","28127","11.43"
"Smith","2","173","Mississippi","6/12/20","156","17","28129","10.9"
"Stone","0","34","Mississippi","6/12/20","32","2","28131","6.25"
"Sunflower","2","113","Mississippi","6/12/20","96","17","28133","17.71"
"Tallahatchie","1","39","Mississippi","6/12/20","31","8","28135","25.81"
"Tate","4","123","Mississippi","6/12/20","93","30","28137","32.26"
"Tippah","2","92","Mississippi","6/12/20","76","16","28139","21.05"
"Tishomingo","1","44","Mississippi","6/12/20","36","8","28141","22.22"
"Tunica","1","62","Mississippi","6/12/20","58","4","28143","6.9"
"Union","1","96","Mississippi","6/12/20","89","7","28145","7.87"
"Walthall","4","97","Mississippi","6/12/20","67","30","28147","44.78"
"Warren","7","245","Mississippi","6/12/20","199","46","28149","23.12"
"Washington","5","236","Mississippi","6/12/20","199","37","28151","18.59"
"Wayne","13","373","Mississippi","6/12/20","280","93","28153","33.21"
"Webster","3","109","Mississippi","6/12/20","88","21","28155","23.86"
"Wilkinson","0","85","Mississippi","6/12/20","85","0","28157","0"
"Winston","3","143","Mississippi","6/12/20","124","19","28159","15.32"
"Yalobusha","4","136","Mississippi","6/12/20","111","25","28161","22.52"
"Yazoo","6","337","Mississippi","6/12/20","298","39","28163","13.09"
"Adair","1","75","Missouri","6/12/20","67","8","29001","11.94"
"Andrew","0","34","Missouri","6/12/20","32","2","29003","6.25"
"Atchison","0","3","Missouri","6/12/20","3","0","29005","0"
"Audrain","2","122","Missouri","6/12/20","108","14","29007","12.96"
"Barry","0","9","Missouri","6/12/20","9","0","29009","0"
"Barton","0","1","Missouri","6/12/20","0","1","29011","1"
"Bates","0","12","Missouri","6/12/20","12","0","29013","0"
"Benton","0","14","Missouri","6/12/20","12","2","29015","16.67"
"Bollinger","0","8","Missouri","6/12/20","7","1","29017","14.29"
"Boone","4","204","Missouri","6/12/20","173","31","29019","17.92"
"Buchanan","4","772","Missouri","6/12/20","741","31","29021","4.18"
"Butler","-1","40","Missouri","6/12/20","47","-7","29023","-14.89"
"Caldwell","0","7","Missouri","6/12/20","7","0","29025","0"
"Callaway","0","34","Missouri","6/12/20","32","2","29027","6.25"
"Camden","0","38","Missouri","6/12/20","38","0","29029","0"
"Cape Girardeau","3","101","Missouri","6/12/20","83","18","29031","21.69"
"Carroll","0","9","Missouri","6/12/20","9","0","29033","0"
"Carter","0","5","Missouri","6/12/20","5","0","29035","0"
"Cass","2","111","Missouri","6/12/20","100","11","29037","11"
"Cedar","0","9","Missouri","6/12/20","9","0","29039","0"
"Chariton","0","6","Missouri","6/12/20","6","0","29041","0"
"Christian","0","29","Missouri","6/12/20","29","0","29043","0"
"Clark","0","1","Missouri","6/12/20","1","0","29045","0"
"Clay","14","284","Missouri","6/12/20","186","98","29047","52.69"
"Clinton","0","19","Missouri","6/12/20","20","-1","29049","-5"
"Cole","-1","57","Missouri","6/12/20","61","-4","29051","-6.56"
"Cooper","0","9","Missouri","6/12/20","9","0","29053","0"
"Crawford","0","8","Missouri","6/12/20","9","-1","29055","-11.11"
"Dallas","0","6","Missouri","6/12/20","4","2","29059","50"
"Daviess","0","7","Missouri","6/12/20","5","2","29061","40"
"DeKalb","0","7","Missouri","6/12/20","6","1","29063","16.67"
"Dent","0","1","Missouri","6/12/20","0","1","29065","1"
"Douglas","0","3","Missouri","6/12/20","0","3","29067","1"
"Dunklin","1","54","Missouri","6/12/20","48","6","29069","12.5"
"Franklin","2","166","Missouri","6/12/20","149","17","29071","11.41"
"Gasconade","0","2","Missouri","6/12/20","2","0","29073","0"
"Gentry","1","54","Missouri","6/12/20","46","8","29075","17.39"
"Greene","2","185","Missouri","6/12/20","171","14","29077","8.19"
"Grundy","1","8","Missouri","6/12/20","0","8","29079","1"
"Harrison","0","9","Missouri","6/12/20","9","0","29081","0"
"Henry","1","16","Missouri","6/12/20","12","4","29083","33.33"
"Holt","0","1","Missouri","6/12/20","2","-1","29087","-50"
"Howard","0","3","Missouri","6/12/20","3","0","29089","0"
"Howell","1","19","Missouri","6/12/20","11","8","29091","72.73"
"Iron","0","2","Missouri","6/12/20","3","-1","29093","-33.33"
"Jackson","15","791","Missouri","6/12/20","686","105","29095","15.31"
"Jasper","9","107","Missouri","6/12/20","46","61","29097","132.61"
"Jefferson","-3","374","Missouri","6/12/20","398","-24","29099","-6.03"
"Johnson","0","79","Missouri","6/12/20","77","2","29101","2.6"
"Kansas City","30","1680","Missouri","6/12/20","1468","212","00000","14.44"
"Knox","0","2","Missouri","6/12/20","0","2","29103","1"
"Laclede","0","9","Missouri","6/12/20","7","2","29105","28.57"
"Lafayette","1","84","Missouri","6/12/20","80","4","29107","5"
"Lawrence","0","7","Missouri","6/12/20","8","-1","29109","-12.5"
"Lewis","0","7","Missouri","6/12/20","7","0","29111","0"
"Lincoln","-4","88","Missouri","6/12/20","118","-30","29113","-25.42"
"Linn","0","11","Missouri","6/12/20","10","1","29115","10"
"Livingston","0","4","Missouri","6/12/20","4","0","29117","0"
"Macon","0","6","Missouri","6/12/20","6","0","29121","0"
"Madison","0","3","Missouri","6/12/20","3","0","29123","0"
"Maries","0","2","Missouri","6/12/20","2","0","29125","0"
"Marion","0","7","Missouri","6/12/20","5","2","29127","40"
"McDonald","6","63","Missouri","6/12/20","23","40","29119","173.91"
"Mercer","1","5","Missouri","6/12/20","0","5","29129","1"
"Miller","0","4","Missouri","6/12/20","4","0","29131","0"
"Mississippi","1","70","Missouri","6/12/20","61","9","29133","14.75"
"Moniteau","0","49","Missouri","6/12/20","49","0","29135","0"
"Monroe","0","3","Missouri","6/12/20","0","3","29137","1"
"Montgomery","0","12","Missouri","6/12/20","10","2","29139","20"
"Morgan","0","9","Missouri","6/12/20","9","0","29141","0"
"New Madrid","2","32","Missouri","6/12/20","21","11","29143","52.38"
"Newton","4","49","Missouri","6/12/20","23","26","29145","113.04"
"Nodaway","0","15","Missouri","6/12/20","14","1","29147","7.14"
"Oregon","0","3","Missouri","6/12/20","2","1","29149","50"
"Osage","0","5","Missouri","6/12/20","5","0","29151","0"
"Pemiscot","1","99","Missouri","6/12/20","90","9","29155","10"
"Perry","2","80","Missouri","6/12/20","69","11","29157","15.94"
"Pettis","1","84","Missouri","6/12/20","79","5","29159","6.33"
"Phelps","0","6","Missouri","6/12/20","5","1","29161","20"
"Pike","0","31","Missouri","6/12/20","28","3","29163","10.71"
"Platte","2","89","Missouri","6/12/20","77","12","29165","15.58"
"Polk","0","7","Missouri","6/12/20","4","3","29167","75"
"Pulaski","10","106","Missouri","6/12/20","39","67","29169","171.79"
"Putnam","0","1","Missouri","6/12/20","0","1","29171","1"
"Ralls","0","5","Missouri","6/12/20","5","0","29173","0"
"Randolph","0","10","Missouri","6/12/20","10","0","29175","0"
"Ray","0","24","Missouri","6/12/20","23","1","29177","4.35"
"Reynolds","0","2","Missouri","6/12/20","2","0","29179","0"
"Ripley","0","12","Missouri","6/12/20","11","1","29181","9.09"
"Saline","-2","270","Missouri","6/12/20","281","-11","29195","-3.91"
"Schuyler","0","1","Missouri","6/12/20","0","1","29197","1"
"Scotland","0","8","Missouri","6/12/20","9","-1","29199","-11.11"
"Scott","2","134","Missouri","6/12/20","119","15","29201","12.61"
"Shannon","1","6","Missouri","6/12/20","0","6","29203","1"
"Shelby","0","1","Missouri","6/12/20","1","0","29205","0"
"St. Charles","9","882","Missouri","6/12/20","821","61","29183","7.43"
"St. Clair","0","2","Missouri","6/12/20","3","-1","29185","-33.33"
"St. Francois","0","40","Missouri","6/12/20","38","2","29187","5.26"
"St. Louis","28","5460","Missouri","6/12/20","5262","198","29189","3.76"
"St. Louis City","18","2179","Missouri","6/12/20","2053","126","29510","6.14"
"Ste. Genevieve","0","13","Missouri","6/12/20","12","1","29186","8.33"
"Stoddard","1","113","Missouri","6/12/20","105","8","29207","7.62"
"Stone","0","7","Missouri","6/12/20","10","-3","29209","-30"
"Sullivan","1","72","Missouri","6/12/20","63","9","29211","14.29"
"Taney","0","15","Missouri","6/12/20","14","1","29213","7.14"
"Texas","0","1","Missouri","6/12/20","1","0","29215","0"
"Vernon","0","12","Missouri","6/12/20","10","2","29217","20"
"Warren","0","31","Missouri","6/12/20","29","2","29219","6.9"
"Washington","0","13","Missouri","6/12/20","12","1","29221","8.33"
"Webster","0","18","Missouri","6/12/20","18","0","29225","0"
"Worth","0","4","Missouri","6/12/20","4","0","29227","0"
"Wright","0","14","Missouri","6/12/20","11","3","29229","27.27"
"Beaverhead","0","1","Montana","6/12/20","1","0","30001","0"
"Big Horn","1","43","Montana","6/12/20","36","7","30003","19.44"
"Broadwater","0","4","Montana","6/12/20","4","0","30007","0"
"Carbon","0","6","Montana","6/12/20","6","0","30009","0"
"Cascade","0","17","Montana","6/12/20","17","0","30013","0"
"Custer","0","1","Montana","6/12/20","0","1","30017","1"
"Deer Lodge","0","3","Montana","6/12/20","3","0","30023","0"
"Flathead","0","37","Montana","6/12/20","37","0","30029","0"
"Gallatin","3","182","Montana","6/12/20","163","19","30031","11.66"
"Glacier","0","6","Montana","6/12/20","6","0","30035","0"
"Golden Valley","0","3","Montana","6/12/20","3","0","30037","0"
"Hill","0","1","Montana","6/12/20","1","0","30041","0"
"Jefferson","0","3","Montana","6/12/20","3","0","30043","0"
"Lake","0","6","Montana","6/12/20","5","1","30047","20"
"Lewis and Clark","0","19","Montana","6/12/20","18","1","30049","5.56"
"Liberty","0","1","Montana","6/12/20","1","0","30051","0"
"Lincoln","0","7","Montana","6/12/20","7","0","30053","0"
"Madison","0","8","Montana","6/12/20","8","0","30057","0"
"Meagher","0","1","Montana","6/12/20","1","0","30059","0"
"Missoula","0","39","Montana","6/12/20","40","-1","30063","-2.5"
"Musselshell","0","1","Montana","6/12/20","1","0","30065","0"
"Park","0","8","Montana","6/12/20","8","0","30067","0"
"Pondera","0","2","Montana","6/12/20","2","0","30073","0"
"Ravalli","0","14","Montana","6/12/20","14","0","30081","0"
"Richland","0","3","Montana","6/12/20","3","0","30083","0"
"Roosevelt","0","7","Montana","6/12/20","7","0","30085","0"
"Rosebud","0","1","Montana","6/12/20","1","0","30087","0"
"Silver Bow","0","11","Montana","6/12/20","11","0","30093","0"
"Stillwater","0","2","Montana","6/12/20","1","1","30095","100"
"Toole","0","29","Montana","6/12/20","29","0","30101","0"
"Wheatland","0","1","Montana","6/12/20","1","0","30107","0"
"Yellowstone","0","106","Montana","6/12/20","103","3","30111","2.91"
"Adams","0","278","Nebraska","6/12/20","275","3","31001","1.09"
"Antelope","0","8","Nebraska","6/12/20","8","0","31003","0"
"Banner","0","1","Nebraska","6/12/20","0","1","31007","1"
"Boone","0","7","Nebraska","6/12/20","7","0","31011","0"
"Box Butte","0","3","Nebraska","6/12/20","2","1","31013","50"
"Boyd","0","1","Nebraska","6/12/20","1","0","31015","0"
"Buffalo","1","177","Nebraska","6/12/20","172","5","31019","2.91"
"Burt","0","9","Nebraska","6/12/20","10","-1","31021","-10"
"Butler","0","51","Nebraska","6/12/20","50","1","31023","2"
"Cass","1","59","Nebraska","6/12/20","54","5","31025","9.26"
"Cedar","0","8","Nebraska","6/12/20","8","0","31027","0"
"Chase","0","1","Nebraska","6/12/20","1","0","31029","0"
"Cherry","0","1","Nebraska","6/12/20","1","0","31031","0"
"Cheyenne","0","10","Nebraska","6/12/20","10","0","31033","0"
"Clay","0","24","Nebraska","6/12/20","24","0","31035","0"
"Colfax","2","646","Nebraska","6/12/20","631","15","31037","2.38"
"Cuming","0","34","Nebraska","6/12/20","34","0","31039","0"
"Custer","0","34","Nebraska","6/12/20","34","0","31041","0"
"Dakota","2","1719","Nebraska","6/12/20","1702","17","31043","1"
"Dawes","0","1","Nebraska","6/12/20","1","0","31045","0"
"Dawson","0","844","Nebraska","6/12/20","842","2","31047","0.24"
"Dixon","1","38","Nebraska","6/12/20","32","6","31051","18.75"
"Dodge","8","616","Nebraska","6/12/20","557","59","31053","10.59"
"Douglas","92","5540","Nebraska","6/12/20","4893","647","31055","13.22"
"Fillmore","0","9","Nebraska","6/12/20","7","2","31059","28.57"
"Franklin","0","6","Nebraska","6/12/20","6","0","31061","0"
"Frontier","0","1","Nebraska","6/12/20","1","0","31063","0"
"Furnas","0","9","Nebraska","6/12/20","9","0","31065","0"
"Gage","0","45","Nebraska","6/12/20","45","0","31067","0"
"Garden","0","4","Nebraska","6/12/20","4","0","31069","0"
"Garfield","0","1","Nebraska","6/12/20","1","0","31071","0"
"Gosper","0","13","Nebraska","6/12/20","13","0","31073","0"
"Greeley","0","3","Nebraska","6/12/20","3","0","31077","0"
"Hall","3","1560","Nebraska","6/12/20","1539","21","31079","1.36"
"Hamilton","0","56","Nebraska","6/12/20","55","1","31081","1.82"
"Hitchcock","0","1","Nebraska","6/12/20","1","0","31087","0"
"Holt","0","1","Nebraska","6/12/20","1","0","31089","0"
"Howard","0","44","Nebraska","6/12/20","43","1","31093","2.33"
"Jefferson","0","9","Nebraska","6/12/20","7","2","31095","28.57"
"Johnson","0","6","Nebraska","6/12/20","6","0","31097","0"
"Kearney","0","12","Nebraska","6/12/20","12","0","31099","0"
"Keith","0","2","Nebraska","6/12/20","2","0","31101","0"
"Kimball","0","8","Nebraska","6/12/20","8","0","31105","0"
"Knox","0","11","Nebraska","6/12/20","10","1","31107","10"
"Lancaster","19","1445","Nebraska","6/12/20","1310","135","31109","10.31"
"Lincoln","1","52","Nebraska","6/12/20","48","4","31111","8.33"
"Madison","1","331","Nebraska","6/12/20","323","8","31119","2.48"
"Merrick","0","37","Nebraska","6/12/20","34","3","31121","8.82"
"Morrill","0","12","Nebraska","6/12/20","11","1","31123","9.09"
"Nance","0","4","Nebraska","6/12/20","4","0","31125","0"
"Nemaha","0","4","Nebraska","6/12/20","4","0","31127","0"
"Nuckolls","0","1","Nebraska","6/12/20","1","0","31129","0"
"Otoe","0","12","Nebraska","6/12/20","10","2","31131","20"
"Phelps","0","20","Nebraska","6/12/20","20","0","31137","0"
"Pierce","0","6","Nebraska","6/12/20","6","0","31139","0"
"Platte","3","639","Nebraska","6/12/20","619","20","31141","3.23"
"Polk","0","12","Nebraska","6/12/20","11","1","31143","9.09"
"Red Willow","0","5","Nebraska","6/12/20","5","0","31145","0"
"Richardson","0","1","Nebraska","6/12/20","1","0","31147","0"
"Saline","1","518","Nebraska","6/12/20","513","5","31151","0.97"
"Sarpy","16","868","Nebraska","6/12/20","753","115","31153","15.27"
"Saunders","1","56","Nebraska","6/12/20","47","9","31155","19.15"
"Scotts Bluff","5","170","Nebraska","6/12/20","137","33","31157","24.09"
"Seward","0","31","Nebraska","6/12/20","29","2","31159","6.9"
"Sherman","0","4","Nebraska","6/12/20","5","-1","31163","-20"
"Sioux","0","2","Nebraska","6/12/20","0","2","31165","1"
"Stanton","0","21","Nebraska","6/12/20","21","0","31167","0"
"Thayer","0","1","Nebraska","6/12/20","1","0","31169","0"
"Thomas","0","1","Nebraska","6/12/20","1","0","31171","0"
"Thurston","2","63","Nebraska","6/12/20","50","13","31173","26"
"Valley","0","7","Nebraska","6/12/20","5","2","31175","40"
"Washington","1","39","Nebraska","6/12/20","33","6","31177","18.18"
"Wayne","0","26","Nebraska","6/12/20","23","3","31179","13.04"
"Webster","0","6","Nebraska","6/12/20","5","1","31181","20"
"York","0","37","Nebraska","6/12/20","37","0","31185","0"
"Carson City","1","115","Nevada","6/12/20","107","8","32510","7.48"
"Churchill","0","10","Nevada","6/12/20","8","2","32001","25"
"Clark","161","8314","Nevada","6/12/20","7186","1128","32003","15.7"
"Douglas","0","39","Nevada","6/12/20","38","1","32005","2.63"
"Elko","1","37","Nevada","6/12/20","27","10","32007","37.04"
"Humboldt","0","78","Nevada","6/12/20","78","0","32013","0"
"Lander","0","22","Nevada","6/12/20","21","1","32015","4.76"
"Lincoln","0","2","Nevada","6/12/20","2","0","32017","0"
"Lyon","1","91","Nevada","6/12/20","81","10","32019","12.35"
"Mineral","0","4","Nevada","6/12/20","4","0","32021","0"
"Nye","0","69","Nevada","6/12/20","66","3","32023","4.55"
"Pershing","0","5","Nevada","6/12/20","2","3","32027","150"
"Storey","0","1","Nevada","6/12/20","1","0","32029","0"
"Washoe","33","1914","Nevada","6/12/20","1685","229","32031","13.59"
"White Pine","0","3","Nevada","6/12/20","3","0","32033","0"
"Belknap","1","73","New Hampshire","6/12/20","64","9","33001","14.06"
"Carroll","0","49","New Hampshire","6/12/20","48","1","33003","2.08"
"Cheshire","0","60","New Hampshire","6/12/20","57","3","33005","5.26"
"Coos","0","6","New Hampshire","6/12/20","5","1","33007","20"
"Grafton","0","76","New Hampshire","6/12/20","76","0","33009","0"
"Hillsborough","38","2883","New Hampshire","6/12/20","2614","269","33011","10.29"
"Merrimack","4","390","New Hampshire","6/12/20","359","31","33013","8.64"
"Rockingham","8","1406","New Hampshire","6/12/20","1347","59","33015","4.38"
"Strafford","0","278","New Hampshire","6/12/20","278","0","33017","0"
"Sullivan","1","25","New Hampshire","6/12/20","20","5","33019","25"
"Atlantic","21","2453","New Jersey","6/12/20","2309","144","34001","6.24"
"Bergen","40","18743","New Jersey","6/12/20","18463","280","34003","1.52"
"Burlington","15","4848","New Jersey","6/12/20","4746","102","34005","2.15"
"Camden","31","6952","New Jersey","6/12/20","6732","220","34007","3.27"
"Cape May","4","664","New Jersey","6/12/20","637","27","34009","4.24"
"Cumberland","16","2645","New Jersey","6/12/20","2531","114","34011","4.5"
"Essex","39","18295","New Jersey","6/12/20","18019","276","34013","1.53"
"Gloucester","10","2379","New Jersey","6/12/20","2310","69","34015","2.99"
"Hudson","39","19149","New Jersey","6/12/20","18875","274","34017","1.45"
"Hunterdon","3","1034","New Jersey","6/12/20","1015","19","34019","1.87"
"Mercer","25","7295","New Jersey","6/12/20","7120","175","34021","2.46"
"Middlesex","31","16353","New Jersey","6/12/20","16137","216","34023","1.34"
"Monmouth","33","8660","New Jersey","6/12/20","8428","232","34025","2.75"
"Morris","-2","6556","New Jersey","6/12/20","6572","-16","34027","-0.24"
"Ocean","35","9200","New Jersey","6/12/20","8954","246","34029","2.75"
"Passaic","28","16581","New Jersey","6/12/20","16387","194","34031","1.18"
"Salem","5","699","New Jersey","6/12/20","665","34","34033","5.11"
"Somerset","12","4736","New Jersey","6/12/20","4651","85","34035","1.83"
"Sussex","3","1179","New Jersey","6/12/20","1155","24","34037","2.08"
"Union","45","16351","New Jersey","6/12/20","16038","313","34039","1.95"
"Warren","2","1200","New Jersey","6/12/20","1189","11","34041","0.93"
"Bernalillo","16","1669","New Mexico","6/12/20","1559","110","35001","7.06"
"Catron","0","2","New Mexico","6/12/20","2","0","35003","0"
"Chaves","0","53","New Mexico","6/12/20","50","3","35005","6"
"Cibola","4","180","New Mexico","6/12/20","152","28","35006","18.42"
"Colfax","0","5","New Mexico","6/12/20","5","0","35007","0"
"Curry","1","71","New Mexico","6/12/20","62","9","35009","14.52"
"Dona Ana","15","637","New Mexico","6/12/20","535","102","35013","19.07"
"Eddy","3","46","New Mexico","6/12/20","28","18","35015","64.29"
"Grant","0","17","New Mexico","6/12/20","15","2","35017","13.33"
"Guadalupe","0","20","New Mexico","6/12/20","20","0","35019","0"
"Harding","0","1","New Mexico","6/12/20","1","0","35021","0"
"Hidalgo","0","2","New Mexico","6/12/20","1","1","35023","100"
"Lea","1","38","New Mexico","6/12/20","29","9","35025","31.03"
"Lincoln","0","5","New Mexico","6/12/20","5","0","35027","0"
"Los Alamos","0","6","New Mexico","6/12/20","6","0","35028","0"
"Luna","1","20","New Mexico","6/12/20","11","9","35029","81.82"
"McKinley","36","2870","New Mexico","6/12/20","2617","253","35031","9.67"
"Otero","1","30","New Mexico","6/12/20","25","5","35035","20"
"Quay","0","4","New Mexico","6/12/20","5","-1","35037","-20"
"Rio Arriba","1","60","New Mexico","6/12/20","54","6","35039","11.11"
"Roosevelt","2","53","New Mexico","6/12/20","42","11","35041","26.19"
"San Juan","27","2081","New Mexico","6/12/20","1893","188","35045","9.93"
"San Miguel","0","16","New Mexico","6/12/20","15","1","35047","6.67"
"Sandoval","4","609","New Mexico","6/12/20","579","30","35043","5.18"
"Santa Fe","2","165","New Mexico","6/12/20","150","15","35049","10"
"Sierra","0","3","New Mexico","6/12/20","1","2","35051","200"
"Socorro","0","55","New Mexico","6/12/20","54","1","35053","1.85"
"Taos","0","32","New Mexico","6/12/20","31","1","35055","3.23"
"Torrance","0","34","New Mexico","6/12/20","34","0","35057","0"
"Union","0","5","New Mexico","6/12/20","5","0","35059","0"
"Valencia","1","87","New Mexico","6/12/20","81","6","35061","7.41"
"Albany","9","2007","New York","6/12/20","1941","66","36001","3.4"
"Allegany","0","53","New York","6/12/20","51","2","36003","3.92"
"Broome","6","644","New York","6/12/20","605","39","36007","6.45"
"Cattaraugus","1","101","New York","6/12/20","92","9","36009","9.78"
"Cayuga","1","103","New York","6/12/20","98","5","36011","5.1"
"Chautauqua","1","106","New York","6/12/20","97","9","36013","9.28"
"Chemung","0","138","New York","6/12/20","137","1","36015","0.73"
"Chenango","1","138","New York","6/12/20","133","5","36017","3.76"
"Clinton","0","98","New York","6/12/20","97","1","36019","1.03"
"Columbia","2","428","New York","6/12/20","411","17","36021","4.14"
"Cortland","0","42","New York","6/12/20","41","1","36023","2.44"
"Delaware","1","88","New York","6/12/20","84","4","36025","4.76"
"Dutchess","7","4035","New York","6/12/20","3984","51","36027","1.28"
"Erie","51","6717","New York","6/12/20","6359","358","36029","5.63"
"Essex","0","40","New York","6/12/20","38","2","36031","5.26"
"Franklin","0","24","New York","6/12/20","23","1","36033","4.35"
"Fulton","2","231","New York","6/12/20","219","12","36035","5.48"
"Genesee","1","212","New York","6/12/20","205","7","36037","3.41"
"Greene","1","249","New York","6/12/20","242","7","36039","2.89"
"Hamilton","0","5","New York","6/12/20","5","0","36041","0"
"Herkimer","2","127","New York","6/12/20","115","12","36043","10.43"
"Jefferson","1","80","New York","6/12/20","75","5","36045","6.67"
"Lewis","0","20","New York","6/12/20","20","0","36049","0"
"Livingston","0","121","New York","6/12/20","121","0","36051","0"
"Madison","1","333","New York","6/12/20","323","10","36053","3.1"
"Monroe","29","3320","New York","6/12/20","3117","203","36055","6.51"
"Montgomery","1","103","New York","6/12/20","96","7","36057","7.29"
"Nassau","45","41114","New York","6/12/20","40797","317","36059","0.78"
"New York","431","208954","New York","6/12/20","205940","3014","36061","1.46"
"Niagara","6","1143","New York","6/12/20","1099","44","36063","4"
"Oneida","23","1237","New York","6/12/20","1077","160","36065","14.86"
"Onondaga","21","2474","New York","6/12/20","2329","145","36067","6.23"
"Ontario","2","230","New York","6/12/20","219","11","36069","5.02"
"Orange","11","10558","New York","6/12/20","10484","74","36071","0.71"
"Orleans","2","260","New York","6/12/20","247","13","36073","5.26"
"Oswego","1","120","New York","6/12/20","112","8","36075","7.14"
"Otsego","1","78","New York","6/12/20","73","5","36077","6.85"
"Putnam","2","1282","New York","6/12/20","1270","12","36079","0.94"
"Rensselaer","2","510","New York","6/12/20","497","13","36083","2.62"
"Rockland","14","13396","New York","6/12/20","13297","99","36087","0.74"
"Saratoga","3","514","New York","6/12/20","496","18","36091","3.63"
"Schenectady","2","721","New York","6/12/20","706","15","36093","2.12"
"Schoharie","0","54","New York","6/12/20","51","3","36095","5.88"
"Schuyler","0","12","New York","6/12/20","12","0","36097","0"
"Seneca","0","63","New York","6/12/20","61","2","36099","3.28"
"St. Lawrence","1","214","New York","6/12/20","207","7","36089","3.38"
"Steuben","1","254","New York","6/12/20","246","8","36101","3.25"
"Suffolk","46","40559","New York","6/12/20","40239","320","36103","0.8"
"Sullivan","3","1428","New York","6/12/20","1409","19","36105","1.35"
"Tioga","0","137","New York","6/12/20","134","3","36107","2.24"
"Tompkins","1","172","New York","6/12/20","167","5","36109","2.99"
"Ulster","3","1734","New York","6/12/20","1711","23","36111","1.34"
"Warren","0","257","New York","6/12/20","256","1","36113","0.39"
"Washington","0","242","New York","6/12/20","240","2","36115","0.83"
"Wayne","1","129","New York","6/12/20","122","7","36117","5.74"
"Westchester","46","34175","New York","6/12/20","33854","321","36119","0.95"
"Wyoming","0","91","New York","6/12/20","88","3","36121","3.41"
"Yates","0","39","New York","6/12/20","39","0","36123","0"
"Alamance","26","641","North Carolina","6/12/20","458","183","37001","39.96"
"Alexander","1","46","North Carolina","6/12/20","38","8","37003","21.05"
"Alleghany","0","30","North Carolina","6/12/20","27","3","37005","11.11"
"Anson","2","83","North Carolina","6/12/20","70","13","37007","18.57"
"Ashe","1","43","North Carolina","6/12/20","39","4","37009","10.26"
"Avery","0","6","North Carolina","6/12/20","3","3","37011","100"
"Beaufort","1","49","North Carolina","6/12/20","43","6","37013","13.95"
"Bertie","1","135","North Carolina","6/12/20","129","6","37015","4.65"
"Bladen","6","186","North Carolina","6/12/20","143","43","37017","30.07"
"Brunswick","8","190","North Carolina","6/12/20","131","59","37019","45.04"
"Buncombe","6","426","North Carolina","6/12/20","382","44","37021","11.52"
"Burke","37","775","North Carolina","6/12/20","514","261","37023","50.78"
"Cabarrus","20","685","North Carolina","6/12/20","546","139","37025","25.46"
"Caldwell","8","238","North Carolina","6/12/20","183","55","37027","30.05"
"Camden","0","3","North Carolina","6/12/20","3","0","37029","0"
"Carteret","1","45","North Carolina","6/12/20","39","6","37031","15.38"
"Caswell","1","101","North Carolina","6/12/20","94","7","37033","7.45"
"Catawba","14","379","North Carolina","6/12/20","278","101","37035","36.33"
"Chatham","13","780","North Carolina","6/12/20","690","90","37037","13.04"
"Cherokee","0","30","North Carolina","6/12/20","30","0","37039","0"
"Chowan","0","19","North Carolina","6/12/20","17","2","37041","11.76"
"Clay","0","8","North Carolina","6/12/20","8","0","37043","0"
"Cleveland","5","143","North Carolina","6/12/20","111","32","37045","28.83"
"Columbus","7","404","North Carolina","6/12/20","355","49","37047","13.8"
"Craven","5","256","North Carolina","6/12/20","218","38","37049","17.43"
"Cumberland","14","855","North Carolina","6/12/20","754","101","37051","13.4"
"Currituck","0","15","North Carolina","6/12/20","15","0","37053","0"
"Dare","0","25","North Carolina","6/12/20","22","3","37055","13.64"
"Davidson","13","589","North Carolina","6/12/20","500","89","37057","17.8"
"Davie","3","132","North Carolina","6/12/20","113","19","37059","16.81"
"Duplin","27","1130","North Carolina","6/12/20","943","187","37061","19.83"
"Durham","79","2473","North Carolina","6/12/20","1921","552","37063","28.74"
"Edgecombe","3","235","North Carolina","6/12/20","216","19","37065","8.8"
"Forsyth","56","2051","North Carolina","6/12/20","1660","391","37067","23.55"
"Franklin","4","209","North Carolina","6/12/20","179","30","37069","16.76"
"Gaston","19","452","North Carolina","6/12/20","320","132","37071","41.25"
"Gates","0","24","North Carolina","6/12/20","24","0","37073","0"
"Graham","0","6","North Carolina","6/12/20","4","2","37075","50"
"Granville","43","653","North Carolina","6/12/20","354","299","37077","84.46"
"Greene","4","117","North Carolina","6/12/20","88","29","37079","32.95"
"Guilford","56","1899","North Carolina","6/12/20","1508","391","37081","25.93"
"Halifax","5","231","North Carolina","6/12/20","197","34","37083","17.26"
"Harnett","9","381","North Carolina","6/12/20","318","63","37085","19.81"
"Haywood","1","63","North Carolina","6/12/20","55","8","37087","14.55"
"Henderson","8","415","North Carolina","6/12/20","360","55","37089","15.28"
"Hertford","1","143","North Carolina","6/12/20","133","10","37091","7.52"
"Hoke","5","296","North Carolina","6/12/20","262","34","37093","12.98"
"Hyde","0","2","North Carolina","6/12/20","2","0","37095","0"
"Iredell","15","404","North Carolina","6/12/20","301","103","37097","34.22"
"Jackson","3","59","North Carolina","6/12/20","38","21","37099","55.26"
"Johnston","29","756","North Carolina","6/12/20","554","202","37101","36.46"
"Jones","0","28","North Carolina","6/12/20","28","0","37103","0"
"Lee","10","574","North Carolina","6/12/20","505","69","37105","13.66"
"Lenoir","7","277","North Carolina","6/12/20","229","48","37107","20.96"
"Lincoln","4","118","North Carolina","6/12/20","93","25","37109","26.88"
"Macon","8","178","North Carolina","6/12/20","119","59","37113","49.58"
"Madison","0","4","North Carolina","6/12/20","4","0","37115","0"
"Martin","2","88","North Carolina","6/12/20","74","14","37117","18.92"
"McDowell","6","129","North Carolina","6/12/20","86","43","37111","50"
"Mecklenburg","212","6538","North Carolina","6/12/20","5057","1481","37119","29.29"
"Mitchell","0","17","North Carolina","6/12/20","17","0","37121","0"
"Montgomery","6","205","North Carolina","6/12/20","162","43","37123","26.54"
"Moore","6","288","North Carolina","6/12/20","248","40","37125","16.13"
"Nash","6","262","North Carolina","6/12/20","223","39","37127","17.49"
"New Hanover","12","315","North Carolina","6/12/20","230","85","37129","36.96"
"Northampton","1","170","North Carolina","6/12/20","165","5","37131","3.03"
"Onslow","4","149","North Carolina","6/12/20","120","29","37133","24.17"
"Orange","9","440","North Carolina","6/12/20","377","63","37135","16.71"
"Pamlico","1","15","North Carolina","6/12/20","10","5","37137","50"
"Pasquotank","2","128","North Carolina","6/12/20","117","11","37139","9.4"
"Pender","4","123","North Carolina","6/12/20","98","25","37141","25.51"
"Perquimans","0","29","North Carolina","6/12/20","26","3","37143","11.54"
"Person","2","72","North Carolina","6/12/20","57","15","37145","26.32"
"Pitt","17","451","North Carolina","6/12/20","332","119","37147","35.84"
"Polk","1","53","North Carolina","6/12/20","45","8","37149","17.78"
"Randolph","19","882","North Carolina","6/12/20","751","131","37151","17.44"
"Richmond","2","196","North Carolina","6/12/20","180","16","37153","8.89"
"Robeson","19","1040","North Carolina","6/12/20","905","135","37155","14.92"
"Rockingham","3","124","North Carolina","6/12/20","106","18","37157","16.98"
"Rowan","16","835","North Carolina","6/12/20","720","115","37159","15.97"
"Rutherford","2","205","North Carolina","6/12/20","191","14","37161","7.33"
"Sampson","21","702","North Carolina","6/12/20","553","149","37163","26.94"
"Scotland","2","104","North Carolina","6/12/20","90","14","37165","15.56"
"Stanly","6","144","North Carolina","6/12/20","103","41","37167","39.81"
"Stokes","1","91","North Carolina","6/12/20","81","10","37169","12.35"
"Surry","7","315","North Carolina","6/12/20","269","46","37171","17.1"
"Swain","2","37","North Carolina","6/12/20","22","15","37173","68.18"
"Transylvania","0","16","North Carolina","6/12/20","16","0","37175","0"
"Tyrrell","0","5","North Carolina","6/12/20","4","1","37177","25"
"Union","19","672","North Carolina","6/12/20","540","132","37179","24.44"
"Vance","7","403","North Carolina","6/12/20","351","52","37181","14.81"
"Wake","100","2769","North Carolina","6/12/20","2067","702","37183","33.96"
"Warren","6","125","North Carolina","6/12/20","82","43","37185","52.44"
"Washington","0","33","North Carolina","6/12/20","32","1","37187","3.12"
"Watauga","1","41","North Carolina","6/12/20","37","4","37189","10.81"
"Wayne","30","1448","North Carolina","6/12/20","1240","208","37191","16.77"
"Wilkes","4","530","North Carolina","6/12/20","504","26","37193","5.16"
"Wilson","10","482","North Carolina","6/12/20","413","69","37195","16.71"
"Yadkin","3","228","North Carolina","6/12/20","208","20","37197","9.62"
"Yancey","1","23","North Carolina","6/12/20","18","5","37199","27.78"
"Barnes","0","9","North Dakota","6/12/20","6","3","38003","50"
"Benson","0","3","North Dakota","6/12/20","1","2","38005","200"
"Bottineau","0","4","North Dakota","6/12/20","3","1","38009","33.33"
"Bowman","0","1","North Dakota","6/12/20","1","0","38011","0"
"Burke","0","5","North Dakota","6/12/20","5","0","38013","0"
"Burleigh","3","156","North Dakota","6/12/20","135","21","38015","15.56"
"Cass","25","2006","North Dakota","6/12/20","1834","172","38017","9.38"
"Dickey","0","2","North Dakota","6/12/20","1","1","38021","100"
"Divide","0","1","North Dakota","6/12/20","1","0","38023","0"
"Dunn","0","11","North Dakota","6/12/20","11","0","38025","0"
"Eddy","0","5","North Dakota","6/12/20","4","1","38027","25"
"Emmons","0","4","North Dakota","6/12/20","4","0","38029","0"
"Foster","0","1","North Dakota","6/12/20","1","0","38031","0"
"Grand Forks","1","341","North Dakota","6/12/20","336","5","38035","1.49"
"Grant","0","2","North Dakota","6/12/20","2","0","38037","0"
"Griggs","0","1","North Dakota","6/12/20","1","0","38039","0"
"Kidder","0","2","North Dakota","6/12/20","0","2","38043","1"
"LaMoure","1","8","North Dakota","6/12/20","0","8","38045","1"
"McHenry","0","2","North Dakota","6/12/20","2","0","38049","0"
"McIntosh","0","1","North Dakota","6/12/20","1","0","38051","0"
"McKenzie","0","21","North Dakota","6/12/20","18","3","38053","16.67"
"McLean","0","9","North Dakota","6/12/20","7","2","38055","28.57"
"Mercer","0","6","North Dakota","6/12/20","6","0","38057","0"
"Morton","0","62","North Dakota","6/12/20","60","2","38059","3.33"
"Mountrail","0","43","North Dakota","6/12/20","42","1","38061","2.38"
"Nelson","0","1","North Dakota","6/12/20","1","0","38063","0"
"Oliver","0","1","North Dakota","6/12/20","1","0","38065","0"
"Pembina","0","6","North Dakota","6/12/20","6","0","38067","0"
"Pierce","0","3","North Dakota","6/12/20","3","0","38069","0"
"Ramsey","0","8","North Dakota","6/12/20","8","0","38071","0"
"Ransom","0","12","North Dakota","6/12/20","11","1","38073","9.09"
"Renville","0","3","North Dakota","6/12/20","3","0","38075","0"
"Richland","1","33","North Dakota","6/12/20","24","9","38077","37.5"
"Rolette","0","7","North Dakota","6/12/20","6","1","38079","16.67"
"Sargent","0","4","North Dakota","6/12/20","4","0","38081","0"
"Sheridan","0","1","North Dakota","6/12/20","0","1","38083","1"
"Sioux","0","3","North Dakota","6/12/20","2","1","38085","50"
"Slope","0","3","North Dakota","6/12/20","3","0","38087","0"
"Stark","0","63","North Dakota","6/12/20","62","1","38089","1.61"
"Steele","0","1","North Dakota","6/12/20","1","0","38091","0"
"Stutsman","3","51","North Dakota","6/12/20","30","21","38093","70"
"Traill","0","15","North Dakota","6/12/20","14","1","38097","7.14"
"Walsh","0","16","North Dakota","6/12/20","15","1","38099","6.67"
"Ward","1","45","North Dakota","6/12/20","41","4","38101","9.76"
"Wells","1","8","North Dakota","6/12/20","3","5","38103","166.67"
"Williams","0","26","North Dakota","6/12/20","25","1","38105","4"
"","1","30","Northern Mariana Islands","6/12/20","26","4",,"15.38"
"Adams","0","12","Ohio","6/12/20","11","1","39001","9.09"
"Allen","2","232","Ohio","6/12/20","221","11","39003","4.98"
"Ashland","0","26","Ohio","6/12/20","23","3","39005","13.04"
"Ashtabula","2","381","Ohio","6/12/20","369","12","39007","3.25"
"Athens","1","23","Ohio","6/12/20","18","5","39009","27.78"
"Auglaize","1","84","Ohio","6/12/20","77","7","39011","9.09"
"Belmont","2","463","Ohio","6/12/20","449","14","39013","3.12"
"Brown","1","37","Ohio","6/12/20","31","6","39015","19.35"
"Butler","13","1065","Ohio","6/12/20","975","90","39017","9.23"
"Carroll","0","36","Ohio","6/12/20","35","1","39019","2.86"
"Champaign","1","34","Ohio","6/12/20","28","6","39021","21.43"
"Clark","11","400","Ohio","6/12/20","323","77","39023","23.84"
"Clermont","2","236","Ohio","6/12/20","219","17","39025","7.76"
"Clinton","1","52","Ohio","6/12/20","47","5","39027","10.64"
"Columbiana","3","914","Ohio","6/12/20","894","20","39029","2.24"
"Coshocton","0","50","Ohio","6/12/20","48","2","39031","4.17"
"Crawford","1","122","Ohio","6/12/20","118","4","39033","3.39"
"Cuyahoga","46","5112","Ohio","6/12/20","4789","323","39035","6.74"
"Darke","4","220","Ohio","6/12/20","190","30","39037","15.79"
"Defiance","1","40","Ohio","6/12/20","34","6","39039","17.65"
"Delaware","4","389","Ohio","6/12/20","360","29","39041","8.06"
"Erie","1","191","Ohio","6/12/20","184","7","39043","3.8"
"Fairfield","5","353","Ohio","6/12/20","318","35","39045","11.01"
"Fayette","0","44","Ohio","6/12/20","41","3","39047","7.32"
"Franklin","85","6918","Ohio","6/12/20","6323","595","39049","9.41"
"Fulton","1","52","Ohio","6/12/20","45","7","39051","15.56"
"Gallia","0","9","Ohio","6/12/20","8","1","39053","12.5"
"Geauga","4","331","Ohio","6/12/20","303","28","39055","9.24"
"Greene","4","132","Ohio","6/12/20","106","26","39057","24.53"
"Guernsey","1","44","Ohio","6/12/20","38","6","39059","15.79"
"Hamilton","38","3078","Ohio","6/12/20","2811","267","39061","9.5"
"Hancock","1","61","Ohio","6/12/20","53","8","39063","15.09"
"Hardin","2","87","Ohio","6/12/20","73","14","39065","19.18"
"Harrison","0","10","Ohio","6/12/20","10","0","39067","0"
"Henry","0","19","Ohio","6/12/20","17","2","39069","11.76"
"Highland","0","32","Ohio","6/12/20","29","3","39071","10.34"
"Hocking","0","73","Ohio","6/12/20","70","3","39073","4.29"
"Holmes","4","84","Ohio","6/12/20","57","27","39075","47.37"
"Huron","2","72","Ohio","6/12/20","61","11","39077","18.03"
"Jackson","0","16","Ohio","6/12/20","15","1","39079","6.67"
"Jefferson","0","69","Ohio","6/12/20","67","2","39081","2.99"
"Knox","1","31","Ohio","6/12/20","25","6","39083","24"
"Lake","3","344","Ohio","6/12/20","325","19","39085","5.85"
"Lawrence","0","32","Ohio","6/12/20","30","2","39087","6.67"
"Licking","4","297","Ohio","6/12/20","271","26","39089","9.59"
"Logan","1","47","Ohio","6/12/20","43","4","39091","9.3"
"Lorain","7","779","Ohio","6/12/20","730","49","39093","6.71"
"Lucas","12","2411","Ohio","6/12/20","2329","82","39095","3.52"
"Madison","1","168","Ohio","6/12/20","164","4","39097","2.44"
"Mahoning","13","1576","Ohio","6/12/20","1486","90","39099","6.06"
"Marion","2","2701","Ohio","6/12/20","2688","13","39101","0.48"
"Medina","3","397","Ohio","6/12/20","376","21","39103","5.59"
"Meigs","0","6","Ohio","6/12/20","6","0","39105","0"
"Mercer","2","244","Ohio","6/12/20","227","17","39107","7.49"
"Miami","2","382","Ohio","6/12/20","367","15","39109","4.09"
"Monroe","0","83","Ohio","6/12/20","80","3","39111","3.75"
"Montgomery","24","901","Ohio","6/12/20","734","167","39113","22.75"
"Morgan","0","6","Ohio","6/12/20","5","1","39115","20"
"Morrow","0","110","Ohio","6/12/20","108","2","39117","1.85"
"Muskingum","0","56","Ohio","6/12/20","56","0","39119","0"
"Noble","0","6","Ohio","6/12/20","6","0","39121","0"
"Ottawa","1","114","Ohio","6/12/20","107","7","39123","6.54"
"Paulding","0","14","Ohio","6/12/20","14","0","39125","0"
"Perry","0","22","Ohio","6/12/20","19","3","39127","15.79"
"Pickaway","2","2115","Ohio","6/12/20","2099","16","39129","0.76"
"Pike","0","9","Ohio","6/12/20","9","0","39131","0"
"Portage","2","352","Ohio","6/12/20","335","17","39133","5.07"
"Preble","0","41","Ohio","6/12/20","39","2","39135","5.13"
"Putnam","1","100","Ohio","6/12/20","95","5","39137","5.26"
"Richland","3","242","Ohio","6/12/20","222","20","39139","9.01"
"Ross","1","79","Ohio","6/12/20","73","6","39141","8.22"
"Sandusky","2","102","Ohio","6/12/20","91","11","39143","12.09"
"Scioto","0","19","Ohio","6/12/20","18","1","39145","5.56"
"Seneca","0","29","Ohio","6/12/20","26","3","39147","11.54"
"Shelby","0","49","Ohio","6/12/20","47","2","39149","4.26"
"Stark","6","847","Ohio","6/12/20","803","44","39151","5.48"
"Summit","16","1638","Ohio","6/12/20","1529","109","39153","7.13"
"Trumbull","6","642","Ohio","6/12/20","600","42","39155","7"
"Tuscarawas","4","397","Ohio","6/12/20","371","26","39157","7.01"
"Union","1","62","Ohio","6/12/20","56","6","39159","10.71"
"Van Wert","0","10","Ohio","6/12/20","7","3","39161","42.86"
"Vinton","0","21","Ohio","6/12/20","21","0","39163","0"
"Warren","13","497","Ohio","6/12/20","407","90","39165","22.11"
"Washington","0","117","Ohio","6/12/20","118","-1","39167","-0.85"
"Wayne","1","304","Ohio","6/12/20","296","8","39169","2.7"
"Williams","0","58","Ohio","6/12/20","58","0","39171","0"
"Wood","1","316","Ohio","6/12/20","306","10","39173","3.27"
"Wyandot","0","48","Ohio","6/12/20","48","0","39175","0"
"Adair","0","95","Oklahoma","6/12/20","93","2","40001","2.15"
"Alfalfa","0","1","Oklahoma","6/12/20","1","0","40003","0"
"Atoka","1","8","Oklahoma","6/12/20","4","4","40005","100"
"Beaver","1","30","Oklahoma","6/12/20","24","6","40007","25"
"Beckham","0","7","Oklahoma","6/12/20","7","0","40009","0"
"Blaine","0","9","Oklahoma","6/12/20","9","0","40011","0"
"Bryan","2","49","Oklahoma","6/12/20","35","14","40013","40"
"Caddo","1","173","Oklahoma","6/12/20","168","5","40015","2.98"
"Canadian","1","146","Oklahoma","6/12/20","141","5","40017","3.55"
"Carter","1","57","Oklahoma","6/12/20","51","6","40019","11.76"
"Cherokee","1","41","Oklahoma","6/12/20","31","10","40021","32.26"
"Choctaw","1","102","Oklahoma","6/12/20","97","5","40023","5.15"
"Cimarron","0","1","Oklahoma","6/12/20","1","0","40025","0"
"Cleveland","3","539","Oklahoma","6/12/20","520","19","40027","3.65"
"Coal","0","6","Oklahoma","6/12/20","5","1","40029","20"
"Comanche","2","319","Oklahoma","6/12/20","306","13","40031","4.25"
"Cotton","0","5","Oklahoma","6/12/20","5","0","40033","0"
"Craig","0","16","Oklahoma","6/12/20","15","1","40035","6.67"
"Creek","0","102","Oklahoma","6/12/20","99","3","40037","3.03"
"Custer","1","40","Oklahoma","6/12/20","32","8","40039","25"
"Delaware","1","107","Oklahoma","6/12/20","100","7","40041","7"
"Dewey","0","2","Oklahoma","6/12/20","3","-1","40043","-33.33"
"Garfield","2","45","Oklahoma","6/12/20","29","16","40047","55.17"
"Garvin","0","20","Oklahoma","6/12/20","18","2","40049","11.11"
"Grady","1","116","Oklahoma","6/12/20","107","9","40051","8.41"
"Grant","0","2","Oklahoma","6/12/20","2","0","40053","0"
"Greer","0","66","Oklahoma","6/12/20","66","0","40055","0"
"Harper","0","1","Oklahoma","6/12/20","1","0","40059","0"
"Haskell","0","6","Oklahoma","6/12/20","6","0","40061","0"
"Hughes","0","3","Oklahoma","6/12/20","3","0","40063","0"
"Jackson","1","32","Oklahoma","6/12/20","27","5","40065","18.52"
"Jefferson","0","4","Oklahoma","6/12/20","4","0","40067","0"
"Johnston","0","4","Oklahoma","6/12/20","3","1","40069","33.33"
"Kay","1","65","Oklahoma","6/12/20","57","8","40071","14.04"
"Kingfisher","0","12","Oklahoma","6/12/20","12","0","40073","0"
"Kiowa","0","6","Oklahoma","6/12/20","6","0","40075","0"
"Latimer","0","5","Oklahoma","6/12/20","5","0","40077","0"
"Le Flore","1","18","Oklahoma","6/12/20","14","4","40079","28.57"
"Lincoln","0","22","Oklahoma","6/12/20","22","0","40081","0"
"Logan","0","22","Oklahoma","6/12/20","19","3","40083","15.79"
"Love","1","21","Oklahoma","6/12/20","16","5","40085","31.25"
"Major","0","6","Oklahoma","6/12/20","6","0","40093","0"
"Marshall","0","13","Oklahoma","6/12/20","10","3","40095","30"
"Mayes","3","50","Oklahoma","6/12/20","31","19","40097","61.29"
"McClain","1","114","Oklahoma","6/12/20","109","5","40087","4.59"
"McCurtain","8","137","Oklahoma","6/12/20","79","58","40089","73.42"
"McIntosh","0","15","Oklahoma","6/12/20","14","1","40091","7.14"
"Murray","0","6","Oklahoma","6/12/20","5","1","40099","20"
"Muskogee","1","70","Oklahoma","6/12/20","61","9","40101","14.75"
"Noble","0","8","Oklahoma","6/12/20","7","1","40103","14.29"
"Nowata","0","25","Oklahoma","6/12/20","23","2","40105","8.7"
"Okfuskee","0","6","Oklahoma","6/12/20","5","1","40107","20"
"Oklahoma","24","1517","Oklahoma","6/12/20","1350","167","40109","12.37"
"Okmulgee","1","29","Oklahoma","6/12/20","25","4","40111","16"
"Osage","0","104","Oklahoma","6/12/20","102","2","40113","1.96"
"Ottawa","0","36","Oklahoma","6/12/20","35","1","40115","2.86"
"Pawnee","1","36","Oklahoma","6/12/20","32","4","40117","12.5"
"Payne","3","72","Oklahoma","6/12/20","48","24","40119","50"
"Pittsburg","0","44","Oklahoma","6/12/20","41","3","40121","7.32"
"Pontotoc","0","20","Oklahoma","6/12/20","17","3","40123","17.65"
"Pottawatomie","1","67","Oklahoma","6/12/20","63","4","40125","6.35"
"Pushmataha","0","7","Oklahoma","6/12/20","5","2","40127","40"
"Rogers","1","93","Oklahoma","6/12/20","83","10","40131","12.05"
"Seminole","0","31","Oklahoma","6/12/20","30","1","40133","3.33"
"Sequoyah","0","19","Oklahoma","6/12/20","17","2","40135","11.76"
"Stephens","0","44","Oklahoma","6/12/20","41","3","40137","7.32"
"Texas","3","963","Oklahoma","6/12/20","944","19","40139","2.01"
"Tillman","0","23","Oklahoma","6/12/20","23","0","40141","0"
"Tulsa","44","1443","Oklahoma","6/12/20","1134","309","40143","27.25"
"Wagoner","2","165","Oklahoma","6/12/20","153","12","40145","7.84"
"Washington","1","345","Oklahoma","6/12/20","339","6","40147","1.77"
"Washita","0","2","Oklahoma","6/12/20","2","0","40149","0"
"Woods","0","5","Oklahoma","6/12/20","4","1","40151","25"
"Woodward","1","9","Oklahoma","6/12/20","5","4","40153","80"
"Baker","0","1","Oregon","6/12/20","1","0","41001","0"
"Benton","0","63","Oregon","6/12/20","62","1","41003","1.61"
"Clackamas","17","455","Oregon","6/12/20","339","116","41005","34.22"
"Clatsop","0","46","Oregon","6/12/20","45","1","41007","2.22"
"Columbia","1","20","Oregon","6/12/20","16","4","41009","25"
"Coos","0","32","Oregon","6/12/20","32","0","41011","0"
"Crook","0","8","Oregon","6/12/20","6","2","41013","33.33"
"Curry","0","7","Oregon","6/12/20","7","0","41015","0"
"Deschutes","0","137","Oregon","6/12/20","134","3","41017","2.24"
"Douglas","0","29","Oregon","6/12/20","29","0","41019","0"
"Grant","0","1","Oregon","6/12/20","1","0","41023","0"
"Harney","0","1","Oregon","6/12/20","1","0","41025","0"
"Hood River","5","71","Oregon","6/12/20","37","34","41027","91.89"
"Jackson","1","78","Oregon","6/12/20","69","9","41029","13.04"
"Jefferson","1","65","Oregon","6/12/20","55","10","41031","18.18"
"Josephine","0","23","Oregon","6/12/20","23","0","41033","0"
"Klamath","0","48","Oregon","6/12/20","45","3","41035","6.67"
"Lake","0","4","Oregon","6/12/20","2","2","41037","100"
"Lane","1","85","Oregon","6/12/20","80","5","41039","6.25"
"Lincoln","22","184","Oregon","6/12/20","27","157","41041","581.48"
"Linn","0","124","Oregon","6/12/20","124","0","41043","0"
"Malheur","0","33","Oregon","6/12/20","33","0","41045","0"
"Marion","15","1134","Oregon","6/12/20","1028","106","41047","10.31"
"Morrow","0","13","Oregon","6/12/20","12","1","41049","8.33"
"Multnomah","29","1440","Oregon","6/12/20","1236","204","41051","16.5"
"Polk","2","117","Oregon","6/12/20","100","17","41053","17"
"Sherman","0","1","Oregon","6/12/20","1","0","41055","0"
"Tillamook","0","6","Oregon","6/12/20","6","0","41057","0"
"Umatilla","5","157","Oregon","6/12/20","125","32","41059","25.6"
"Union","1","12","Oregon","6/12/20","6","6","41061","100"
"Wallowa","0","4","Oregon","6/12/20","2","2","41063","100"
"Wasco","1","38","Oregon","6/12/20","32","6","41065","18.75"
"Washington","11","849","Oregon","6/12/20","775","74","41067","9.55"
"Yamhill","2","91","Oregon","6/12/20","79","12","41071","15.19"
"Adams","3","284","Pennsylvania","6/12/20","264","20","42001","7.58"
"Allegheny","13","2065","Pennsylvania","6/12/20","1973","92","42003","4.66"
"Armstrong","0","66","Pennsylvania","6/12/20","64","2","42005","3.12"
"Beaver","2","611","Pennsylvania","6/12/20","598","13","42007","2.17"
"Bedford","0","46","Pennsylvania","6/12/20","43","3","42009","6.98"
"Berks","16","4281","Pennsylvania","6/12/20","4167","114","42011","2.74"
"Blair","0","54","Pennsylvania","6/12/20","53","1","42013","1.89"
"Bradford","0","46","Pennsylvania","6/12/20","46","0","42015","0"
"Bucks","28","5396","Pennsylvania","6/12/20","5197","199","42017","3.83"
"Butler","2","256","Pennsylvania","6/12/20","239","17","42019","7.11"
"Cambria","0","62","Pennsylvania","6/12/20","59","3","42021","5.08"
"Cameron","0","2","Pennsylvania","6/12/20","2","0","42023","0"
"Carbon","2","257","Pennsylvania","6/12/20","245","12","42025","4.9"
"Centre","2","165","Pennsylvania","6/12/20","154","11","42027","7.14"
"Chester","41","3247","Pennsylvania","6/12/20","2959","288","42029","9.73"
"Clarion","0","30","Pennsylvania","6/12/20","27","3","42031","11.11"
"Clearfield","1","50","Pennsylvania","6/12/20","43","7","42033","16.28"
"Clinton","0","61","Pennsylvania","6/12/20","60","1","42035","1.67"
"Columbia","3","371","Pennsylvania","6/12/20","352","19","42037","5.4"
"Crawford","1","35","Pennsylvania","6/12/20","30","5","42039","16.67"
"Cumberland","7","709","Pennsylvania","6/12/20","659","50","42041","7.59"
"Dauphin","22","1587","Pennsylvania","6/12/20","1434","153","42043","10.67"
"Delaware","33","6837","Pennsylvania","6/12/20","6608","229","42045","3.47"
"Elk","0","6","Pennsylvania","6/12/20","6","0","42047","0"
"Erie","15","439","Pennsylvania","6/12/20","332","107","42049","32.23"
"Fayette","0","95","Pennsylvania","6/12/20","95","0","42051","0"
"Forest","0","7","Pennsylvania","6/12/20","7","0","42053","0"
"Franklin","7","837","Pennsylvania","6/12/20","788","49","42055","6.22"
"Fulton","0","16","Pennsylvania","6/12/20","16","0","42057","0"
"Greene","0","30","Pennsylvania","6/12/20","27","3","42059","11.11"
"Huntingdon","0","237","Pennsylvania","6/12/20","234","3","42061","1.28"
"Indiana","0","93","Pennsylvania","6/12/20","91","2","42063","2.2"
"Jefferson","0","18","Pennsylvania","6/12/20","15","3","42065","20"
"Juniata","1","105","Pennsylvania","6/12/20","95","10","42067","10.53"
"Lackawanna","3","1598","Pennsylvania","6/12/20","1575","23","42069","1.46"
"Lancaster","49","3682","Pennsylvania","6/12/20","3337","345","42071","10.34"
"Lawrence","1","86","Pennsylvania","6/12/20","82","4","42073","4.88"
"Lebanon","20","1140","Pennsylvania","6/12/20","1000","140","42075","14"
"Lehigh","14","3926","Pennsylvania","6/12/20","3829","97","42077","2.53"
"Luzerne","6","2823","Pennsylvania","6/12/20","2782","41","42079","1.47"
"Lycoming","0","168","Pennsylvania","6/12/20","166","2","42081","1.2"
"McKean","0","13","Pennsylvania","6/12/20","13","0","42083","0"
"Mercer","1","114","Pennsylvania","6/12/20","110","4","42085","3.64"
"Mifflin","0","59","Pennsylvania","6/12/20","59","0","42087","0"
"Monroe","2","1347","Pennsylvania","6/12/20","1335","12","42089","0.9"
"Montgomery","60","7834","Pennsylvania","6/12/20","7416","418","42091","5.64"
"Montour","0","56","Pennsylvania","6/12/20","53","3","42093","5.66"
"Northampton","12","3217","Pennsylvania","6/12/20","3136","81","42095","2.58"
"Northumberland","2","219","Pennsylvania","6/12/20","206","13","42097","6.31"
"Perry","0","70","Pennsylvania","6/12/20","67","3","42099","4.48"
"Philadelphia","117","24228","Pennsylvania","6/12/20","23407","821","42101","3.51"
"Pike","1","482","Pennsylvania","6/12/20","478","4","42103","0.84"
"Potter","1","13","Pennsylvania","6/12/20","8","5","42105","62.5"
"Schuylkill","3","677","Pennsylvania","6/12/20","653","24","42107","3.68"
"Snyder","1","59","Pennsylvania","6/12/20","53","6","42109","11.32"
"Somerset","0","39","Pennsylvania","6/12/20","38","1","42111","2.63"
"Sullivan","0","3","Pennsylvania","6/12/20","3","0","42113","0"
"Susquehanna","6","166","Pennsylvania","6/12/20","124","42","42115","33.87"
"Tioga","0","20","Pennsylvania","6/12/20","19","1","42117","5.26"
"Union","2","81","Pennsylvania","6/12/20","70","11","42119","15.71"
"Venango","0","17","Pennsylvania","6/12/20","15","2","42121","13.33"
"Warren","0","5","Pennsylvania","6/12/20","5","0","42123","0"
"Washington","2","153","Pennsylvania","6/12/20","141","12","42125","8.51"
"Wayne","0","125","Pennsylvania","6/12/20","123","2","42127","1.63"
"Westmoreland","4","483","Pennsylvania","6/12/20","456","27","42129","5.92"
"Wyoming","0","36","Pennsylvania","6/12/20","34","2","42131","5.88"
"York","14","1141","Pennsylvania","6/12/20","1040","101","42133","9.71"
"","131","5536","Puerto Rico","6/12/20","4620","916",,"19.83"
"Bristol","1","231","Rhode Island","6/12/20","224","7","44001","3.12"
"Kent","8","1105","Rhode Island","6/12/20","1052","53","44003","5.04"
"Newport","4","269","Rhode Island","6/12/20","244","25","44005","10.25"
"Providence","130","11959","Rhode Island","6/12/20","11052","907","44007","8.21"
"Washington","2","513","Rhode Island","6/12/20","499","14","44009","2.81"
"Abbeville","2","62","South Carolina","6/12/20","47","15","45001","31.91"
"Aiken","1","225","South Carolina","6/12/20","216","9","45003","4.17"
"Allendale","0","40","South Carolina","6/12/20","39","1","45005","2.56"
"Anderson","6","306","South Carolina","6/12/20","263","43","45007","16.35"
"Bamberg","1","40","South Carolina","6/12/20","33","7","45009","21.21"
"Barnwell","0","54","South Carolina","6/12/20","52","2","45011","3.85"
"Beaufort","18","540","South Carolina","6/12/20","417","123","45013","29.5"
"Berkeley","13","346","South Carolina","6/12/20","257","89","45015","34.63"
"Calhoun","1","27","South Carolina","6/12/20","19","8","45017","42.11"
"Charleston","36","959","South Carolina","6/12/20","709","250","45019","35.26"
"Cherokee","5","86","South Carolina","6/12/20","49","37","45021","75.51"
"Chester","3","114","South Carolina","6/12/20","96","18","45023","18.75"
"Chesterfield","6","281","South Carolina","6/12/20","236","45","45025","19.07"
"Clarendon","3","325","South Carolina","6/12/20","304","21","45027","6.91"
"Colleton","7","177","South Carolina","6/12/20","128","49","45029","38.28"
"Darlington","4","343","South Carolina","6/12/20","316","27","45031","8.54"
"Dillon","3","198","South Carolina","6/12/20","177","21","45033","11.86"
"Dorchester","6","230","South Carolina","6/12/20","189","41","45035","21.69"
"Edgefield","1","58","South Carolina","6/12/20","54","4","45037","7.41"
"Fairfield","3","223","South Carolina","6/12/20","203","20","45039","9.85"
"Florence","9","770","South Carolina","6/12/20","707","63","45041","8.91"
"Georgetown","7","132","South Carolina","6/12/20","82","50","45043","60.98"
"Greenville","99","2624","South Carolina","6/12/20","1934","690","45045","35.68"
"Greenwood","14","259","South Carolina","6/12/20","160","99","45047","61.88"
"Hampton","2","50","South Carolina","6/12/20","38","12","45049","31.58"
"Horry","57","936","South Carolina","6/12/20","536","400","45051","74.63"
"Jasper","1","54","South Carolina","6/12/20","45","9","45053","20"
"Kershaw","7","419","South Carolina","6/12/20","368","51","45055","13.86"
"Lancaster","6","230","South Carolina","6/12/20","189","41","45057","21.69"
"Laurens","6","120","South Carolina","6/12/20","77","43","45059","55.84"
"Lee","1","233","South Carolina","6/12/20","227","6","45061","2.64"
"Lexington","40","1049","South Carolina","6/12/20","766","283","45063","36.95"
"Marion","2","88","South Carolina","6/12/20","74","14","45067","18.92"
"Marlboro","4","226","South Carolina","6/12/20","198","28","45069","14.14"
"McCormick","0","11","South Carolina","6/12/20","10","1","45065","10"
"Newberry","3","93","South Carolina","6/12/20","71","22","45071","30.99"
"Oconee","3","73","South Carolina","6/12/20","55","18","45073","32.73"
"Orangeburg","10","309","South Carolina","6/12/20","242","67","45075","27.69"
"Pickens","11","262","South Carolina","6/12/20","186","76","45077","40.86"
"Richland","59","2076","South Carolina","6/12/20","1666","410","45079","24.61"
"Saluda","1","158","South Carolina","6/12/20","151","7","45081","4.64"
"Spartanburg","27","887","South Carolina","6/12/20","701","186","45083","26.53"
"Sumter","22","580","South Carolina","6/12/20","426","154","45085","36.15"
"Union","0","43","South Carolina","6/12/20","40","3","45087","7.5"
"Williamsburg","3","274","South Carolina","6/12/20","254","20","45089","7.87"
"York","19","580","South Carolina","6/12/20","446","134","45091","30.04"
"Aurora","0","30","South Dakota","6/12/20","27","3","46003","11.11"
"Beadle","11","418","South Dakota","6/12/20","343","75","46005","21.87"
"Bon Homme","0","8","South Dakota","6/12/20","8","0","46009","0"
"Brookings","1","26","South Dakota","6/12/20","20","6","46011","30"
"Brown","2","307","South Dakota","6/12/20","291","16","46013","5.5"
"Brule","1","7","South Dakota","6/12/20","2","5","46015","250"
"Buffalo","2","39","South Dakota","6/12/20","22","17","46017","77.27"
"Charles Mix","0","21","South Dakota","6/12/20","18","3","46023","16.67"
"Clark","0","7","South Dakota","6/12/20","4","3","46025","75"
"Clay","5","56","South Dakota","6/12/20","19","37","46027","194.74"
"Codington","1","44","South Dakota","6/12/20","39","5","46029","12.82"
"Corson","1","9","South Dakota","6/12/20","4","5","46031","125"
"Custer","0","2","South Dakota","6/12/20","1","1","46033","100"
"Davison","1","31","South Dakota","6/12/20","24","7","46035","29.17"
"Day","0","13","South Dakota","6/12/20","14","-1","46037","-7.14"
"Deuel","0","1","South Dakota","6/12/20","1","0","46039","0"
"Dewey","0","2","South Dakota","6/12/20","0","2","46041","1"
"Douglas","0","4","South Dakota","6/12/20","3","1","46043","33.33"
"Edmunds","0","4","South Dakota","6/12/20","3","1","46045","33.33"
"Fall River","0","6","South Dakota","6/12/20","6","0","46047","0"
"Faulk","3","19","South Dakota","6/12/20","1","18","46049","1800"
"Grant","0","13","South Dakota","6/12/20","13","0","46051","0"
"Gregory","0","1","South Dakota","6/12/20","1","0","46053","0"
"Hamlin","1","9","South Dakota","6/12/20","5","4","46057","80"
"Hand","0","6","South Dakota","6/12/20","4","2","46059","50"
"Hanson","0","3","South Dakota","6/12/20","2","1","46061","50"
"Hughes","0","21","South Dakota","6/12/20","19","2","46065","10.53"
"Hutchinson","0","8","South Dakota","6/12/20","6","2","46067","33.33"
"Hyde","0","3","South Dakota","6/12/20","1","2","46069","200"
"Jackson","0","4","South Dakota","6/12/20","4","0","46071","0"
"Jerauld","0","40","South Dakota","6/12/20","39","1","46073","2.56"
"Kingsbury","0","5","South Dakota","6/12/20","3","2","46077","66.67"
"Lake","0","14","South Dakota","6/12/20","12","2","46079","16.67"
"Lawrence","0","12","South Dakota","6/12/20","12","0","46081","0"
"Lincoln","2","262","South Dakota","6/12/20","246","16","46083","6.5"
"Lyman","2","32","South Dakota","6/12/20","16","16","46085","100"
"Marshall","0","4","South Dakota","6/12/20","4","0","46091","0"
"McCook","0","8","South Dakota","6/12/20","6","2","46087","33.33"
"McPherson","0","3","South Dakota","6/12/20","1","2","46089","200"
"Meade","1","30","South Dakota","6/12/20","24","6","46093","25"
"Miner","0","3","South Dakota","6/12/20","2","1","46097","50"
"Minnehaha","10","3458","South Dakota","6/12/20","3387","71","46099","2.1"
"Moody","0","20","South Dakota","6/12/20","19","1","46101","5.26"
"Oglala Lakota","1","45","South Dakota","6/12/20","35","10","46102","28.57"
"Pennington","11","362","South Dakota","6/12/20","284","78","46103","27.46"
"Roberts","0","40","South Dakota","6/12/20","37","3","46109","8.11"
"Sanborn","0","13","South Dakota","6/12/20","13","0","46111","0"
"Spink","0","5","South Dakota","6/12/20","5","0","46115","0"
"Stanley","0","11","South Dakota","6/12/20","10","1","46117","10"
"Sully","0","1","South Dakota","6/12/20","1","0","46119","0"
"Todd","2","46","South Dakota","6/12/20","33","13","46121","39.39"
"Tripp","0","7","South Dakota","6/12/20","6","1","46123","16.67"
"Turner","0","25","South Dakota","6/12/20","25","0","46125","0"
"Union","2","109","South Dakota","6/12/20","93","16","46127","17.2"
"Walworth","0","5","South Dakota","6/12/20","5","0","46129","0"
"Yankton","1","58","South Dakota","6/12/20","52","6","46135","11.54"
"Ziebach","0","2","South Dakota","6/12/20","2","0","46137","0"
"Anderson","2","59","Tennessee","6/12/20","42","17","47001","40.48"
"Bedford","11","376","Tennessee","6/12/20","302","74","47003","24.5"
"Benton","0","8","Tennessee","6/12/20","7","1","47005","14.29"
"Bledsoe","0","614","Tennessee","6/12/20","613","1","47007","0.16"
"Blount","2","104","Tennessee","6/12/20","93","11","47009","11.83"
"Bradley","13","266","Tennessee","6/12/20","174","92","47011","52.87"
"Campbell","1","22","Tennessee","6/12/20","18","4","47013","22.22"
"Cannon","0","34","Tennessee","6/12/20","32","2","47015","6.25"
"Carroll","1","34","Tennessee","6/12/20","28","6","47017","21.43"
"Carter","0","20","Tennessee","6/12/20","19","1","47019","5.26"
"Cheatham","2","152","Tennessee","6/12/20","140","12","47021","8.57"
"Chester","0","12","Tennessee","6/12/20","12","0","47023","0"
"Claiborne","0","15","Tennessee","6/12/20","12","3","47025","25"
"Clay","0","9","Tennessee","6/12/20","8","1","47027","12.5"
"Cocke","1","26","Tennessee","6/12/20","21","5","47029","23.81"
"Coffee","2","92","Tennessee","6/12/20","81","11","47031","13.58"
"Crockett","0","18","Tennessee","6/12/20","16","2","47033","12.5"
"Cumberland","1","130","Tennessee","6/12/20","120","10","47035","8.33"
"Davidson","106","6379","Tennessee","6/12/20","5638","741","47037","13.14"
"Decatur","1","14","Tennessee","6/12/20","5","9","47039","180"
"DeKalb","0","41","Tennessee","6/12/20","39","2","47041","5.13"
"Dickson","1","131","Tennessee","6/12/20","121","10","47043","8.26"
"Dyer","3","82","Tennessee","6/12/20","59","23","47045","38.98"
"Fayette","3","167","Tennessee","6/12/20","144","23","47047","15.97"
"Fentress","0","14","Tennessee","6/12/20","12","2","47049","16.67"
"Franklin","1","59","Tennessee","6/12/20","54","5","47051","9.26"
"Gibson","1","68","Tennessee","6/12/20","63","5","47053","7.94"
"Giles","1","21","Tennessee","6/12/20","14","7","47055","50"
"Grainger","0","18","Tennessee","6/12/20","15","3","47057","20"
"Greene","0","53","Tennessee","6/12/20","52","1","47059","1.92"
"Grundy","0","32","Tennessee","6/12/20","32","0","47061","0"
"Hamblen","4","75","Tennessee","6/12/20","44","31","47063","70.45"
"Hamilton","63","1433","Tennessee","6/12/20","992","441","47065","44.46"
"Hancock","0","1","Tennessee","6/12/20","1","0","47067","0"
"Hardeman","2","215","Tennessee","6/12/20","204","11","47069","5.39"
"Hardin","1","30","Tennessee","6/12/20","22","8","47071","36.36"
"Hawkins","0","34","Tennessee","6/12/20","34","0","47073","0"
"Haywood","0","36","Tennessee","6/12/20","34","2","47075","5.88"
"Henderson","0","17","Tennessee","6/12/20","15","2","47077","13.33"
"Henry","0","34","Tennessee","6/12/20","32","2","47079","6.25"
"Hickman","0","61","Tennessee","6/12/20","59","2","47081","3.39"
"Houston","0","9","Tennessee","6/12/20","8","1","47083","12.5"
"Humphreys","0","18","Tennessee","6/12/20","16","2","47085","12.5"
"Jackson","0","19","Tennessee","6/12/20","19","0","47087","0"
"Jefferson","2","42","Tennessee","6/12/20","29","13","47089","44.83"
"Johnson","1","24","Tennessee","6/12/20","19","5","47091","26.32"
"Knox","11","525","Tennessee","6/12/20","445","80","47093","17.98"
"Lake","-21","691","Tennessee","6/12/20","835","-144","47095","-17.25"
"Lauderdale","0","61","Tennessee","6/12/20","60","1","47097","1.67"
"Lawrence","3","57","Tennessee","6/12/20","35","22","47099","62.86"
"Lewis","0","5","Tennessee","6/12/20","3","2","47101","66.67"
"Lincoln","2","42","Tennessee","6/12/20","30","12","47103","40"
"Loudon","3","188","Tennessee","6/12/20","165","23","47105","13.94"
"Macon","3","191","Tennessee","6/12/20","171","20","47111","11.7"
"Madison","1","182","Tennessee","6/12/20","173","9","47113","5.2"
"Marion","1","48","Tennessee","6/12/20","44","4","47115","9.09"
"Marshall","1","40","Tennessee","6/12/20","34","6","47117","17.65"
"Maury","6","147","Tennessee","6/12/20","108","39","47119","36.11"
"McMinn","2","162","Tennessee","6/12/20","146","16","47107","10.96"
"McNairy","2","26","Tennessee","6/12/20","15","11","47109","73.33"
"Meigs","0","29","Tennessee","6/12/20","27","2","47121","7.41"
"Monroe","2","85","Tennessee","6/12/20","74","11","47123","14.86"
"Montgomery","5","319","Tennessee","6/12/20","287","32","47125","11.15"
"Moore","0","5","Tennessee","6/12/20","5","0","47127","0"
"Morgan","0","18","Tennessee","6/12/20","18","0","47129","0"
"Obion","1","56","Tennessee","6/12/20","48","8","47131","16.67"
"Out of TN","4","457","Tennessee","6/12/20","426","31","80047","7.28"
"Overton","1","37","Tennessee","6/12/20","33","4","47133","12.12"
"Perry","0","25","Tennessee","6/12/20","24","1","47135","4.17"
"Pickett","0","4","Tennessee","6/12/20","3","1","47137","33.33"
"Polk","1","28","Tennessee","6/12/20","19","9","47139","47.37"
"Putnam","9","588","Tennessee","6/12/20","525","63","47141","12"
"Rhea","1","222","Tennessee","6/12/20","217","5","47143","2.3"
"Roane","2","33","Tennessee","6/12/20","17","16","47145","94.12"
"Robertson","8","597","Tennessee","6/12/20","542","55","47147","10.15"
"Rutherford","36","1653","Tennessee","6/12/20","1398","255","47149","18.24"
"Scott","0","14","Tennessee","6/12/20","13","1","47151","7.69"
"Sequatchie","0","21","Tennessee","6/12/20","20","1","47153","5"
"Sevier","15","206","Tennessee","6/12/20","100","106","47155","106"
"Shelby","112","6451","Tennessee","6/12/20","5669","782","47157","13.79"
"Smith","0","39","Tennessee","6/12/20","36","3","47159","8.33"
"Stewart","0","14","Tennessee","6/12/20","14","0","47161","0"
"Sullivan","1","70","Tennessee","6/12/20","60","10","47163","16.67"
"Sumner","15","1059","Tennessee","6/12/20","951","108","47165","11.36"
"Tipton","4","497","Tennessee","6/12/20","467","30","47167","6.42"
"Trousdale","9","1458","Tennessee","6/12/20","1394","64","47169","4.59"
"Unicoi","0","52","Tennessee","6/12/20","49","3","47171","6.12"
"Union","0","7","Tennessee","6/12/20","4","3","47173","75"
"Van Buren","0","4","Tennessee","6/12/20","4","0","47175","0"
"Warren","1","32","Tennessee","6/12/20","27","5","47177","18.52"
"Washington","2","88","Tennessee","6/12/20","76","12","47179","15.79"
"Wayne","0","64","Tennessee","6/12/20","64","0","47181","0"
"Weakley","0","28","Tennessee","6/12/20","26","2","47183","7.69"
"White","2","46","Tennessee","6/12/20","34","12","47185","35.29"
"Williamson","11","670","Tennessee","6/12/20","595","75","47187","12.61"
"Wilson","7","511","Tennessee","6/12/20","459","52","47189","11.33"
"Anderson","1","95","Texas","6/12/20","87","8","48001","9.2"
"Andrews","0","27","Texas","6/12/20","27","0","48003","0"
"Angelina","11","309","Texas","6/12/20","232","77","48005","33.19"
"Aransas","0","6","Texas","6/12/20","5","1","48007","20"
"Archer","0","3","Texas","6/12/20","2","1","48009","50"
"Armstrong","0","3","Texas","6/12/20","3","0","48011","0"
"Atascosa","0","43","Texas","6/12/20","41","2","48013","4.88"
"Austin","1","33","Texas","6/12/20","29","4","48015","13.79"
"Bailey","1","30","Texas","6/12/20","24","6","48017","25"
"Bandera","0","7","Texas","6/12/20","6","1","48019","16.67"
"Bastrop","6","288","Texas","6/12/20","245","43","48021","17.55"
"Baylor","0","1","Texas","6/12/20","3","-2","48023","-66.67"
"Bee","2","31","Texas","6/12/20","18","13","48025","72.22"
"Bell","20","574","Texas","6/12/20","432","142","48027","32.87"
"Bexar","117","3840","Texas","6/12/20","3018","822","48029","27.24"
"Blanco","0","11","Texas","6/12/20","11","0","48031","0"
"Bosque","0","7","Texas","6/12/20","7","0","48035","0"
"Bowie","9","367","Texas","6/12/20","301","66","48037","21.93"
"Brazoria","-22","813","Texas","6/12/20","967","-154","48039","-15.93"
"Brazos","25","710","Texas","6/12/20","532","178","48041","33.46"
"Brewster","0","1","Texas","6/12/20","1","0","48043","0"
"Briscoe","0","1","Texas","6/12/20","1","0","48045","0"
"Brooks","0","1","Texas","6/12/20","1","0","48047","0"
"Brown","0","60","Texas","6/12/20","59","1","48049","1.69"
"Burleson","2","40","Texas","6/12/20","29","11","48051","37.93"
"Burnet","1","56","Texas","6/12/20","49","7","48053","14.29"
"Caldwell","2","87","Texas","6/12/20","74","13","48055","17.57"
"Calhoun","1","46","Texas","6/12/20","37","9","48057","24.32"
"Callahan","0","12","Texas","6/12/20","10","2","48059","20"
"Cameron","27","1031","Texas","6/12/20","841","190","48061","22.59"
"Camp","2","98","Texas","6/12/20","87","11","48063","12.64"
"Carson","0","6","Texas","6/12/20","6","0","48065","0"
"Cass","1","34","Texas","6/12/20","30","4","48067","13.33"
"Castro","1","39","Texas","6/12/20","34","5","48069","14.71"
"Chambers","4","98","Texas","6/12/20","73","25","48071","34.25"
"Cherokee","1","54","Texas","6/12/20","50","4","48073","8"
"Childress","1","6","Texas","6/12/20","2","4","48075","200"
"Clay","0","5","Texas","6/12/20","5","0","48077","0"
"Cochran","0","1","Texas","6/12/20","1","0","48079","0"
"Coke","0","4","Texas","6/12/20","1","3","48081","300"
"Coleman","0","3","Texas","6/12/20","4","-1","48083","-25"
"Collin","19","1560","Texas","6/12/20","1430","130","48085","9.09"
"Collingsworth","0","5","Texas","6/12/20","5","0","48087","0"
"Colorado","1","31","Texas","6/12/20","24","7","48089","29.17"
"Comal","4","141","Texas","6/12/20","113","28","48091","24.78"
"Comanche","0","12","Texas","6/12/20","12","0","48093","0"
"Concho","0","1","Texas","6/12/20","1","0","48095","0"
"Cooke","0","23","Texas","6/12/20","20","3","48097","15"
"Coryell","1","299","Texas","6/12/20","289","10","48099","3.46"
"Cottle","0","4","Texas","6/12/20","4","0","48101","0"
"Crane","1","32","Texas","6/12/20","26","6","48103","23.08"
"Crockett","1","5","Texas","6/12/20","1","4","48105","400"
"Crosby","0","4","Texas","6/12/20","3","1","48107","33.33"
"Dallam","1","36","Texas","6/12/20","27","9","48111","33.33"
"Dallas","292","13585","Texas","6/12/20","11541","2044","48113","17.71"
"Dawson","0","45","Texas","6/12/20","45","0","48115","0"
"Deaf Smith","4","203","Texas","6/12/20","174","29","48117","16.67"
"Delta","0","2","Texas","6/12/20","2","0","48119","0"
"Denton","25","1632","Texas","6/12/20","1454","178","48121","12.24"
"DeWitt","1","26","Texas","6/12/20","18","8","48123","44.44"
"Dickens","0","2","Texas","6/12/20","1","1","48125","100"
"Dimmit","0","1","Texas","6/12/20","1","0","48127","0"
"Donley","0","28","Texas","6/12/20","27","1","48129","3.7"
"Duval","0","5","Texas","6/12/20","5","0","48131","0"
"Eastland","0","7","Texas","6/12/20","7","0","48133","0"
"Ector","6","227","Texas","6/12/20","185","42","48135","22.7"
"El Paso","62","3650","Texas","6/12/20","3213","437","48141","13.6"
"Ellis","10","437","Texas","6/12/20","366","71","48139","19.4"
"Erath","1","32","Texas","6/12/20","25","7","48143","28"
"Falls","0","14","Texas","6/12/20","11","3","48145","27.27"
"Fannin","1","52","Texas","6/12/20","42","10","48147","23.81"
"Fayette","1","44","Texas","6/12/20","38","6","48149","15.79"
"Fisher","0","2","Texas","6/12/20","2","0","48151","0"
"Floyd","0","16","Texas","6/12/20","16","0","48153","0"
"Fort Bend","41","2320","Texas","6/12/20","2032","288","48157","14.17"
"Franklin","1","24","Texas","6/12/20","18","6","48159","33.33"
"Freestone","1","15","Texas","6/12/20","10","5","48161","50"
"Frio","2","57","Texas","6/12/20","40","17","48163","42.5"
"Gaines","0","9","Texas","6/12/20","7","2","48165","28.57"
"Galveston","30","1114","Texas","6/12/20","906","208","48167","22.96"
"Garza","0","6","Texas","6/12/20","6","0","48169","0"
"Gillespie","0","5","Texas","6/12/20","5","0","48171","0"
"Glasscock","0","1","Texas","6/12/20","1","0","48173","0"
"Goliad","0","7","Texas","6/12/20","7","0","48175","0"
"Gonzales","1","157","Texas","6/12/20","147","10","48177","6.8"
"Gray","1","111","Texas","6/12/20","104","7","48179","6.73"
"Grayson","6","408","Texas","6/12/20","366","42","48181","11.48"
"Gregg","3","274","Texas","6/12/20","250","24","48183","9.6"
"Grimes","6","270","Texas","6/12/20","226","44","48185","19.47"
"Guadalupe","2","160","Texas","6/12/20","145","15","48187","10.34"
"Hale","2","76","Texas","6/12/20","60","16","48189","26.67"
"Hall","0","2","Texas","6/12/20","2","0","48191","0"
"Hamilton","0","11","Texas","6/12/20","9","2","48193","22.22"
"Hansford","0","21","Texas","6/12/20","20","1","48195","5"
"Hardeman","0","4","Texas","6/12/20","3","1","48197","33.33"
"Hardin","0","145","Texas","6/12/20","142","3","48199","2.11"
"Harris","321","16188","Texas","6/12/20","13940","2248","48201","16.13"
"Harrison","2","267","Texas","6/12/20","256","11","48203","4.3"
"Hartley","0","12","Texas","6/12/20","12","0","48205","0"
"Haskell","0","4","Texas","6/12/20","3","1","48207","33.33"
"Hays","27","574","Texas","6/12/20","385","189","48209","49.09"
"Hemphill","0","1","Texas","6/12/20","1","0","48211","0"
"Henderson","1","74","Texas","6/12/20","65","9","48213","13.85"
"Hidalgo","33","912","Texas","6/12/20","679","233","48215","34.32"
"Hill","1","34","Texas","6/12/20","26","8","48217","30.77"
"Hockley","0","28","Texas","6/12/20","27","1","48219","3.7"
"Hood","0","34","Texas","6/12/20","31","3","48221","9.68"
"Hopkins","2","41","Texas","6/12/20","28","13","48223","46.43"
"Houston","0","154","Texas","6/12/20","151","3","48225","1.99"
"Howard","1","18","Texas","6/12/20","9","9","48227","100"
"Hudspeth","1","12","Texas","6/12/20","4","8","48229","200"
"Hunt","7","162","Texas","6/12/20","114","48","48231","42.11"
"Hutchinson","0","45","Texas","6/12/20","44","1","48233","2.27"
"Irion","0","1","Texas","6/12/20","1","0","48235","0"
"Jack","0","4","Texas","6/12/20","4","0","48237","0"
"Jackson","0","20","Texas","6/12/20","19","1","48239","5.26"
"Jasper","0","32","Texas","6/12/20","29","3","48241","10.34"
"Jefferson","88","1222","Texas","6/12/20","604","618","48245","102.32"
"Jim Hogg","0","4","Texas","6/12/20","4","0","48247","0"
"Jim Wells","1","17","Texas","6/12/20","12","5","48249","41.67"
"Johnson","4","229","Texas","6/12/20","202","27","48251","13.37"
"Jones","-1","633","Texas","6/12/20","637","-4","48253","-0.63"
"Karnes","0","4","Texas","6/12/20","4","0","48255","0"
"Kaufman","9","325","Texas","6/12/20","260","65","48257","25"
"Kendall","0","35","Texas","6/12/20","32","3","48259","9.38"
"Kerr","0","20","Texas","6/12/20","20","0","48265","0"
"Kimble","0","1","Texas","6/12/20","1","0","48267","0"
"Kinney","0","1","Texas","6/12/20","1","0","48271","0"
"Kleberg","0","20","Texas","6/12/20","18","2","48273","11.11"
"Knox","0","1","Texas","6/12/20","1","0","48275","0"
"La Salle","0","4","Texas","6/12/20","4","0","48283","0"
"Lamar","1","163","Texas","6/12/20","154","9","48277","5.84"
"Lamb","0","18","Texas","6/12/20","16","2","48279","12.5"
"Lampasas","0","9","Texas","6/12/20","9","0","48281","0"
"Lavaca","0","21","Texas","6/12/20","18","3","48285","16.67"
"Lee","1","35","Texas","6/12/20","25","10","48287","40"
"Leon","0","11","Texas","6/12/20","11","0","48289","0"
"Liberty","3","121","Texas","6/12/20","101","20","48291","19.8"
"Limestone","1","36","Texas","6/12/20","30","6","48293","20"
"Lipscomb","0","7","Texas","6/12/20","5","2","48295","40"
"Live Oak","0","9","Texas","6/12/20","9","0","48297","0"
"Llano","0","4","Texas","6/12/20","3","1","48299","33.33"
"Lubbock","10","790","Texas","6/12/20","720","70","48303","9.72"
"Lynn","1","14","Texas","6/12/20","8","6","48305","75"
"Madison","1","19","Texas","6/12/20","9","10","48313","111.11"
"Marion","0","19","Texas","6/12/20","17","2","48315","11.76"
"Martin","0","3","Texas","6/12/20","3","0","48317","0"
"Mason","0","33","Texas","6/12/20","32","1","48319","3.12"
"Matagorda","1","80","Texas","6/12/20","71","9","48321","12.68"
"Maverick","3","149","Texas","6/12/20","129","20","48323","15.5"
"McCulloch","0","3","Texas","6/12/20","3","0","48307","0"
"McLennan","4","150","Texas","6/12/20","125","25","48309","20"
"Medina","20","220","Texas","6/12/20","78","142","48325","182.05"
"Midland","7","194","Texas","6/12/20","146","48","48329","32.88"
"Milam","1","40","Texas","6/12/20","32","8","48331","25"
"Mills","0","1","Texas","6/12/20","1","0","48333","0"
"Mitchell","0","2","Texas","6/12/20","1","1","48335","100"
"Montague","0","9","Texas","6/12/20","9","0","48337","0"
"Montgomery","28","1258","Texas","6/12/20","1064","194","48339","18.23"
"Moore","3","871","Texas","6/12/20","851","20","48341","2.35"
"Morris","0","28","Texas","6/12/20","27","1","48343","3.7"
"Motley","0","1","Texas","6/12/20","1","0","48345","0"
"Nacogdoches","2","317","Texas","6/12/20","301","16","48347","5.32"
"Navarro","3","84","Texas","6/12/20","64","20","48349","31.25"
"Newton","0","6","Texas","6/12/20","5","1","48351","20"
"Nolan","-1","3","Texas","6/12/20","8","-5","48353","-62.5"
"Nueces","5","321","Texas","6/12/20","286","35","48355","12.24"
"Ochiltree","0","53","Texas","6/12/20","51","2","48357","3.92"
"Oldham","0","4","Texas","6/12/20","4","0","48359","0"
"Orange","1","105","Texas","6/12/20","101","4","48361","3.96"
"Palo Pinto","0","14","Texas","6/12/20","13","1","48363","7.69"
"Panola","0","216","Texas","6/12/20","213","3","48365","1.41"
"Parker","3","110","Texas","6/12/20","87","23","48367","26.44"
"Parmer","3","111","Texas","6/12/20","88","23","48369","26.14"
"Pecos","1","107","Texas","6/12/20","103","4","48371","3.88"
"Polk","1","65","Texas","6/12/20","60","5","48373","8.33"
"Potter","40","2785","Texas","6/12/20","2504","281","48375","11.22"
"Presidio","0","2","Texas","6/12/20","1","1","48377","100"
"Rains","0","4","Texas","6/12/20","4","0","48379","0"
"Randall","3","748","Texas","6/12/20","724","24","48381","3.31"
"Reagan","0","2","Texas","6/12/20","2","0","48383","0"
"Real","0","1","Texas","6/12/20","1","0","48385","0"
"Red River","2","89","Texas","6/12/20","76","13","48387","17.11"
"Reeves","1","12","Texas","6/12/20","8","4","48389","50"
"Refugio","0","5","Texas","6/12/20","3","2","48391","66.67"
"Roberts","0","2","Texas","6/12/20","2","0","48393","0"
"Robertson","1","18","Texas","6/12/20","14","4","48395","28.57"
"Rockwall","6","233","Texas","6/12/20","194","39","48397","20.1"
"Runnels","0","2","Texas","6/12/20","3","-1","48399","-33.33"
"Rusk","1","68","Texas","6/12/20","60","8","48401","13.33"
"Sabine","0","15","Texas","6/12/20","15","0","48403","0"
"San Augustine","2","55","Texas","6/12/20","44","11","48405","25"
"San Jacinto","0","20","Texas","6/12/20","17","3","48407","17.65"
"San Patricio","0","41","Texas","6/12/20","38","3","48409","7.89"
"San Saba","0","1","Texas","6/12/20","1","0","48411","0"
"Scurry","0","28","Texas","6/12/20","26","2","48415","7.69"
"Shackelford","0","1","Texas","6/12/20","1","0","48417","0"
"Shelby","2","226","Texas","6/12/20","213","13","48419","6.1"
"Sherman","0","28","Texas","6/12/20","28","0","48421","0"
"Smith","4","244","Texas","6/12/20","216","28","48423","12.96"
"Somervell","0","2","Texas","6/12/20","0","2","48425","1"
"Starr","6","88","Texas","6/12/20","44","44","48427","100"
"Stephens","0","4","Texas","6/12/20","4","0","48429","0"
"Swisher","0","21","Texas","6/12/20","18","3","48437","16.67"
"Tarrant","162","7120","Texas","6/12/20","5985","1135","48439","18.96"
"Taylor","1","252","Texas","6/12/20","245","7","48441","2.86"
"Terry","0","13","Texas","6/12/20","13","0","48445","0"
"Throckmorton","0","1","Texas","6/12/20","1","0","48447","0"
"Titus","10","655","Texas","6/12/20","583","72","48449","12.35"
"Tom Green","4","137","Texas","6/12/20","109","28","48451","25.69"
"Travis","107","4314","Texas","6/12/20","3562","752","48453","21.11"
"Trinity","0","22","Texas","6/12/20","20","2","48455","10"
"Tyler","0","16","Texas","6/12/20","14","2","48457","14.29"
"Upshur","1","37","Texas","6/12/20","30","7","48459","23.33"
"Uvalde","1","24","Texas","6/12/20","18","6","48463","33.33"
"Val Verde","2","32","Texas","6/12/20","21","11","48465","52.38"
"Van Zandt","1","44","Texas","6/12/20","37","7","48467","18.92"
"Victoria","2","184","Texas","6/12/20","170","14","48469","8.24"
"Walker","4","1868","Texas","6/12/20","1843","25","48471","1.36"
"Waller","4","90","Texas","6/12/20","65","25","48473","38.46"
"Ward","0","4","Texas","6/12/20","1","3","48475","300"
"Washington","1","216","Texas","6/12/20","206","10","48477","4.85"
"Webb","12","661","Texas","6/12/20","574","87","48479","15.16"
"Wharton","2","89","Texas","6/12/20","73","16","48481","21.92"
"Wheeler","0","15","Texas","6/12/20","15","0","48483","0"
"Wichita","1","93","Texas","6/12/20","87","6","48485","6.9"
"Wilbarger","0","7","Texas","6/12/20","7","0","48487","0"
"Willacy","4","52","Texas","6/12/20","26","26","48489","100"
"Williamson","21","820","Texas","6/12/20","672","148","48491","22.02"
"Wilson","1","50","Texas","6/12/20","44","6","48493","13.64"
"Winkler","0","4","Texas","6/12/20","3","1","48495","33.33"
"Wise","0","55","Texas","6/12/20","52","3","48497","5.77"
"Wood","2","51","Texas","6/12/20","40","11","48499","27.5"
"Yoakum","1","8","Texas","6/12/20","3","5","48501","166.67"
"Young","1","14","Texas","6/12/20","6","8","48503","133.33"
"Zapata","0","14","Texas","6/12/20","11","3","48505","27.27"
"Zavala","0","12","Texas","6/12/20","12","0","48507","0"
"Bear River","62","927","Utah","6/12/20","491","436","00000","88.8"
"Central Utah","3","61","Utah","6/12/20","42","19","00000","45.24"
"Davis","15","628","Utah","6/12/20","525","103","49011","19.62"
"Salt Lake","149","6942","Utah","6/12/20","5901","1041","49035","17.64"
"San Juan","5","350","Utah","6/12/20","314","36","49037","11.46"
"Southeast Utah","0","28","Utah","6/12/20","26","2","00000","7.69"
"Southwest Utah","26","739","Utah","6/12/20","554","185","00000","33.39"
"Summit","3","444","Utah","6/12/20","422","22","49043","5.21"
"Tooele","2","159","Utah","6/12/20","144","15","49045","10.42"
"TriCounty","1","27","Utah","6/12/20","20","7","00000","35"
"Utah","50","2491","Utah","6/12/20","2143","348","49049","16.24"
"Wasatch","4","342","Utah","6/12/20","317","25","49051","7.89"
"Weber-Morgan","12","439","Utah","6/12/20","353","86","00000","24.36"
"Addison","0","66","Vermont","6/12/20","64","2","50001","3.12"
"Bennington","0","67","Vermont","6/12/20","66","1","50003","1.52"
"Caledonia","0","16","Vermont","6/12/20","16","0","50005","0"
"Chittenden","11","564","Vermont","6/12/20","490","74","50007","15.1"
"Essex","0","3","Vermont","6/12/20","3","0","50009","0"
"Franklin","0","102","Vermont","6/12/20","100","2","50011","2"
"Grand Isle","0","8","Vermont","6/12/20","7","1","50013","14.29"
"Lamoille","0","29","Vermont","6/12/20","29","0","50015","0"
"Orange","0","9","Vermont","6/12/20","9","0","50017","0"
"Orleans","0","13","Vermont","6/12/20","10","3","50019","30"
"Rutland","0","58","Vermont","6/12/20","56","2","50021","3.57"
"Washington","0","40","Vermont","6/12/20","39","1","50023","2.56"
"Windham","0","84","Vermont","6/12/20","81","3","50025","3.7"
"Windsor","0","55","Vermont","6/12/20","52","3","50027","5.77"
"","0","72","Virgin Islands","6/12/20","71","1",,"1.41"
"Accomack","3","987","Virginia","6/12/20","969","18","51001","1.86"
"Albemarle","8","272","Virginia","6/12/20","217","55","51003","25.35"
"Alexandria","12","2128","Virginia","6/12/20","2045","83","51510","4.06"
"Alleghany","0","27","Virginia","6/12/20","24","3","51005","12.5"
"Amelia","1","37","Virginia","6/12/20","28","9","51007","32.14"
"Amherst","0","27","Virginia","6/12/20","27","0","51009","0"
"Appomattox","0","34","Virginia","6/12/20","33","1","51011","3.03"
"Arlington","19","2307","Virginia","6/12/20","2173","134","51013","6.17"
"Augusta","2","141","Virginia","6/12/20","124","17","51015","13.71"
"Bedford","2","86","Virginia","6/12/20","72","14","51019","19.44"
"Botetourt","1","44","Virginia","6/12/20","35","9","51023","25.71"
"Bristol","0","4","Virginia","6/12/20","4","0","51520","0"
"Brunswick","2","44","Virginia","6/12/20","32","12","51025","37.5"
"Buchanan","0","18","Virginia","6/12/20","18","0","51027","0"
"Buckingham","6","518","Virginia","6/12/20","475","43","51029","9.05"
"Buena Vista","0","12","Virginia","6/12/20","13","-1","51530","-7.69"
"Campbell","0","22","Virginia","6/12/20","20","2","51031","10"
"Caroline","3","101","Virginia","6/12/20","79","22","51033","27.85"
"Carroll","5","159","Virginia","6/12/20","122","37","51035","30.33"
"Charles City","0","28","Virginia","6/12/20","27","1","51036","3.7"
"Charlotte","0","30","Virginia","6/12/20","28","2","51037","7.14"
"Charlottesville","2","146","Virginia","6/12/20","131","15","51540","11.45"
"Chesapeake","10","636","Virginia","6/12/20","563","73","51550","12.97"
"Chesterfield","50","2109","Virginia","6/12/20","1761","348","51041","19.76"
"Clarke","1","37","Virginia","6/12/20","31","6","51043","19.35"
"Colonial Heights","2","111","Virginia","6/12/20","97","14","51570","14.43"
"Covington","0","4","Virginia","6/12/20","4","0","51580","0"
"Craig","0","6","Virginia","6/12/20","5","1","51045","20"
"Culpeper","5","774","Virginia","6/12/20","740","34","51047","4.59"
"Cumberland","1","46","Virginia","6/12/20","41","5","51049","12.2"
"Danville","0","63","Virginia","6/12/20","60","3","51590","5"
"Dinwiddie","2","105","Virginia","6/12/20","93","12","51053","12.9"
"Emporia","1","94","Virginia","6/12/20","86","8","51595","9.3"
"Essex","0","52","Virginia","6/12/20","53","-1","51057","-1.89"
"Fairfax","137","12863","Virginia","6/12/20","11904","959","51059","8.06"
"Fairfax City","0","68","Virginia","6/12/20","67","1","51600","1.49"
"Falls Church","0","56","Virginia","6/12/20","56","0","51610","0"
"Fauquier","5","376","Virginia","6/12/20","339","37","51061","10.91"
"Floyd","0","8","Virginia","6/12/20","6","2","51063","33.33"
"Fluvanna","1","101","Virginia","6/12/20","94","7","51065","7.45"
"Franklin","1","42","Virginia","6/12/20","38","4","51067","10.53"
"Franklin City","0","43","Virginia","6/12/20","42","1","51620","2.38"
"Frederick","5","423","Virginia","6/12/20","388","35","51069","9.02"
"Fredericksburg","2","199","Virginia","6/12/20","186","13","51630","6.99"
"Galax","4","171","Virginia","6/12/20","140","31","51640","22.14"
"Giles","0","5","Virginia","6/12/20","5","0","51071","0"
"Gloucester","0","35","Virginia","6/12/20","32","3","51073","9.38"
"Goochland","1","112","Virginia","6/12/20","105","7","51075","6.67"
"Grayson","2","63","Virginia","6/12/20","46","17","51077","36.96"
"Greene","1","45","Virginia","6/12/20","35","10","51079","28.57"
"Greensville","11","306","Virginia","6/12/20","229","77","51081","33.62"
"Halifax","0","32","Virginia","6/12/20","31","1","51083","3.23"
"Hampton","3","234","Virginia","6/12/20","215","19","51650","8.84"
"Hanover","3","362","Virginia","6/12/20","338","24","51085","7.1"
"Harrisonburg","5","850","Virginia","6/12/20","817","33","51660","4.04"
"Henrico","30","2193","Virginia","6/12/20","1983","210","51087","10.59"
"Henry","5","193","Virginia","6/12/20","155","38","51089","24.52"
"Highland","0","2","Virginia","6/12/20","3","-1","51091","-33.33"
"Hopewell","3","129","Virginia","6/12/20","110","19","51670","17.27"
"Isle of Wight","2","150","Virginia","6/12/20","137","13","51093","9.49"
"James City","3","230","Virginia","6/12/20","211","19","51095","9"
"King and Queen","0","24","Virginia","6/12/20","21","3","51097","14.29"
"King George","2","87","Virginia","6/12/20","72","15","51099","20.83"
"King William","0","32","Virginia","6/12/20","31","1","51101","3.23"
"Lancaster","0","11","Virginia","6/12/20","10","1","51103","10"
"Lee","0","9","Virginia","6/12/20","9","0","51105","0"
"Lexington","0","8","Virginia","6/12/20","7","1","51678","14.29"
"Loudoun","63","3280","Virginia","6/12/20","2837","443","51107","15.62"
"Louisa","2","98","Virginia","6/12/20","85","13","51109","15.29"
"Lunenburg","0","19","Virginia","6/12/20","17","2","51111","11.76"
"Lynchburg","1","91","Virginia","6/12/20","87","4","51680","4.6"
"Madison","0","42","Virginia","6/12/20","41","1","51113","2.44"
"Manassas","13","1282","Virginia","6/12/20","1190","92","51683","7.73"
"Manassas Park","4","369","Virginia","6/12/20","343","26","51685","7.58"
"Martinsville","2","54","Virginia","6/12/20","41","13","51690","31.71"
"Mathews","0","5","Virginia","6/12/20","5","0","51115","0"
"Mecklenburg","1","226","Virginia","6/12/20","220","6","51117","2.73"
"Middlesex","0","14","Virginia","6/12/20","14","0","51119","0"
"Montgomery","2","96","Virginia","6/12/20","85","11","51121","12.94"
"Nelson","0","18","Virginia","6/12/20","17","1","51125","5.88"
"New Kent","1","44","Virginia","6/12/20","39","5","51127","12.82"
"Newport News","6","351","Virginia","6/12/20","309","42","51700","13.59"
"Norfolk","10","630","Virginia","6/12/20","560","70","51710","12.5"
"Northampton","1","259","Virginia","6/12/20","249","10","51131","4.02"
"Northumberland","0","25","Virginia","6/12/20","25","0","51133","0"
"Norton","0","2","Virginia","6/12/20","2","0","51720","0"
"Nottoway","3","63","Virginia","6/12/20","44","19","51135","43.18"
"Orange","1","124","Virginia","6/12/20","119","5","51137","4.2"
"Page","2","250","Virginia","6/12/20","233","17","51139","7.3"
"Patrick","1","31","Virginia","6/12/20","23","8","51141","34.78"
"Petersburg","3","178","Virginia","6/12/20","159","19","51730","11.95"
"Pittsylvania","2","59","Virginia","6/12/20","47","12","51143","25.53"
"Poquoson","0","11","Virginia","6/12/20","8","3","51735","37.5"
"Portsmouth","6","370","Virginia","6/12/20","325","45","51740","13.85"
"Powhatan","2","50","Virginia","6/12/20","37","13","51145","35.14"
"Prince Edward","2","161","Virginia","6/12/20","146","15","51147","10.27"
"Prince George","2","158","Virginia","6/12/20","142","16","51149","11.27"
"Prince William","58","6439","Virginia","6/12/20","6030","409","51153","6.78"
"Pulaski","1","30","Virginia","6/12/20","21","9","51155","42.86"
"Radford","0","7","Virginia","6/12/20","6","1","51750","16.67"
"Rappahannock","0","16","Virginia","6/12/20","15","1","51157","6.67"
"Richmond","0","290","Virginia","6/12/20","289","1","51159","0.35"
"Richmond City","29","1733","Virginia","6/12/20","1527","206","51760","13.49"
"Roanoke","2","132","Virginia","6/12/20","119","13","51161","10.92"
"Roanoke City","6","232","Virginia","6/12/20","190","42","51770","22.11"
"Rockbridge","0","19","Virginia","6/12/20","18","1","51163","5.56"
"Rockingham","8","614","Virginia","6/12/20","561","53","51165","9.45"
"Russell","0","8","Virginia","6/12/20","8","0","51167","0"
"Salem","1","43","Virginia","6/12/20","37","6","51775","16.22"
"Scott","0","7","Virginia","6/12/20","7","0","51169","0"
"Shenandoah","5","505","Virginia","6/12/20","472","33","51171","6.99"
"Smyth","0","18","Virginia","6/12/20","15","3","51173","20"
"Southampton","0","155","Virginia","6/12/20","152","3","51175","1.97"
"Spotsylvania","18","739","Virginia","6/12/20","615","124","51177","20.16"
"Stafford","16","862","Virginia","6/12/20","750","112","51179","14.93"
"Staunton","1","57","Virginia","6/12/20","53","4","51790","7.55"
"Suffolk","2","337","Virginia","6/12/20","322","15","51800","4.66"
"Surry","0","13","Virginia","6/12/20","10","3","51181","30"
"Sussex","0","177","Virginia","6/12/20","174","3","51183","1.72"
"Tazewell","0","9","Virginia","6/12/20","9","0","51185","0"
"Virginia Beach","9","847","Virginia","6/12/20","784","63","51810","8.04"
"Warren","1","228","Virginia","6/12/20","220","8","51187","3.64"
"Washington","1","58","Virginia","6/12/20","53","5","51191","9.43"
"Waynesboro","1","53","Virginia","6/12/20","48","5","51820","10.42"
"Westmoreland","1","84","Virginia","6/12/20","80","4","51193","5"
"Williamsburg","1","49","Virginia","6/12/20","45","4","51830","8.89"
"Winchester","5","260","Virginia","6/12/20","225","35","51840","15.56"
"Wise","0","27","Virginia","6/12/20","27","0","51195","0"
"Wythe","2","42","Virginia","6/12/20","30","12","51197","40"
"York","2","90","Virginia","6/12/20","79","11","51199","13.92"
"Adams","2","89","Washington","6/12/20","78","11","53001","14.1"
"Asotin","0","20","Washington","6/12/20","19","1","53003","5.26"
"Benton","29","1075","Washington","6/12/20","873","202","53005","23.14"
"Chelan","2","271","Washington","6/12/20","260","11","53007","4.23"
"Clallam","0","28","Washington","6/12/20","27","1","53009","3.7"
"Clark","8","604","Washington","6/12/20","550","54","53011","9.82"
"Columbia","0","1","Washington","6/12/20","1","0","53013","0"
"Cowlitz","4","102","Washington","6/12/20","76","26","53015","34.21"
"Douglas","0","178","Washington","6/12/20","177","1","53017","0.56"
"Ferry","0","1","Washington","6/12/20","1","0","53019","0"
"Franklin","25","847","Washington","6/12/20","670","177","53021","26.42"
"Grant","4","241","Washington","6/12/20","214","27","53025","12.62"
"Grays Harbor","0","20","Washington","6/12/20","19","1","53027","5.26"
"Island","0","182","Washington","6/12/20","181","1","53029","0.55"
"Jefferson","0","31","Washington","6/12/20","31","0","53031","0"
"King","34","8611","Washington","6/12/20","8371","240","53033","2.87"
"Kitsap","1","173","Washington","6/12/20","164","9","53035","5.49"
"Kittitas","1","92","Washington","6/12/20","88","4","53037","4.55"
"Klickitat","2","42","Washington","6/12/20","30","12","53039","40"
"Lewis","0","38","Washington","6/12/20","37","1","53041","2.7"
"Lincoln","0","2","Washington","6/12/20","2","0","53043","0"
"Mason","0","39","Washington","6/12/20","37","2","53045","5.41"
"Okanogan","1","57","Washington","6/12/20","52","5","53047","9.62"
"Pacific","0","11","Washington","6/12/20","9","2","53049","22.22"
"Pend Oreille","0","3","Washington","6/12/20","3","0","53051","0"
"Pierce","13","2097","Washington","6/12/20","2007","90","53053","4.48"
"San Juan","0","15","Washington","6/12/20","15","0","53055","0"
"Skagit","1","454","Washington","6/12/20","450","4","53057","0.89"
"Skamania","0","3","Washington","6/12/20","3","0","53059","0"
"Snohomish","13","3107","Washington","6/12/20","3014","93","53061","3.09"
"Spokane","18","791","Washington","6/12/20","664","127","53063","19.13"
"Stevens","0","15","Washington","6/12/20","13","2","53065","15.38"
"Thurston","4","183","Washington","6/12/20","157","26","53067","16.56"
"Wahkiakum","0","4","Washington","6/12/20","4","0","53069","0"
"Walla Walla","1","118","Washington","6/12/20","111","7","53071","6.31"
"Whatcom","4","436","Washington","6/12/20","405","31","53073","7.65"
"Whitman","1","27","Washington","6/12/20","20","7","53075","35"
"Yakima","141","5129","Washington","6/12/20","4141","988","53077","23.86"
"Barbour","0","10","West Virginia","6/12/20","8","2","54001","25"
"Berkeley","5","376","West Virginia","6/12/20","340","36","54003","10.59"
"Boone","1","17","West Virginia","6/12/20","11","6","54005","54.55"
"Braxton","0","3","West Virginia","6/12/20","2","1","54007","50"
"Brooke","0","5","West Virginia","6/12/20","5","0","54009","0"
"Cabell","0","72","West Virginia","6/12/20","69","3","54011","4.35"
"Calhoun","0","2","West Virginia","6/12/20","2","0","54013","0"
"Clay","0","8","West Virginia","6/12/20","7","1","54015","14.29"
"Fayette","0","54","West Virginia","6/12/20","54","0","54019","0"
"Gilmer","0","10","West Virginia","6/12/20","10","0","54021","0"
"Grant","1","16","West Virginia","6/12/20","12","4","54023","33.33"
"Greenbrier","0","11","West Virginia","6/12/20","9","2","54025","22.22"
"Hampshire","0","35","West Virginia","6/12/20","33","2","54027","6.06"
"Hancock","0","20","West Virginia","6/12/20","20","0","54029","0"
"Hardy","0","40","West Virginia","6/12/20","40","0","54031","0"
"Harrison","0","43","West Virginia","6/12/20","40","3","54033","7.5"
"Jackson","0","141","West Virginia","6/12/20","138","3","54035","2.17"
"Jefferson","0","205","West Virginia","6/12/20","203","2","54037","0.99"
"Kanawha","2","247","West Virginia","6/12/20","233","14","54039","6.01"
"Lewis","0","8","West Virginia","6/12/20","9","-1","54041","-11.11"
"Lincoln","0","5","West Virginia","6/12/20","5","0","54043","0"
"Logan","0","21","West Virginia","6/12/20","20","1","54045","5"
"Marion","0","53","West Virginia","6/12/20","52","1","54049","1.92"
"Marshall","1","37","West Virginia","6/12/20","30","7","54051","23.33"
"Mason","0","15","West Virginia","6/12/20","15","0","54053","0"
"McDowell","0","6","West Virginia","6/12/20","6","0","54047","0"
"Mercer","0","13","West Virginia","6/12/20","13","0","54055","0"
"Mineral","0","51","West Virginia","6/12/20","50","1","54057","2"
"Mingo","1","12","West Virginia","6/12/20","8","4","54059","50"
"Monongalia","1","142","West Virginia","6/12/20","138","4","54061","2.9"
"Monroe","0","9","West Virginia","6/12/20","8","1","54063","12.5"
"Morgan","0","19","West Virginia","6/12/20","19","0","54065","0"
"Nicholas","0","7","West Virginia","6/12/20","8","-1","54067","-12.5"
"Ohio","1","53","West Virginia","6/12/20","48","5","54069","10.42"
"Pendleton","0","13","West Virginia","6/12/20","13","0","54071","0"
"Pleasants","0","4","West Virginia","6/12/20","4","0","54073","0"
"Pocahontas","0","21","West Virginia","6/12/20","21","0","54075","0"
"Preston","0","24","West Virginia","6/12/20","24","0","54077","0"
"Putnam","1","42","West Virginia","6/12/20","38","4","54079","10.53"
"Raleigh","1","23","West Virginia","6/12/20","17","6","54081","35.29"
"Randolph","1","141","West Virginia","6/12/20","132","9","54083","6.82"
"Ritchie","0","2","West Virginia","6/12/20","1","1","54085","100"
"Roane","0","10","West Virginia","6/12/20","9","1","54087","11.11"
"Summers","0","1","West Virginia","6/12/20","1","0","54089","0"
"Taylor","0","10","West Virginia","6/12/20","9","1","54091","11.11"
"Tucker","0","5","West Virginia","6/12/20","4","1","54093","25"
"Tyler","0","3","West Virginia","6/12/20","3","0","54095","0"
"Upshur","0","7","West Virginia","6/12/20","7","0","54097","0"
"Wayne","0","104","West Virginia","6/12/20","103","1","54099","0.97"
"Wetzel","0","9","West Virginia","6/12/20","9","0","54103","0"
"Wirt","0","4","West Virginia","6/12/20","4","0","54105","0"
"Wood","0","55","West Virginia","6/12/20","53","2","54107","3.77"
"Wyoming","0","5","West Virginia","6/12/20","2","3","54109","150"
"Adams","0","7","Wisconsin","6/12/20","5","2","55001","40"
"Ashland","0","3","Wisconsin","6/12/20","3","0","55003","0"
"Barron","1","24","Wisconsin","6/12/20","20","4","55005","20"
"Bayfield","0","3","Wisconsin","6/12/20","3","0","55007","0"
"Brown","10","2442","Wisconsin","6/12/20","2369","73","55009","3.08"
"Buffalo","0","7","Wisconsin","6/12/20","6","1","55011","16.67"
"Burnett","0","2","Wisconsin","6/12/20","1","1","55013","100"
"Calumet","1","84","Wisconsin","6/12/20","79","5","55015","6.33"
"Chippewa","1","64","Wisconsin","6/12/20","58","6","55017","10.34"
"Clark","2","50","Wisconsin","6/12/20","39","11","55019","28.21"
"Columbia","2","55","Wisconsin","6/12/20","44","11","55021","25"
"Crawford","0","26","Wisconsin","6/12/20","26","0","55023","0"
"Dane","19","930","Wisconsin","6/12/20","800","130","55025","16.25"
"Dodge","3","415","Wisconsin","6/12/20","394","21","55027","5.33"
"Door","0","41","Wisconsin","6/12/20","39","2","55029","5.13"
"Douglas","0","20","Wisconsin","6/12/20","19","1","55031","5.26"
"Dunn","0","29","Wisconsin","6/12/20","26","3","55033","11.54"
"Eau Claire","2","130","Wisconsin","6/12/20","119","11","55035","9.24"
"Florence","0","2","Wisconsin","6/12/20","2","0","55037","0"
"Fond du Lac","4","253","Wisconsin","6/12/20","226","27","55039","11.95"
"Forest","0","34","Wisconsin","6/12/20","34","0","55041","0"
"Grant","1","103","Wisconsin","6/12/20","98","5","55043","5.1"
"Green","1","75","Wisconsin","6/12/20","70","5","55045","7.14"
"Green Lake","0","24","Wisconsin","6/12/20","22","2","55047","9.09"
"Iowa","0","16","Wisconsin","6/12/20","16","0","55049","0"
"Iron","0","2","Wisconsin","6/12/20","2","0","55051","0"
"Jackson","1","21","Wisconsin","6/12/20","17","4","55053","23.53"
"Jefferson","4","152","Wisconsin","6/12/20","122","30","55055","24.59"
"Juneau","0","24","Wisconsin","6/12/20","22","2","55057","9.09"
"Kenosha","11","1336","Wisconsin","6/12/20","1259","77","55059","6.12"
"Kewaunee","0","37","Wisconsin","6/12/20","36","1","55061","2.78"
"La Crosse","5","100","Wisconsin","6/12/20","68","32","55063","47.06"
"Lafayette","1","38","Wisconsin","6/12/20","29","9","55065","31.03"
"Langlade","0","5","Wisconsin","6/12/20","4","1","55067","25"
"Lincoln","0","7","Wisconsin","6/12/20","7","0","55069","0"
"Manitowoc","0","42","Wisconsin","6/12/20","39","3","55071","7.69"
"Marathon","3","80","Wisconsin","6/12/20","57","23","55073","40.35"
"Marinette","1","37","Wisconsin","6/12/20","33","4","55075","12.12"
"Marquette","1","9","Wisconsin","6/12/20","5","4","55077","80"
"Menominee","0","3","Wisconsin","6/12/20","3","0","55078","0"
"Milwaukee","109","9310","Wisconsin","6/12/20","8547","763","55079","8.93"
"Monroe","2","29","Wisconsin","6/12/20","18","11","55081","61.11"
"Oconto","1","43","Wisconsin","6/12/20","39","4","55083","10.26"
"Oneida","0","14","Wisconsin","6/12/20","12","2","55085","16.67"
"Outagamie","9","318","Wisconsin","6/12/20","253","65","55087","25.69"
"Ozaukee","2","188","Wisconsin","6/12/20","177","11","55089","6.21"
"Pepin","0","1","Wisconsin","6/12/20","1","0","55091","0"
"Pierce","0","51","Wisconsin","6/12/20","50","1","55093","2"
"Polk","1","36","Wisconsin","6/12/20","31","5","55095","16.13"
"Portage","6","68","Wisconsin","6/12/20","23","45","55097","195.65"
"Price","0","2","Wisconsin","6/12/20","2","0","55099","0"
"Racine","14","1975","Wisconsin","6/12/20","1878","97","55101","5.17"
"Richland","0","14","Wisconsin","6/12/20","14","0","55103","0"
"Rock","9","744","Wisconsin","6/12/20","682","62","55105","9.09"
"Rusk","1","9","Wisconsin","6/12/20","5","4","55107","80"
"Sauk","0","84","Wisconsin","6/12/20","81","3","55111","3.7"
"Sawyer","0","9","Wisconsin","6/12/20","8","1","55113","12.5"
"Shawano","1","62","Wisconsin","6/12/20","53","9","55115","16.98"
"Sheboygan","5","137","Wisconsin","6/12/20","105","32","55117","30.48"
"St. Croix","1","110","Wisconsin","6/12/20","102","8","55109","7.84"
"Taylor","0","2","Wisconsin","6/12/20","2","0","55119","0"
"Trempealeau","2","49","Wisconsin","6/12/20","32","17","55121","53.12"
"Vernon","0","23","Wisconsin","6/12/20","21","2","55123","9.52"
"Vilas","0","8","Wisconsin","6/12/20","8","0","55125","0"
"Walworth","6","469","Wisconsin","6/12/20","428","41","55127","9.58"
"Washburn","0","3","Wisconsin","6/12/20","2","1","55129","50"
"Washington","2","289","Wisconsin","6/12/20","272","17","55131","6.25"
"Waukesha","15","884","Wisconsin","6/12/20","778","106","55133","13.62"
"Waupaca","2","66","Wisconsin","6/12/20","49","17","55135","34.69"
"Waushara","1","16","Wisconsin","6/12/20","10","6","55137","60"
"Winnebago","22","485","Wisconsin","6/12/20","334","151","55139","45.21"
"Wood","1","16","Wisconsin","6/12/20","11","5","55141","45.45"
"Albany","0","25","Wyoming","6/12/20","26","-1","56001","-3.85"
"Big Horn","1","10","Wyoming","6/12/20","6","4","56003","66.67"
"Campbell","1","40","Wyoming","6/12/20","32","8","56005","25"
"Carbon","1","20","Wyoming","6/12/20","16","4","56007","25"
"Converse","0","24","Wyoming","6/12/20","24","0","56009","0"
"Crook","0","5","Wyoming","6/12/20","5","0","56011","0"
"Fremont","2","303","Wyoming","6/12/20","289","14","56013","4.84"
"Goshen","0","5","Wyoming","6/12/20","5","0","56015","0"
"Hot Springs","0","12","Wyoming","6/12/20","12","0","56017","0"
"Johnson","0","18","Wyoming","6/12/20","18","0","56019","0"
"Laramie","0","191","Wyoming","6/12/20","188","3","56021","1.6"
"Lincoln","0","15","Wyoming","6/12/20","15","0","56023","0"
"Natrona","1","87","Wyoming","6/12/20","82","5","56025","6.1"
"Niobrara","0","2","Wyoming","6/12/20","2","0","56027","0"
"Park","0","3","Wyoming","6/12/20","2","1","56029","50"
"Platte","0","1","Wyoming","6/12/20","1","0","56031","0"
"Sheridan","0","19","Wyoming","6/12/20","16","3","56033","18.75"
"Sublette","0","3","Wyoming","6/12/20","3","0","56035","0"
"Sweetwater","1","38","Wyoming","6/12/20","32","6","56037","18.75"
"Teton","1","104","Wyoming","6/12/20","100","4","56039","4"
"Uinta","6","62","Wyoming","6/12/20","19","43","56041","226.32"
"Washakie","0","39","Wyoming","6/12/20","39","0","56043","0"
"Weston","0","1","Wyoming","6/12/20","1","0","56045","0"
