"Locality","DailyAvgNewCasesPast7Days","TotalCases","State","Date","TotalCases7DaysAgo","NewCasesPast7Days","FIPS-Code","PercentIncreaseTotalCasesPast7Days"
"Autauga","11","369","Alabama","6/17/20","295","74","01001","25.08"
"Baldwin","7","377","Alabama","6/17/20","331","46","01003","13.9"
"Barbour","6","250","Alabama","6/17/20","208","42","01005","20.19"
"Bibb","4","115","Alabama","6/17/20","89","26","01007","29.21"
"Blount","6","121","Alabama","6/17/20","79","42","01009","53.16"
"Bullock","9","311","Alabama","6/17/20","248","63","01011","25.4"
"Butler","11","551","Alabama","6/17/20","471","80","01013","16.99"
"Calhoun","3","200","Alabama","6/17/20","182","18","01015","9.89"
"Chambers","10","472","Alabama","6/17/20","401","71","01017","17.71"
"Cherokee","1","51","Alabama","6/17/20","42","9","01019","21.43"
"Chilton","4","143","Alabama","6/17/20","118","25","01021","21.19"
"Choctaw","3","180","Alabama","6/17/20","158","22","01023","13.92"
"Clarke","5","197","Alabama","6/17/20","163","34","01025","20.86"
"Clay","0","30","Alabama","6/17/20","30","0","01027","0"
"Cleburne","0","22","Alabama","6/17/20","19","3","01029","15.79"
"Coffee","7","297","Alabama","6/17/20","250","47","01031","18.8"
"Colbert","8","276","Alabama","6/17/20","219","57","01033","26.03"
"Conecuh","6","109","Alabama","6/17/20","64","45","01035","70.31"
"Coosa","1","46","Alabama","6/17/20","41","5","01037","12.2"
"Covington","13","182","Alabama","6/17/20","92","90","01039","97.83"
"Crenshaw","2","112","Alabama","6/17/20","96","16","01041","16.67"
"Cullman","10","282","Alabama","6/17/20","212","70","01043","33.02"
"Dale","6","183","Alabama","6/17/20","141","42","01045","29.79"
"Dallas","22","531","Alabama","6/17/20","375","156","01047","41.6"
"DeKalb","11","352","Alabama","6/17/20","278","74","01049","26.62"
"Elmore","18","576","Alabama","6/17/20","447","129","01051","28.86"
"Escambia","3","113","Alabama","6/17/20","91","22","01053","24.18"
"Etowah","9","342","Alabama","6/17/20","280","62","01055","22.14"
"Fayette","4","49","Alabama","6/17/20","23","26","01057","113.04"
"Franklin","17","754","Alabama","6/17/20","634","120","01059","18.93"
"Geneva","0","48","Alabama","6/17/20","46","2","01061","4.35"
"Greene","4","135","Alabama","6/17/20","107","28","01063","26.17"
"Hale","4","237","Alabama","6/17/20","210","27","01065","12.86"
"Henry","2","109","Alabama","6/17/20","93","16","01067","17.2"
"Houston","10","328","Alabama","6/17/20","259","69","01069","26.64"
"Jackson","5","134","Alabama","6/17/20","101","33","01071","32.67"
"Jefferson","66","2647","Alabama","6/17/20","2187","460","01073","21.03"
"Lamar","3","50","Alabama","6/17/20","30","20","01075","66.67"
"Lauderdale","10","265","Alabama","6/17/20","196","69","01077","35.2"
"Lawrence","1","67","Alabama","6/17/20","58","9","01079","15.52"
"Lee","21","753","Alabama","6/17/20","605","148","01081","24.46"
"Limestone","13","242","Alabama","6/17/20","151","91","01083","60.26"
"Lowndes","13","401","Alabama","6/17/20","307","94","01085","30.62"
"Macon","4","133","Alabama","6/17/20","105","28","01087","26.67"
"Madison","23","577","Alabama","6/17/20","413","164","01089","39.71"
"Marengo","5","225","Alabama","6/17/20","192","33","01091","17.19"
"Marion","3","149","Alabama","6/17/20","126","23","01093","18.25"
"Marshall","27","956","Alabama","6/17/20","764","192","01095","25.13"
"Mobile","35","2788","Alabama","6/17/20","2545","243","01097","9.55"
"Monroe","10","148","Alabama","6/17/20","79","69","01099","87.34"
"Montgomery","95","2956","Alabama","6/17/20","2290","666","01101","29.08"
"Morgan","31","676","Alabama","6/17/20","456","220","01103","48.25"
"Perry","4","79","Alabama","6/17/20","54","25","01105","46.3"
"Pickens","2","142","Alabama","6/17/20","128","14","01107","10.94"
"Pike","11","342","Alabama","6/17/20","266","76","01109","28.57"
"Randolph","1","141","Alabama","6/17/20","136","5","01111","3.68"
"Russell","11","313","Alabama","6/17/20","236","77","01113","32.63"
"Shelby","17","687","Alabama","6/17/20","567","120","01117","21.16"
"St. Clair","4","180","Alabama","6/17/20","149","31","01115","20.81"
"Sumter","2","264","Alabama","6/17/20","248","16","01119","6.45"
"Talladega","4","166","Alabama","6/17/20","140","26","01121","18.57"
"Tallapoosa","4","482","Alabama","6/17/20","451","31","01123","6.87"
"Tuscaloosa","58","1418","Alabama","6/17/20","1009","409","01125","40.54"
"Walker","19","616","Alabama","6/17/20","481","135","01127","28.07"
"Washington","1","88","Alabama","6/17/20","83","5","01129","6.02"
"Wilcox","7","230","Alabama","6/17/20","183","47","01131","25.68"
"Winston","7","149","Alabama","6/17/20","98","51","01133","52.04"
"Anchorage","5","330","Alaska","6/17/20","297","33","02020","11.11"
"Bethel","0","5","Alaska","6/17/20","3","2","02050","66.67"
"Fairbanks North Star","2","102","Alaska","6/17/20","85","17","02090","20"
"Haines","0","1","Alaska","6/17/20","1","0","02100","0"
"Juneau","0","38","Alaska","6/17/20","35","3","02110","8.57"
"Kenai Peninsula","3","115","Alaska","6/17/20","94","21","02122","22.34"
"Ketchikan Gateway","1","20","Alaska","6/17/20","16","4","02130","25"
"Kodiak Island","0","3","Alaska","6/17/20","1","2","02150","200"
"Matanuska-Susitna","1","48","Alaska","6/17/20","38","10","02170","26.32"
"Nome","0","5","Alaska","6/17/20","4","1","02180","25"
"North Slope","0","2","Alaska","6/17/20","1","1","02185","100"
"Northwest Arctic","0","4","Alaska","6/17/20","3","1","02188","33.33"
"Petersburg","0","4","Alaska","6/17/20","4","0","02195","0"
"Prince of Wales-Hyder","0","2","Alaska","6/17/20","2","0","02198","0"
"Sitka","1","9","Alaska","6/17/20","3","6","02220","200"
"Southeast Fairbanks","0","3","Alaska","6/17/20","3","0","02240","0"
"Wrangell","0","3","Alaska","6/17/20","1","2","02275","200"
"Yukon-Koyukuk","0","1","Alaska","6/17/20","1","0","02290","0"
"Apache","27","1998","Arizona","6/17/20","1811","187","04001","10.33"
"Cochise","12","248","Arizona","6/17/20","167","81","04003","48.5"
"Coconino","14","1410","Arizona","6/17/20","1310","100","04005","7.63"
"Gila","7","99","Arizona","6/17/20","48","51","04007","106.25"
"Graham","2","56","Arizona","6/17/20","45","11","04009","24.44"
"Greenlee","0","12","Arizona","6/17/20","10","2","04011","20"
"La Paz","5","238","Arizona","6/17/20","205","33","04012","16.1"
"Maricopa","999","22272","Arizona","6/17/20","15282","6990","04013","45.74"
"Mohave","12","636","Arizona","6/17/20","552","84","04015","15.22"
"Navajo","55","2771","Arizona","6/17/20","2388","383","04017","16.04"
"Pima","148","4385","Arizona","6/17/20","3350","1035","04019","30.9"
"Pinal","83","1793","Arizona","6/17/20","1209","584","04021","48.3"
"Santa Cruz","68","1165","Arizona","6/17/20","688","477","04023","69.33"
"Yavapai","6","387","Arizona","6/17/20","348","39","04025","11.21"
"Yuma","147","3467","Arizona","6/17/20","2439","1028","04027","42.15"
"Arkansas","1","14","Arkansas","6/17/20","7","7","05001","100"
"Ashley","2","48","Arkansas","6/17/20","34","14","05003","41.18"
"Baxter","0","14","Arkansas","6/17/20","14","0","05005","0"
"Benton","68","1612","Arkansas","6/17/20","1137","475","05007","41.78"
"Boone","0","10","Arkansas","6/17/20","7","3","05009","42.86"
"Bradley","0","35","Arkansas","6/17/20","34","1","05011","2.94"
"Carroll","8","95","Arkansas","6/17/20","42","53","05015","126.19"
"Chicot","5","62","Arkansas","6/17/20","30","32","05017","106.67"
"Clark","1","50","Arkansas","6/17/20","41","9","05019","21.95"
"Clay","2","23","Arkansas","6/17/20","8","15","05021","187.5"
"Cleburne","0","75","Arkansas","6/17/20","74","1","05023","1.35"
"Cleveland","0","20","Arkansas","6/17/20","19","1","05025","5.26"
"Columbia","0","28","Arkansas","6/17/20","26","2","05027","7.69"
"Conway","1","24","Arkansas","6/17/20","16","8","05029","50"
"Craighead","5","369","Arkansas","6/17/20","331","38","05031","11.48"
"Crawford","4","69","Arkansas","6/17/20","43","26","05033","60.47"
"Crittenden","9","554","Arkansas","6/17/20","489","65","05035","13.29"
"Cross","2","79","Arkansas","6/17/20","67","12","05037","17.91"
"Dallas","0","4","Arkansas","6/17/20","3","1","05039","33.33"
"Desha","1","25","Arkansas","6/17/20","20","5","05041","25"
"Drew","1","27","Arkansas","6/17/20","23","4","05043","17.39"
"Faulkner","10","195","Arkansas","6/17/20","124","71","05045","57.26"
"Franklin","1","9","Arkansas","6/17/20","5","4","05047","80"
"Fulton","0","9","Arkansas","6/17/20","8","1","05049","12.5"
"Garland","2","168","Arkansas","6/17/20","153","15","05051","9.8"
"Grant","0","24","Arkansas","6/17/20","22","2","05053","9.09"
"Greene","1","76","Arkansas","6/17/20","67","9","05055","13.43"
"Hempstead","1","40","Arkansas","6/17/20","34","6","05057","17.65"
"Hot Spring","1","44","Arkansas","6/17/20","34","10","05059","29.41"
"Howard","1","45","Arkansas","6/17/20","35","10","05061","28.57"
"Independence","1","43","Arkansas","6/17/20","36","7","05063","19.44"
"Izard","0","20","Arkansas","6/17/20","17","3","05065","17.65"
"Jackson","1","20","Arkansas","6/17/20","14","6","05067","42.86"
"Jefferson","9","634","Arkansas","6/17/20","573","61","05069","10.65"
"Johnson","4","99","Arkansas","6/17/20","71","28","05071","39.44"
"Lafayette","0","12","Arkansas","6/17/20","10","2","05073","20"
"Lawrence","0","92","Arkansas","6/17/20","89","3","05075","3.37"
"Lee","64","569","Arkansas","6/17/20","120","449","05077","374.17"
"Lincoln","1","995","Arkansas","6/17/20","985","10","05079","1.02"
"Little River","0","34","Arkansas","6/17/20","31","3","05081","9.68"
"Logan","1","20","Arkansas","6/17/20","14","6","05083","42.86"
"Lonoke","2","78","Arkansas","6/17/20","64","14","05085","21.88"
"Madison","10","128","Arkansas","6/17/20","58","70","05087","120.69"
"Marion","0","2","Arkansas","6/17/20","2","0","05089","0"
"Miller","2","77","Arkansas","6/17/20","60","17","05091","28.33"
"Mississippi","2","102","Arkansas","6/17/20","86","16","05093","18.6"
"Monroe","0","7","Arkansas","6/17/20","5","2","05095","40"
"Montgomery","0","2","Arkansas","6/17/20","3","-1","05097","-33.33"
"Nevada","2","86","Arkansas","6/17/20","70","16","05099","22.86"
"Newton","0","3","Arkansas","6/17/20","3","0","05101","0"
"Ouachita","1","17","Arkansas","6/17/20","12","5","05103","41.67"
"Perry","0","16","Arkansas","6/17/20","15","1","05105","6.67"
"Phillips","3","53","Arkansas","6/17/20","30","23","05107","76.67"
"Pike","0","7","Arkansas","6/17/20","6","1","05109","16.67"
"Poinsett","1","52","Arkansas","6/17/20","44","8","05111","18.18"
"Polk","2","60","Arkansas","6/17/20","47","13","05113","27.66"
"Pope","10","291","Arkansas","6/17/20","222","69","05115","31.08"
"Prairie","1","12","Arkansas","6/17/20","5","7","05117","140"
"Pulaski","25","1365","Arkansas","6/17/20","1188","177","05119","14.9"
"Randolph","0","29","Arkansas","6/17/20","27","2","05121","7.41"
"Saline","4","189","Arkansas","6/17/20","159","30","05125","18.87"
"Scott","0","5","Arkansas","6/17/20","2","3","05127","150"
"Searcy","0","7","Arkansas","6/17/20","7","0","05129","0"
"Sebastian","12","187","Arkansas","6/17/20","102","85","05131","83.33"
"Sevier","17","498","Arkansas","6/17/20","382","116","05133","30.37"
"Sharp","0","50","Arkansas","6/17/20","50","0","05135","0"
"St. Francis","2","779","Arkansas","6/17/20","764","15","05123","1.96"
"Stone","0","11","Arkansas","6/17/20","11","0","05137","0"
"Union","3","213","Arkansas","6/17/20","190","23","05139","12.11"
"Van Buren","0","30","Arkansas","6/17/20","30","0","05141","0"
"Washington","121","2080","Arkansas","6/17/20","1235","845","05143","68.42"
"White","2","65","Arkansas","6/17/20","52","13","05145","25"
"Woodruff","1","5","Arkansas","6/17/20","1","4","05147","400"
"Yell","10","324","Arkansas","6/17/20","251","73","05149","29.08"
"Alameda","71","4533","California","6/17/20","4033","500","06001","12.4"
"Alpine","0","2","California","6/17/20","2","0","06003","0"
"Amador","0","12","California","6/17/20","10","2","06005","20"
"Butte","2","90","California","6/17/20","73","17","06007","23.29"
"Calaveras","1","26","California","6/17/20","21","5","06009","23.81"
"Colusa","0","7","California","6/17/20","7","0","06011","0"
"Contra Costa","39","2071","California","6/17/20","1798","273","06013","15.18"
"Del Norte","0","48","California","6/17/20","47","1","06015","2.13"
"El Dorado","1","121","California","6/17/20","111","10","06017","9.01"
"Fresno","67","2788","California","6/17/20","2318","470","06019","20.28"
"Glenn","2","34","California","6/17/20","23","11","06021","47.83"
"Humboldt","0","107","California","6/17/20","105","2","06023","1.9"
"Imperial","156","4478","California","6/17/20","3386","1092","06025","32.25"
"Inyo","0","24","California","6/17/20","22","2","06027","9.09"
"Kern","81","3512","California","6/17/20","2942","570","06029","19.37"
"Kings","33","1870","California","6/17/20","1637","233","06031","14.23"
"Lake","1","34","California","6/17/20","30","4","06033","13.33"
"Lassen","0","9","California","6/17/20","9","0","06035","0"
"Los Angeles","1450","77260","California","6/17/20","67111","10149","06037","15.12"
"Madera","14","275","California","6/17/20","178","97","06039","54.49"
"Marin","30","842","California","6/17/20","635","207","06041","32.6"
"Mariposa","0","18","California","6/17/20","16","2","06043","12.5"
"Mendocino","2","47","California","6/17/20","36","11","06045","30.56"
"Merced","12","470","California","6/17/20","387","83","06047","21.45"
"Mono","0","37","California","6/17/20","38","-1","06051","-2.63"
"Monterey","41","1075","California","6/17/20","791","284","06053","35.9"
"Napa","6","202","California","6/17/20","161","41","06055","25.47"
"Nevada","1","57","California","6/17/20","50","7","06057","14"
"Orange","209","9197","California","6/17/20","7737","1460","06059","18.87"
"Placer","17","432","California","6/17/20","314","118","06061","37.58"
"Plumas","0","5","California","6/17/20","4","1","06063","25"
"Riverside","291","11951","California","6/17/20","9911","2040","06065","20.58"
"Sacramento","36","1892","California","6/17/20","1642","250","06067","15.23"
"San Benito","4","140","California","6/17/20","109","31","06069","28.44"
"San Bernardino","203","8014","California","6/17/20","6593","1421","06071","21.55"
"San Diego","128","9730","California","6/17/20","8837","893","06073","10.11"
"San Francisco","25","2982","California","6/17/20","2809","173","06075","6.16"
"San Joaquin","83","1888","California","6/17/20","1309","579","06077","44.23"
"San Luis Obispo","10","376","California","6/17/20","306","70","06079","22.88"
"San Mateo","25","2653","California","6/17/20","2475","178","06081","7.19"
"Santa Barbara","36","2115","California","6/17/20","1864","251","06083","13.47"
"Santa Clara","37","3288","California","6/17/20","3032","256","06085","8.44"
"Santa Cruz","4","269","California","6/17/20","239","30","06087","12.55"
"Shasta","1","51","California","6/17/20","47","4","06089","8.51"
"Sierra","0","1","California","6/17/20","1","0","06091","0"
"Siskiyou","1","20","California","6/17/20","14","6","06093","42.86"
"Solano","10","687","California","6/17/20","617","70","06095","11.35"
"Sonoma","15","774","California","6/17/20","671","103","06097","15.35"
"Stanislaus","35","1267","California","6/17/20","1023","244","06099","23.85"
"Sutter","3","89","California","6/17/20","67","22","06101","32.84"
"Tehama","2","28","California","6/17/20","12","16","06103","133.33"
"Trinity","0","2","California","6/17/20","2","0","06105","0"
"Tulare","64","2881","California","6/17/20","2432","449","06107","18.46"
"Tuolumne","0","9","California","6/17/20","7","2","06109","28.57"
"Ventura","43","1706","California","6/17/20","1404","302","06111","21.51"
"Yolo","5","265","California","6/17/20","227","38","06113","16.74"
"Yuba","1","37","California","6/17/20","33","4","06115","12.12"
"Adams","21","3791","Colorado","6/17/20","3643","148","08001","4.06"
"Alamosa","3","130","Colorado","6/17/20","107","23","08003","21.5"
"Arapahoe","22","4861","Colorado","6/17/20","4709","152","08005","3.23"
"Archuleta","0","8","Colorado","6/17/20","8","0","08007","0"
"Baca","0","12","Colorado","6/17/20","12","0","08009","0"
"Bent","0","3","Colorado","6/17/20","3","0","08011","0"
"Boulder","15","1137","Colorado","6/17/20","1031","106","08013","10.28"
"Broomfield","2","270","Colorado","6/17/20","258","12","08014","4.65"
"Chaffee","0","78","Colorado","6/17/20","78","0","08015","0"
"Cheyenne","0","5","Colorado","6/17/20","5","0","08017","0"
"Clear Creek","0","18","Colorado","6/17/20","17","1","08019","5.88"
"Conejos","0","7","Colorado","6/17/20","5","2","08021","40"
"Costilla","1","15","Colorado","6/17/20","10","5","08023","50"
"Crowley","0","68","Colorado","6/17/20","66","2","08025","3.03"
"Custer","0","2","Colorado","6/17/20","2","0","08027","0"
"Delta","0","79","Colorado","6/17/20","76","3","08029","3.95"
"Denver","34","6445","Colorado","6/17/20","6204","241","08031","3.88"
"Douglas","7","820","Colorado","6/17/20","771","49","08035","6.36"
"Eagle","2","632","Colorado","6/17/20","615","17","08037","2.76"
"El Paso","16","2001","Colorado","6/17/20","1888","113","08041","5.99"
"Elbert","0","54","Colorado","6/17/20","54","0","08039","0"
"Fremont","1","30","Colorado","6/17/20","26","4","08043","15.38"
"Garfield","4","199","Colorado","6/17/20","171","28","08045","16.37"
"Gilpin","0","6","Colorado","6/17/20","5","1","08047","20"
"Grand","0","17","Colorado","6/17/20","15","2","08049","13.33"
"Gunnison","0","182","Colorado","6/17/20","181","1","08051","0.55"
"Hinsdale","0","3","Colorado","6/17/20","3","0","08053","0"
"Huerfano","0","3","Colorado","6/17/20","3","0","08055","0"
"Jefferson","9","2488","Colorado","6/17/20","2424","64","08059","2.64"
"Kit Carson","0","31","Colorado","6/17/20","30","1","08063","3.33"
"La Plata","0","85","Colorado","6/17/20","84","1","08067","1.19"
"Lake","0","40","Colorado","6/17/20","38","2","08065","5.26"
"Larimer","3","658","Colorado","6/17/20","636","22","08069","3.46"
"Las Animas","0","7","Colorado","6/17/20","6","1","08071","16.67"
"Lincoln","0","3","Colorado","6/17/20","3","0","08073","0"
"Logan","0","634","Colorado","6/17/20","631","3","08075","0.48"
"Mesa","1","73","Colorado","6/17/20","65","8","08077","12.31"
"Mineral","0","2","Colorado","6/17/20","2","0","08079","0"
"Moffat","0","8","Colorado","6/17/20","8","0","08081","0"
"Montezuma","1","65","Colorado","6/17/20","58","7","08083","12.07"
"Montrose","1","198","Colorado","6/17/20","190","8","08085","4.21"
"Morgan","0","646","Colorado","6/17/20","644","2","08087","0.31"
"Otero","0","22","Colorado","6/17/20","22","0","08089","0"
"Ouray","0","8","Colorado","6/17/20","8","0","08091","0"
"Park","0","23","Colorado","6/17/20","24","-1","08093","-4.17"
"Phillips","0","15","Colorado","6/17/20","15","0","08095","0"
"Pitkin","2","75","Colorado","6/17/20","63","12","08097","19.05"
"Prowers","0","16","Colorado","6/17/20","16","0","08099","0"
"Pueblo","4","351","Colorado","6/17/20","324","27","08101","8.33"
"Rio Blanco","0","2","Colorado","6/17/20","1","1","08103","100"
"Rio Grande","1","55","Colorado","6/17/20","48","7","08105","14.58"
"Routt","0","63","Colorado","6/17/20","63","0","08107","0"
"Saguache","1","99","Colorado","6/17/20","95","4","08109","4.21"
"San Juan","0","1","Colorado","6/17/20","1","0","08111","0"
"San Miguel","0","25","Colorado","6/17/20","23","2","08113","8.7"
"Summit","1","262","Colorado","6/17/20","252","10","08117","3.97"
"Teller","0","39","Colorado","6/17/20","37","2","08119","5.41"
"Washington","0","44","Colorado","6/17/20","43","1","08121","2.33"
"Weld","11","2693","Colorado","6/17/20","2616","77","08123","2.94"
"Yuma","0","49","Colorado","6/17/20","48","1","08125","2.08"
"Fairfield","35","16381","Connecticut","6/17/20","16134","247","09001","1.53"
"Hartford","51","11284","Connecticut","6/17/20","10924","360","09003","3.3"
"Litchfield","2","1444","Connecticut","6/17/20","1430","14","09005","0.98"
"Middlesex","6","1241","Connecticut","6/17/20","1199","42","09007","3.5"
"New Haven","25","12089","Connecticut","6/17/20","11911","178","09009","1.49"
"New London","22","1285","Connecticut","6/17/20","1130","155","09011","13.72"
"Tolland","2","889","Connecticut","6/17/20","878","11","09013","1.25"
"Windham","5","471","Connecticut","6/17/20","437","34","09015","7.78"
"Kent","7","1579","Delaware","6/17/20","1530","49","10001","3.2"
"New Castle","40","4422","Delaware","6/17/20","4139","283","10003","6.84"
"Sussex","8","4429","Delaware","6/17/20","4373","56","10005","1.28"
"","0","49","Diamond Princess","6/17/20","49","0",,"0"
"District of Columbia","44","9847","District of Columbia","6/17/20","9537","310","11001","3.25"
"Alachua","24","580","Florida","6/17/20","412","168","12001","40.78"
"Baker","1","35","Florida","6/17/20","29","6","12003","20.69"
"Bay","4","161","Florida","6/17/20","135","26","12005","19.26"
"Bradford","1","56","Florida","6/17/20","52","4","12007","7.69"
"Brevard","24","650","Florida","6/17/20","484","166","12009","34.3"
"Broward","231","9812","Florida","6/17/20","8193","1619","12011","19.76"
"Calhoun","0","66","Florida","6/17/20","64","2","12013","3.12"
"Charlotte","7","551","Florida","6/17/20","505","46","12015","9.11"
"Citrus","4","157","Florida","6/17/20","130","27","12017","20.77"
"Clay","4","450","Florida","6/17/20","420","30","12019","7.14"
"Collier","84","2817","Florida","6/17/20","2230","587","12021","26.32"
"Columbia","4","202","Florida","6/17/20","175","27","12023","15.43"
"DeSoto","15","406","Florida","6/17/20","299","107","12027","35.79"
"Dixie","0","60","Florida","6/17/20","60","0","12029","0"
"Duval","49","2194","Florida","6/17/20","1848","346","12031","18.72"
"Escambia","20","1052","Florida","6/17/20","915","137","12033","14.97"
"Flagler","2","214","Florida","6/17/20","200","14","12035","7"
"Franklin","0","2","Florida","6/17/20","2","0","12037","0"
"Gadsden","2","312","Florida","6/17/20","298","14","12039","4.7"
"Gilchrist","8","73","Florida","6/17/20","19","54","12041","284.21"
"Glades","2","119","Florida","6/17/20","104","15","12043","14.42"
"Gulf","0","11","Florida","6/17/20","8","3","12045","37.5"
"Hamilton","2","279","Florida","6/17/20","267","12","12047","4.49"
"Hardee","9","221","Florida","6/17/20","160","61","12049","38.12"
"Hendry","14","675","Florida","6/17/20","580","95","12051","16.38"
"Hernando","3","147","Florida","6/17/20","129","18","12053","13.95"
"Highlands","6","197","Florida","6/17/20","153","44","12055","28.76"
"Hillsborough","178","4273","Florida","6/17/20","3027","1246","12057","41.16"
"Holmes","0","32","Florida","6/17/20","31","1","12059","3.23"
"Indian River","12","256","Florida","6/17/20","172","84","12061","48.84"
"Jackson","3","329","Florida","6/17/20","311","18","12063","5.79"
"Jefferson","1","36","Florida","6/17/20","31","5","12065","16.13"
"Lafayette","0","15","Florida","6/17/20","12","3","12067","25"
"Lake","30","552","Florida","6/17/20","342","210","12069","61.4"
"Lee","109","3187","Florida","6/17/20","2422","765","12071","31.59"
"Leon","5","485","Florida","6/17/20","451","34","12073","7.54"
"Levy","6","131","Florida","6/17/20","90","41","12075","45.56"
"Liberty","0","220","Florida","6/17/20","218","2","12077","0.92"
"Madison","2","86","Florida","6/17/20","71","15","12079","21.13"
"Manatee","40","1523","Florida","6/17/20","1245","278","12081","22.33"
"Marion","6","331","Florida","6/17/20","286","45","12083","15.73"
"Martin","50","1311","Florida","6/17/20","958","353","12085","36.85"
"Miami-Dade","428","23273","Florida","6/17/20","20277","2996","12086","14.78"
"Monroe","3","137","Florida","6/17/20","116","21","12087","18.1"
"Nassau","2","96","Florida","6/17/20","84","12","12089","14.29"
"Okaloosa","9","351","Florida","6/17/20","287","64","12091","22.3"
"Okeechobee","7","200","Florida","6/17/20","149","51","12093","34.23"
"Orange","149","3584","Florida","6/17/20","2542","1042","12095","40.99"
"Osceola","17","892","Florida","6/17/20","770","122","12097","15.84"
"Palm Beach","256","9472","Florida","6/17/20","7678","1794","12099","23.37"
"Pasco","18","583","Florida","6/17/20","457","126","12101","27.57"
"Pinellas","134","2684","Florida","6/17/20","1746","938","12103","53.72"
"Polk","50","1634","Florida","6/17/20","1287","347","12105","26.96"
"Putnam","4","205","Florida","6/17/20","176","29","12107","16.48"
"Santa Rosa","6","305","Florida","6/17/20","262","43","12113","16.41"
"Sarasota","14","803","Florida","6/17/20","705","98","12115","13.9"
"Seminole","42","876","Florida","6/17/20","585","291","12117","49.74"
"St. Johns","8","347","Florida","6/17/20","288","59","12109","20.49"
"St. Lucie","49","1037","Florida","6/17/20","696","341","12111","48.99"
"Sumter","1","269","Florida","6/17/20","265","4","12119","1.51"
"Suwannee","6","217","Florida","6/17/20","178","39","12121","21.91"
"Taylor","2","62","Florida","6/17/20","47","15","12123","31.91"
"Union","0","38","Florida","6/17/20","38","0","12125","0"
"Volusia","21","995","Florida","6/17/20","849","146","12127","17.2"
"Wakulla","0","36","Florida","6/17/20","35","1","12129","2.86"
"Walton","3","157","Florida","6/17/20","135","22","12131","16.3"
"Washington","1","95","Florida","6/17/20","85","10","12133","11.76"
"Appling","1","208","Georgia","6/17/20","199","9","13001","4.52"
"Atkinson","3","80","Georgia","6/17/20","62","18","13003","29.03"
"Bacon","4","179","Georgia","6/17/20","152","27","13005","17.76"
"Baker","0","37","Georgia","6/17/20","37","0","13007","0"
"Baldwin","3","431","Georgia","6/17/20","407","24","13009","5.9"
"Banks","1","108","Georgia","6/17/20","100","8","13011","8"
"Barrow","5","401","Georgia","6/17/20","366","35","13013","9.56"
"Bartow","6","570","Georgia","6/17/20","530","40","13015","7.55"
"Ben Hill","2","109","Georgia","6/17/20","96","13","13017","13.54"
"Berrien","3","80","Georgia","6/17/20","59","21","13019","35.59"
"Bibb","8","570","Georgia","6/17/20","516","54","13021","10.47"
"Bleckley","0","52","Georgia","6/17/20","53","-1","13023","-1.89"
"Brantley","1","71","Georgia","6/17/20","63","8","13025","12.7"
"Brooks","2","100","Georgia","6/17/20","87","13","13027","14.94"
"Bryan","1","89","Georgia","6/17/20","80","9","13029","11.25"
"Bulloch","4","115","Georgia","6/17/20","87","28","13031","32.18"
"Burke","0","127","Georgia","6/17/20","125","2","13033","1.6"
"Butts","-1","247","Georgia","6/17/20","254","-7","13035","-2.76"
"Calhoun","2","152","Georgia","6/17/20","139","13","13037","9.35"
"Camden","1","75","Georgia","6/17/20","70","5","13039","7.14"
"Candler","0","18","Georgia","6/17/20","17","1","13043","5.88"
"Carroll","4","619","Georgia","6/17/20","591","28","13045","4.74"
"Catoosa","11","254","Georgia","6/17/20","175","79","13047","45.14"
"Charlton","0","36","Georgia","6/17/20","36","0","13049","0"
"Chatham","17","684","Georgia","6/17/20","562","122","13051","21.71"
"Chattahoochee","16","304","Georgia","6/17/20","191","113","13053","59.16"
"Chattooga","2","43","Georgia","6/17/20","27","16","13055","59.26"
"Cherokee","10","1058","Georgia","6/17/20","990","68","13057","6.87"
"Clarke","4","361","Georgia","6/17/20","331","30","13059","9.06"
"Clay","0","53","Georgia","6/17/20","50","3","13061","6"
"Clayton","17","1495","Georgia","6/17/20","1378","117","13063","8.49"
"Clinch","1","80","Georgia","6/17/20","72","8","13065","11.11"
"Cobb","49","3712","Georgia","6/17/20","3370","342","13067","10.15"
"Coffee","8","369","Georgia","6/17/20","310","59","13069","19.03"
"Colquitt","15","708","Georgia","6/17/20","603","105","13071","17.41"
"Columbia","5","324","Georgia","6/17/20","289","35","13073","12.11"
"Cook","3","82","Georgia","6/17/20","59","23","13075","38.98"
"Coweta","7","526","Georgia","6/17/20","476","50","13077","10.5"
"Crawford","0","32","Georgia","6/17/20","31","1","13079","3.23"
"Crisp","1","249","Georgia","6/17/20","240","9","13081","3.75"
"Dade","1","52","Georgia","6/17/20","43","9","13083","20.93"
"Dawson","1","121","Georgia","6/17/20","116","5","13085","4.31"
"Decatur","2","235","Georgia","6/17/20","219","16","13087","7.31"
"DeKalb","43","4489","Georgia","6/17/20","4186","303","13089","7.24"
"Dodge","1","62","Georgia","6/17/20","53","9","13091","16.98"
"Dooly","0","193","Georgia","6/17/20","196","-3","13093","-1.53"
"Dougherty","4","1845","Georgia","6/17/20","1820","25","13095","1.37"
"Douglas","8","682","Georgia","6/17/20","624","58","13097","9.29"
"Early","0","256","Georgia","6/17/20","253","3","13099","1.19"
"Echols","2","164","Georgia","6/17/20","149","15","13101","10.07"
"Effingham","1","88","Georgia","6/17/20","81","7","13103","8.64"
"Elbert","1","87","Georgia","6/17/20","82","5","13105","6.1"
"Emanuel","2","47","Georgia","6/17/20","34","13","13107","38.24"
"Evans","1","11","Georgia","6/17/20","6","5","13109","83.33"
"Fannin","2","70","Georgia","6/17/20","59","11","13111","18.64"
"Fayette","2","271","Georgia","6/17/20","254","17","13113","6.69"
"Floyd","4","380","Georgia","6/17/20","349","31","13115","8.88"
"Forsyth","5","616","Georgia","6/17/20","579","37","13117","6.39"
"Franklin","1","144","Georgia","6/17/20","134","10","13119","7.46"
"Fulton","43","5292","Georgia","6/17/20","4989","303","13121","6.07"
"Gilmer","1","176","Georgia","6/17/20","166","10","13123","6.02"
"Glascock","0","2","Georgia","6/17/20","1","1","13125","100"
"Glynn","6","208","Georgia","6/17/20","166","42","13127","25.3"
"Gordon","7","267","Georgia","6/17/20","219","48","13129","21.92"
"Grady","2","146","Georgia","6/17/20","129","17","13131","13.18"
"Greene","1","87","Georgia","6/17/20","83","4","13133","4.82"
"Gwinnett","121","5658","Georgia","6/17/20","4808","850","13135","17.68"
"Habersham","6","612","Georgia","6/17/20","572","40","13137","6.99"
"Hall","19","2822","Georgia","6/17/20","2686","136","13139","5.06"
"Hancock","0","203","Georgia","6/17/20","202","1","13141","0.5"
"Haralson","1","61","Georgia","6/17/20","56","5","13143","8.93"
"Harris","8","226","Georgia","6/17/20","173","53","13145","30.64"
"Hart","1","44","Georgia","6/17/20","39","5","13147","12.82"
"Heard","1","45","Georgia","6/17/20","39","6","13149","15.38"
"Henry","14","886","Georgia","6/17/20","787","99","13151","12.58"
"Houston","9","470","Georgia","6/17/20","408","62","13153","15.2"
"Irwin","1","41","Georgia","6/17/20","34","7","13155","20.59"
"Jackson","5","276","Georgia","6/17/20","239","37","13157","15.48"
"Jasper","1","59","Georgia","6/17/20","51","8","13159","15.69"
"Jeff Davis","2","64","Georgia","6/17/20","49","15","13161","30.61"
"Jefferson","1","61","Georgia","6/17/20","52","9","13163","17.31"
"Jenkins","1","49","Georgia","6/17/20","40","9","13165","22.5"
"Johnson","-1","78","Georgia","6/17/20","83","-5","13167","-6.02"
"Jones","0","51","Georgia","6/17/20","50","1","13169","2"
"Lamar","1","84","Georgia","6/17/20","78","6","13171","7.69"
"Lanier","9","102","Georgia","6/17/20","36","66","13173","183.33"
"Laurens","1","121","Georgia","6/17/20","116","5","13175","4.31"
"Lee","0","372","Georgia","6/17/20","369","3","13177","0.81"
"Liberty","2","97","Georgia","6/17/20","86","11","13179","12.79"
"Lincoln","0","18","Georgia","6/17/20","17","1","13181","5.88"
"Long","1","27","Georgia","6/17/20","18","9","13183","50"
"Lowndes","36","758","Georgia","6/17/20","505","253","13185","50.1"
"Lumpkin","1","110","Georgia","6/17/20","105","5","13187","4.76"
"Macon","1","112","Georgia","6/17/20","106","6","13193","5.66"
"Madison","1","75","Georgia","6/17/20","67","8","13195","11.94"
"Marion","1","66","Georgia","6/17/20","59","7","13197","11.86"
"McDuffie","0","76","Georgia","6/17/20","73","3","13189","4.11"
"McIntosh","0","19","Georgia","6/17/20","16","3","13191","18.75"
"Meriwether","3","135","Georgia","6/17/20","114","21","13199","18.42"
"Miller","0","45","Georgia","6/17/20","45","0","13201","0"
"Mitchell","1","433","Georgia","6/17/20","425","8","13205","1.88"
"Monroe","1","135","Georgia","6/17/20","126","9","13207","7.14"
"Montgomery","1","23","Georgia","6/17/20","17","6","13209","35.29"
"Morgan","0","42","Georgia","6/17/20","40","2","13211","5"
"Murray","5","152","Georgia","6/17/20","120","32","13213","26.67"
"Muscogee","28","1099","Georgia","6/17/20","904","195","13215","21.57"
"Newton","5","440","Georgia","6/17/20","402","38","13217","9.45"
"Oconee","1","131","Georgia","6/17/20","127","4","13219","3.15"
"Oglethorpe","1","77","Georgia","6/17/20","71","6","13221","8.45"
"Out of GA","43","2813","Georgia","6/17/20","2515","298","80013","11.85"
"Paulding","6","425","Georgia","6/17/20","382","43","13223","11.26"
"Peach","2","92","Georgia","6/17/20","80","12","13225","15"
"Pickens","2","73","Georgia","6/17/20","57","16","13227","28.07"
"Pierce","1","132","Georgia","6/17/20","122","10","13229","8.2"
"Pike","2","76","Georgia","6/17/20","65","11","13231","16.92"
"Polk","3","174","Georgia","6/17/20","154","20","13233","12.99"
"Pulaski","0","46","Georgia","6/17/20","46","0","13235","0"
"Putnam","1","112","Georgia","6/17/20","103","9","13237","8.74"
"Quitman","0","14","Georgia","6/17/20","15","-1","13239","-6.67"
"Rabun","1","33","Georgia","6/17/20","28","5","13241","17.86"
"Randolph","1","191","Georgia","6/17/20","186","5","13243","2.69"
"Richmond","6","703","Georgia","6/17/20","659","44","13245","6.68"
"Rockdale","4","353","Georgia","6/17/20","325","28","13247","8.62"
"Schley","0","20","Georgia","6/17/20","18","2","13249","11.11"
"Screven","1","66","Georgia","6/17/20","60","6","13251","10"
"Seminole","0","48","Georgia","6/17/20","47","1","13253","2.13"
"Spalding","4","332","Georgia","6/17/20","302","30","13255","9.93"
"Stephens","2","161","Georgia","6/17/20","147","14","13257","9.52"
"Stewart","2","70","Georgia","6/17/20","59","11","13259","18.64"
"Sumter","4","526","Georgia","6/17/20","499","27","13261","5.41"
"Talbot","1","52","Georgia","6/17/20","44","8","13263","18.18"
"Taliaferro","0","2","Georgia","6/17/20","1","1","13265","100"
"Tattnall","4","61","Georgia","6/17/20","35","26","13267","74.29"
"Taylor","0","26","Georgia","6/17/20","24","2","13269","8.33"
"Telfair","3","58","Georgia","6/17/20","39","19","13271","48.72"
"Terrell","0","220","Georgia","6/17/20","217","3","13273","1.38"
"Thomas","1","365","Georgia","6/17/20","356","9","13275","2.53"
"Tift","15","448","Georgia","6/17/20","345","103","13277","29.86"
"Toombs","7","129","Georgia","6/17/20","83","46","13279","55.42"
"Towns","1","35","Georgia","6/17/20","31","4","13281","12.9"
"Treutlen","0","17","Georgia","6/17/20","17","0","13283","0"
"Troup","43","844","Georgia","6/17/20","545","299","13285","54.86"
"Turner","2","157","Georgia","6/17/20","144","13","13287","9.03"
"Twiggs","0","22","Georgia","6/17/20","19","3","13289","15.79"
"Union","1","56","Georgia","6/17/20","51","5","13291","9.8"
"Upson","2","308","Georgia","6/17/20","291","17","13293","5.84"
"Walker","7","253","Georgia","6/17/20","206","47","13295","22.82"
"Walton","4","335","Georgia","6/17/20","309","26","13297","8.41"
"Ware","7","298","Georgia","6/17/20","252","46","13299","18.25"
"Warren","0","19","Georgia","6/17/20","19","0","13301","0"
"Washington","0","76","Georgia","6/17/20","75","1","13303","1.33"
"Wayne","1","41","Georgia","6/17/20","32","9","13305","28.12"
"Webster","0","16","Georgia","6/17/20","14","2","13307","14.29"
"Wheeler","2","28","Georgia","6/17/20","15","13","13309","86.67"
"White","1","124","Georgia","6/17/20","117","7","13311","5.98"
"Whitfield","21","668","Georgia","6/17/20","520","148","13313","28.46"
"Wilcox","0","119","Georgia","6/17/20","118","1","13315","0.85"
"Wilkes","1","42","Georgia","6/17/20","34","8","13317","23.53"
"Wilkinson","0","74","Georgia","6/17/20","71","3","13319","4.23"
"Worth","3","269","Georgia","6/17/20","247","22","13321","8.91"
"","0","103","Grand Princess","6/17/20","103","0",,"0"
"","1","188","Guam","6/17/20","180","8",,"4.44"
"Hawaii","0","83","Hawaii","6/17/20","81","2","15001","2.47"
"Honolulu","8","508","Hawaii","6/17/20","451","57","15003","12.64"
"Kauai","0","21","Hawaii","6/17/20","21","0","15007","0"
"Maui","0","120","Hawaii","6/17/20","120","0","15009","0"
"Out of HI","0","12","Hawaii","6/17/20","12","0","80015","0"
"Ada","19","986","Idaho","6/17/20","854","132","16001","15.46"
"Adams","1","9","Idaho","6/17/20","3","6","16003","200"
"Bannock","2","69","Idaho","6/17/20","52","17","16005","32.69"
"Benewah","0","20","Idaho","6/17/20","19","1","16009","5.26"
"Bingham","0","26","Idaho","6/17/20","23","3","16011","13.04"
"Blaine","0","515","Idaho","6/17/20","515","0","16013","0"
"Bonner","0","10","Idaho","6/17/20","7","3","16017","42.86"
"Bonneville","3","90","Idaho","6/17/20","68","22","16019","32.35"
"Camas","0","1","Idaho","6/17/20","1","0","16025","0"
"Canyon","3","369","Idaho","6/17/20","351","18","16027","5.13"
"Caribou","0","6","Idaho","6/17/20","3","3","16029","100"
"Cassia","4","152","Idaho","6/17/20","123","29","16031","23.58"
"Custer","0","2","Idaho","6/17/20","2","0","16037","0"
"Elmore","1","37","Idaho","6/17/20","33","4","16039","12.12"
"Franklin","1","17","Idaho","6/17/20","10","7","16041","70"
"Fremont","0","4","Idaho","6/17/20","4","0","16043","0"
"Gem","0","17","Idaho","6/17/20","17","0","16045","0"
"Gooding","0","60","Idaho","6/17/20","57","3","16047","5.26"
"Idaho","0","3","Idaho","6/17/20","3","0","16049","0"
"Jefferson","0","11","Idaho","6/17/20","9","2","16051","22.22"
"Jerome","2","214","Idaho","6/17/20","202","12","16053","5.94"
"Kootenai","2","105","Idaho","6/17/20","91","14","16055","15.38"
"Latah","0","8","Idaho","6/17/20","7","1","16057","14.29"
"Lemhi","0","2","Idaho","6/17/20","1","1","16059","100"
"Lincoln","0","35","Idaho","6/17/20","34","1","16063","2.94"
"Madison","0","30","Idaho","6/17/20","27","3","16065","11.11"
"Minidoka","3","109","Idaho","6/17/20","85","24","16067","28.24"
"Nez Perce","0","84","Idaho","6/17/20","84","0","16069","0"
"Owyhee","1","18","Idaho","6/17/20","8","10","16073","125"
"Payette","1","30","Idaho","6/17/20","26","4","16075","15.38"
"Power","0","9","Idaho","6/17/20","9","0","16077","0"
"Teton","0","12","Idaho","6/17/20","11","1","16081","9.09"
"Twin Falls","4","499","Idaho","6/17/20","469","30","16083","6.4"
"Valley","0","3","Idaho","6/17/20","3","0","16085","0"
"Washington","3","70","Idaho","6/17/20","49","21","16087","42.86"
"Adams","0","45","Illinois","6/17/20","45","0","17001","0"
"Alexander","0","17","Illinois","6/17/20","16","1","17003","6.25"
"Bond","0","12","Illinois","6/17/20","12","0","17005","0"
"Boone","4","542","Illinois","6/17/20","511","31","17007","6.07"
"Brown","0","10","Illinois","6/17/20","10","0","17009","0"
"Bureau","0","24","Illinois","6/17/20","22","2","17011","9.09"
"Calhoun","0","1","Illinois","6/17/20","1","0","17013","0"
"Carroll","0","20","Illinois","6/17/20","19","1","17015","5.26"
"Cass","1","78","Illinois","6/17/20","74","4","17017","5.41"
"Champaign","8","754","Illinois","6/17/20","700","54","17019","7.71"
"Christian","1","39","Illinois","6/17/20","35","4","17021","11.43"
"Clark","0","13","Illinois","6/17/20","12","1","17023","8.33"
"Clay","0","2","Illinois","6/17/20","2","0","17025","0"
"Clinton","3","216","Illinois","6/17/20","197","19","17027","9.64"
"Coles","0","145","Illinois","6/17/20","142","3","17029","2.11"
"Cook","325","85858","Illinois","6/17/20","83585","2273","17031","2.72"
"Crawford","1","17","Illinois","6/17/20","11","6","17033","54.55"
"Cumberland","0","10","Illinois","6/17/20","10","0","17035","0"
"De Witt","0","4","Illinois","6/17/20","4","0","17039","0"
"DeKalb","6","499","Illinois","6/17/20","460","39","17037","8.48"
"Douglas","1","39","Illinois","6/17/20","30","9","17041","30"
"DuPage","42","8546","Illinois","6/17/20","8255","291","17043","3.53"
"Edgar","0","2","Illinois","6/17/20","1","1","17045","100"
"Edwards","0","2","Illinois","6/17/20","2","0","17047","0"
"Effingham","0","9","Illinois","6/17/20","8","1","17049","12.5"
"Fayette","0","23","Illinois","6/17/20","22","1","17051","4.55"
"Ford","0","22","Illinois","6/17/20","22","0","17053","0"
"Franklin","0","12","Illinois","6/17/20","12","0","17055","0"
"Fulton","0","11","Illinois","6/17/20","12","-1","17057","-8.33"
"Gallatin","0","2","Illinois","6/17/20","2","0","17059","0"
"Greene","0","8","Illinois","6/17/20","7","1","17061","14.29"
"Grundy","1","133","Illinois","6/17/20","125","8","17063","6.4"
"Hamilton","0","2","Illinois","6/17/20","2","0","17065","0"
"Hancock","0","18","Illinois","6/17/20","18","0","17067","0"
"Hardin","0","1","Illinois","6/17/20","1","0","17069","0"
"Henderson","0","8","Illinois","6/17/20","8","0","17071","0"
"Henry","0","71","Illinois","6/17/20","71","0","17073","0"
"Iroquois","1","142","Illinois","6/17/20","136","6","17075","4.41"
"Jackson","2","321","Illinois","6/17/20","307","14","17077","4.56"
"Jasper","0","46","Illinois","6/17/20","46","0","17079","0"
"Jefferson","0","104","Illinois","6/17/20","101","3","17081","2.97"
"Jersey","0","29","Illinois","6/17/20","27","2","17083","7.41"
"Jo Daviess","0","35","Illinois","6/17/20","33","2","17085","6.06"
"Johnson","1","20","Illinois","6/17/20","13","7","17087","53.85"
"Kane","36","7202","Illinois","6/17/20","6948","254","17089","3.66"
"Kankakee","9","1109","Illinois","6/17/20","1047","62","17091","5.92"
"Kendall","5","897","Illinois","6/17/20","863","34","17093","3.94"
"Knox","1","113","Illinois","6/17/20","106","7","17095","6.6"
"Lake","38","9154","Illinois","6/17/20","8886","268","17097","3.02"
"LaSalle","2","183","Illinois","6/17/20","172","11","17099","6.4"
"Lawrence","0","4","Illinois","6/17/20","4","0","17101","0"
"Lee","0","90","Illinois","6/17/20","89","1","17103","1.12"
"Livingston","0","35","Illinois","6/17/20","36","-1","17105","-2.78"
"Logan","0","11","Illinois","6/17/20","10","1","17107","10"
"Macon","1","213","Illinois","6/17/20","204","9","17115","4.41"
"Macoupin","0","45","Illinois","6/17/20","46","-1","17117","-2.17"
"Madison","13","750","Illinois","6/17/20","660","90","17119","13.64"
"Marion","0","55","Illinois","6/17/20","55","0","17121","0"
"Marshall","0","5","Illinois","6/17/20","5","0","17123","0"
"Mason","0","18","Illinois","6/17/20","18","0","17125","0"
"Massac","0","7","Illinois","6/17/20","7","0","17127","0"
"McDonough","1","100","Illinois","6/17/20","93","7","17109","7.53"
"McHenry","14","1872","Illinois","6/17/20","1776","96","17111","5.41"
"McLean","2","246","Illinois","6/17/20","231","15","17113","6.49"
"Menard","0","23","Illinois","6/17/20","22","1","17129","4.55"
"Mercer","0","19","Illinois","6/17/20","18","1","17131","5.56"
"Monroe","1","109","Illinois","6/17/20","105","4","17133","3.81"
"Montgomery","0","41","Illinois","6/17/20","41","0","17135","0"
"Morgan","8","110","Illinois","6/17/20","56","54","17137","96.43"
"Moultrie","0","16","Illinois","6/17/20","14","2","17139","14.29"
"Ogle","1","230","Illinois","6/17/20","224","6","17141","2.68"
"Out of IL","-8","58","Illinois","6/17/20","115","-57","80017","-49.57"
"Peoria","9","405","Illinois","6/17/20","342","63","17143","18.42"
"Perry","0","44","Illinois","6/17/20","43","1","17145","2.33"
"Piatt","0","14","Illinois","6/17/20","11","3","17147","27.27"
"Pike","0","2","Illinois","6/17/20","1","1","17149","100"
"Pope","0","1","Illinois","6/17/20","1","0","17151","0"
"Pulaski","0","62","Illinois","6/17/20","59","3","17153","5.08"
"Putnam","0","1","Illinois","6/17/20","1","0","17155","0"
"Randolph","0","279","Illinois","6/17/20","276","3","17157","1.09"
"Richland","0","4","Illinois","6/17/20","4","0","17159","0"
"Rock Island","6","760","Illinois","6/17/20","719","41","17161","5.7"
"Saline","0","7","Illinois","6/17/20","7","0","17165","0"
"Sangamon","2","382","Illinois","6/17/20","367","15","17167","4.09"
"Schuyler","0","13","Illinois","6/17/20","13","0","17169","0"
"Shelby","0","16","Illinois","6/17/20","16","0","17173","0"
"St. Clair","24","1520","Illinois","6/17/20","1354","166","17163","12.26"
"Stark","0","3","Illinois","6/17/20","3","0","17175","0"
"Stephenson","2","233","Illinois","6/17/20","222","11","17177","4.95"
"Tazewell","2","97","Illinois","6/17/20","82","15","17179","18.29"
"Union","0","174","Illinois","6/17/20","172","2","17181","1.16"
"Vermilion","0","47","Illinois","6/17/20","44","3","17183","6.82"
"Wabash","0","14","Illinois","6/17/20","12","2","17185","16.67"
"Warren","0","127","Illinois","6/17/20","127","0","17187","0"
"Washington","0","19","Illinois","6/17/20","19","0","17189","0"
"Wayne","0","9","Illinois","6/17/20","9","0","17191","0"
"White","0","3","Illinois","6/17/20","2","1","17193","50"
"Whiteside","1","163","Illinois","6/17/20","157","6","17195","3.82"
"Will","30","6222","Illinois","6/17/20","6011","211","17197","3.51"
"Williamson","1","89","Illinois","6/17/20","81","8","17199","9.88"
"Winnebago","21","2776","Illinois","6/17/20","2627","149","17201","5.67"
"Woodford","1","28","Illinois","6/17/20","22","6","17203","27.27"
"Adams","1","28","Indiana","6/17/20","24","4","18001","16.67"
"Allen","38","2277","Indiana","6/17/20","2014","263","18003","13.06"
"Bartholomew","3","561","Indiana","6/17/20","540","21","18005","3.89"
"Benton","1","37","Indiana","6/17/20","33","4","18007","12.12"
"Blackford","0","31","Indiana","6/17/20","29","2","18009","6.9"
"Boone","6","383","Indiana","6/17/20","339","44","18011","12.98"
"Brown","0","36","Indiana","6/17/20","35","1","18013","2.86"
"Carroll","1","102","Indiana","6/17/20","96","6","18015","6.25"
"Cass","2","1608","Indiana","6/17/20","1592","16","18017","1.01"
"Clark","5","581","Indiana","6/17/20","549","32","18019","5.83"
"Clay","0","56","Indiana","6/17/20","56","0","18021","0"
"Clinton","2","262","Indiana","6/17/20","249","13","18023","5.22"
"Crawford","0","27","Indiana","6/17/20","27","0","18025","0"
"Daviess","2","128","Indiana","6/17/20","113","15","18027","13.27"
"Dearborn","1","180","Indiana","6/17/20","175","5","18029","2.86"
"Decatur","0","238","Indiana","6/17/20","235","3","18031","1.28"
"DeKalb","6","123","Indiana","6/17/20","84","39","18033","46.43"
"Delaware","1","403","Indiana","6/17/20","399","4","18035","1"
"Dubois","2","243","Indiana","6/17/20","231","12","18037","5.19"
"Elkhart","64","2280","Indiana","6/17/20","1832","448","18039","24.45"
"Fayette","1","85","Indiana","6/17/20","80","5","18041","6.25"
"Floyd","1","338","Indiana","6/17/20","329","9","18043","2.74"
"Fountain","0","24","Indiana","6/17/20","24","0","18045","0"
"Franklin","0","120","Indiana","6/17/20","119","1","18047","0.84"
"Fulton","1","56","Indiana","6/17/20","51","5","18049","9.8"
"Gibson","0","24","Indiana","6/17/20","21","3","18051","14.29"
"Grant","3","265","Indiana","6/17/20","245","20","18053","8.16"
"Greene","1","182","Indiana","6/17/20","177","5","18055","2.82"
"Hamilton","18","1371","Indiana","6/17/20","1242","129","18057","10.39"
"Hancock","2","382","Indiana","6/17/20","367","15","18059","4.09"
"Harrison","0","200","Indiana","6/17/20","198","2","18061","1.01"
"Hendricks","7","1283","Indiana","6/17/20","1234","49","18063","3.97"
"Henry","2","204","Indiana","6/17/20","192","12","18065","6.25"
"Howard","4","479","Indiana","6/17/20","451","28","18067","6.21"
"Huntington","1","55","Indiana","6/17/20","49","6","18069","12.24"
"Jackson","2","422","Indiana","6/17/20","407","15","18071","3.69"
"Jasper","1","86","Indiana","6/17/20","82","4","18073","4.88"
"Jay","1","64","Indiana","6/17/20","59","5","18075","8.47"
"Jefferson","0","54","Indiana","6/17/20","51","3","18077","5.88"
"Jennings","1","142","Indiana","6/17/20","135","7","18079","5.19"
"Johnson","3","1177","Indiana","6/17/20","1155","22","18081","1.9"
"Knox","1","38","Indiana","6/17/20","33","5","18083","15.15"
"Kosciusko","12","335","Indiana","6/17/20","252","83","18085","32.94"
"LaGrange","19","320","Indiana","6/17/20","188","132","18087","70.21"
"Lake","27","4222","Indiana","6/17/20","4033","189","18089","4.69"
"LaPorte","1","473","Indiana","6/17/20","463","10","18091","2.16"
"Lawrence","2","186","Indiana","6/17/20","172","14","18093","8.14"
"Madison","1","615","Indiana","6/17/20","606","9","18095","1.49"
"Marion","57","10862","Indiana","6/17/20","10464","398","18097","3.8"
"Marshall","11","322","Indiana","6/17/20","247","75","18099","30.36"
"Martin","0","16","Indiana","6/17/20","15","1","18101","6.67"
"Miami","4","177","Indiana","6/17/20","152","25","18103","16.45"
"Monroe","3","202","Indiana","6/17/20","181","21","18105","11.6"
"Montgomery","1","268","Indiana","6/17/20","259","9","18107","3.47"
"Morgan","1","300","Indiana","6/17/20","294","6","18109","2.04"
"Newton","1","88","Indiana","6/17/20","82","6","18111","7.32"
"Noble","5","346","Indiana","6/17/20","310","36","18113","11.61"
"Ohio","0","13","Indiana","6/17/20","13","0","18115","0"
"Orange","0","132","Indiana","6/17/20","132","0","18117","0"
"Owen","0","39","Indiana","6/17/20","37","2","18119","5.41"
"Parke","0","20","Indiana","6/17/20","19","1","18121","5.26"
"Perry","7","94","Indiana","6/17/20","48","46","18123","95.83"
"Pike","0","6","Indiana","6/17/20","6","0","18125","0"
"Porter","3","597","Indiana","6/17/20","576","21","18127","3.65"
"Posey","1","22","Indiana","6/17/20","17","5","18129","29.41"
"Pulaski","0","53","Indiana","6/17/20","52","1","18131","1.92"
"Putnam","1","158","Indiana","6/17/20","148","10","18133","6.76"
"Randolph","2","68","Indiana","6/17/20","57","11","18135","19.3"
"Ripley","0","111","Indiana","6/17/20","109","2","18137","1.83"
"Rush","0","51","Indiana","6/17/20","50","1","18139","2"
"Scott","2","145","Indiana","6/17/20","132","13","18143","9.85"
"Shelby","1","408","Indiana","6/17/20","403","5","18145","1.24"
"Spencer","0","23","Indiana","6/17/20","22","1","18147","4.55"
"St. Joseph","19","1583","Indiana","6/17/20","1453","130","18141","8.95"
"Starke","1","55","Indiana","6/17/20","47","8","18149","17.02"
"Steuben","1","107","Indiana","6/17/20","98","9","18151","9.18"
"Sullivan","0","41","Indiana","6/17/20","39","2","18153","5.13"
"Switzerland","0","22","Indiana","6/17/20","21","1","18155","4.76"
"Tippecanoe","4","497","Indiana","6/17/20","466","31","18157","6.65"
"Tipton","0","28","Indiana","6/17/20","27","1","18159","3.7"
"Union","0","12","Indiana","6/17/20","12","0","18161","0"
"Vanderburgh","3","335","Indiana","6/17/20","313","22","18163","7.03"
"Vermillion","0","12","Indiana","6/17/20","10","2","18165","20"
"Vigo","1","202","Indiana","6/17/20","197","5","18167","2.54"
"Wabash","0","88","Indiana","6/17/20","87","1","18169","1.15"
"Warren","0","15","Indiana","6/17/20","13","2","18171","15.38"
"Warrick","1","176","Indiana","6/17/20","170","6","18173","3.53"
"Washington","0","59","Indiana","6/17/20","56","3","18175","5.36"
"Wayne","2","104","Indiana","6/17/20","91","13","18177","14.29"
"Wells","3","63","Indiana","6/17/20","45","18","18179","40"
"White","0","242","Indiana","6/17/20","242","0","18181","0"
"Whitley","1","65","Indiana","6/17/20","58","7","18183","12.07"
"Adair","0","12","Iowa","6/17/20","10","2","19001","20"
"Adams","0","8","Iowa","6/17/20","7","1","19003","14.29"
"Allamakee","0","121","Iowa","6/17/20","121","0","19005","0"
"Appanoose","0","17","Iowa","6/17/20","16","1","19007","6.25"
"Audubon","0","14","Iowa","6/17/20","13","1","19009","7.69"
"Benton","0","48","Iowa","6/17/20","46","2","19011","4.35"
"Black Hawk","4","1843","Iowa","6/17/20","1813","30","19013","1.65"
"Boone","3","101","Iowa","6/17/20","79","22","19015","27.85"
"Bremer","0","75","Iowa","6/17/20","74","1","19017","1.35"
"Buchanan","0","35","Iowa","6/17/20","34","1","19019","2.94"
"Buena Vista","40","1620","Iowa","6/17/20","1343","277","19021","20.63"
"Butler","1","27","Iowa","6/17/20","18","9","19023","50"
"Calhoun","1","24","Iowa","6/17/20","16","8","19025","50"
"Carroll","6","57","Iowa","6/17/20","17","40","19027","235.29"
"Cass","0","14","Iowa","6/17/20","13","1","19029","7.69"
"Cedar","0","54","Iowa","6/17/20","52","2","19031","3.85"
"Cerro Gordo","2","48","Iowa","6/17/20","36","12","19033","33.33"
"Cherokee","2","62","Iowa","6/17/20","51","11","19035","21.57"
"Chickasaw","0","15","Iowa","6/17/20","15","0","19037","0"
"Clarke","1","89","Iowa","6/17/20","83","6","19039","7.23"
"Clay","7","85","Iowa","6/17/20","38","47","19041","123.68"
"Clayton","0","35","Iowa","6/17/20","34","1","19043","2.94"
"Clinton","0","70","Iowa","6/17/20","67","3","19045","4.48"
"Crawford","6","628","Iowa","6/17/20","587","41","19047","6.98"
"Dallas","9","1038","Iowa","6/17/20","973","65","19049","6.68"
"Davis","1","34","Iowa","6/17/20","30","4","19051","13.33"
"Decatur","1","8","Iowa","6/17/20","3","5","19053","166.67"
"Delaware","1","29","Iowa","6/17/20","25","4","19055","16"
"Des Moines","0","66","Iowa","6/17/20","68","-2","19057","-2.94"
"Dickinson","12","168","Iowa","6/17/20","84","84","19059","100"
"Dubuque","3","393","Iowa","6/17/20","371","22","19061","5.93"
"Emmet","2","45","Iowa","6/17/20","34","11","19063","32.35"
"Fayette","0","28","Iowa","6/17/20","28","0","19065","0"
"Floyd","0","22","Iowa","6/17/20","19","3","19067","15.79"
"Franklin","2","51","Iowa","6/17/20","38","13","19069","34.21"
"Fremont","0","4","Iowa","6/17/20","4","0","19071","0"
"Greene","1","23","Iowa","6/17/20","15","8","19073","53.33"
"Grundy","0","24","Iowa","6/17/20","23","1","19075","4.35"
"Guthrie","1","60","Iowa","6/17/20","55","5","19077","9.09"
"Hamilton","4","130","Iowa","6/17/20","104","26","19079","25"
"Hancock","1","30","Iowa","6/17/20","24","6","19081","25"
"Hardin","1","46","Iowa","6/17/20","36","10","19083","27.78"
"Harrison","2","40","Iowa","6/17/20","28","12","19085","42.86"
"Henry","0","75","Iowa","6/17/20","74","1","19087","1.35"
"Howard","0","12","Iowa","6/17/20","12","0","19089","0"
"Humboldt","1","34","Iowa","6/17/20","26","8","19091","30.77"
"Ida","1","19","Iowa","6/17/20","15","4","19093","26.67"
"Iowa","0","35","Iowa","6/17/20","35","0","19095","0"
"Jackson","0","14","Iowa","6/17/20","14","0","19097","0"
"Jasper","1","286","Iowa","6/17/20","276","10","19099","3.62"
"Jefferson","0","46","Iowa","6/17/20","43","3","19101","6.98"
"Johnson","5","668","Iowa","6/17/20","633","35","19103","5.53"
"Jones","0","41","Iowa","6/17/20","38","3","19105","7.89"
"Keokuk","0","16","Iowa","6/17/20","15","1","19107","6.67"
"Kossuth","1","20","Iowa","6/17/20","16","4","19109","25"
"Lee","1","40","Iowa","6/17/20","36","4","19111","11.11"
"Linn","4","1036","Iowa","6/17/20","1005","31","19113","3.08"
"Louisa","0","354","Iowa","6/17/20","354","0","19115","0"
"Lucas","0","25","Iowa","6/17/20","22","3","19117","13.64"
"Lyon","1","32","Iowa","6/17/20","26","6","19119","23.08"
"Madison","1","34","Iowa","6/17/20","30","4","19121","13.33"
"Mahaska","1","108","Iowa","6/17/20","104","4","19123","3.85"
"Marion","0","41","Iowa","6/17/20","38","3","19125","7.89"
"Marshall","2","944","Iowa","6/17/20","931","13","19127","1.4"
"Mills","0","24","Iowa","6/17/20","21","3","19129","14.29"
"Mitchell","0","8","Iowa","6/17/20","6","2","19131","33.33"
"Monona","3","52","Iowa","6/17/20","29","23","19133","79.31"
"Monroe","0","48","Iowa","6/17/20","45","3","19135","6.67"
"Montgomery","0","9","Iowa","6/17/20","9","0","19137","0"
"Muscatine","1","575","Iowa","6/17/20","568","7","19139","1.23"
"O'Brien","1","68","Iowa","6/17/20","60","8","19141","13.33"
"Osceola","1","49","Iowa","6/17/20","41","8","19143","19.51"
"Page","0","17","Iowa","6/17/20","16","1","19145","6.25"
"Palo Alto","1","16","Iowa","6/17/20","9","7","19147","77.78"
"Plymouth","5","205","Iowa","6/17/20","173","32","19149","18.5"
"Pocahontas","0","31","Iowa","6/17/20","29","2","19151","6.9"
"Polk","48","5244","Iowa","6/17/20","4906","338","19153","6.89"
"Pottawattamie","13","532","Iowa","6/17/20","438","94","19155","21.46"
"Poweshiek","0","95","Iowa","6/17/20","94","1","19157","1.06"
"Ringgold","0","9","Iowa","6/17/20","7","2","19159","28.57"
"Sac","1","40","Iowa","6/17/20","34","6","19161","17.65"
"Scott","2","413","Iowa","6/17/20","397","16","19163","4.03"
"Shelby","2","56","Iowa","6/17/20","42","14","19165","33.33"
"Sioux","4","362","Iowa","6/17/20","332","30","19167","9.04"
"Story","19","301","Iowa","6/17/20","169","132","19169","78.11"
"Tama","1","429","Iowa","6/17/20","419","10","19171","2.39"
"Taylor","1","74","Iowa","6/17/20","69","5","19173","7.25"
"Union","0","11","Iowa","6/17/20","10","1","19175","10"
"Van Buren","0","11","Iowa","6/17/20","11","0","19177","0"
"Wapello","2","678","Iowa","6/17/20","661","17","19179","2.57"
"Warren","3","200","Iowa","6/17/20","182","18","19181","9.89"
"Washington","0","209","Iowa","6/17/20","206","3","19183","1.46"
"Wayne","0","5","Iowa","6/17/20","3","2","19185","66.67"
"Webster","2","103","Iowa","6/17/20","88","15","19187","17.05"
"Winnebago","0","13","Iowa","6/17/20","12","1","19189","8.33"
"Winneshiek","0","24","Iowa","6/17/20","25","-1","19191","-4"
"Woodbury","10","3026","Iowa","6/17/20","2957","69","19193","2.33"
"Worth","0","5","Iowa","6/17/20","3","2","19195","66.67"
"Wright","4","292","Iowa","6/17/20","263","29","19197","11.03"
"Allen","0","2","Kansas","6/17/20","1","1","20001","100"
"Anderson","0","3","Kansas","6/17/20","1","2","20003","200"
"Atchison","0","27","Kansas","6/17/20","25","2","20005","8"
"Barber","0","1","Kansas","6/17/20","1","0","20007","0"
"Barton","0","49","Kansas","6/17/20","47","2","20009","4.26"
"Bourbon","0","9","Kansas","6/17/20","8","1","20011","12.5"
"Brown","0","10","Kansas","6/17/20","9","1","20013","11.11"
"Butler","0","37","Kansas","6/17/20","37","0","20015","0"
"Chase","0","3","Kansas","6/17/20","3","0","20017","0"
"Chautauqua","0","4","Kansas","6/17/20","4","0","20019","0"
"Cherokee","1","17","Kansas","6/17/20","11","6","20021","54.55"
"Cheyenne","0","2","Kansas","6/17/20","2","0","20023","0"
"Clark","0","34","Kansas","6/17/20","33","1","20025","3.03"
"Clay","0","6","Kansas","6/17/20","6","0","20027","0"
"Cloud","0","6","Kansas","6/17/20","5","1","20029","20"
"Coffey","0","52","Kansas","6/17/20","52","0","20031","0"
"Comanche","0","2","Kansas","6/17/20","2","0","20033","0"
"Cowley","2","45","Kansas","6/17/20","28","17","20035","60.71"
"Crawford","20","156","Kansas","6/17/20","13","143","20037","1100"
"Dickinson","0","6","Kansas","6/17/20","6","0","20041","0"
"Doniphan","0","23","Kansas","6/17/20","20","3","20043","15"
"Douglas","1","86","Kansas","6/17/20","76","10","20045","13.16"
"Edwards","0","5","Kansas","6/17/20","5","0","20047","0"
"Ellis","0","13","Kansas","6/17/20","12","1","20051","8.33"
"Ellsworth","0","3","Kansas","6/17/20","3","0","20053","0"
"Finney","1","1545","Kansas","6/17/20","1537","8","20055","0.52"
"Ford","5","1873","Kansas","6/17/20","1837","36","20057","1.96"
"Franklin","1","53","Kansas","6/17/20","46","7","20059","15.22"
"Geary","1","30","Kansas","6/17/20","26","4","20061","15.38"
"Gove","0","1","Kansas","6/17/20","1","0","20063","0"
"Grant","0","18","Kansas","6/17/20","18","0","20067","0"
"Gray","0","23","Kansas","6/17/20","23","0","20069","0"
"Greenwood","0","11","Kansas","6/17/20","10","1","20073","10"
"Hamilton","0","28","Kansas","6/17/20","25","3","20075","12"
"Harper","0","2","Kansas","6/17/20","2","0","20077","0"
"Harvey","0","12","Kansas","6/17/20","11","1","20079","9.09"
"Haskell","0","22","Kansas","6/17/20","22","0","20081","0"
"Hodgeman","0","7","Kansas","6/17/20","5","2","20083","40"
"Jackson","0","103","Kansas","6/17/20","102","1","20085","0.98"
"Jefferson","0","22","Kansas","6/17/20","23","-1","20087","-4.35"
"Jewell","0","4","Kansas","6/17/20","4","0","20089","0"
"Johnson","19","1107","Kansas","6/17/20","972","135","20091","13.89"
"Kearny","0","46","Kansas","6/17/20","46","0","20093","0"
"Kiowa","0","3","Kansas","6/17/20","3","0","20097","0"
"Labette","0","27","Kansas","6/17/20","27","0","20099","0"
"Lane","0","4","Kansas","6/17/20","4","0","20101","0"
"Leavenworth","2","1118","Kansas","6/17/20","1103","15","20103","1.36"
"Linn","0","12","Kansas","6/17/20","11","1","20107","9.09"
"Lyon","11","476","Kansas","6/17/20","401","75","20111","18.7"
"Marion","0","7","Kansas","6/17/20","5","2","20115","40"
"McPherson","0","39","Kansas","6/17/20","38","1","20113","2.63"
"Meade","0","30","Kansas","6/17/20","30","0","20119","0"
"Miami","1","16","Kansas","6/17/20","10","6","20121","60"
"Mitchell","0","4","Kansas","6/17/20","4","0","20123","0"
"Montgomery","1","25","Kansas","6/17/20","20","5","20125","25"
"Morris","0","5","Kansas","6/17/20","5","0","20127","0"
"Morton","0","6","Kansas","6/17/20","6","0","20129","0"
"Nemaha","0","22","Kansas","6/17/20","19","3","20131","15.79"
"Neosho","1","10","Kansas","6/17/20","4","6","20133","150"
"Ness","0","4","Kansas","6/17/20","4","0","20135","0"
"Norton","0","3","Kansas","6/17/20","3","0","20137","0"
"Osage","0","10","Kansas","6/17/20","10","0","20139","0"
"Osborne","0","2","Kansas","6/17/20","2","0","20141","0"
"Ottawa","0","4","Kansas","6/17/20","4","0","20143","0"
"Pawnee","0","3","Kansas","6/17/20","3","0","20145","0"
"Phillips","0","2","Kansas","6/17/20","2","0","20147","0"
"Pottawatomie","2","40","Kansas","6/17/20","29","11","20149","37.93"
"Pratt","1","6","Kansas","6/17/20","2","4","20151","200"
"Reno","0","50","Kansas","6/17/20","47","3","20155","6.38"
"Republic","0","4","Kansas","6/17/20","4","0","20157","0"
"Rice","0","4","Kansas","6/17/20","4","0","20159","0"
"Riley","3","91","Kansas","6/17/20","71","20","20161","28.17"
"Rooks","0","6","Kansas","6/17/20","6","0","20163","0"
"Saline","1","33","Kansas","6/17/20","27","6","20169","22.22"
"Scott","0","16","Kansas","6/17/20","15","1","20171","6.67"
"Sedgwick","14","810","Kansas","6/17/20","710","100","20173","14.08"
"Seward","3","940","Kansas","6/17/20","917","23","20175","2.51"
"Shawnee","7","456","Kansas","6/17/20","409","47","20177","11.49"
"Sheridan","0","3","Kansas","6/17/20","2","1","20179","50"
"Sherman","0","7","Kansas","6/17/20","7","0","20181","0"
"Smith","0","3","Kansas","6/17/20","2","1","20183","50"
"Stafford","0","1","Kansas","6/17/20","1","0","20185","0"
"Stanton","0","9","Kansas","6/17/20","9","0","20187","0"
"Stevens","0","30","Kansas","6/17/20","31","-1","20189","-3.23"
"Sumner","0","9","Kansas","6/17/20","10","-1","20191","-10"
"Trego","0","1","Kansas","6/17/20","1","0","20195","0"
"Wabaunsee","0","32","Kansas","6/17/20","31","1","20197","3.23"
"Washington","0","1","Kansas","6/17/20","1","0","20201","0"
"Wilson","0","1","Kansas","6/17/20","1","0","20205","0"
"Woodson","0","6","Kansas","6/17/20","6","0","20207","0"
"Wyandotte","25","1745","Kansas","6/17/20","1569","176","20209","11.22"
"Adair","0","102","Kentucky","6/17/20","101","1","21001","0.99"
"Allen","2","137","Kentucky","6/17/20","120","17","21003","14.17"
"Anderson","0","27","Kentucky","6/17/20","25","2","21005","8"
"Ballard","0","14","Kentucky","6/17/20","13","1","21007","7.69"
"Barren","1","67","Kentucky","6/17/20","59","8","21009","13.56"
"Bath","0","10","Kentucky","6/17/20","9","1","21011","11.11"
"Bell","0","4","Kentucky","6/17/20","3","1","21013","33.33"
"Boone","3","552","Kentucky","6/17/20","532","20","21015","3.76"
"Bourbon","1","26","Kentucky","6/17/20","21","5","21017","23.81"
"Boyd","0","44","Kentucky","6/17/20","43","1","21019","2.33"
"Boyle","0","30","Kentucky","6/17/20","28","2","21021","7.14"
"Bracken","0","14","Kentucky","6/17/20","14","0","21023","0"
"Breathitt","0","4","Kentucky","6/17/20","3","1","21025","33.33"
"Breckinridge","1","23","Kentucky","6/17/20","19","4","21027","21.05"
"Bullitt","1","136","Kentucky","6/17/20","127","9","21029","7.09"
"Butler","1","246","Kentucky","6/17/20","240","6","21031","2.5"
"Caldwell","0","12","Kentucky","6/17/20","12","0","21033","0"
"Calloway","1","61","Kentucky","6/17/20","56","5","21035","8.93"
"Campbell","2","212","Kentucky","6/17/20","198","14","21037","7.07"
"Carlisle","0","5","Kentucky","6/17/20","5","0","21039","0"
"Carroll","1","25","Kentucky","6/17/20","16","9","21041","56.25"
"Carter","1","21","Kentucky","6/17/20","17","4","21043","23.53"
"Casey","0","10","Kentucky","6/17/20","8","2","21045","25"
"Christian","0","139","Kentucky","6/17/20","136","3","21047","2.21"
"Clark","2","78","Kentucky","6/17/20","62","16","21049","25.81"
"Clay","2","23","Kentucky","6/17/20","12","11","21051","91.67"
"Clinton","0","5","Kentucky","6/17/20","5","0","21053","0"
"Crittenden","0","7","Kentucky","6/17/20","7","0","21055","0"
"Cumberland","0","5","Kentucky","6/17/20","5","0","21057","0"
"Daviess","4","368","Kentucky","6/17/20","343","25","21059","7.29"
"Edmonson","1","69","Kentucky","6/17/20","63","6","21061","9.52"
"Elliott","0","2","Kentucky","6/17/20","1","1","21063","100"
"Estill","1","5","Kentucky","6/17/20","1","4","21065","400"
"Fayette","21","1106","Kentucky","6/17/20","956","150","21067","15.69"
"Fleming","1","9","Kentucky","6/17/20","2","7","21069","350"
"Floyd","1","22","Kentucky","6/17/20","17","5","21071","29.41"
"Franklin","2","105","Kentucky","6/17/20","88","17","21073","19.32"
"Fulton","0","12","Kentucky","6/17/20","12","0","21075","0"
"Gallatin","1","57","Kentucky","6/17/20","51","6","21077","11.76"
"Garrard","1","13","Kentucky","6/17/20","6","7","21079","116.67"
"Grant","0","53","Kentucky","6/17/20","51","2","21081","3.92"
"Graves","1","176","Kentucky","6/17/20","167","9","21083","5.39"
"Grayson","0","137","Kentucky","6/17/20","135","2","21085","1.48"
"Green","0","2","Kentucky","6/17/20","2","0","21087","0"
"Greenup","0","16","Kentucky","6/17/20","14","2","21089","14.29"
"Hancock","1","11","Kentucky","6/17/20","7","4","21091","57.14"
"Hardin","1","135","Kentucky","6/17/20","125","10","21093","8"
"Harlan","1","15","Kentucky","6/17/20","8","7","21095","87.5"
"Harrison","1","37","Kentucky","6/17/20","31","6","21097","19.35"
"Hart","1","31","Kentucky","6/17/20","26","5","21099","19.23"
"Henderson","3","140","Kentucky","6/17/20","120","20","21101","16.67"
"Henry","0","27","Kentucky","6/17/20","24","3","21103","12.5"
"Hickman","0","5","Kentucky","6/17/20","5","0","21105","0"
"Hopkins","1","231","Kentucky","6/17/20","225","6","21107","2.67"
"Jackson","2","74","Kentucky","6/17/20","61","13","21109","21.31"
"Jefferson","32","3451","Kentucky","6/17/20","3226","225","21111","6.97"
"Jessamine","1","88","Kentucky","6/17/20","80","8","21113","10"
"Johnson","0","7","Kentucky","6/17/20","5","2","21115","40"
"Kenton","3","699","Kentucky","6/17/20","681","18","21117","2.64"
"Knott","0","4","Kentucky","6/17/20","4","0","21119","0"
"Knox","0","12","Kentucky","6/17/20","10","2","21121","20"
"Larue","0","11","Kentucky","6/17/20","11","0","21123","0"
"Laurel","4","47","Kentucky","6/17/20","22","25","21125","113.64"
"Lawrence","0","5","Kentucky","6/17/20","5","0","21127","0"
"Lee","0","1","Kentucky","6/17/20","1","0","21129","0"
"Leslie","0","7","Kentucky","6/17/20","6","1","21131","16.67"
"Letcher","0","5","Kentucky","6/17/20","3","2","21133","66.67"
"Lewis","1","15","Kentucky","6/17/20","8","7","21135","87.5"
"Lincoln","0","15","Kentucky","6/17/20","14","1","21137","7.14"
"Livingston","0","9","Kentucky","6/17/20","9","0","21139","0"
"Logan","4","201","Kentucky","6/17/20","176","25","21141","14.2"
"Lyon","0","18","Kentucky","6/17/20","17","1","21143","5.88"
"Madison","2","82","Kentucky","6/17/20","70","12","21151","17.14"
"Magoffin","0","4","Kentucky","6/17/20","2","2","21153","100"
"Marion","1","43","Kentucky","6/17/20","37","6","21155","16.22"
"Marshall","1","47","Kentucky","6/17/20","37","10","21157","27.03"
"Martin","0","3","Kentucky","6/17/20","3","0","21159","0"
"Mason","0","17","Kentucky","6/17/20","15","2","21161","13.33"
"McCracken","2","126","Kentucky","6/17/20","113","13","21145","11.5"
"McCreary","0","13","Kentucky","6/17/20","13","0","21147","0"
"McLean","0","24","Kentucky","6/17/20","23","1","21149","4.35"
"Meade","0","24","Kentucky","6/17/20","23","1","21163","4.35"
"Menifee","0","10","Kentucky","6/17/20","10","0","21165","0"
"Mercer","0","16","Kentucky","6/17/20","15","1","21167","6.67"
"Metcalfe","0","8","Kentucky","6/17/20","7","1","21169","14.29"
"Monroe","1","31","Kentucky","6/17/20","27","4","21171","14.81"
"Montgomery","1","40","Kentucky","6/17/20","31","9","21173","29.03"
"Morgan","0","7","Kentucky","6/17/20","4","3","21175","75"
"Muhlenberg","0","482","Kentucky","6/17/20","484","-2","21177","-0.41"
"Nelson","0","49","Kentucky","6/17/20","47","2","21179","4.26"
"Nicholas","0","4","Kentucky","6/17/20","4","0","21181","0"
"Ohio","2","168","Kentucky","6/17/20","157","11","21183","7.01"
"Oldham","0","114","Kentucky","6/17/20","113","1","21185","0.88"
"Owen","0","5","Kentucky","6/17/20","4","1","21187","25"
"Owsley","0","2","Kentucky","6/17/20","2","0","21189","0"
"Pendleton","0","14","Kentucky","6/17/20","14","0","21191","0"
"Perry","0","25","Kentucky","6/17/20","22","3","21193","13.64"
"Pike","2","53","Kentucky","6/17/20","38","15","21195","39.47"
"Powell","0","5","Kentucky","6/17/20","3","2","21197","66.67"
"Pulaski","1","73","Kentucky","6/17/20","66","7","21199","10.61"
"Rockcastle","0","15","Kentucky","6/17/20","13","2","21203","15.38"
"Rowan","1","15","Kentucky","6/17/20","11","4","21205","36.36"
"Russell","0","38","Kentucky","6/17/20","36","2","21207","5.56"
"Scott","1","45","Kentucky","6/17/20","39","6","21209","15.38"
"Shelby","7","281","Kentucky","6/17/20","233","48","21211","20.6"
"Simpson","0","60","Kentucky","6/17/20","58","2","21213","3.45"
"Spencer","0","26","Kentucky","6/17/20","25","1","21215","4"
"Taylor","1","21","Kentucky","6/17/20","15","6","21217","40"
"Todd","0","23","Kentucky","6/17/20","23","0","21219","0"
"Trigg","1","17","Kentucky","6/17/20","13","4","21221","30.77"
"Trimble","0","4","Kentucky","6/17/20","6","-2","21223","-33.33"
"Union","1","20","Kentucky","6/17/20","15","5","21225","33.33"
"Warren","17","1299","Kentucky","6/17/20","1179","120","21227","10.18"
"Washington","1","15","Kentucky","6/17/20","8","7","21229","87.5"
"Wayne","0","10","Kentucky","6/17/20","9","1","21231","11.11"
"Webster","0","37","Kentucky","6/17/20","34","3","21233","8.82"
"Whitley","0","18","Kentucky","6/17/20","15","3","21235","20"
"Wolfe","0","1","Kentucky","6/17/20","1","0","21237","0"
"Woodford","1","55","Kentucky","6/17/20","45","10","21239","22.22"
"Acadia","15","625","Louisiana","6/17/20","520","105","22001","20.19"
"Allen","8","243","Louisiana","6/17/20","189","54","22003","28.57"
"Ascension","8","962","Louisiana","6/17/20","906","56","22005","6.18"
"Assumption","3","282","Louisiana","6/17/20","259","23","22007","8.88"
"Avoyelles","2","193","Louisiana","6/17/20","178","15","22009","8.43"
"Beauregard","3","139","Louisiana","6/17/20","116","23","22011","19.83"
"Bienville","2","183","Louisiana","6/17/20","166","17","22013","10.24"
"Bossier","7","528","Louisiana","6/17/20","478","50","22015","10.46"
"Caddo","21","2933","Louisiana","6/17/20","2784","149","22017","5.35"
"Calcasieu","22","824","Louisiana","6/17/20","673","151","22019","22.44"
"Caldwell","1","86","Louisiana","6/17/20","76","10","22021","13.16"
"Cameron","0","12","Louisiana","6/17/20","10","2","22023","20"
"Catahoula","6","164","Louisiana","6/17/20","123","41","22025","33.33"
"Claiborne","2","85","Louisiana","6/17/20","71","14","22027","19.72"
"Concordia","3","117","Louisiana","6/17/20","97","20","22029","20.62"
"De Soto","2","275","Louisiana","6/17/20","263","12","22031","4.56"
"East Baton Rouge","43","4357","Louisiana","6/17/20","4054","303","22033","7.47"
"East Carroll","5","244","Louisiana","6/17/20","208","36","22035","17.31"
"East Feliciana","3","231","Louisiana","6/17/20","210","21","22037","10"
"Evangeline","2","100","Louisiana","6/17/20","85","15","22039","17.65"
"Franklin","7","439","Louisiana","6/17/20","391","48","22041","12.28"
"Grant","1","61","Louisiana","6/17/20","51","10","22043","19.61"
"Iberia","10","501","Louisiana","6/17/20","428","73","22045","17.06"
"Iberville","2","618","Louisiana","6/17/20","607","11","22047","1.81"
"Jackson","4","173","Louisiana","6/17/20","148","25","22049","16.89"
"Jefferson","77","8507","Louisiana","6/17/20","7971","536","22051","6.72"
"Jefferson Davis","9","162","Louisiana","6/17/20","102","60","22053","58.82"
"Lafayette","53","1302","Louisiana","6/17/20","931","371","22055","39.85"
"Lafourche","12","1013","Louisiana","6/17/20","928","85","22057","9.16"
"LaSalle","3","90","Louisiana","6/17/20","67","23","22059","34.33"
"Lincoln","9","259","Louisiana","6/17/20","193","66","22061","34.2"
"Livingston","13","573","Louisiana","6/17/20","484","89","22063","18.39"
"Madison","9","287","Louisiana","6/17/20","221","66","22065","29.86"
"Morehouse","7","186","Louisiana","6/17/20","136","50","22067","36.76"
"Natchitoches","2","195","Louisiana","6/17/20","180","15","22069","8.33"
"Orleans","26","7459","Louisiana","6/17/20","7279","180","22071","2.47"
"Ouachita","42","1889","Louisiana","6/17/20","1592","297","22073","18.66"
"Plaquemines","1","228","Louisiana","6/17/20","220","8","22075","3.64"
"Pointe Coupee","1","224","Louisiana","6/17/20","217","7","22077","3.23"
"Rapides","32","1229","Louisiana","6/17/20","1007","222","22079","22.05"
"Red River","0","52","Louisiana","6/17/20","52","0","22081","0"
"Richland","1","167","Louisiana","6/17/20","157","10","22083","6.37"
"Sabine","1","63","Louisiana","6/17/20","53","10","22085","18.87"
"St. Bernard","3","580","Louisiana","6/17/20","558","22","22087","3.94"
"St. Charles","2","667","Louisiana","6/17/20","653","14","22089","2.14"
"St. Helena","1","60","Louisiana","6/17/20","56","4","22091","7.14"
"St. James","1","313","Louisiana","6/17/20","306","7","22093","2.29"
"St. John the Baptist","3","904","Louisiana","6/17/20","883","21","22095","2.38"
"St. Landry","10","393","Louisiana","6/17/20","323","70","22097","21.67"
"St. Martin","21","441","Louisiana","6/17/20","295","146","22099","49.49"
"St. Mary","3","363","Louisiana","6/17/20","342","21","22101","6.14"
"St. Tammany","18","1999","Louisiana","6/17/20","1872","127","22103","6.78"
"Tangipahoa","16","1082","Louisiana","6/17/20","973","109","22105","11.2"
"Tensas","0","22","Louisiana","6/17/20","21","1","22107","4.76"
"Terrebonne","9","826","Louisiana","6/17/20","761","65","22109","8.54"
"Union","9","435","Louisiana","6/17/20","375","60","22111","16"
"Vermilion","5","99","Louisiana","6/17/20","62","37","22113","59.68"
"Vernon","4","67","Louisiana","6/17/20","39","28","22115","71.79"
"Washington","9","560","Louisiana","6/17/20","500","60","22117","12"
"Webster","18","331","Louisiana","6/17/20","203","128","22119","63.05"
"West Baton Rouge","1","205","Louisiana","6/17/20","195","10","22121","5.13"
"West Carroll","2","115","Louisiana","6/17/20","99","16","22123","16.16"
"West Feliciana","2","239","Louisiana","6/17/20","225","14","22125","6.22"
"Winn","3","215","Louisiana","6/17/20","194","21","22127","10.82"
"Androscoggin","6","434","Maine","6/17/20","390","44","23001","11.28"
"Aroostook","0","10","Maine","6/17/20","10","0","23003","0"
"Cumberland","17","1461","Maine","6/17/20","1339","122","23005","9.11"
"Franklin","0","37","Maine","6/17/20","36","1","23007","2.78"
"Hancock","0","13","Maine","6/17/20","12","1","23009","8.33"
"Kennebec","1","138","Maine","6/17/20","132","6","23011","4.55"
"Knox","0","23","Maine","6/17/20","21","2","23013","9.52"
"Lincoln","0","21","Maine","6/17/20","20","1","23015","5"
"Oxford","0","34","Maine","6/17/20","31","3","23017","9.68"
"Penobscot","0","101","Maine","6/17/20","101","0","23019","0"
"Piscataquis","0","1","Maine","6/17/20","1","0","23021","0"
"Sagadahoc","0","30","Maine","6/17/20","30","0","23023","0"
"Somerset","0","26","Maine","6/17/20","25","1","23025","4"
"Waldo","0","55","Maine","6/17/20","54","1","23027","1.85"
"Washington","0","1","Maine","6/17/20","1","0","23029","0"
"York","3","450","Maine","6/17/20","432","18","23031","4.17"
"Allegany","0","188","Maryland","6/17/20","185","3","24001","1.62"
"Anne Arundel","64","4796","Maryland","6/17/20","4348","448","24003","10.3"
"Baltimore","59","7329","Maryland","6/17/20","6916","413","24005","5.97"
"Baltimore City","63","6866","Maryland","6/17/20","6428","438","24510","6.81"
"Calvert","3","382","Maryland","6/17/20","363","19","24009","5.23"
"Caroline","1","284","Maryland","6/17/20","276","8","24011","2.9"
"Carroll","5","1006","Maryland","6/17/20","969","37","24013","3.82"
"Cecil","5","455","Maryland","6/17/20","423","32","24015","7.57"
"Charles","9","1291","Maryland","6/17/20","1231","60","24017","4.87"
"Dorchester","2","170","Maryland","6/17/20","157","13","24019","8.28"
"Frederick","23","2336","Maryland","6/17/20","2178","158","24021","7.25"
"Garrett","0","10","Maryland","6/17/20","10","0","24023","0"
"Harford","7","1032","Maryland","6/17/20","982","50","24025","5.09"
"Howard","18","2343","Maryland","6/17/20","2220","123","24027","5.54"
"Kent","0","192","Maryland","6/17/20","189","3","24029","1.59"
"Montgomery","99","13819","Maryland","6/17/20","13124","695","24031","5.3"
"Prince George's","123","17611","Maryland","6/17/20","16753","858","24033","5.12"
"Queen Anne's","1","187","Maryland","6/17/20","178","9","24035","5.06"
"Somerset","1","82","Maryland","6/17/20","77","5","24039","6.49"
"St. Mary's","3","587","Maryland","6/17/20","565","22","24037","3.89"
"Talbot","0","110","Maryland","6/17/20","108","2","24041","1.85"
"Washington","6","593","Maryland","6/17/20","551","42","24043","7.62"
"Wicomico","6","1035","Maryland","6/17/20","992","43","24045","4.33"
"Worcester","3","265","Maryland","6/17/20","242","23","24047","9.5"
"Barnstable","4","1497","Massachusetts","6/17/20","1467","30","25001","2.04"
"Berkshire","1","582","Massachusetts","6/17/20","574","8","25003","1.39"
"Bristol","29","7956","Massachusetts","6/17/20","7754","202","25005","2.61"
"Dukes and Nantucket","0","57","Massachusetts","6/17/20","55","2","00000","3.64"
"Essex","48","15703","Massachusetts","6/17/20","15365","338","25009","2.2"
"Franklin","1","354","Massachusetts","6/17/20","344","10","25011","2.91"
"Hampden","18","6518","Massachusetts","6/17/20","6395","123","25013","1.92"
"Hampshire","4","936","Massachusetts","6/17/20","905","31","25015","3.43"
"Middlesex","65","23346","Massachusetts","6/17/20","22889","457","25017","2"
"Norfolk","19","8908","Massachusetts","6/17/20","8774","134","25021","1.53"
"Plymouth","15","8522","Massachusetts","6/17/20","8418","104","25023","1.24"
"Suffolk","48","19434","Massachusetts","6/17/20","19099","335","25025","1.75"
"Worcester","30","12032","Massachusetts","6/17/20","11820","212","25027","1.79"
"Alcona","0","21","Michigan","6/17/20","20","1","26001","5"
"Alger","0","2","Michigan","6/17/20","1","1","26003","100"
"Allegan","2","288","Michigan","6/17/20","274","14","26005","5.11"
"Alpena","0","114","Michigan","6/17/20","112","2","26007","1.79"
"Antrim","0","14","Michigan","6/17/20","14","0","26009","0"
"Arenac","0","38","Michigan","6/17/20","38","0","26011","0"
"Baraga","0","1","Michigan","6/17/20","1","0","26013","0"
"Barry","0","92","Michigan","6/17/20","89","3","26015","3.37"
"Bay","1","378","Michigan","6/17/20","372","6","26017","1.61"
"Benzie","0","5","Michigan","6/17/20","5","0","26019","0"
"Berrien","3","829","Michigan","6/17/20","808","21","26021","2.6"
"Branch","12","238","Michigan","6/17/20","155","83","26023","53.55"
"Calhoun","3","495","Michigan","6/17/20","475","20","26025","4.21"
"Cass","1","118","Michigan","6/17/20","110","8","26027","7.27"
"Charlevoix","0","22","Michigan","6/17/20","19","3","26029","15.79"
"Cheboygan","0","26","Michigan","6/17/20","26","0","26031","0"
"Chippewa","0","4","Michigan","6/17/20","3","1","26033","33.33"
"Clare","0","25","Michigan","6/17/20","24","1","26035","4.17"
"Clinton","1","191","Michigan","6/17/20","187","4","26037","2.14"
"Crawford","0","65","Michigan","6/17/20","63","2","26039","3.17"
"Delta","0","21","Michigan","6/17/20","20","1","26041","5"
"Dickinson","0","7","Michigan","6/17/20","6","1","26043","16.67"
"Eaton","1","261","Michigan","6/17/20","255","6","26045","2.35"
"Emmet","0","26","Michigan","6/17/20","26","0","26047","0"
"Federal Correctional Institution (FCI)","1","168","Michigan","6/17/20","159","9","00000","5.66"
"Genesee","5","2596","Michigan","6/17/20","2558","38","26049","1.49"
"Gladwin","0","20","Michigan","6/17/20","20","0","26051","0"
"Gogebic","0","5","Michigan","6/17/20","5","0","26053","0"
"Grand Traverse","0","36","Michigan","6/17/20","35","1","26055","2.86"
"Gratiot","0","91","Michigan","6/17/20","88","3","26057","3.41"
"Hillsdale","0","182","Michigan","6/17/20","179","3","26059","1.68"
"Houghton","0","8","Michigan","6/17/20","8","0","26061","0"
"Huron","0","60","Michigan","6/17/20","60","0","26063","0"
"Ingham","1","818","Michigan","6/17/20","810","8","26065","0.99"
"Ionia","1","182","Michigan","6/17/20","176","6","26067","3.41"
"Iosco","0","111","Michigan","6/17/20","110","1","26069","0.91"
"Iron","0","3","Michigan","6/17/20","2","1","26071","50"
"Isabella","1","99","Michigan","6/17/20","95","4","26073","4.21"
"Jackson","0","487","Michigan","6/17/20","484","3","26075","0.62"
"Kalamazoo","4","969","Michigan","6/17/20","940","29","26077","3.09"
"Kalkaska","0","30","Michigan","6/17/20","30","0","26079","0"
"Kent","33","4491","Michigan","6/17/20","4261","230","26081","5.4"
"Keweenaw","0","1","Michigan","6/17/20","1","0","26083","0"
"Lake","0","7","Michigan","6/17/20","7","0","26085","0"
"Lapeer","1","231","Michigan","6/17/20","225","6","26087","2.67"
"Leelanau","0","12","Michigan","6/17/20","12","0","26089","0"
"Lenawee","1","199","Michigan","6/17/20","191","8","26091","4.19"
"Livingston","1","527","Michigan","6/17/20","519","8","26093","1.54"
"Luce","0","3","Michigan","6/17/20","3","0","26095","0"
"Mackinac","0","8","Michigan","6/17/20","8","0","26097","0"
"Macomb","15","7102","Michigan","6/17/20","7000","102","26099","1.46"
"Manistee","0","12","Michigan","6/17/20","12","0","26101","0"
"Marquette","0","59","Michigan","6/17/20","59","0","26103","0"
"Mason","0","38","Michigan","6/17/20","38","0","26105","0"
"Mecosta","0","26","Michigan","6/17/20","24","2","26107","8.33"
"Menominee","0","9","Michigan","6/17/20","9","0","26109","0"
"Michigan Department of Corrections (MDOC)","-9","4067","Michigan","6/17/20","4129","-62","00000","-1.5"
"Midland","2","153","Michigan","6/17/20","138","15","26111","10.87"
"Missaukee","0","24","Michigan","6/17/20","23","1","26113","4.35"
"Monroe","1","570","Michigan","6/17/20","560","10","26115","1.79"
"Montcalm","0","81","Michigan","6/17/20","81","0","26117","0"
"Montmorency","0","5","Michigan","6/17/20","5","0","26119","0"
"Muskegon","3","748","Michigan","6/17/20","726","22","26121","3.03"
"Newaygo","1","130","Michigan","6/17/20","125","5","26123","4"
"Oakland","17","11384","Michigan","6/17/20","11262","122","26125","1.08"
"Oceana","2","119","Michigan","6/17/20","103","16","26127","15.53"
"Ogemaw","0","32","Michigan","6/17/20","31","1","26129","3.23"
"Osceola","1","22","Michigan","6/17/20","18","4","26133","22.22"
"Oscoda","0","8","Michigan","6/17/20","8","0","26135","0"
"Otsego","0","120","Michigan","6/17/20","120","0","26137","0"
"Ottawa","5","936","Michigan","6/17/20","900","36","26139","4"
"Out of MI","2","40","Michigan","6/17/20","23","17","80026","73.91"
"Presque Isle","0","12","Michigan","6/17/20","11","1","26141","9.09"
"Roscommon","0","25","Michigan","6/17/20","24","1","26143","4.17"
"Saginaw","5","1171","Michigan","6/17/20","1138","33","26145","2.9"
"Sanilac","0","43","Michigan","6/17/20","42","1","26151","2.38"
"Schoolcraft","0","4","Michigan","6/17/20","4","0","26153","0"
"Shiawassee","0","264","Michigan","6/17/20","262","2","26155","0.76"
"St. Clair","1","518","Michigan","6/17/20","514","4","26147","0.78"
"St. Joseph","6","200","Michigan","6/17/20","160","40","26149","25"
"Tuscola","3","230","Michigan","6/17/20","206","24","26157","11.65"
"Van Buren","2","210","Michigan","6/17/20","195","15","26159","7.69"
"Washtenaw","6","1592","Michigan","6/17/20","1551","41","26161","2.64"
"Wayne","47","21897","Michigan","6/17/20","21570","327","26163","1.52"
"Wexford","0","17","Michigan","6/17/20","14","3","26165","21.43"
"Aitkin","0","13","Minnesota","6/17/20","13","0","27001","0"
"Anoka","19","1786","Minnesota","6/17/20","1654","132","27003","7.98"
"Becker","1","49","Minnesota","6/17/20","45","4","27005","8.89"
"Beltrami","0","23","Minnesota","6/17/20","21","2","27007","9.52"
"Benton","1","195","Minnesota","6/17/20","190","5","27009","2.63"
"Big Stone","0","14","Minnesota","6/17/20","13","1","27011","7.69"
"Blue Earth","2","169","Minnesota","6/17/20","154","15","27013","9.74"
"Brown","0","20","Minnesota","6/17/20","17","3","27015","17.65"
"Carlton","0","81","Minnesota","6/17/20","78","3","27017","3.85"
"Carver","2","278","Minnesota","6/17/20","261","17","27019","6.51"
"Cass","0","11","Minnesota","6/17/20","11","0","27021","0"
"Chippewa","1","58","Minnesota","6/17/20","54","4","27023","7.41"
"Chisago","1","81","Minnesota","6/17/20","73","8","27025","10.96"
"Clay","3","512","Minnesota","6/17/20","490","22","27027","4.49"
"Clearwater","0","6","Minnesota","6/17/20","3","3","27029","100"
"Cook","0","1","Minnesota","6/17/20","0","1","27031","1"
"Cottonwood","3","115","Minnesota","6/17/20","94","21","27033","22.34"
"Crow Wing","1","91","Minnesota","6/17/20","87","4","27035","4.6"
"Dakota","29","1776","Minnesota","6/17/20","1572","204","27037","12.98"
"Dodge","1","61","Minnesota","6/17/20","55","6","27039","10.91"
"Douglas","0","51","Minnesota","6/17/20","48","3","27041","6.25"
"Faribault","1","30","Minnesota","6/17/20","25","5","27043","20"
"Fillmore","0","20","Minnesota","6/17/20","20","0","27045","0"
"Freeborn","5","235","Minnesota","6/17/20","197","38","27047","19.29"
"Goodhue","2","97","Minnesota","6/17/20","86","11","27049","12.79"
"Grant","0","6","Minnesota","6/17/20","6","0","27051","0"
"Hennepin","106","10415","Minnesota","6/17/20","9674","741","27053","7.66"
"Houston","0","7","Minnesota","6/17/20","5","2","27055","40"
"Hubbard","0","5","Minnesota","6/17/20","5","0","27057","0"
"Isanti","1","50","Minnesota","6/17/20","44","6","27059","13.64"
"Itasca","0","59","Minnesota","6/17/20","58","1","27061","1.72"
"Jackson","1","48","Minnesota","6/17/20","43","5","27063","11.63"
"Kanabec","0","13","Minnesota","6/17/20","12","1","27065","8.33"
"Kandiyohi","3","552","Minnesota","6/17/20","534","18","27067","3.37"
"Kittson","0","1","Minnesota","6/17/20","1","0","27069","0"
"Koochiching","0","9","Minnesota","6/17/20","9","0","27071","0"
"Lac qui Parle","0","3","Minnesota","6/17/20","3","0","27073","0"
"Lake","0","4","Minnesota","6/17/20","1","3","27075","300"
"Le Sueur","0","53","Minnesota","6/17/20","50","3","27079","6"
"Lincoln","0","6","Minnesota","6/17/20","6","0","27081","0"
"Lyon","10","229","Minnesota","6/17/20","158","71","27083","44.94"
"Mahnomen","0","6","Minnesota","6/17/20","6","0","27087","0"
"Marshall","0","12","Minnesota","6/17/20","12","0","27089","0"
"Martin","1","147","Minnesota","6/17/20","143","4","27091","2.8"
"McLeod","1","56","Minnesota","6/17/20","46","10","27085","21.74"
"Meeker","0","50","Minnesota","6/17/20","47","3","27093","6.38"
"Mille Lacs","1","28","Minnesota","6/17/20","24","4","27095","16.67"
"Morrison","0","54","Minnesota","6/17/20","52","2","27097","3.85"
"Mower","23","733","Minnesota","6/17/20","574","159","27099","27.7"
"Murray","0","43","Minnesota","6/17/20","41","2","27101","4.88"
"Nicollet","0","95","Minnesota","6/17/20","93","2","27103","2.15"
"Nobles","3","1620","Minnesota","6/17/20","1599","21","27105","1.31"
"Norman","0","18","Minnesota","6/17/20","16","2","27107","12.5"
"Olmsted","10","810","Minnesota","6/17/20","740","70","27109","9.46"
"Otter Tail","1","83","Minnesota","6/17/20","78","5","27111","6.41"
"Pennington","2","51","Minnesota","6/17/20","37","14","27113","37.84"
"Pine","0","96","Minnesota","6/17/20","94","2","27115","2.13"
"Pipestone","0","14","Minnesota","6/17/20","14","0","27117","0"
"Polk","0","67","Minnesota","6/17/20","67","0","27119","0"
"Pope","0","10","Minnesota","6/17/20","10","0","27121","0"
"Ramsey","57","4079","Minnesota","6/17/20","3680","399","27123","10.84"
"Red Lake","0","4","Minnesota","6/17/20","4","0","27125","0"
"Redwood","1","12","Minnesota","6/17/20","8","4","27127","50"
"Renville","1","12","Minnesota","6/17/20","8","4","27129","50"
"Rice","15","701","Minnesota","6/17/20","594","107","27131","18.01"
"Rock","0","25","Minnesota","6/17/20","23","2","27133","8.7"
"Roseau","0","6","Minnesota","6/17/20","5","1","27135","20"
"Scott","6","546","Minnesota","6/17/20","504","42","27139","8.33"
"Sherburne","2","272","Minnesota","6/17/20","260","12","27141","4.62"
"Sibley","0","26","Minnesota","6/17/20","25","1","27143","4"
"St. Louis","1","127","Minnesota","6/17/20","119","8","27137","6.72"
"Stearns","4","2111","Minnesota","6/17/20","2081","30","27145","1.44"
"Steele","1","179","Minnesota","6/17/20","173","6","27147","3.47"
"Stevens","0","1","Minnesota","6/17/20","1","0","27149","0"
"Swift","0","20","Minnesota","6/17/20","19","1","27151","5.26"
"Todd","2","379","Minnesota","6/17/20","364","15","27153","4.12"
"Traverse","0","5","Minnesota","6/17/20","5","0","27155","0"
"Wabasha","1","24","Minnesota","6/17/20","20","4","27157","20"
"Wadena","0","10","Minnesota","6/17/20","10","0","27159","0"
"Waseca","0","34","Minnesota","6/17/20","32","2","27161","6.25"
"Washington","13","826","Minnesota","6/17/20","735","91","27163","12.38"
"Watonwan","3","108","Minnesota","6/17/20","86","22","27165","25.58"
"Wilkin","0","15","Minnesota","6/17/20","12","3","27167","25"
"Winona","0","89","Minnesota","6/17/20","86","3","27169","3.49"
"Wright","4","390","Minnesota","6/17/20","362","28","27171","7.73"
"Yellow Medicine","0","10","Minnesota","6/17/20","8","2","27173","25"
"Adams","1","227","Mississippi","6/17/20","222","5","28001","2.25"
"Alcorn","1","32","Mississippi","6/17/20","26","6","28003","23.08"
"Amite","1","73","Mississippi","6/17/20","67","6","28005","8.96"
"Attala","2","335","Mississippi","6/17/20","323","12","28007","3.72"
"Benton","0","18","Mississippi","6/17/20","17","1","28009","5.88"
"Bolivar","2","197","Mississippi","6/17/20","180","17","28011","9.44"
"Calhoun","1","83","Mississippi","6/17/20","75","8","28013","10.67"
"Carroll","0","122","Mississippi","6/17/20","123","-1","28015","-0.81"
"Chickasaw","3","177","Mississippi","6/17/20","158","19","28017","12.03"
"Choctaw","1","71","Mississippi","6/17/20","62","9","28019","14.52"
"Claiborne","2","144","Mississippi","6/17/20","131","13","28021","9.92"
"Clarke","1","168","Mississippi","6/17/20","164","4","28023","2.44"
"Clay","6","185","Mississippi","6/17/20","145","40","28025","27.59"
"Coahoma","2","156","Mississippi","6/17/20","141","15","28027","10.64"
"Copiah","8","425","Mississippi","6/17/20","366","59","28029","16.12"
"Covington","2","213","Mississippi","6/17/20","200","13","28031","6.5"
"DeSoto","18","790","Mississippi","6/17/20","664","126","28033","18.98"
"Forrest","4","697","Mississippi","6/17/20","667","30","28035","4.5"
"Franklin","0","30","Mississippi","6/17/20","29","1","28037","3.45"
"George","1","41","Mississippi","6/17/20","32","9","28039","28.12"
"Greene","2","56","Mississippi","6/17/20","45","11","28041","24.44"
"Grenada","5","170","Mississippi","6/17/20","138","32","28043","23.19"
"Hancock","1","100","Mississippi","6/17/20","94","6","28045","6.38"
"Harrison","12","393","Mississippi","6/17/20","311","82","28047","26.37"
"Hinds","26","1390","Mississippi","6/17/20","1206","184","28049","15.26"
"Holmes","2","477","Mississippi","6/17/20","460","17","28051","3.7"
"Humphreys","1","83","Mississippi","6/17/20","78","5","28053","6.41"
"Itawamba","1","106","Mississippi","6/17/20","96","10","28057","10.42"
"Jackson","7","385","Mississippi","6/17/20","339","46","28059","13.57"
"Jasper","2","203","Mississippi","6/17/20","189","14","28061","7.41"
"Jefferson","1","57","Mississippi","6/17/20","50","7","28063","14"
"Jefferson Davis","0","86","Mississippi","6/17/20","84","2","28065","2.38"
"Jones","14","910","Mississippi","6/17/20","812","98","28067","12.07"
"Kemper","0","169","Mississippi","6/17/20","166","3","28069","1.81"
"Lafayette","7","209","Mississippi","6/17/20","161","48","28071","29.81"
"Lamar","3","300","Mississippi","6/17/20","278","22","28073","7.91"
"Lauderdale","3","818","Mississippi","6/17/20","795","23","28075","2.89"
"Lawrence","1","121","Mississippi","6/17/20","113","8","28077","7.08"
"Leake","3","496","Mississippi","6/17/20","472","24","28079","5.08"
"Lee","10","330","Mississippi","6/17/20","261","69","28081","26.44"
"Leflore","8","385","Mississippi","6/17/20","330","55","28083","16.67"
"Lincoln","2","330","Mississippi","6/17/20","314","16","28085","5.1"
"Lowndes","9","352","Mississippi","6/17/20","290","62","28087","21.38"
"Madison","11","922","Mississippi","6/17/20","843","79","28089","9.37"
"Marion","4","163","Mississippi","6/17/20","132","31","28091","23.48"
"Marshall","3","122","Mississippi","6/17/20","98","24","28093","24.49"
"Monroe","2","301","Mississippi","6/17/20","290","11","28095","3.79"
"Montgomery","1","98","Mississippi","6/17/20","88","10","28097","11.36"
"Neshoba","14","921","Mississippi","6/17/20","821","100","28099","12.18"
"Newton","2","325","Mississippi","6/17/20","313","12","28101","3.83"
"Noxubee","1","218","Mississippi","6/17/20","209","9","28103","4.31"
"Oktibbeha","8","386","Mississippi","6/17/20","327","59","28105","18.04"
"Panola","5","146","Mississippi","6/17/20","110","36","28107","32.73"
"Pearl River","0","224","Mississippi","6/17/20","221","3","28109","1.36"
"Perry","0","55","Mississippi","6/17/20","52","3","28111","5.77"
"Pike","5","248","Mississippi","6/17/20","213","35","28113","16.43"
"Pontotoc","4","93","Mississippi","6/17/20","64","29","28115","45.31"
"Prentiss","1","70","Mississippi","6/17/20","63","7","28117","11.11"
"Quitman","3","52","Mississippi","6/17/20","34","18","28119","52.94"
"Rankin","8","563","Mississippi","6/17/20","505","58","28121","11.49"
"Scott","2","696","Mississippi","6/17/20","682","14","28123","2.05"
"Sharkey","0","9","Mississippi","6/17/20","7","2","28125","28.57"
"Simpson","1","126","Mississippi","6/17/20","117","9","28127","7.69"
"Smith","1","182","Mississippi","6/17/20","173","9","28129","5.2"
"Stone","0","35","Mississippi","6/17/20","33","2","28131","6.06"
"Sunflower","3","128","Mississippi","6/17/20","109","19","28133","17.43"
"Tallahatchie","2","49","Mississippi","6/17/20","35","14","28135","40"
"Tate","5","155","Mississippi","6/17/20","118","37","28137","31.36"
"Tippah","1","100","Mississippi","6/17/20","90","10","28139","11.11"
"Tishomingo","1","47","Mississippi","6/17/20","43","4","28141","9.3"
"Tunica","1","67","Mississippi","6/17/20","61","6","28143","9.84"
"Union","2","109","Mississippi","6/17/20","93","16","28145","17.2"
"Walthall","4","111","Mississippi","6/17/20","85","26","28147","30.59"
"Warren","7","280","Mississippi","6/17/20","232","48","28149","20.69"
"Washington","8","276","Mississippi","6/17/20","222","54","28151","24.32"
"Wayne","9","409","Mississippi","6/17/20","346","63","28153","18.21"
"Webster","1","109","Mississippi","6/17/20","99","10","28155","10.1"
"Wilkinson","0","85","Mississippi","6/17/20","85","0","28157","0"
"Winston","3","158","Mississippi","6/17/20","139","19","28159","13.67"
"Yalobusha","2","139","Mississippi","6/17/20","128","11","28161","8.59"
"Yazoo","4","354","Mississippi","6/17/20","329","25","28163","7.6"
"Adair","2","85","Missouri","6/17/20","74","11","29001","14.86"
"Andrew","0","35","Missouri","6/17/20","34","1","29003","2.94"
"Atchison","0","3","Missouri","6/17/20","3","0","29005","0"
"Audrain","0","122","Missouri","6/17/20","119","3","29007","2.52"
"Barry","2","20","Missouri","6/17/20","9","11","29009","122.22"
"Barton","2","11","Missouri","6/17/20","0","11","29011","1"
"Bates","0","12","Missouri","6/17/20","12","0","29013","0"
"Benton","0","14","Missouri","6/17/20","13","1","29015","7.69"
"Bollinger","0","10","Missouri","6/17/20","7","3","29017","42.86"
"Boone","4","222","Missouri","6/17/20","197","25","29019","12.69"
"Buchanan","4","793","Missouri","6/17/20","762","31","29021","4.07"
"Butler","0","53","Missouri","6/17/20","51","2","29023","3.92"
"Caldwell","0","8","Missouri","6/17/20","8","0","29025","0"
"Callaway","1","40","Missouri","6/17/20","34","6","29027","17.65"
"Camden","1","45","Missouri","6/17/20","38","7","29029","18.42"
"Cape Girardeau","3","111","Missouri","6/17/20","88","23","29031","26.14"
"Carroll","0","11","Missouri","6/17/20","9","2","29033","22.22"
"Carter","0","5","Missouri","6/17/20","5","0","29035","0"
"Cass","0","109","Missouri","6/17/20","108","1","29037","0.93"
"Cedar","0","9","Missouri","6/17/20","9","0","29039","0"
"Chariton","0","6","Missouri","6/17/20","6","0","29041","0"
"Christian","0","30","Missouri","6/17/20","29","1","29043","3.45"
"Clark","0","1","Missouri","6/17/20","2","-1","29045","-50"
"Clay","7","301","Missouri","6/17/20","254","47","29047","18.5"
"Clinton","0","21","Missouri","6/17/20","20","1","29049","5"
"Cole","-1","57","Missouri","6/17/20","61","-4","29051","-6.56"
"Cooper","0","11","Missouri","6/17/20","9","2","29053","22.22"
"Crawford","0","9","Missouri","6/17/20","9","0","29055","0"
"Dade","0","1","Missouri","6/17/20","0","1","29057","1"
"Dallas","0","6","Missouri","6/17/20","6","0","29059","0"
"Daviess","0","7","Missouri","6/17/20","7","0","29061","0"
"DeKalb","0","9","Missouri","6/17/20","7","2","29063","28.57"
"Dent","0","1","Missouri","6/17/20","0","1","29065","1"
"Douglas","0","3","Missouri","6/17/20","0","3","29067","1"
"Dunklin","2","64","Missouri","6/17/20","52","12","29069","23.08"
"Franklin","2","173","Missouri","6/17/20","156","17","29071","10.9"
"Gasconade","0","2","Missouri","6/17/20","2","0","29073","0"
"Gentry","0","54","Missouri","6/17/20","54","0","29075","0"
"Greene","2","199","Missouri","6/17/20","183","16","29077","8.74"
"Grundy","2","11","Missouri","6/17/20","0","11","29079","1"
"Harrison","0","9","Missouri","6/17/20","9","0","29081","0"
"Henry","0","18","Missouri","6/17/20","15","3","29083","20"
"Holt","0","1","Missouri","6/17/20","2","-1","29087","-50"
"Howard","0","3","Missouri","6/17/20","3","0","29089","0"
"Howell","2","28","Missouri","6/17/20","17","11","29091","64.71"
"Iron","0","2","Missouri","6/17/20","3","-1","29093","-33.33"
"Jackson","23","916","Missouri","6/17/20","752","164","29095","21.81"
"Jasper","15","184","Missouri","6/17/20","79","105","29097","132.91"
"Jefferson","-3","388","Missouri","6/17/20","411","-23","29099","-5.6"
"Johnson","1","84","Missouri","6/17/20","78","6","29101","7.69"
"Kansas City","25","1802","Missouri","6/17/20","1626","176","00000","10.82"
"Knox","0","2","Missouri","6/17/20","0","2","29103","1"
"Laclede","0","10","Missouri","6/17/20","7","3","29105","42.86"
"Lafayette","0","86","Missouri","6/17/20","83","3","29107","3.61"
"Lawrence","0","8","Missouri","6/17/20","8","0","29109","0"
"Lewis","0","7","Missouri","6/17/20","7","0","29111","0"
"Lincoln","-4","90","Missouri","6/17/20","121","-31","29113","-25.62"
"Linn","0","12","Missouri","6/17/20","11","1","29115","9.09"
"Livingston","0","6","Missouri","6/17/20","5","1","29117","20"
"Macon","0","7","Missouri","6/17/20","6","1","29121","16.67"
"Madison","0","3","Missouri","6/17/20","3","0","29123","0"
"Maries","0","2","Missouri","6/17/20","2","0","29125","0"
"Marion","0","9","Missouri","6/17/20","6","3","29127","50"
"McDonald","11","116","Missouri","6/17/20","42","74","29119","176.19"
"Mercer","1","5","Missouri","6/17/20","0","5","29129","1"
"Miller","0","7","Missouri","6/17/20","5","2","29131","40"
"Mississippi","1","75","Missouri","6/17/20","66","9","29133","13.64"
"Moniteau","0","49","Missouri","6/17/20","49","0","29135","0"
"Monroe","0","3","Missouri","6/17/20","0","3","29137","1"
"Montgomery","0","12","Missouri","6/17/20","13","-1","29139","-7.69"
"Morgan","0","11","Missouri","6/17/20","9","2","29141","22.22"
"New Madrid","1","34","Missouri","6/17/20","24","10","29143","41.67"
"Newton","6","88","Missouri","6/17/20","44","44","29145","100"
"Nodaway","0","16","Missouri","6/17/20","14","2","29147","14.29"
"Oregon","1","6","Missouri","6/17/20","2","4","29149","200"
"Osage","0","5","Missouri","6/17/20","6","-1","29151","-16.67"
"Pemiscot","1","104","Missouri","6/17/20","99","5","29155","5.05"
"Perry","2","87","Missouri","6/17/20","75","12","29157","16"
"Pettis","1","89","Missouri","6/17/20","84","5","29159","5.95"
"Phelps","0","7","Missouri","6/17/20","6","1","29161","16.67"
"Pike","0","31","Missouri","6/17/20","29","2","29163","6.9"
"Platte","3","99","Missouri","6/17/20","81","18","29165","22.22"
"Polk","1","10","Missouri","6/17/20","4","6","29167","150"
"Pulaski","0","106","Missouri","6/17/20","109","-3","29169","-2.75"
"Putnam","0","2","Missouri","6/17/20","0","2","29171","1"
"Ralls","0","5","Missouri","6/17/20","5","0","29173","0"
"Randolph","0","11","Missouri","6/17/20","10","1","29175","10"
"Ray","0","25","Missouri","6/17/20","24","1","29177","4.17"
"Reynolds","0","2","Missouri","6/17/20","2","0","29179","0"
"Ripley","0","12","Missouri","6/17/20","11","1","29181","9.09"
"Saline","-1","274","Missouri","6/17/20","283","-9","29195","-3.18"
"Schuyler","0","1","Missouri","6/17/20","0","1","29197","1"
"Scotland","0","8","Missouri","6/17/20","9","-1","29199","-11.11"
"Scott","3","149","Missouri","6/17/20","128","21","29201","16.41"
"Shannon","1","6","Missouri","6/17/20","0","6","29203","1"
"Shelby","0","1","Missouri","6/17/20","1","0","29205","0"
"St. Charles","8","926","Missouri","6/17/20","871","55","29183","6.31"
"St. Clair","0","2","Missouri","6/17/20","3","-1","29185","-33.33"
"St. Francois","0","43","Missouri","6/17/20","41","2","29187","4.88"
"St. Louis","31","5669","Missouri","6/17/20","5455","214","29189","3.92"
"St. Louis City","16","2254","Missouri","6/17/20","2145","109","29510","5.08"
"Ste. Genevieve","0","14","Missouri","6/17/20","13","1","29186","7.69"
"Stoddard","2","124","Missouri","6/17/20","109","15","29207","13.76"
"Stone","0","7","Missouri","6/17/20","10","-3","29209","-30"
"Sullivan","3","91","Missouri","6/17/20","71","20","29211","28.17"
"Taney","2","27","Missouri","6/17/20","14","13","29213","92.86"
"Texas","0","1","Missouri","6/17/20","1","0","29215","0"
"Vernon","0","12","Missouri","6/17/20","12","0","29217","0"
"Warren","0","32","Missouri","6/17/20","31","1","29219","3.23"
"Washington","0","13","Missouri","6/17/20","13","0","29221","0"
"Webster","0","19","Missouri","6/17/20","18","1","29225","5.56"
"Worth","0","4","Missouri","6/17/20","4","0","29227","0"
"Wright","0","14","Missouri","6/17/20","14","0","29229","0"
"Beaverhead","0","1","Montana","6/17/20","1","0","30001","0"
"Big Horn","1","49","Montana","6/17/20","43","6","30003","13.95"
"Broadwater","0","4","Montana","6/17/20","4","0","30007","0"
"Carbon","0","7","Montana","6/17/20","6","1","30009","16.67"
"Cascade","0","20","Montana","6/17/20","17","3","30013","17.65"
"Custer","3","19","Montana","6/17/20","0","19","30017","1"
"Deer Lodge","0","3","Montana","6/17/20","3","0","30023","0"
"Flathead","1","41","Montana","6/17/20","37","4","30029","10.81"
"Gallatin","2","191","Montana","6/17/20","174","17","30031","9.77"
"Glacier","0","6","Montana","6/17/20","6","0","30035","0"
"Golden Valley","0","3","Montana","6/17/20","3","0","30037","0"
"Hill","0","1","Montana","6/17/20","1","0","30041","0"
"Jefferson","0","3","Montana","6/17/20","3","0","30043","0"
"Lake","1","9","Montana","6/17/20","5","4","30047","80"
"Lewis and Clark","0","20","Montana","6/17/20","18","2","30049","11.11"
"Liberty","0","1","Montana","6/17/20","1","0","30051","0"
"Lincoln","0","7","Montana","6/17/20","7","0","30053","0"
"Madison","0","8","Montana","6/17/20","8","0","30057","0"
"Meagher","0","1","Montana","6/17/20","1","0","30059","0"
"Missoula","1","44","Montana","6/17/20","39","5","30063","12.82"
"Musselshell","0","1","Montana","6/17/20","1","0","30065","0"
"Park","0","8","Montana","6/17/20","8","0","30067","0"
"Pondera","0","2","Montana","6/17/20","2","0","30073","0"
"Ravalli","0","17","Montana","6/17/20","14","3","30081","21.43"
"Richland","0","3","Montana","6/17/20","3","0","30083","0"
"Roosevelt","0","7","Montana","6/17/20","7","0","30085","0"
"Rosebud","0","1","Montana","6/17/20","1","0","30087","0"
"Silver Bow","0","11","Montana","6/17/20","11","0","30093","0"
"Stillwater","0","3","Montana","6/17/20","2","1","30095","50"
"Toole","0","29","Montana","6/17/20","29","0","30101","0"
"Wheatland","0","1","Montana","6/17/20","1","0","30107","0"
"Yellowstone","1","109","Montana","6/17/20","105","4","30111","3.81"
"Adams","0","278","Nebraska","6/17/20","277","1","31001","0.36"
"Antelope","0","8","Nebraska","6/17/20","8","0","31003","0"
"Banner","0","1","Nebraska","6/17/20","0","1","31007","1"
"Boone","0","7","Nebraska","6/17/20","7","0","31011","0"
"Box Butte","0","3","Nebraska","6/17/20","3","0","31013","0"
"Boyd","0","1","Nebraska","6/17/20","1","0","31015","0"
"Buffalo","0","176","Nebraska","6/17/20","175","1","31019","0.57"
"Burt","0","11","Nebraska","6/17/20","10","1","31021","10"
"Butler","0","51","Nebraska","6/17/20","51","0","31023","0"
"Cass","0","60","Nebraska","6/17/20","58","2","31025","3.45"
"Cedar","0","8","Nebraska","6/17/20","8","0","31027","0"
"Chase","0","1","Nebraska","6/17/20","1","0","31029","0"
"Cherry","0","1","Nebraska","6/17/20","1","0","31031","0"
"Cheyenne","0","11","Nebraska","6/17/20","10","1","31033","10"
"Clay","0","24","Nebraska","6/17/20","24","0","31035","0"
"Colfax","2","653","Nebraska","6/17/20","639","14","31037","2.19"
"Cuming","0","34","Nebraska","6/17/20","34","0","31039","0"
"Custer","0","34","Nebraska","6/17/20","34","0","31041","0"
"Dakota","2","1729","Nebraska","6/17/20","1717","12","31043","0.7"
"Dawes","0","1","Nebraska","6/17/20","1","0","31045","0"
"Dawson","0","847","Nebraska","6/17/20","844","3","31047","0.36"
"Dixon","1","40","Nebraska","6/17/20","34","6","31051","17.65"
"Dodge","7","642","Nebraska","6/17/20","591","51","31053","8.63"
"Douglas","101","5953","Nebraska","6/17/20","5245","708","31055","13.5"
"Fillmore","1","13","Nebraska","6/17/20","9","4","31059","44.44"
"Franklin","0","6","Nebraska","6/17/20","6","0","31061","0"
"Frontier","0","1","Nebraska","6/17/20","1","0","31063","0"
"Furnas","0","9","Nebraska","6/17/20","9","0","31065","0"
"Gage","0","46","Nebraska","6/17/20","45","1","31067","2.22"
"Garden","0","4","Nebraska","6/17/20","4","0","31069","0"
"Garfield","0","1","Nebraska","6/17/20","1","0","31071","0"
"Gosper","0","13","Nebraska","6/17/20","13","0","31073","0"
"Greeley","0","3","Nebraska","6/17/20","3","0","31077","0"
"Hall","2","1567","Nebraska","6/17/20","1553","14","31079","0.9"
"Hamilton","0","57","Nebraska","6/17/20","56","1","31081","1.79"
"Hitchcock","0","1","Nebraska","6/17/20","1","0","31087","0"
"Holt","0","1","Nebraska","6/17/20","1","0","31089","0"
"Howard","0","44","Nebraska","6/17/20","44","0","31093","0"
"Jefferson","0","9","Nebraska","6/17/20","9","0","31095","0"
"Johnson","0","6","Nebraska","6/17/20","6","0","31097","0"
"Kearney","0","12","Nebraska","6/17/20","12","0","31099","0"
"Keith","0","2","Nebraska","6/17/20","2","0","31101","0"
"Kimball","0","8","Nebraska","6/17/20","8","0","31105","0"
"Knox","0","13","Nebraska","6/17/20","11","2","31107","18.18"
"Lancaster","21","1538","Nebraska","6/17/20","1393","145","31109","10.41"
"Lincoln","0","54","Nebraska","6/17/20","51","3","31111","5.88"
"Madison","2","339","Nebraska","6/17/20","328","11","31119","3.35"
"Merrick","0","36","Nebraska","6/17/20","36","0","31121","0"
"Morrill","0","14","Nebraska","6/17/20","11","3","31123","27.27"
"Nance","0","4","Nebraska","6/17/20","4","0","31125","0"
"Nemaha","0","4","Nebraska","6/17/20","4","0","31127","0"
"Nuckolls","0","1","Nebraska","6/17/20","1","0","31129","0"
"Otoe","0","14","Nebraska","6/17/20","11","3","31131","27.27"
"Phelps","0","21","Nebraska","6/17/20","20","1","31137","5"
"Pierce","0","6","Nebraska","6/17/20","6","0","31139","0"
"Platte","3","650","Nebraska","6/17/20","631","19","31141","3.01"
"Polk","0","12","Nebraska","6/17/20","12","0","31143","0"
"Red Willow","0","6","Nebraska","6/17/20","5","1","31145","20"
"Richardson","0","1","Nebraska","6/17/20","1","0","31147","0"
"Saline","1","525","Nebraska","6/17/20","518","7","31151","1.35"
"Sarpy","20","948","Nebraska","6/17/20","809","139","31153","17.18"
"Saunders","1","59","Nebraska","6/17/20","55","4","31155","7.27"
"Scotts Bluff","5","184","Nebraska","6/17/20","149","35","31157","23.49"
"Seward","0","32","Nebraska","6/17/20","29","3","31159","10.34"
"Sherman","0","5","Nebraska","6/17/20","5","0","31163","0"
"Sioux","0","1","Nebraska","6/17/20","0","1","31165","1"
"Stanton","0","21","Nebraska","6/17/20","21","0","31167","0"
"Thayer","0","1","Nebraska","6/17/20","1","0","31169","0"
"Thomas","0","1","Nebraska","6/17/20","1","0","31171","0"
"Thurston","1","71","Nebraska","6/17/20","61","10","31173","16.39"
"Valley","0","7","Nebraska","6/17/20","7","0","31175","0"
"Washington","1","41","Nebraska","6/17/20","36","5","31177","13.89"
"Wayne","0","26","Nebraska","6/17/20","26","0","31179","0"
"Webster","0","6","Nebraska","6/17/20","5","1","31181","20"
"York","0","37","Nebraska","6/17/20","37","0","31185","0"
"Carson City","1","124","Nevada","6/17/20","115","9","32510","7.83"
"Churchill","0","10","Nevada","6/17/20","10","0","32001","0"
"Clark","200","9318","Nevada","6/17/20","7915","1403","32003","17.73"
"Douglas","1","47","Nevada","6/17/20","39","8","32005","20.51"
"Elko","2","47","Nevada","6/17/20","33","14","32007","42.42"
"Humboldt","0","78","Nevada","6/17/20","78","0","32013","0"
"Lander","0","23","Nevada","6/17/20","24","-1","32015","-4.17"
"Lincoln","0","2","Nevada","6/17/20","2","0","32017","0"
"Lyon","1","94","Nevada","6/17/20","89","5","32019","5.62"
"Mineral","0","4","Nevada","6/17/20","4","0","32021","0"
"Nye","1","75","Nevada","6/17/20","69","6","32023","8.7"
"Pershing","0","5","Nevada","6/17/20","4","1","32027","25"
"Storey","0","1","Nevada","6/17/20","1","0","32029","0"
"Washoe","27","2023","Nevada","6/17/20","1832","191","32031","10.43"
"White Pine","0","3","Nevada","6/17/20","3","0","32033","0"
"Belknap","1","74","New Hampshire","6/17/20","70","4","33001","5.71"
"Carroll","0","49","New Hampshire","6/17/20","49","0","33003","0"
"Cheshire","1","63","New Hampshire","6/17/20","59","4","33005","6.78"
"Coos","0","6","New Hampshire","6/17/20","6","0","33007","0"
"Grafton","0","75","New Hampshire","6/17/20","76","-1","33009","-1.32"
"Hillsborough","31","3048","New Hampshire","6/17/20","2833","215","33011","7.59"
"Merrimack","1","392","New Hampshire","6/17/20","383","9","33013","2.35"
"Rockingham","4","1422","New Hampshire","6/17/20","1392","30","33015","2.16"
"Strafford","0","280","New Hampshire","6/17/20","278","2","33017","0.72"
"Sullivan","0","24","New Hampshire","6/17/20","24","0","33019","0"
"Atlantic","19","2553","New Jersey","6/17/20","2422","131","34001","5.41"
"Bergen","37","18928","New Jersey","6/17/20","18667","261","34003","1.4"
"Burlington","16","4935","New Jersey","6/17/20","4826","109","34005","2.26"
"Camden","21","7047","New Jersey","6/17/20","6903","144","34007","2.09"
"Cape May","3","682","New Jersey","6/17/20","662","20","34009","3.02"
"Cumberland","20","2745","New Jersey","6/17/20","2604","141","34011","5.41"
"Essex","31","18421","New Jersey","6/17/20","18206","215","34013","1.18"
"Gloucester","10","2428","New Jersey","6/17/20","2357","71","34015","3.01"
"Hudson","25","19238","New Jersey","6/17/20","19066","172","34017","0.9"
"Hunterdon","3","1049","New Jersey","6/17/20","1028","21","34019","2.04"
"Mercer","21","7393","New Jersey","6/17/20","7245","148","34021","2.04"
"Middlesex","32","16513","New Jersey","6/17/20","16288","225","34023","1.38"
"Monmouth","34","8804","New Jersey","6/17/20","8563","241","34025","2.81"
"Morris","4","6627","New Jersey","6/17/20","6596","31","34027","0.47"
"Ocean","29","9306","New Jersey","6/17/20","9100","206","34029","2.26"
"Passaic","23","16683","New Jersey","6/17/20","16524","159","34031","0.96"
"Salem","5","723","New Jersey","6/17/20","687","36","34033","5.24"
"Somerset","12","4780","New Jersey","6/17/20","4698","82","34035","1.75"
"Sussex","3","1203","New Jersey","6/17/20","1179","24","34037","2.04"
"Union","0","16315","New Jersey","6/17/20","16317","-2","34039","-0.01"
"Warren","1","1206","New Jersey","6/17/20","1197","9","34041","0.75"
"Bernalillo","18","1752","New Mexico","6/17/20","1623","129","35001","7.95"
"Catron","0","2","New Mexico","6/17/20","2","0","35003","0"
"Chaves","2","61","New Mexico","6/17/20","50","11","35005","22"
"Cibola","2","186","New Mexico","6/17/20","170","16","35006","9.41"
"Colfax","0","8","New Mexico","6/17/20","6","2","35007","33.33"
"Curry","3","92","New Mexico","6/17/20","68","24","35009","35.29"
"Dona Ana","9","676","New Mexico","6/17/20","615","61","35013","9.92"
"Eddy","1","48","New Mexico","6/17/20","42","6","35015","14.29"
"Grant","0","16","New Mexico","6/17/20","15","1","35017","6.67"
"Guadalupe","0","20","New Mexico","6/17/20","20","0","35019","0"
"Harding","0","1","New Mexico","6/17/20","1","0","35021","0"
"Hidalgo","3","23","New Mexico","6/17/20","1","22","35023","2200"
"Lea","3","55","New Mexico","6/17/20","34","21","35025","61.76"
"Lincoln","0","6","New Mexico","6/17/20","5","1","35027","20"
"Los Alamos","0","7","New Mexico","6/17/20","6","1","35028","16.67"
"Luna","3","32","New Mexico","6/17/20","12","20","35029","166.67"
"McKinley","23","2968","New Mexico","6/17/20","2807","161","35031","5.74"
"Otero","0","31","New Mexico","6/17/20","28","3","35035","10.71"
"Quay","0","4","New Mexico","6/17/20","4","0","35037","0"
"Rio Arriba","0","61","New Mexico","6/17/20","59","2","35039","3.39"
"Roosevelt","1","53","New Mexico","6/17/20","46","7","35041","15.22"
"San Juan","15","2140","New Mexico","6/17/20","2034","106","35045","5.21"
"San Miguel","0","16","New Mexico","6/17/20","16","0","35047","0"
"Sandoval","7","651","New Mexico","6/17/20","604","47","35043","7.78"
"Santa Fe","3","182","New Mexico","6/17/20","160","22","35049","13.75"
"Sierra","0","4","New Mexico","6/17/20","3","1","35051","33.33"
"Socorro","0","55","New Mexico","6/17/20","55","0","35053","0"
"Taos","0","33","New Mexico","6/17/20","31","2","35055","6.45"
"Torrance","0","34","New Mexico","6/17/20","35","-1","35057","-2.86"
"Union","0","5","New Mexico","6/17/20","5","0","35059","0"
"Valencia","1","94","New Mexico","6/17/20","84","10","35061","11.9"
"Albany","6","2029","New York","6/17/20","1986","43","36001","2.17"
"Allegany","0","55","New York","6/17/20","52","3","36003","5.77"
"Broome","4","657","New York","6/17/20","630","27","36007","4.29"
"Cattaraugus","2","109","New York","6/17/20","96","13","36009","13.54"
"Cayuga","1","106","New York","6/17/20","102","4","36011","3.92"
"Chautauqua","0","108","New York","6/17/20","105","3","36013","2.86"
"Chemung","0","138","New York","6/17/20","138","0","36015","0"
"Chenango","0","139","New York","6/17/20","137","2","36017","1.46"
"Clinton","0","99","New York","6/17/20","97","2","36019","2.06"
"Columbia","3","442","New York","6/17/20","420","22","36021","5.24"
"Cortland","0","42","New York","6/17/20","42","0","36023","0"
"Delaware","0","89","New York","6/17/20","87","2","36025","2.3"
"Dutchess","8","4077","New York","6/17/20","4022","55","36027","1.37"
"Erie","38","6882","New York","6/17/20","6616","266","36029","4.02"
"Essex","0","40","New York","6/17/20","40","0","36031","0"
"Franklin","0","25","New York","6/17/20","23","2","36033","8.7"
"Fulton","1","236","New York","6/17/20","228","8","36035","3.51"
"Genesee","1","216","New York","6/17/20","211","5","36037","2.37"
"Greene","0","252","New York","6/17/20","249","3","36039","1.2"
"Hamilton","0","6","New York","6/17/20","5","1","36041","20"
"Herkimer","0","128","New York","6/17/20","125","3","36043","2.4"
"Jefferson","0","82","New York","6/17/20","79","3","36045","3.8"
"Lewis","0","21","New York","6/17/20","20","1","36049","5"
"Livingston","0","123","New York","6/17/20","121","2","36051","1.65"
"Madison","1","338","New York","6/17/20","331","7","36053","2.11"
"Monroe","23","3418","New York","6/17/20","3255","163","36055","5.01"
"Montgomery","1","104","New York","6/17/20","100","4","36057","4"
"Nassau","44","41320","New York","6/17/20","41015","305","36059","0.74"
"New York","403","210941","New York","6/17/20","208118","2823","36061","1.36"
"Niagara","7","1177","New York","6/17/20","1129","48","36063","4.25"
"Oneida","15","1307","New York","6/17/20","1203","104","36065","8.65"
"Onondaga","18","2558","New York","6/17/20","2433","125","36067","5.14"
"Ontario","2","234","New York","6/17/20","222","12","36069","5.41"
"Orange","8","10599","New York","6/17/20","10541","58","36071","0.55"
"Orleans","2","270","New York","6/17/20","259","11","36073","4.25"
"Oswego","3","139","New York","6/17/20","115","24","36075","20.87"
"Otsego","1","82","New York","6/17/20","77","5","36077","6.49"
"Putnam","2","1294","New York","6/17/20","1282","12","36079","0.94"
"Rensselaer","1","515","New York","6/17/20","507","8","36083","1.58"
"Rockland","14","13467","New York","6/17/20","13372","95","36087","0.71"
"Saratoga","2","523","New York","6/17/20","511","12","36091","2.35"
"Schenectady","3","737","New York","6/17/20","716","21","36093","2.93"
"Schoharie","0","55","New York","6/17/20","54","1","36095","1.85"
"Schuyler","0","12","New York","6/17/20","12","0","36097","0"
"Seneca","0","64","New York","6/17/20","61","3","36099","4.92"
"St. Lawrence","1","215","New York","6/17/20","209","6","36089","2.87"
"Steuben","1","257","New York","6/17/20","253","4","36101","1.58"
"Suffolk","44","40770","New York","6/17/20","40464","306","36103","0.76"
"Sullivan","1","1433","New York","6/17/20","1425","8","36105","0.56"
"Tioga","1","140","New York","6/17/20","135","5","36107","3.7"
"Tompkins","0","173","New York","6/17/20","171","2","36109","1.17"
"Ulster","3","1744","New York","6/17/20","1726","18","36111","1.04"
"Warren","0","257","New York","6/17/20","257","0","36113","0"
"Washington","0","243","New York","6/17/20","240","3","36115","1.25"
"Wayne","2","137","New York","6/17/20","126","11","36117","8.73"
"Westchester","44","34385","New York","6/17/20","34076","309","36119","0.91"
"Wyoming","0","93","New York","6/17/20","91","2","36121","2.2"
"Yates","0","40","New York","6/17/20","39","1","36123","2.56"
"Alamance","36","827","North Carolina","6/17/20","574","253","37001","44.08"
"Alexander","1","51","North Carolina","6/17/20","43","8","37003","18.6"
"Alleghany","0","30","North Carolina","6/17/20","30","0","37005","0"
"Anson","2","91","North Carolina","6/17/20","78","13","37007","16.67"
"Ashe","0","43","North Carolina","6/17/20","42","1","37009","2.38"
"Avery","0","6","North Carolina","6/17/20","6","0","37011","0"
"Beaufort","1","53","North Carolina","6/17/20","44","9","37013","20.45"
"Bertie","0","135","North Carolina","6/17/20","134","1","37015","0.75"
"Bladen","7","214","North Carolina","6/17/20","165","49","37017","29.7"
"Brunswick","15","268","North Carolina","6/17/20","163","105","37019","64.42"
"Buncombe","8","464","North Carolina","6/17/20","408","56","37021","13.73"
"Burke","18","838","North Carolina","6/17/20","710","128","37023","18.03"
"Cabarrus","22","769","North Carolina","6/17/20","617","152","37025","24.64"
"Caldwell","6","258","North Carolina","6/17/20","219","39","37027","17.81"
"Camden","1","7","North Carolina","6/17/20","3","4","37029","133.33"
"Carteret","1","48","North Carolina","6/17/20","42","6","37031","14.29"
"Caswell","1","106","North Carolina","6/17/20","98","8","37033","8.16"
"Catawba","18","465","North Carolina","6/17/20","338","127","37035","37.57"
"Chatham","10","821","North Carolina","6/17/20","749","72","37037","9.61"
"Cherokee","0","30","North Carolina","6/17/20","30","0","37039","0"
"Chowan","0","19","North Carolina","6/17/20","18","1","37041","5.56"
"Clay","0","9","North Carolina","6/17/20","8","1","37043","12.5"
"Cleveland","8","180","North Carolina","6/17/20","127","53","37045","41.73"
"Columbus","8","432","North Carolina","6/17/20","379","53","37047","13.98"
"Craven","6","280","North Carolina","6/17/20","241","39","37049","16.18"
"Cumberland","18","935","North Carolina","6/17/20","811","124","37051","15.29"
"Currituck","0","16","North Carolina","6/17/20","15","1","37053","6.67"
"Dare","0","27","North Carolina","6/17/20","25","2","37055","8"
"Davidson","19","678","North Carolina","6/17/20","544","134","37057","24.63"
"Davie","3","145","North Carolina","6/17/20","126","19","37059","15.08"
"Duplin","23","1231","North Carolina","6/17/20","1072","159","37061","14.83"
"Durham","80","2841","North Carolina","6/17/20","2284","557","37063","24.39"
"Edgecombe","4","256","North Carolina","6/17/20","231","25","37065","10.82"
"Forsyth","58","2333","North Carolina","6/17/20","1925","408","37067","21.19"
"Franklin","6","237","North Carolina","6/17/20","197","40","37069","20.3"
"Gaston","26","576","North Carolina","6/17/20","392","184","37071","46.94"
"Gates","0","25","North Carolina","6/17/20","24","1","37073","4.17"
"Graham","0","6","North Carolina","6/17/20","6","0","37075","0"
"Granville","13","703","North Carolina","6/17/20","610","93","37077","15.25"
"Greene","3","128","North Carolina","6/17/20","106","22","37079","20.75"
"Guilford","49","2194","North Carolina","6/17/20","1853","341","37081","18.4"
"Halifax","3","241","North Carolina","6/17/20","219","22","37083","10.05"
"Harnett","10","422","North Carolina","6/17/20","352","70","37085","19.89"
"Haywood","1","67","North Carolina","6/17/20","63","4","37087","6.35"
"Henderson","11","464","North Carolina","6/17/20","389","75","37089","19.28"
"Hertford","2","152","North Carolina","6/17/20","140","12","37091","8.57"
"Hoke","3","308","North Carolina","6/17/20","288","20","37093","6.94"
"Hyde","0","3","North Carolina","6/17/20","2","1","37095","50"
"Iredell","16","475","North Carolina","6/17/20","363","112","37097","30.85"
"Jackson","1","61","North Carolina","6/17/20","55","6","37099","10.91"
"Johnston","37","935","North Carolina","6/17/20","677","258","37101","38.11"
"Jones","0","28","North Carolina","6/17/20","28","0","37103","0"
"Lee","7","606","North Carolina","6/17/20","554","52","37105","9.39"
"Lenoir","6","305","North Carolina","6/17/20","261","44","37107","16.86"
"Lincoln","7","157","North Carolina","6/17/20","108","49","37109","45.37"
"Macon","11","237","North Carolina","6/17/20","158","79","37113","50"
"Madison","0","5","North Carolina","6/17/20","4","1","37115","25"
"Martin","3","101","North Carolina","6/17/20","78","23","37117","29.49"
"McDowell","9","168","North Carolina","6/17/20","106","62","37111","58.49"
"Mecklenburg","243","7563","North Carolina","6/17/20","5861","1702","37119","29.04"
"Mitchell","0","19","North Carolina","6/17/20","17","2","37121","11.76"
"Montgomery","7","218","North Carolina","6/17/20","170","48","37123","28.24"
"Moore","8","320","North Carolina","6/17/20","266","54","37125","20.3"
"Nash","8","301","North Carolina","6/17/20","248","53","37127","21.37"
"New Hanover","17","421","North Carolina","6/17/20","304","117","37129","38.49"
"Northampton","0","171","North Carolina","6/17/20","170","1","37131","0.59"
"Onslow","6","178","North Carolina","6/17/20","136","42","37133","30.88"
"Orange","10","487","North Carolina","6/17/20","415","72","37135","17.35"
"Pamlico","0","15","North Carolina","6/17/20","13","2","37137","15.38"
"Pasquotank","4","147","North Carolina","6/17/20","120","27","37139","22.5"
"Pender","4","145","North Carolina","6/17/20","117","28","37141","23.93"
"Perquimans","1","30","North Carolina","6/17/20","26","4","37143","15.38"
"Person","3","83","North Carolina","6/17/20","65","18","37145","27.69"
"Pitt","12","502","North Carolina","6/17/20","416","86","37147","20.67"
"Polk","1","56","North Carolina","6/17/20","51","5","37149","9.8"
"Randolph","15","969","North Carolina","6/17/20","862","107","37151","12.41"
"Richmond","4","215","North Carolina","6/17/20","188","27","37153","14.36"
"Robeson","18","1127","North Carolina","6/17/20","1001","126","37155","12.59"
"Rockingham","4","147","North Carolina","6/17/20","118","29","37157","24.58"
"Rowan","21","937","North Carolina","6/17/20","788","149","37159","18.91"
"Rutherford","4","226","North Carolina","6/17/20","200","26","37161","13"
"Sampson","23","791","North Carolina","6/17/20","627","164","37163","26.16"
"Scotland","2","114","North Carolina","6/17/20","99","15","37165","15.15"
"Stanly","7","174","North Carolina","6/17/20","124","50","37167","40.32"
"Stokes","1","96","North Carolina","6/17/20","89","7","37169","7.87"
"Surry","7","346","North Carolina","6/17/20","294","52","37171","17.69"
"Swain","1","39","North Carolina","6/17/20","32","7","37173","21.88"
"Transylvania","0","17","North Carolina","6/17/20","16","1","37175","6.25"
"Tyrrell","0","5","North Carolina","6/17/20","4","1","37177","25"
"Union","21","764","North Carolina","6/17/20","616","148","37179","24.03"
"Vance","6","421","North Carolina","6/17/20","377","44","37181","11.67"
"Wake","101","3249","North Carolina","6/17/20","2541","708","37183","27.86"
"Warren","3","136","North Carolina","6/17/20","113","23","37185","20.35"
"Washington","0","35","North Carolina","6/17/20","32","3","37187","9.38"
"Watauga","0","44","North Carolina","6/17/20","41","3","37189","7.32"
"Wayne","25","1540","North Carolina","6/17/20","1367","173","37191","12.66"
"Wilkes","5","550","North Carolina","6/17/20","513","37","37193","7.21"
"Wilson","12","540","North Carolina","6/17/20","456","84","37195","18.42"
"Yadkin","4","255","North Carolina","6/17/20","225","30","37197","13.33"
"Yancey","1","31","North Carolina","6/17/20","23","8","37199","34.78"
"Barnes","0","11","North Dakota","6/17/20","9","2","38003","22.22"
"Benson","0","3","North Dakota","6/17/20","3","0","38005","0"
"Bottineau","0","4","North Dakota","6/17/20","4","0","38009","0"
"Bowman","0","1","North Dakota","6/17/20","1","0","38011","0"
"Burke","0","5","North Dakota","6/17/20","5","0","38013","0"
"Burleigh","5","180","North Dakota","6/17/20","147","33","38015","22.45"
"Cass","18","2084","North Dakota","6/17/20","1958","126","38017","6.44"
"Dickey","0","3","North Dakota","6/17/20","1","2","38021","200"
"Divide","0","1","North Dakota","6/17/20","1","0","38023","0"
"Dunn","0","11","North Dakota","6/17/20","11","0","38025","0"
"Eddy","0","5","North Dakota","6/17/20","5","0","38027","0"
"Emmons","0","4","North Dakota","6/17/20","4","0","38029","0"
"Foster","0","1","North Dakota","6/17/20","1","0","38031","0"
"Grand Forks","2","350","North Dakota","6/17/20","339","11","38035","3.24"
"Grant","0","2","North Dakota","6/17/20","2","0","38037","0"
"Griggs","0","1","North Dakota","6/17/20","1","0","38039","0"
"Kidder","0","2","North Dakota","6/17/20","2","0","38043","0"
"LaMoure","1","10","North Dakota","6/17/20","6","4","38045","66.67"
"McHenry","0","2","North Dakota","6/17/20","2","0","38049","0"
"McIntosh","0","1","North Dakota","6/17/20","1","0","38051","0"
"McKenzie","1","22","North Dakota","6/17/20","18","4","38053","22.22"
"McLean","0","11","North Dakota","6/17/20","8","3","38055","37.5"
"Mercer","0","6","North Dakota","6/17/20","6","0","38057","0"
"Morton","1","70","North Dakota","6/17/20","60","10","38059","16.67"
"Mountrail","0","43","North Dakota","6/17/20","43","0","38061","0"
"Nelson","0","1","North Dakota","6/17/20","1","0","38063","0"
"Oliver","0","1","North Dakota","6/17/20","1","0","38065","0"
"Pembina","0","7","North Dakota","6/17/20","6","1","38067","16.67"
"Pierce","0","3","North Dakota","6/17/20","3","0","38069","0"
"Ramsey","0","8","North Dakota","6/17/20","8","0","38071","0"
"Ransom","0","13","North Dakota","6/17/20","11","2","38073","18.18"
"Renville","0","3","North Dakota","6/17/20","3","0","38075","0"
"Richland","1","37","North Dakota","6/17/20","31","6","38077","19.35"
"Rolette","0","7","North Dakota","6/17/20","7","0","38079","0"
"Sargent","0","4","North Dakota","6/17/20","4","0","38081","0"
"Sheridan","0","1","North Dakota","6/17/20","1","0","38083","0"
"Sioux","1","7","North Dakota","6/17/20","2","5","38085","250"
"Slope","0","3","North Dakota","6/17/20","3","0","38087","0"
"Stark","0","63","North Dakota","6/17/20","63","0","38089","0"
"Steele","0","1","North Dakota","6/17/20","1","0","38091","0"
"Stutsman","1","60","North Dakota","6/17/20","51","9","38093","17.65"
"Traill","0","15","North Dakota","6/17/20","14","1","38097","7.14"
"Walsh","0","17","North Dakota","6/17/20","16","1","38099","6.25"
"Ward","1","48","North Dakota","6/17/20","44","4","38101","9.09"
"Wells","0","8","North Dakota","6/17/20","8","0","38103","0"
"Williams","0","26","North Dakota","6/17/20","25","1","38105","4"
"","0","30","Northern Mariana Islands","6/17/20","30","0",,"0"
"Adams","1","17","Ohio","6/17/20","12","5","39001","41.67"
"Allen","2","242","Ohio","6/17/20","229","13","39003","5.68"
"Ashland","1","31","Ohio","6/17/20","26","5","39005","19.23"
"Ashtabula","3","397","Ohio","6/17/20","377","20","39007","5.31"
"Athens","0","24","Ohio","6/17/20","22","2","39009","9.09"
"Auglaize","1","86","Ohio","6/17/20","81","5","39011","6.17"
"Belmont","2","472","Ohio","6/17/20","460","12","39013","2.61"
"Brown","1","39","Ohio","6/17/20","32","7","39015","21.88"
"Butler","12","1129","Ohio","6/17/20","1045","84","39017","8.04"
"Carroll","0","37","Ohio","6/17/20","36","1","39019","2.78"
"Champaign","0","36","Ohio","6/17/20","34","2","39021","5.88"
"Clark","17","502","Ohio","6/17/20","384","118","39023","30.73"
"Clermont","2","252","Ohio","6/17/20","237","15","39025","6.33"
"Clinton","1","54","Ohio","6/17/20","49","5","39027","10.2"
"Columbiana","3","923","Ohio","6/17/20","903","20","39029","2.21"
"Coshocton","1","53","Ohio","6/17/20","48","5","39031","10.42"
"Crawford","0","122","Ohio","6/17/20","121","1","39033","0.83"
"Cuyahoga","46","5336","Ohio","6/17/20","5011","325","39035","6.49"
"Darke","4","223","Ohio","6/17/20","195","28","39037","14.36"
"Defiance","0","40","Ohio","6/17/20","39","1","39039","2.56"
"Delaware","3","403","Ohio","6/17/20","384","19","39041","4.95"
"Erie","3","215","Ohio","6/17/20","191","24","39043","12.57"
"Fairfield","6","387","Ohio","6/17/20","342","45","39045","13.16"
"Fayette","0","45","Ohio","6/17/20","43","2","39047","4.65"
"Franklin","89","7365","Ohio","6/17/20","6741","624","39049","9.26"
"Fulton","0","53","Ohio","6/17/20","52","1","39051","1.92"
"Gallia","0","9","Ohio","6/17/20","9","0","39053","0"
"Geauga","2","344","Ohio","6/17/20","327","17","39055","5.2"
"Greene","4","150","Ohio","6/17/20","122","28","39057","22.95"
"Guernsey","0","44","Ohio","6/17/20","44","0","39059","0"
"Hamilton","57","3374","Ohio","6/17/20","2975","399","39061","13.41"
"Hancock","0","61","Ohio","6/17/20","60","1","39063","1.67"
"Hardin","3","96","Ohio","6/17/20","78","18","39065","23.08"
"Harrison","0","11","Ohio","6/17/20","10","1","39067","10"
"Henry","0","20","Ohio","6/17/20","19","1","39069","5.26"
"Highland","1","35","Ohio","6/17/20","31","4","39071","12.9"
"Hocking","0","73","Ohio","6/17/20","73","0","39073","0"
"Holmes","3","92","Ohio","6/17/20","72","20","39075","27.78"
"Huron","2","81","Ohio","6/17/20","64","17","39077","26.56"
"Jackson","0","16","Ohio","6/17/20","16","0","39079","0"
"Jefferson","0","71","Ohio","6/17/20","69","2","39081","2.9"
"Knox","1","33","Ohio","6/17/20","29","4","39083","13.79"
"Lake","2","354","Ohio","6/17/20","337","17","39085","5.04"
"Lawrence","1","37","Ohio","6/17/20","30","7","39087","23.33"
"Licking","5","321","Ohio","6/17/20","285","36","39089","12.63"
"Logan","0","48","Ohio","6/17/20","46","2","39091","4.35"
"Lorain","7","814","Ohio","6/17/20","762","52","39093","6.82"
"Lucas","10","2462","Ohio","6/17/20","2390","72","39095","3.01"
"Madison","0","169","Ohio","6/17/20","167","2","39097","1.2"
"Mahoning","11","1606","Ohio","6/17/20","1529","77","39099","5.04"
"Marion","2","2712","Ohio","6/17/20","2697","15","39101","0.56"
"Medina","1","402","Ohio","6/17/20","394","8","39103","2.03"
"Meigs","0","8","Ohio","6/17/20","6","2","39105","33.33"
"Mercer","2","253","Ohio","6/17/20","239","14","39107","5.86"
"Miami","2","392","Ohio","6/17/20","379","13","39109","3.43"
"Monroe","0","82","Ohio","6/17/20","83","-1","39111","-1.2"
"Montgomery","30","1058","Ohio","6/17/20","847","211","39113","24.91"
"Morgan","0","6","Ohio","6/17/20","6","0","39115","0"
"Morrow","0","110","Ohio","6/17/20","108","2","39117","1.85"
"Muskingum","1","60","Ohio","6/17/20","55","5","39119","9.09"
"Noble","0","6","Ohio","6/17/20","6","0","39121","0"
"Ottawa","1","118","Ohio","6/17/20","111","7","39123","6.31"
"Paulding","0","17","Ohio","6/17/20","14","3","39125","21.43"
"Perry","0","24","Ohio","6/17/20","21","3","39127","14.29"
"Pickaway","3","2128","Ohio","6/17/20","2110","18","39129","0.85"
"Pike","0","11","Ohio","6/17/20","9","2","39131","22.22"
"Portage","2","359","Ohio","6/17/20","346","13","39133","3.76"
"Preble","1","45","Ohio","6/17/20","40","5","39135","12.5"
"Putnam","0","101","Ohio","6/17/20","99","2","39137","2.02"
"Richland","3","257","Ohio","6/17/20","234","23","39139","9.83"
"Ross","1","81","Ohio","6/17/20","77","4","39141","5.19"
"Sandusky","0","104","Ohio","6/17/20","102","2","39143","1.96"
"Scioto","0","21","Ohio","6/17/20","19","2","39145","10.53"
"Seneca","0","30","Ohio","6/17/20","28","2","39147","7.14"
"Shelby","0","50","Ohio","6/17/20","49","1","39149","2.04"
"Stark","7","891","Ohio","6/17/20","839","52","39151","6.2"
"Summit","13","1712","Ohio","6/17/20","1621","91","39153","5.61"
"Trumbull","8","675","Ohio","6/17/20","620","55","39155","8.87"
"Tuscarawas","2","405","Ohio","6/17/20","389","16","39157","4.11"
"Union","0","63","Ohio","6/17/20","61","2","39159","3.28"
"Van Wert","1","14","Ohio","6/17/20","8","6","39161","75"
"Vinton","0","22","Ohio","6/17/20","21","1","39163","4.76"
"Warren","10","532","Ohio","6/17/20","461","71","39165","15.4"
"Washington","0","118","Ohio","6/17/20","118","0","39167","0"
"Wayne","2","313","Ohio","6/17/20","302","11","39169","3.64"
"Williams","0","59","Ohio","6/17/20","58","1","39171","1.72"
"Wood","2","329","Ohio","6/17/20","312","17","39173","5.45"
"Wyandot","0","50","Ohio","6/17/20","48","2","39175","4.17"
"Adair","0","96","Oklahoma","6/17/20","95","1","40001","1.05"
"Alfalfa","0","1","Oklahoma","6/17/20","1","0","40003","0"
"Atoka","1","9","Oklahoma","6/17/20","5","4","40005","80"
"Beaver","0","30","Oklahoma","6/17/20","27","3","40007","11.11"
"Beckham","0","8","Oklahoma","6/17/20","7","1","40009","14.29"
"Blaine","0","11","Oklahoma","6/17/20","10","1","40011","10"
"Bryan","2","57","Oklahoma","6/17/20","46","11","40013","23.91"
"Caddo","1","178","Oklahoma","6/17/20","174","4","40015","2.3"
"Canadian","3","167","Oklahoma","6/17/20","144","23","40017","15.97"
"Carter","1","60","Oklahoma","6/17/20","55","5","40019","9.09"
"Cherokee","2","52","Oklahoma","6/17/20","37","15","40021","40.54"
"Choctaw","1","106","Oklahoma","6/17/20","101","5","40023","4.95"
"Cimarron","0","1","Oklahoma","6/17/20","1","0","40025","0"
"Cleveland","7","576","Oklahoma","6/17/20","529","47","40027","8.88"
"Coal","0","6","Oklahoma","6/17/20","5","1","40029","20"
"Comanche","4","342","Oklahoma","6/17/20","312","30","40031","9.62"
"Cotton","0","5","Oklahoma","6/17/20","5","0","40033","0"
"Craig","0","16","Oklahoma","6/17/20","16","0","40035","0"
"Creek","1","108","Oklahoma","6/17/20","102","6","40037","5.88"
"Custer","1","42","Oklahoma","6/17/20","37","5","40039","13.51"
"Delaware","1","112","Oklahoma","6/17/20","104","8","40041","7.69"
"Dewey","0","4","Oklahoma","6/17/20","2","2","40043","100"
"Garfield","3","51","Oklahoma","6/17/20","31","20","40047","64.52"
"Garvin","2","33","Oklahoma","6/17/20","20","13","40049","65"
"Grady","1","120","Oklahoma","6/17/20","115","5","40051","4.35"
"Grant","0","2","Oklahoma","6/17/20","2","0","40053","0"
"Greer","0","66","Oklahoma","6/17/20","66","0","40055","0"
"Harmon","0","1","Oklahoma","6/17/20","0","1","40057","1"
"Harper","0","1","Oklahoma","6/17/20","1","0","40059","0"
"Haskell","0","6","Oklahoma","6/17/20","6","0","40061","0"
"Hughes","0","3","Oklahoma","6/17/20","3","0","40063","0"
"Jackson","0","32","Oklahoma","6/17/20","30","2","40065","6.67"
"Jefferson","0","4","Oklahoma","6/17/20","4","0","40067","0"
"Johnston","0","6","Oklahoma","6/17/20","3","3","40069","100"
"Kay","1","70","Oklahoma","6/17/20","60","10","40071","16.67"
"Kingfisher","0","13","Oklahoma","6/17/20","12","1","40073","8.33"
"Kiowa","0","6","Oklahoma","6/17/20","6","0","40075","0"
"Latimer","0","7","Oklahoma","6/17/20","5","2","40077","40"
"Le Flore","1","20","Oklahoma","6/17/20","16","4","40079","25"
"Lincoln","0","24","Oklahoma","6/17/20","22","2","40081","9.09"
"Logan","0","24","Oklahoma","6/17/20","21","3","40083","14.29"
"Love","1","25","Oklahoma","6/17/20","21","4","40085","19.05"
"Major","0","6","Oklahoma","6/17/20","6","0","40093","0"
"Marshall","1","20","Oklahoma","6/17/20","12","8","40095","66.67"
"Mayes","3","59","Oklahoma","6/17/20","37","22","40097","59.46"
"McClain","1","118","Oklahoma","6/17/20","110","8","40087","7.27"
"McCurtain","7","166","Oklahoma","6/17/20","117","49","40089","41.88"
"McIntosh","1","23","Oklahoma","6/17/20","14","9","40091","64.29"
"Murray","1","13","Oklahoma","6/17/20","6","7","40099","116.67"
"Muskogee","1","77","Oklahoma","6/17/20","67","10","40101","14.93"
"Noble","2","20","Oklahoma","6/17/20","7","13","40103","185.71"
"Nowata","0","26","Oklahoma","6/17/20","24","2","40105","8.33"
"Okfuskee","0","6","Oklahoma","6/17/20","6","0","40107","0"
"Oklahoma","45","1754","Oklahoma","6/17/20","1436","318","40109","22.14"
"Okmulgee","0","31","Oklahoma","6/17/20","29","2","40111","6.9"
"Osage","2","116","Oklahoma","6/17/20","103","13","40113","12.62"
"Ottawa","1","42","Oklahoma","6/17/20","35","7","40115","20"
"Pawnee","1","41","Oklahoma","6/17/20","35","6","40117","17.14"
"Payne","14","156","Oklahoma","6/17/20","55","101","40119","183.64"
"Pittsburg","0","44","Oklahoma","6/17/20","44","0","40121","0"
"Pontotoc","0","22","Oklahoma","6/17/20","20","2","40123","10"
"Pottawatomie","2","78","Oklahoma","6/17/20","66","12","40125","18.18"
"Pushmataha","0","7","Oklahoma","6/17/20","6","1","40127","16.67"
"Rogers","1","98","Oklahoma","6/17/20","92","6","40131","6.52"
"Seminole","0","31","Oklahoma","6/17/20","30","1","40133","3.33"
"Sequoyah","0","21","Oklahoma","6/17/20","19","2","40135","10.53"
"Stephens","1","48","Oklahoma","6/17/20","43","5","40137","11.63"
"Texas","3","975","Oklahoma","6/17/20","955","20","40139","2.09"
"Tillman","0","23","Oklahoma","6/17/20","23","0","40141","0"
"Tulsa","74","1825","Oklahoma","6/17/20","1308","517","40143","39.53"
"Wagoner","3","181","Oklahoma","6/17/20","161","20","40145","12.42"
"Washington","2","357","Oklahoma","6/17/20","343","14","40147","4.08"
"Washita","0","3","Oklahoma","6/17/20","2","1","40149","50"
"Woods","0","5","Oklahoma","6/17/20","5","0","40151","0"
"Woodward","0","11","Oklahoma","6/17/20","8","3","40153","37.5"
"Baker","0","1","Oregon","6/17/20","1","0","41001","0"
"Benton","0","66","Oregon","6/17/20","63","3","41003","4.76"
"Clackamas","18","526","Oregon","6/17/20","399","127","41005","31.83"
"Clatsop","0","46","Oregon","6/17/20","45","1","41007","2.22"
"Columbia","1","22","Oregon","6/17/20","17","5","41009","29.41"
"Coos","0","32","Oregon","6/17/20","32","0","41011","0"
"Crook","0","9","Oregon","6/17/20","6","3","41013","50"
"Curry","0","7","Oregon","6/17/20","7","0","41015","0"
"Deschutes","1","139","Oregon","6/17/20","134","5","41017","3.73"
"Douglas","0","29","Oregon","6/17/20","29","0","41019","0"
"Grant","0","1","Oregon","6/17/20","1","0","41023","0"
"Harney","0","1","Oregon","6/17/20","1","0","41025","0"
"Hood River","2","82","Oregon","6/17/20","67","15","41027","22.39"
"Jackson","1","85","Oregon","6/17/20","77","8","41029","10.39"
"Jefferson","1","69","Oregon","6/17/20","64","5","41031","7.81"
"Josephine","0","26","Oregon","6/17/20","23","3","41033","13.04"
"Klamath","3","64","Oregon","6/17/20","46","18","41035","39.13"
"Lake","1","6","Oregon","6/17/20","2","4","41037","200"
"Lane","1","90","Oregon","6/17/20","82","8","41039","9.76"
"Lincoln","9","226","Oregon","6/17/20","161","65","41041","40.37"
"Linn","0","125","Oregon","6/17/20","124","1","41043","0.81"
"Malheur","1","38","Oregon","6/17/20","33","5","41045","15.15"
"Marion","21","1218","Oregon","6/17/20","1071","147","41047","13.73"
"Morrow","1","18","Oregon","6/17/20","13","5","41049","38.46"
"Multnomah","39","1632","Oregon","6/17/20","1361","271","41051","19.91"
"Polk","3","128","Oregon","6/17/20","104","24","41053","23.08"
"Sherman","0","1","Oregon","6/17/20","1","0","41055","0"
"Tillamook","0","6","Oregon","6/17/20","6","0","41057","0"
"Umatilla","6","193","Oregon","6/17/20","148","45","41059","30.41"
"Union","34","242","Oregon","6/17/20","7","235","41061","3357.14"
"Wallowa","0","4","Oregon","6/17/20","3","1","41063","33.33"
"Wasco","1","42","Oregon","6/17/20","34","8","41065","23.53"
"Washington","20","950","Oregon","6/17/20","813","137","41067","16.85"
"Yamhill","1","94","Oregon","6/17/20","85","9","41071","10.59"
"Adams","3","300","Pennsylvania","6/17/20","278","22","42001","7.91"
"Allegheny","11","2113","Pennsylvania","6/17/20","2034","79","42003","3.88"
"Armstrong","0","68","Pennsylvania","6/17/20","65","3","42005","4.62"
"Beaver","1","615","Pennsylvania","6/17/20","610","5","42007","0.82"
"Bedford","2","59","Pennsylvania","6/17/20","45","14","42009","31.11"
"Berks","14","4350","Pennsylvania","6/17/20","4251","99","42011","2.33"
"Blair","0","55","Pennsylvania","6/17/20","53","2","42013","3.77"
"Bradford","0","47","Pennsylvania","6/17/20","46","1","42015","2.17"
"Bucks","18","5466","Pennsylvania","6/17/20","5340","126","42017","2.36"
"Butler","2","263","Pennsylvania","6/17/20","250","13","42019","5.2"
"Cambria","0","61","Pennsylvania","6/17/20","60","1","42021","1.67"
"Cameron","0","2","Pennsylvania","6/17/20","2","0","42023","0"
"Carbon","1","262","Pennsylvania","6/17/20","255","7","42025","2.75"
"Centre","2","172","Pennsylvania","6/17/20","158","14","42027","8.86"
"Chester","29","3367","Pennsylvania","6/17/20","3161","206","42029","6.52"
"Clarion","0","31","Pennsylvania","6/17/20","30","1","42031","3.33"
"Clearfield","1","57","Pennsylvania","6/17/20","48","9","42033","18.75"
"Clinton","0","64","Pennsylvania","6/17/20","62","2","42035","3.23"
"Columbia","3","387","Pennsylvania","6/17/20","368","19","42037","5.16"
"Crawford","1","35","Pennsylvania","6/17/20","31","4","42039","12.9"
"Cumberland","9","751","Pennsylvania","6/17/20","688","63","42041","9.16"
"Dauphin","22","1693","Pennsylvania","6/17/20","1541","152","42043","9.86"
"Delaware","30","6967","Pennsylvania","6/17/20","6754","213","42045","3.15"
"Elk","0","6","Pennsylvania","6/17/20","6","0","42047","0"
"Erie","10","478","Pennsylvania","6/17/20","408","70","42049","17.16"
"Fayette","0","98","Pennsylvania","6/17/20","95","3","42051","3.16"
"Forest","0","7","Pennsylvania","6/17/20","7","0","42053","0"
"Franklin","6","852","Pennsylvania","6/17/20","807","45","42055","5.58"
"Fulton","0","17","Pennsylvania","6/17/20","16","1","42057","6.25"
"Greene","0","30","Pennsylvania","6/17/20","28","2","42059","7.14"
"Huntingdon","0","239","Pennsylvania","6/17/20","237","2","42061","0.84"
"Indiana","0","95","Pennsylvania","6/17/20","92","3","42063","3.26"
"Jefferson","0","19","Pennsylvania","6/17/20","16","3","42065","18.75"
"Juniata","1","108","Pennsylvania","6/17/20","102","6","42067","5.88"
"Lackawanna","3","1611","Pennsylvania","6/17/20","1591","20","42069","1.26"
"Lancaster","33","3830","Pennsylvania","6/17/20","3600","230","42071","6.39"
"Lawrence","0","88","Pennsylvania","6/17/20","87","1","42073","1.15"
"Lebanon","16","1200","Pennsylvania","6/17/20","1091","109","42075","9.99"
"Lehigh","12","3978","Pennsylvania","6/17/20","3895","83","42077","2.13"
"Luzerne","4","2841","Pennsylvania","6/17/20","2810","31","42079","1.1"
"Lycoming","1","172","Pennsylvania","6/17/20","168","4","42081","2.38"
"McKean","0","13","Pennsylvania","6/17/20","13","0","42083","0"
"Mercer","0","117","Pennsylvania","6/17/20","114","3","42085","2.63"
"Mifflin","0","60","Pennsylvania","6/17/20","59","1","42087","1.69"
"Monroe","2","1357","Pennsylvania","6/17/20","1344","13","42089","0.97"
"Montgomery","40","7990","Pennsylvania","6/17/20","7709","281","42091","3.65"
"Montour","2","67","Pennsylvania","6/17/20","53","14","42093","26.42"
"Northampton","9","3255","Pennsylvania","6/17/20","3193","62","42095","1.94"
"Northumberland","3","234","Pennsylvania","6/17/20","211","23","42097","10.9"
"Perry","1","76","Pennsylvania","6/17/20","68","8","42099","11.76"
"Philadelphia","101","24655","Pennsylvania","6/17/20","23951","704","42101","2.94"
"Pike","0","486","Pennsylvania","6/17/20","483","3","42103","0.62"
"Potter","0","13","Pennsylvania","6/17/20","12","1","42105","8.33"
"Schuylkill","5","698","Pennsylvania","6/17/20","664","34","42107","5.12"
"Snyder","0","60","Pennsylvania","6/17/20","59","1","42109","1.69"
"Somerset","0","41","Pennsylvania","6/17/20","39","2","42111","5.13"
"Sullivan","0","3","Pennsylvania","6/17/20","3","0","42113","0"
"Susquehanna","2","172","Pennsylvania","6/17/20","155","17","42115","10.97"
"Tioga","0","20","Pennsylvania","6/17/20","19","1","42117","5.26"
"Union","1","83","Pennsylvania","6/17/20","75","8","42119","10.67"
"Venango","0","17","Pennsylvania","6/17/20","16","1","42121","6.25"
"Warren","0","5","Pennsylvania","6/17/20","5","0","42123","0"
"Washington","1","158","Pennsylvania","6/17/20","151","7","42125","4.64"
"Wayne","0","126","Pennsylvania","6/17/20","123","3","42127","2.44"
"Westmoreland","4","498","Pennsylvania","6/17/20","473","25","42129","5.29"
"Wyoming","0","36","Pennsylvania","6/17/20","36","0","42131","0"
"York","13","1195","Pennsylvania","6/17/20","1102","93","42133","8.44"
"","96","6003","Puerto Rico","6/17/20","5329","674",,"12.65"
"Bristol","1","240","Rhode Island","6/17/20","231","9","44001","3.9"
"Kent","3","1128","Rhode Island","6/17/20","1105","23","44003","2.08"
"Newport","1","277","Rhode Island","6/17/20","269","8","44005","2.97"
"Providence","58","12363","Rhode Island","6/17/20","11959","404","44007","3.38"
"Washington","0","516","Rhode Island","6/17/20","513","3","44009","0.58"
"Abbeville","2","73","South Carolina","6/17/20","60","13","45001","21.67"
"Aiken","4","246","South Carolina","6/17/20","216","30","45003","13.89"
"Allendale","0","41","South Carolina","6/17/20","39","2","45005","5.13"
"Anderson","11","361","South Carolina","6/17/20","287","74","45007","25.78"
"Bamberg","2","50","South Carolina","6/17/20","36","14","45009","38.89"
"Barnwell","0","56","South Carolina","6/17/20","54","2","45011","3.7"
"Beaufort","27","673","South Carolina","6/17/20","483","190","45013","39.34"
"Berkeley","17","434","South Carolina","6/17/20","315","119","45015","37.78"
"Calhoun","3","47","South Carolina","6/17/20","23","24","45017","104.35"
"Charleston","56","1264","South Carolina","6/17/20","869","395","45019","45.45"
"Cherokee","3","96","South Carolina","6/17/20","76","20","45021","26.32"
"Chester","2","127","South Carolina","6/17/20","110","17","45023","15.45"
"Chesterfield","4","295","South Carolina","6/17/20","265","30","45025","11.32"
"Clarendon","5","347","South Carolina","6/17/20","311","36","45027","11.58"
"Colleton","7","211","South Carolina","6/17/20","159","52","45029","32.7"
"Darlington","4","363","South Carolina","6/17/20","334","29","45031","8.68"
"Dillon","2","207","South Carolina","6/17/20","190","17","45033","8.95"
"Dorchester","10","286","South Carolina","6/17/20","214","72","45035","33.64"
"Edgefield","1","61","South Carolina","6/17/20","56","5","45037","8.93"
"Fairfield","2","233","South Carolina","6/17/20","219","14","45039","6.39"
"Florence","18","855","South Carolina","6/17/20","730","125","45041","17.12"
"Georgetown","14","202","South Carolina","6/17/20","103","99","45043","96.12"
"Greenville","110","3143","South Carolina","6/17/20","2371","772","45045","32.56"
"Greenwood","17","320","South Carolina","6/17/20","199","121","45047","60.8"
"Hampton","1","50","South Carolina","6/17/20","45","5","45049","11.11"
"Horry","88","1417","South Carolina","6/17/20","803","614","45051","76.46"
"Jasper","1","57","South Carolina","6/17/20","50","7","45053","14"
"Kershaw","10","469","South Carolina","6/17/20","397","72","45055","18.14"
"Lancaster","7","270","South Carolina","6/17/20","220","50","45057","22.73"
"Laurens","11","179","South Carolina","6/17/20","101","78","45059","77.23"
"Lee","1","238","South Carolina","6/17/20","233","5","45061","2.15"
"Lexington","45","1254","South Carolina","6/17/20","941","313","45063","33.26"
"Marion","4","113","South Carolina","6/17/20","83","30","45067","36.14"
"Marlboro","4","241","South Carolina","6/17/20","215","26","45069","12.09"
"McCormick","0","11","South Carolina","6/17/20","11","0","45065","0"
"Newberry","3","110","South Carolina","6/17/20","88","22","45071","25"
"Oconee","4","95","South Carolina","6/17/20","65","30","45073","46.15"
"Orangeburg","19","417","South Carolina","6/17/20","287","130","45075","45.3"
"Pickens","17","348","South Carolina","6/17/20","226","122","45077","53.98"
"Richland","61","2368","South Carolina","6/17/20","1938","430","45079","22.19"
"Saluda","2","171","South Carolina","6/17/20","154","17","45081","11.04"
"Spartanburg","30","1046","South Carolina","6/17/20","835","211","45083","25.27"
"Sumter","21","655","South Carolina","6/17/20","509","146","45085","28.68"
"Union","1","50","South Carolina","6/17/20","41","9","45087","21.95"
"Williamsburg","6","302","South Carolina","6/17/20","262","40","45089","15.27"
"York","23","699","South Carolina","6/17/20","536","163","45091","30.41"
"Aurora","1","33","South Dakota","6/17/20","29","4","46003","13.79"
"Beadle","10","467","South Dakota","6/17/20","398","69","46005","17.34"
"Bennett","0","2","South Dakota","6/17/20","0","2","46007","1"
"Bon Homme","0","11","South Dakota","6/17/20","8","3","46009","37.5"
"Brookings","2","39","South Dakota","6/17/20","26","13","46011","50"
"Brown","1","315","South Dakota","6/17/20","305","10","46013","3.28"
"Brule","1","12","South Dakota","6/17/20","2","10","46015","500"
"Buffalo","4","55","South Dakota","6/17/20","30","25","46017","83.33"
"Charles Mix","2","37","South Dakota","6/17/20","20","17","46023","85"
"Clark","1","11","South Dakota","6/17/20","6","5","46025","83.33"
"Clay","4","69","South Dakota","6/17/20","43","26","46027","60.47"
"Codington","0","47","South Dakota","6/17/20","44","3","46029","6.82"
"Corson","1","12","South Dakota","6/17/20","6","6","46031","100"
"Custer","0","2","South Dakota","6/17/20","1","1","46033","100"
"Davison","0","33","South Dakota","6/17/20","30","3","46035","10"
"Day","0","13","South Dakota","6/17/20","13","0","46037","0"
"Deuel","0","1","South Dakota","6/17/20","1","0","46039","0"
"Dewey","0","4","South Dakota","6/17/20","1","3","46041","300"
"Douglas","0","4","South Dakota","6/17/20","4","0","46043","0"
"Edmunds","0","4","South Dakota","6/17/20","4","0","46045","0"
"Fall River","0","6","South Dakota","6/17/20","6","0","46047","0"
"Faulk","1","20","South Dakota","6/17/20","15","5","46049","33.33"
"Grant","0","13","South Dakota","6/17/20","13","0","46051","0"
"Gregory","0","1","South Dakota","6/17/20","1","0","46053","0"
"Hamlin","0","11","South Dakota","6/17/20","9","2","46057","22.22"
"Hand","0","6","South Dakota","6/17/20","5","1","46059","20"
"Hanson","0","3","South Dakota","6/17/20","3","0","46061","0"
"Hughes","1","25","South Dakota","6/17/20","21","4","46065","19.05"
"Hutchinson","0","9","South Dakota","6/17/20","8","1","46067","12.5"
"Hyde","0","3","South Dakota","6/17/20","3","0","46069","0"
"Jackson","0","6","South Dakota","6/17/20","4","2","46071","50"
"Jerauld","0","40","South Dakota","6/17/20","40","0","46073","0"
"Kingsbury","0","5","South Dakota","6/17/20","5","0","46077","0"
"Lake","1","17","South Dakota","6/17/20","13","4","46079","30.77"
"Lawrence","0","13","South Dakota","6/17/20","12","1","46081","8.33"
"Lincoln","2","272","South Dakota","6/17/20","258","14","46083","5.43"
"Lyman","1","39","South Dakota","6/17/20","30","9","46085","30"
"Marshall","0","5","South Dakota","6/17/20","4","1","46091","25"
"McCook","0","8","South Dakota","6/17/20","7","1","46087","14.29"
"McPherson","0","3","South Dakota","6/17/20","3","0","46089","0"
"Meade","2","39","South Dakota","6/17/20","28","11","46093","39.29"
"Mellette","0","2","South Dakota","6/17/20","0","2","46095","1"
"Miner","0","3","South Dakota","6/17/20","3","0","46097","0"
"Minnehaha","10","3499","South Dakota","6/17/20","3430","69","46099","2.01"
"Moody","0","20","South Dakota","6/17/20","19","1","46101","5.26"
"Oglala Lakota","1","49","South Dakota","6/17/20","45","4","46102","8.89"
"Pennington","13","424","South Dakota","6/17/20","335","89","46103","26.57"
"Roberts","0","40","South Dakota","6/17/20","39","1","46109","2.56"
"Sanborn","0","13","South Dakota","6/17/20","13","0","46111","0"
"Spink","0","5","South Dakota","6/17/20","5","0","46115","0"
"Stanley","0","11","South Dakota","6/17/20","10","1","46117","10"
"Sully","0","1","South Dakota","6/17/20","1","0","46119","0"
"Todd","1","50","South Dakota","6/17/20","44","6","46121","13.64"
"Tripp","0","9","South Dakota","6/17/20","6","3","46123","50"
"Turner","0","25","South Dakota","6/17/20","25","0","46125","0"
"Union","1","113","South Dakota","6/17/20","105","8","46127","7.62"
"Walworth","0","7","South Dakota","6/17/20","5","2","46129","40"
"Yankton","1","62","South Dakota","6/17/20","58","4","46135","6.9"
"Ziebach","0","2","South Dakota","6/17/20","2","0","46137","0"
"Anderson","2","66","Tennessee","6/17/20","54","12","47001","22.22"
"Bedford","8","403","Tennessee","6/17/20","346","57","47003","16.47"
"Benton","0","8","Tennessee","6/17/20","8","0","47005","0"
"Bledsoe","0","614","Tennessee","6/17/20","613","1","47007","0.16"
"Blount","3","115","Tennessee","6/17/20","96","19","47009","19.79"
"Bradley","9","303","Tennessee","6/17/20","238","65","47011","27.31"
"Campbell","1","25","Tennessee","6/17/20","18","7","47013","38.89"
"Cannon","0","34","Tennessee","6/17/20","34","0","47015","0"
"Carroll","1","36","Tennessee","6/17/20","29","7","47017","24.14"
"Carter","0","22","Tennessee","6/17/20","19","3","47019","15.79"
"Cheatham","1","159","Tennessee","6/17/20","149","10","47021","6.71"
"Chester","0","14","Tennessee","6/17/20","12","2","47023","16.67"
"Claiborne","0","15","Tennessee","6/17/20","15","0","47025","0"
"Clay","0","11","Tennessee","6/17/20","9","2","47027","22.22"
"Cocke","1","27","Tennessee","6/17/20","22","5","47029","22.73"
"Coffee","1","97","Tennessee","6/17/20","87","10","47031","11.49"
"Crockett","0","19","Tennessee","6/17/20","16","3","47033","18.75"
"Cumberland","1","137","Tennessee","6/17/20","127","10","47035","7.87"
"Davidson","127","7082","Tennessee","6/17/20","6190","892","47037","14.41"
"Decatur","0","14","Tennessee","6/17/20","14","0","47039","0"
"DeKalb","0","41","Tennessee","6/17/20","41","0","47041","0"
"Dickson","2","140","Tennessee","6/17/20","128","12","47043","9.38"
"Dyer","6","116","Tennessee","6/17/20","71","45","47045","63.38"
"Fayette","3","186","Tennessee","6/17/20","162","24","47047","14.81"
"Fentress","0","15","Tennessee","6/17/20","13","2","47049","15.38"
"Franklin","1","64","Tennessee","6/17/20","55","9","47051","16.36"
"Gibson","1","69","Tennessee","6/17/20","64","5","47053","7.81"
"Giles","1","23","Tennessee","6/17/20","19","4","47055","21.05"
"Grainger","1","22","Tennessee","6/17/20","16","6","47057","37.5"
"Greene","0","55","Tennessee","6/17/20","52","3","47059","5.77"
"Grundy","1","37","Tennessee","6/17/20","32","5","47061","15.62"
"Hamblen","4","92","Tennessee","6/17/20","63","29","47063","46.03"
"Hamilton","104","1881","Tennessee","6/17/20","1156","725","47065","62.72"
"Hancock","0","1","Tennessee","6/17/20","1","0","47067","0"
"Hardeman","2","226","Tennessee","6/17/20","213","13","47069","6.1"
"Hardin","2","44","Tennessee","6/17/20","31","13","47071","41.94"
"Hawkins","0","37","Tennessee","6/17/20","34","3","47073","8.82"
"Haywood","1","39","Tennessee","6/17/20","35","4","47075","11.43"
"Henderson","0","19","Tennessee","6/17/20","16","3","47077","18.75"
"Henry","0","35","Tennessee","6/17/20","33","2","47079","6.06"
"Hickman","0","62","Tennessee","6/17/20","60","2","47081","3.33"
"Houston","0","10","Tennessee","6/17/20","9","1","47083","11.11"
"Humphreys","0","18","Tennessee","6/17/20","18","0","47085","0"
"Jackson","0","20","Tennessee","6/17/20","19","1","47087","5.26"
"Jefferson","2","48","Tennessee","6/17/20","31","17","47089","54.84"
"Johnson","0","25","Tennessee","6/17/20","23","2","47091","8.7"
"Knox","10","573","Tennessee","6/17/20","500","73","47093","14.6"
"Lake","-6","689","Tennessee","6/17/20","730","-41","47095","-5.62"
"Lauderdale","2","71","Tennessee","6/17/20","60","11","47097","18.33"
"Lawrence","3","72","Tennessee","6/17/20","48","24","47099","50"
"Lewis","0","5","Tennessee","6/17/20","4","1","47101","25"
"Lincoln","2","48","Tennessee","6/17/20","34","14","47103","41.18"
"Loudon","6","214","Tennessee","6/17/20","174","40","47105","22.99"
"Macon","3","209","Tennessee","6/17/20","186","23","47111","12.37"
"Madison","1","188","Tennessee","6/17/20","183","5","47113","2.73"
"Marion","0","49","Tennessee","6/17/20","46","3","47115","6.52"
"Marshall","1","44","Tennessee","6/17/20","40","4","47117","10"
"Maury","7","177","Tennessee","6/17/20","128","49","47119","38.28"
"McMinn","2","170","Tennessee","6/17/20","159","11","47107","6.92"
"McNairy","1","33","Tennessee","6/17/20","24","9","47109","37.5"
"Meigs","0","29","Tennessee","6/17/20","27","2","47121","7.41"
"Monroe","3","93","Tennessee","6/17/20","75","18","47123","24"
"Montgomery","4","341","Tennessee","6/17/20","310","31","47125","10"
"Moore","0","5","Tennessee","6/17/20","5","0","47127","0"
"Morgan","0","21","Tennessee","6/17/20","19","2","47129","10.53"
"Obion","2","67","Tennessee","6/17/20","53","14","47131","26.42"
"Out of TN","1","463","Tennessee","6/17/20","457","6","80047","1.31"
"Overton","0","38","Tennessee","6/17/20","36","2","47133","5.56"
"Perry","1","28","Tennessee","6/17/20","24","4","47135","16.67"
"Pickett","0","4","Tennessee","6/17/20","4","0","47137","0"
"Polk","1","32","Tennessee","6/17/20","24","8","47139","33.33"
"Putnam","6","612","Tennessee","6/17/20","571","41","47141","7.18"
"Rhea","3","243","Tennessee","6/17/20","220","23","47143","10.45"
"Roane","1","32","Tennessee","6/17/20","23","9","47145","39.13"
"Robertson","11","658","Tennessee","6/17/20","584","74","47147","12.67"
"Rutherford","36","1851","Tennessee","6/17/20","1600","251","47149","15.69"
"Scott","0","14","Tennessee","6/17/20","14","0","47151","0"
"Sequatchie","0","23","Tennessee","6/17/20","21","2","47153","9.52"
"Sevier","17","297","Tennessee","6/17/20","178","119","47155","66.85"
"Shelby","140","7183","Tennessee","6/17/20","6204","979","47157","15.78"
"Smith","1","43","Tennessee","6/17/20","37","6","47159","16.22"
"Stewart","0","16","Tennessee","6/17/20","14","2","47161","14.29"
"Sullivan","1","71","Tennessee","6/17/20","67","4","47163","5.97"
"Sumner","12","1119","Tennessee","6/17/20","1033","86","47165","8.33"
"Tipton","7","534","Tennessee","6/17/20","488","46","47167","9.43"
"Trousdale","9","1460","Tennessee","6/17/20","1397","63","47169","4.51"
"Unicoi","0","52","Tennessee","6/17/20","52","0","47171","0"
"Union","1","9","Tennessee","6/17/20","5","4","47173","80"
"Van Buren","0","5","Tennessee","6/17/20","4","1","47175","25"
"Warren","0","35","Tennessee","6/17/20","32","3","47177","9.38"
"Washington","1","93","Tennessee","6/17/20","87","6","47179","6.9"
"Wayne","0","64","Tennessee","6/17/20","64","0","47181","0"
"Weakley","1","35","Tennessee","6/17/20","26","9","47183","34.62"
"White","1","50","Tennessee","6/17/20","45","5","47185","11.11"
"Williamson","11","730","Tennessee","6/17/20","654","76","47187","11.62"
"Wilson","6","544","Tennessee","6/17/20","499","45","47189","9.02"
"Anderson","128","990","Texas","6/17/20","91","899","48001","987.91"
"Andrews","0","30","Texas","6/17/20","27","3","48003","11.11"
"Angelina","10","352","Texas","6/17/20","281","71","48005","25.27"
"Aransas","0","7","Texas","6/17/20","5","2","48007","40"
"Archer","0","3","Texas","6/17/20","3","0","48009","0"
"Armstrong","0","3","Texas","6/17/20","3","0","48011","0"
"Atascosa","0","42","Texas","6/17/20","45","-3","48013","-6.67"
"Austin","1","37","Texas","6/17/20","31","6","48015","19.35"
"Bailey","3","52","Texas","6/17/20","28","24","48017","85.71"
"Bandera","0","7","Texas","6/17/20","6","1","48019","16.67"
"Bastrop","8","338","Texas","6/17/20","279","59","48021","21.15"
"Baylor","0","1","Texas","6/17/20","1","0","48023","0"
"Bee","1","32","Texas","6/17/20","26","6","48025","23.08"
"Bell","24","672","Texas","6/17/20","507","165","48027","32.54"
"Bexar","195","4876","Texas","6/17/20","3513","1363","48029","38.8"
"Blanco","0","12","Texas","6/17/20","12","0","48031","0"
"Bosque","0","7","Texas","6/17/20","7","0","48035","0"
"Bowie","3","381","Texas","6/17/20","358","23","48037","6.42"
"Brazoria","108","1525","Texas","6/17/20","770","755","48039","98.05"
"Brazos","31","880","Texas","6/17/20","665","215","48041","32.33"
"Brewster","2","18","Texas","6/17/20","1","17","48043","1700"
"Briscoe","0","1","Texas","6/17/20","1","0","48045","0"
"Brooks","0","3","Texas","6/17/20","1","2","48047","200"
"Brown","0","61","Texas","6/17/20","60","1","48049","1.67"
"Burleson","1","48","Texas","6/17/20","39","9","48051","23.08"
"Burnet","2","66","Texas","6/17/20","55","11","48053","20"
"Caldwell","13","170","Texas","6/17/20","81","89","48055","109.88"
"Calhoun","1","46","Texas","6/17/20","42","4","48057","9.52"
"Callahan","0","13","Texas","6/17/20","10","3","48059","30"
"Cameron","41","1236","Texas","6/17/20","951","285","48061","29.97"
"Camp","2","109","Texas","6/17/20","95","14","48063","14.74"
"Carson","0","6","Texas","6/17/20","6","0","48065","0"
"Cass","0","35","Texas","6/17/20","32","3","48067","9.38"
"Castro","2","48","Texas","6/17/20","37","11","48069","29.73"
"Chambers","6","128","Texas","6/17/20","86","42","48071","48.84"
"Cherokee","1","61","Texas","6/17/20","54","7","48073","12.96"
"Childress","0","6","Texas","6/17/20","6","0","48075","0"
"Clay","0","5","Texas","6/17/20","5","0","48077","0"
"Cochran","0","1","Texas","6/17/20","1","0","48079","0"
"Coke","0","4","Texas","6/17/20","1","3","48081","300"
"Coleman","0","3","Texas","6/17/20","3","0","48083","0"
"Collin","46","1866","Texas","6/17/20","1546","320","48085","20.7"
"Collingsworth","0","5","Texas","6/17/20","5","0","48087","0"
"Colorado","2","41","Texas","6/17/20","27","14","48089","51.85"
"Comal","9","197","Texas","6/17/20","134","63","48091","47.01"
"Comanche","0","14","Texas","6/17/20","12","2","48093","16.67"
"Concho","0","1","Texas","6/17/20","1","0","48095","0"
"Cooke","1","26","Texas","6/17/20","20","6","48097","30"
"Coryell","1","303","Texas","6/17/20","299","4","48099","1.34"
"Cottle","0","4","Texas","6/17/20","4","0","48101","0"
"Crane","1","39","Texas","6/17/20","31","8","48103","25.81"
"Crockett","0","5","Texas","6/17/20","5","0","48105","0"
"Crosby","1","8","Texas","6/17/20","4","4","48107","100"
"Dallam","1","39","Texas","6/17/20","32","7","48111","21.88"
"Dallas","330","15256","Texas","6/17/20","12945","2311","48113","17.85"
"Dawson","0","45","Texas","6/17/20","45","0","48115","0"
"Deaf Smith","5","223","Texas","6/17/20","190","33","48117","17.37"
"Delta","0","3","Texas","6/17/20","2","1","48119","50"
"Denton","36","1812","Texas","6/17/20","1559","253","48121","16.23"
"DeWitt","1","31","Texas","6/17/20","24","7","48123","29.17"
"Dickens","0","2","Texas","6/17/20","1","1","48125","100"
"Dimmit","0","1","Texas","6/17/20","1","0","48127","0"
"Donley","0","27","Texas","6/17/20","27","0","48129","0"
"Duval","0","5","Texas","6/17/20","5","0","48131","0"
"Eastland","0","7","Texas","6/17/20","7","0","48133","0"
"Ector","9","275","Texas","6/17/20","214","61","48135","28.5"
"El Paso","60","3999","Texas","6/17/20","3582","417","48141","11.64"
"Ellis","7","470","Texas","6/17/20","418","52","48139","12.44"
"Erath","2","41","Texas","6/17/20","29","12","48143","41.38"
"Falls","1","19","Texas","6/17/20","13","6","48145","46.15"
"Fannin","1","59","Texas","6/17/20","50","9","48147","18"
"Fayette","2","52","Texas","6/17/20","39","13","48149","33.33"
"Fisher","0","2","Texas","6/17/20","2","0","48151","0"
"Floyd","0","16","Texas","6/17/20","16","0","48153","0"
"Fort Bend","39","2496","Texas","6/17/20","2225","271","48157","12.18"
"Franklin","1","29","Texas","6/17/20","22","7","48159","31.82"
"Freestone","1","17","Texas","6/17/20","13","4","48161","30.77"
"Frio","4","80","Texas","6/17/20","54","26","48163","48.15"
"Gaines","1","14","Texas","6/17/20","9","5","48165","55.56"
"Galveston","47","1378","Texas","6/17/20","1051","327","48167","31.11"
"Garza","0","7","Texas","6/17/20","7","0","48169","0"
"Gillespie","1","9","Texas","6/17/20","5","4","48171","80"
"Glasscock","0","3","Texas","6/17/20","1","2","48173","200"
"Goliad","0","7","Texas","6/17/20","7","0","48175","0"
"Gonzales","2","172","Texas","6/17/20","155","17","48177","10.97"
"Gray","1","111","Texas","6/17/20","106","5","48179","4.72"
"Grayson","12","473","Texas","6/17/20","389","84","48181","21.59"
"Gregg","3","296","Texas","6/17/20","273","23","48183","8.42"
"Grimes","5","287","Texas","6/17/20","252","35","48185","13.89"
"Guadalupe","5","184","Texas","6/17/20","151","33","48187","21.85"
"Hale","6","110","Texas","6/17/20","67","43","48189","64.18"
"Hall","0","2","Texas","6/17/20","2","0","48191","0"
"Hamilton","1","18","Texas","6/17/20","10","8","48193","80"
"Hansford","0","23","Texas","6/17/20","21","2","48195","9.52"
"Hardeman","0","4","Texas","6/17/20","4","0","48197","0"
"Hardin","2","155","Texas","6/17/20","144","11","48199","7.64"
"Harris","372","18157","Texas","6/17/20","15552","2605","48201","16.75"
"Harrison","1","269","Texas","6/17/20","259","10","48203","3.86"
"Hartley","0","13","Texas","6/17/20","12","1","48205","8.33"
"Haskell","0","4","Texas","6/17/20","3","1","48207","33.33"
"Hays","90","1093","Texas","6/17/20","465","628","48209","135.05"
"Hemphill","0","2","Texas","6/17/20","1","1","48211","100"
"Henderson","2","85","Texas","6/17/20","71","14","48213","19.72"
"Hidalgo","64","1255","Texas","6/17/20","804","451","48215","56.09"
"Hill","2","41","Texas","6/17/20","30","11","48217","36.67"
"Hockley","0","29","Texas","6/17/20","27","2","48219","7.41"
"Hood","1","35","Texas","6/17/20","31","4","48221","12.9"
"Hopkins","1","44","Texas","6/17/20","39","5","48223","12.82"
"Houston","-1","148","Texas","6/17/20","153","-5","48225","-3.27"
"Howard","1","24","Texas","6/17/20","17","7","48227","41.18"
"Hudspeth","0","13","Texas","6/17/20","11","2","48229","18.18"
"Hunt","12","217","Texas","6/17/20","132","85","48231","64.39"
"Hutchinson","0","47","Texas","6/17/20","44","3","48233","6.82"
"Irion","0","1","Texas","6/17/20","1","0","48235","0"
"Jack","0","4","Texas","6/17/20","4","0","48237","0"
"Jackson","0","21","Texas","6/17/20","19","2","48239","10.53"
"Jasper","0","33","Texas","6/17/20","32","1","48241","3.12"
"Jefferson","19","1319","Texas","6/17/20","1184","135","48245","11.4"
"Jim Hogg","0","4","Texas","6/17/20","4","0","48247","0"
"Jim Wells","1","19","Texas","6/17/20","15","4","48249","26.67"
"Johnson","4","244","Texas","6/17/20","214","30","48251","14.02"
"Jones","-3","615","Texas","6/17/20","636","-21","48253","-3.3"
"Karnes","0","7","Texas","6/17/20","4","3","48255","75"
"Kaufman","5","343","Texas","6/17/20","308","35","48257","11.36"
"Kendall","0","36","Texas","6/17/20","35","1","48259","2.86"
"Kerr","0","20","Texas","6/17/20","20","0","48265","0"
"Kimble","0","1","Texas","6/17/20","1","0","48267","0"
"Kinney","0","1","Texas","6/17/20","1","0","48271","0"
"Kleberg","0","20","Texas","6/17/20","20","0","48273","0"
"Knox","0","1","Texas","6/17/20","1","0","48275","0"
"La Salle","0","5","Texas","6/17/20","4","1","48283","25"
"Lamar","3","180","Texas","6/17/20","158","22","48277","13.92"
"Lamb","1","25","Texas","6/17/20","18","7","48279","38.89"
"Lampasas","1","13","Texas","6/17/20","9","4","48281","44.44"
"Lavaca","0","22","Texas","6/17/20","20","2","48285","10"
"Lee","1","39","Texas","6/17/20","29","10","48287","34.48"
"Leon","0","13","Texas","6/17/20","11","2","48289","18.18"
"Liberty","7","156","Texas","6/17/20","110","46","48291","41.82"
"Limestone","1","41","Texas","6/17/20","34","7","48293","20.59"
"Lipscomb","0","9","Texas","6/17/20","7","2","48295","28.57"
"Live Oak","0","10","Texas","6/17/20","9","1","48297","11.11"
"Llano","0","5","Texas","6/17/20","3","2","48299","66.67"
"Lubbock","28","955","Texas","6/17/20","759","196","48303","25.82"
"Lynn","2","21","Texas","6/17/20","10","11","48305","110"
"Madison","1","23","Texas","6/17/20","17","6","48313","35.29"
"Marion","0","21","Texas","6/17/20","18","3","48315","16.67"
"Martin","0","4","Texas","6/17/20","3","1","48317","33.33"
"Mason","0","33","Texas","6/17/20","32","1","48319","3.12"
"Matagorda","2","94","Texas","6/17/20","77","17","48321","22.08"
"Maverick","7","199","Texas","6/17/20","149","50","48323","33.56"
"McCulloch","0","4","Texas","6/17/20","3","1","48307","33.33"
"McLennan","8","196","Texas","6/17/20","138","58","48309","42.03"
"Medina","2","227","Texas","6/17/20","216","11","48325","5.09"
"Midland","6","222","Texas","6/17/20","177","45","48329","25.42"
"Milam","2","48","Texas","6/17/20","37","11","48331","29.73"
"Mills","0","1","Texas","6/17/20","1","0","48333","0"
"Mitchell","0","2","Texas","6/17/20","1","1","48335","100"
"Montague","0","9","Texas","6/17/20","9","0","48337","0"
"Montgomery","38","1428","Texas","6/17/20","1162","266","48339","22.89"
"Moore","1","872","Texas","6/17/20","864","8","48341","0.93"
"Morris","1","31","Texas","6/17/20","27","4","48343","14.81"
"Motley","0","1","Texas","6/17/20","1","0","48345","0"
"Nacogdoches","2","329","Texas","6/17/20","315","14","48347","4.44"
"Navarro","4","98","Texas","6/17/20","70","28","48349","40"
"Newton","0","6","Texas","6/17/20","6","0","48351","0"
"Nolan","0","5","Texas","6/17/20","3","2","48353","66.67"
"Nueces","13","391","Texas","6/17/20","303","88","48355","29.04"
"Ochiltree","0","53","Texas","6/17/20","52","1","48357","1.92"
"Oldham","0","4","Texas","6/17/20","4","0","48359","0"
"Orange","2","118","Texas","6/17/20","102","16","48361","15.69"
"Palo Pinto","0","14","Texas","6/17/20","13","1","48363","7.69"
"Panola","-1","209","Texas","6/17/20","214","-5","48365","-2.34"
"Parker","2","118","Texas","6/17/20","105","13","48367","12.38"
"Parmer","5","132","Texas","6/17/20","98","34","48369","34.69"
"Pecos","1","111","Texas","6/17/20","107","4","48371","3.74"
"Polk","1","72","Texas","6/17/20","62","10","48373","16.13"
"Potter","5","2798","Texas","6/17/20","2766","32","48375","1.16"
"Presidio","1","11","Texas","6/17/20","2","9","48377","450"
"Rains","0","6","Texas","6/17/20","4","2","48379","50"
"Randall","3","763","Texas","6/17/20","740","23","48381","3.11"
"Reagan","0","2","Texas","6/17/20","2","0","48383","0"
"Real","0","1","Texas","6/17/20","1","0","48385","0"
"Red River","2","95","Texas","6/17/20","83","12","48387","14.46"
"Reeves","0","14","Texas","6/17/20","11","3","48389","27.27"
"Refugio","0","6","Texas","6/17/20","5","1","48391","20"
"Roberts","0","2","Texas","6/17/20","2","0","48393","0"
"Robertson","0","18","Texas","6/17/20","17","1","48395","5.88"
"Rockwall","3","247","Texas","6/17/20","224","23","48397","10.27"
"Runnels","0","2","Texas","6/17/20","2","0","48399","0"
"Rusk","24","233","Texas","6/17/20","65","168","48401","258.46"
"Sabine","0","15","Texas","6/17/20","15","0","48403","0"
"San Augustine","4","74","Texas","6/17/20","49","25","48405","51.02"
"San Jacinto","0","22","Texas","6/17/20","19","3","48407","15.79"
"San Patricio","2","58","Texas","6/17/20","41","17","48409","41.46"
"San Saba","0","2","Texas","6/17/20","1","1","48411","100"
"Schleicher","1","8","Texas","6/17/20","0","8","48413","1"
"Scurry","0","28","Texas","6/17/20","26","2","48415","7.69"
"Shackelford","0","1","Texas","6/17/20","1","0","48417","0"
"Shelby","2","230","Texas","6/17/20","215","15","48419","6.98"
"Sherman","0","28","Texas","6/17/20","28","0","48421","0"
"Smith","8","297","Texas","6/17/20","238","59","48423","24.79"
"Somervell","0","3","Texas","6/17/20","1","2","48425","200"
"Starr","14","166","Texas","6/17/20","68","98","48427","144.12"
"Stephens","0","5","Texas","6/17/20","4","1","48429","25"
"Swisher","1","23","Texas","6/17/20","18","5","48437","27.78"
"Tarrant","175","7822","Texas","6/17/20","6599","1223","48439","18.53"
"Taylor","2","259","Texas","6/17/20","248","11","48441","4.44"
"Terry","0","13","Texas","6/17/20","13","0","48445","0"
"Throckmorton","0","1","Texas","6/17/20","1","0","48447","0"
"Titus","12","719","Texas","6/17/20","637","82","48449","12.87"
"Tom Green","6","164","Texas","6/17/20","122","42","48451","34.43"
"Travis","114","4771","Texas","6/17/20","3976","795","48453","19.99"
"Trinity","0","20","Texas","6/17/20","22","-2","48455","-9.09"
"Tyler","0","14","Texas","6/17/20","16","-2","48457","-12.5"
"Upshur","1","42","Texas","6/17/20","35","7","48459","20"
"Upton","0","1","Texas","6/17/20","0","1","48461","1"
"Uvalde","1","29","Texas","6/17/20","21","8","48463","38.1"
"Val Verde","1","36","Texas","6/17/20","27","9","48465","33.33"
"Van Zandt","2","53","Texas","6/17/20","41","12","48467","29.27"
"Victoria","4","207","Texas","6/17/20","180","27","48469","15"
"Walker","4","1879","Texas","6/17/20","1854","25","48471","1.35"
"Waller","2","99","Texas","6/17/20","85","14","48473","16.47"
"Ward","1","7","Texas","6/17/20","2","5","48475","250"
"Washington","1","219","Texas","6/17/20","213","6","48477","2.82"
"Webb","17","756","Texas","6/17/20","634","122","48479","19.24"
"Wharton","2","98","Texas","6/17/20","86","12","48481","13.95"
"Wheeler","0","16","Texas","6/17/20","15","1","48483","6.67"
"Wichita","4","120","Texas","6/17/20","90","30","48485","33.33"
"Wilbarger","0","7","Texas","6/17/20","7","0","48487","0"
"Willacy","3","65","Texas","6/17/20","45","20","48489","44.44"
"Williamson","44","1068","Texas","6/17/20","763","305","48491","39.97"
"Wilson","1","53","Texas","6/17/20","46","7","48493","15.22"
"Winkler","0","4","Texas","6/17/20","3","1","48495","33.33"
"Wise","0","58","Texas","6/17/20","55","3","48497","5.45"
"Wood","2","62","Texas","6/17/20","51","11","48499","21.57"
"Yoakum","0","10","Texas","6/17/20","8","2","48501","25"
"Young","1","15","Texas","6/17/20","11","4","48503","36.36"
"Zapata","2","24","Texas","6/17/20","12","12","48505","100"
"Zavala","0","13","Texas","6/17/20","12","1","48507","8.33"
"Bear River","37","1096","Utah","6/17/20","837","259","00000","30.94"
"Central Utah","4","81","Utah","6/17/20","50","31","00000","62"
"Davis","17","715","Utah","6/17/20","593","122","49011","20.57"
"Salt Lake","174","7809","Utah","6/17/20","6591","1218","49035","18.48"
"San Juan","4","367","Utah","6/17/20","339","28","49037","8.26"
"Southeast Utah","0","29","Utah","6/17/20","28","1","00000","3.57"
"Southwest Utah","30","889","Utah","6/17/20","680","209","00000","30.74"
"Summit","1","451","Utah","6/17/20","443","8","49043","1.81"
"Tooele","4","181","Utah","6/17/20","153","28","49045","18.3"
"TriCounty","1","33","Utah","6/17/20","23","10","00000","43.48"
"Utah","57","2776","Utah","6/17/20","2376","400","49049","16.84"
"Wasatch","4","362","Utah","6/17/20","337","25","49051","7.42"
"Weber-Morgan","20","555","Utah","6/17/20","414","141","00000","34.06"
"Addison","0","66","Vermont","6/17/20","66","0","50001","0"
"Bennington","0","67","Vermont","6/17/20","67","0","50003","0"
"Caledonia","0","16","Vermont","6/17/20","16","0","50005","0"
"Chittenden","4","572","Vermont","6/17/20","544","28","50007","5.15"
"Essex","0","3","Vermont","6/17/20","3","0","50009","0"
"Franklin","0","102","Vermont","6/17/20","101","1","50011","0.99"
"Grand Isle","0","8","Vermont","6/17/20","7","1","50013","14.29"
"Lamoille","0","29","Vermont","6/17/20","29","0","50015","0"
"Orange","0","9","Vermont","6/17/20","9","0","50017","0"
"Orleans","0","13","Vermont","6/17/20","13","0","50019","0"
"Rutland","0","59","Vermont","6/17/20","57","2","50021","3.51"
"Washington","0","41","Vermont","6/17/20","39","2","50023","5.13"
"Windham","0","85","Vermont","6/17/20","83","2","50025","2.41"
"Windsor","0","55","Vermont","6/17/20","56","-1","50027","-1.79"
"","0","73","Virgin Islands","6/17/20","72","1",,"1.39"
"Accomack","5","1018","Virginia","6/17/20","984","34","51001","3.46"
"Albemarle","5","293","Virginia","6/17/20","260","33","51003","12.69"
"Alexandria","7","2175","Virginia","6/17/20","2125","50","51510","2.35"
"Alleghany","1","30","Virginia","6/17/20","26","4","51005","15.38"
"Amelia","1","38","Virginia","6/17/20","34","4","51007","11.76"
"Amherst","0","28","Virginia","6/17/20","27","1","51009","3.7"
"Appomattox","0","34","Virginia","6/17/20","33","1","51011","3.03"
"Arlington","13","2372","Virginia","6/17/20","2280","92","51013","4.04"
"Augusta","3","157","Virginia","6/17/20","139","18","51015","12.95"
"Bedford","2","96","Virginia","6/17/20","83","13","51019","15.66"
"Botetourt","2","51","Virginia","6/17/20","40","11","51023","27.5"
"Bristol","0","4","Virginia","6/17/20","4","0","51520","0"
"Brunswick","2","59","Virginia","6/17/20","43","16","51025","37.21"
"Buchanan","0","18","Virginia","6/17/20","18","0","51027","0"
"Buckingham","6","542","Virginia","6/17/20","497","45","51029","9.05"
"Buena Vista","0","12","Virginia","6/17/20","13","-1","51530","-7.69"
"Campbell","1","28","Virginia","6/17/20","22","6","51031","27.27"
"Caroline","2","116","Virginia","6/17/20","99","17","51033","17.17"
"Carroll","3","177","Virginia","6/17/20","153","24","51035","15.69"
"Charles City","1","34","Virginia","6/17/20","28","6","51036","21.43"
"Charlotte","0","30","Virginia","6/17/20","29","1","51037","3.45"
"Charlottesville","3","161","Virginia","6/17/20","142","19","51540","13.38"
"Chesapeake","10","684","Virginia","6/17/20","617","67","51550","10.86"
"Chesterfield","46","2316","Virginia","6/17/20","1995","321","51041","16.09"
"Clarke","1","40","Virginia","6/17/20","35","5","51043","14.29"
"Colonial Heights","2","117","Virginia","6/17/20","106","11","51570","10.38"
"Covington","0","4","Virginia","6/17/20","4","0","51580","0"
"Craig","0","6","Virginia","6/17/20","6","0","51045","0"
"Culpeper","2","790","Virginia","6/17/20","773","17","51047","2.2"
"Cumberland","1","50","Virginia","6/17/20","45","5","51049","11.11"
"Danville","1","66","Virginia","6/17/20","61","5","51590","8.2"
"Dickenson","0","1","Virginia","6/17/20","0","1","51051","1"
"Dinwiddie","2","113","Virginia","6/17/20","101","12","51053","11.88"
"Emporia","2","106","Virginia","6/17/20","93","13","51595","13.98"
"Essex","0","53","Virginia","6/17/20","53","0","51057","0"
"Fairfax","58","13153","Virginia","6/17/20","12746","407","51059","3.19"
"Fairfax City","0","68","Virginia","6/17/20","69","-1","51600","-1.45"
"Falls Church","0","58","Virginia","6/17/20","56","2","51610","3.57"
"Fauquier","4","398","Virginia","6/17/20","370","28","51061","7.57"
"Floyd","0","10","Virginia","6/17/20","8","2","51063","25"
"Fluvanna","1","103","Virginia","6/17/20","98","5","51065","5.1"
"Franklin","1","46","Virginia","6/17/20","41","5","51067","12.2"
"Franklin City","0","44","Virginia","6/17/20","42","2","51620","4.76"
"Frederick","4","440","Virginia","6/17/20","415","25","51069","6.02"
"Fredericksburg","3","215","Virginia","6/17/20","194","21","51630","10.82"
"Galax","8","208","Virginia","6/17/20","154","54","51640","35.06"
"Giles","0","6","Virginia","6/17/20","5","1","51071","20"
"Gloucester","1","38","Virginia","6/17/20","33","5","51073","15.15"
"Goochland","1","116","Virginia","6/17/20","106","10","51075","9.43"
"Grayson","1","68","Virginia","6/17/20","60","8","51077","13.33"
"Greene","0","46","Virginia","6/17/20","44","2","51079","4.55"
"Greensville","6","343","Virginia","6/17/20","300","43","51081","14.33"
"Halifax","1","39","Virginia","6/17/20","32","7","51083","21.88"
"Hampton","2","248","Virginia","6/17/20","231","17","51650","7.36"
"Hanover","3","378","Virginia","6/17/20","354","24","51085","6.78"
"Harrisonburg","3","864","Virginia","6/17/20","842","22","51660","2.61"
"Henrico","24","2332","Virginia","6/17/20","2162","170","51087","7.86"
"Henry","4","212","Virginia","6/17/20","182","30","51089","16.48"
"Highland","0","3","Virginia","6/17/20","2","1","51091","50"
"Hopewell","4","149","Virginia","6/17/20","120","29","51670","24.17"
"Isle of Wight","1","158","Virginia","6/17/20","150","8","51093","5.33"
"James City","2","236","Virginia","6/17/20","224","12","51095","5.36"
"King and Queen","0","24","Virginia","6/17/20","24","0","51097","0"
"King George","1","93","Virginia","6/17/20","83","10","51099","12.05"
"King William","0","33","Virginia","6/17/20","32","1","51101","3.12"
"Lancaster","0","11","Virginia","6/17/20","10","1","51103","10"
"Lee","0","9","Virginia","6/17/20","9","0","51105","0"
"Lexington","0","8","Virginia","6/17/20","8","0","51678","0"
"Loudoun","40","3458","Virginia","6/17/20","3180","278","51107","8.74"
"Louisa","1","101","Virginia","6/17/20","94","7","51109","7.45"
"Lunenburg","0","21","Virginia","6/17/20","18","3","51111","16.67"
"Lynchburg","1","96","Virginia","6/17/20","89","7","51680","7.87"
"Madison","0","42","Virginia","6/17/20","41","1","51113","2.44"
"Manassas","8","1320","Virginia","6/17/20","1262","58","51683","4.6"
"Manassas Park","4","390","Virginia","6/17/20","360","30","51685","8.33"
"Martinsville","1","58","Virginia","6/17/20","52","6","51690","11.54"
"Mathews","0","5","Virginia","6/17/20","5","0","51115","0"
"Mecklenburg","1","231","Virginia","6/17/20","224","7","51117","3.12"
"Middlesex","0","14","Virginia","6/17/20","14","0","51119","0"
"Montgomery","0","97","Virginia","6/17/20","96","1","51121","1.04"
"Nelson","0","18","Virginia","6/17/20","17","1","51125","5.88"
"New Kent","0","47","Virginia","6/17/20","45","2","51127","4.44"
"Newport News","10","399","Virginia","6/17/20","328","71","51700","21.65"
"Norfolk","13","698","Virginia","6/17/20","605","93","51710","15.37"
"Northampton","1","265","Virginia","6/17/20","257","8","51131","3.11"
"Northumberland","0","27","Virginia","6/17/20","25","2","51133","8"
"Norton","0","2","Virginia","6/17/20","2","0","51720","0"
"Nottoway","2","68","Virginia","6/17/20","51","17","51135","33.33"
"Orange","2","135","Virginia","6/17/20","119","16","51137","13.45"
"Page","1","256","Virginia","6/17/20","247","9","51139","3.64"
"Patrick","1","33","Virginia","6/17/20","28","5","51141","17.86"
"Petersburg","3","194","Virginia","6/17/20","174","20","51730","11.49"
"Pittsylvania","3","73","Virginia","6/17/20","54","19","51143","35.19"
"Poquoson","0","12","Virginia","6/17/20","9","3","51735","33.33"
"Portsmouth","6","395","Virginia","6/17/20","354","41","51740","11.58"
"Powhatan","1","54","Virginia","6/17/20","48","6","51145","12.5"
"Prince Edward","3","171","Virginia","6/17/20","153","18","51147","11.76"
"Prince George","2","169","Virginia","6/17/20","153","16","51149","10.46"
"Prince William","40","6654","Virginia","6/17/20","6376","278","51153","4.36"
"Pulaski","0","30","Virginia","6/17/20","30","0","51155","0"
"Radford","0","9","Virginia","6/17/20","7","2","51750","28.57"
"Rappahannock","0","17","Virginia","6/17/20","16","1","51157","6.25"
"Richmond","1","294","Virginia","6/17/20","290","4","51159","1.38"
"Richmond City","27","1872","Virginia","6/17/20","1686","186","51760","11.03"
"Roanoke","3","148","Virginia","6/17/20","125","23","51161","18.4"
"Roanoke City","10","277","Virginia","6/17/20","207","70","51770","33.82"
"Rockbridge","0","18","Virginia","6/17/20","19","-1","51163","-5.26"
"Rockingham","5","636","Virginia","6/17/20","602","34","51165","5.65"
"Russell","0","9","Virginia","6/17/20","8","1","51167","12.5"
"Salem","1","48","Virginia","6/17/20","42","6","51775","14.29"
"Scott","0","8","Virginia","6/17/20","7","1","51169","14.29"
"Shenandoah","4","522","Virginia","6/17/20","492","30","51171","6.1"
"Smyth","2","26","Virginia","6/17/20","15","11","51173","73.33"
"Southampton","0","154","Virginia","6/17/20","154","0","51175","0"
"Spotsylvania","19","858","Virginia","6/17/20","723","135","51177","18.67"
"Stafford","11","906","Virginia","6/17/20","831","75","51179","9.03"
"Staunton","0","61","Virginia","6/17/20","58","3","51790","5.17"
"Suffolk","3","348","Virginia","6/17/20","330","18","51800","5.45"
"Surry","0","13","Virginia","6/17/20","10","3","51181","30"
"Sussex","1","184","Virginia","6/17/20","175","9","51183","5.14"
"Tazewell","0","9","Virginia","6/17/20","9","0","51185","0"
"Virginia Beach","14","923","Virginia","6/17/20","823","100","51810","12.15"
"Warren","1","233","Virginia","6/17/20","225","8","51187","3.56"
"Washington","0","58","Virginia","6/17/20","58","0","51191","0"
"Waynesboro","1","58","Virginia","6/17/20","51","7","51820","13.73"
"Westmoreland","1","87","Virginia","6/17/20","83","4","51193","4.82"
"Williamsburg","1","54","Virginia","6/17/20","48","6","51830","12.5"
"Winchester","4","273","Virginia","6/17/20","248","25","51840","10.08"
"Wise","0","27","Virginia","6/17/20","27","0","51195","0"
"Wythe","1","42","Virginia","6/17/20","38","4","51197","10.53"
"York","1","94","Virginia","6/17/20","86","8","51199","9.3"
"Adams","3","101","Washington","6/17/20","80","21","53001","26.25"
"Asotin","0","20","Washington","6/17/20","19","1","53003","5.26"
"Benton","37","1236","Washington","6/17/20","979","257","53005","26.25"
"Chelan","2","276","Washington","6/17/20","264","12","53007","4.55"
"Clallam","1","32","Washington","6/17/20","27","5","53009","18.52"
"Clark","8","630","Washington","6/17/20","571","59","53011","10.33"
"Columbia","0","1","Washington","6/17/20","1","0","53013","0"
"Cowlitz","4","120","Washington","6/17/20","89","31","53015","34.83"
"Douglas","1","184","Washington","6/17/20","178","6","53017","3.37"
"Ferry","0","1","Washington","6/17/20","1","0","53019","0"
"Franklin","40","1044","Washington","6/17/20","764","280","53021","36.65"
"Grant","13","310","Washington","6/17/20","222","88","53025","39.64"
"Grays Harbor","0","21","Washington","6/17/20","19","2","53027","10.53"
"Island","0","184","Washington","6/17/20","181","3","53029","1.66"
"Jefferson","0","32","Washington","6/17/20","31","1","53031","3.23"
"King","51","8885","Washington","6/17/20","8529","356","53033","4.17"
"Kitsap","1","180","Washington","6/17/20","170","10","53035","5.88"
"Kittitas","0","92","Washington","6/17/20","90","2","53037","2.22"
"Klickitat","2","49","Washington","6/17/20","37","12","53039","32.43"
"Lewis","1","41","Washington","6/17/20","37","4","53041","10.81"
"Lincoln","0","2","Washington","6/17/20","2","0","53043","0"
"Mason","0","41","Washington","6/17/20","39","2","53045","5.13"
"Okanogan","1","61","Washington","6/17/20","56","5","53047","8.93"
"Pacific","0","12","Washington","6/17/20","10","2","53049","20"
"Pend Oreille","0","3","Washington","6/17/20","3","0","53051","0"
"Pierce","18","2179","Washington","6/17/20","2050","129","53053","6.29"
"San Juan","0","16","Washington","6/17/20","15","1","53055","6.67"
"Skagit","3","469","Washington","6/17/20","450","19","53057","4.22"
"Skamania","0","3","Washington","6/17/20","3","0","53059","0"
"Snohomish","18","3187","Washington","6/17/20","3064","123","53061","4.01"
"Spokane","14","870","Washington","6/17/20","769","101","53063","13.13"
"Stevens","0","16","Washington","6/17/20","13","3","53065","23.08"
"Thurston","4","197","Washington","6/17/20","171","26","53067","15.2"
"Wahkiakum","0","4","Washington","6/17/20","4","0","53069","0"
"Walla Walla","1","124","Washington","6/17/20","117","7","53071","5.98"
"Whatcom","5","457","Washington","6/17/20","420","37","53073","8.81"
"Whitman","1","28","Washington","6/17/20","20","8","53075","40"
"Yakima","117","5651","Washington","6/17/20","4834","817","53077","16.9"
"Barbour","0","11","West Virginia","6/17/20","9","2","54001","22.22"
"Berkeley","7","407","West Virginia","6/17/20","361","46","54003","12.74"
"Boone","1","20","West Virginia","6/17/20","15","5","54005","33.33"
"Braxton","0","3","West Virginia","6/17/20","2","1","54007","50"
"Brooke","0","6","West Virginia","6/17/20","5","1","54009","20"
"Cabell","1","77","West Virginia","6/17/20","71","6","54011","8.45"
"Calhoun","0","2","West Virginia","6/17/20","2","0","54013","0"
"Clay","0","10","West Virginia","6/17/20","7","3","54015","42.86"
"Fayette","0","54","West Virginia","6/17/20","54","0","54019","0"
"Gilmer","0","10","West Virginia","6/17/20","10","0","54021","0"
"Grant","0","16","West Virginia","6/17/20","14","2","54023","14.29"
"Greenbrier","4","37","West Virginia","6/17/20","9","28","54025","311.11"
"Hampshire","1","40","West Virginia","6/17/20","35","5","54027","14.29"
"Hancock","0","20","West Virginia","6/17/20","20","0","54029","0"
"Hardy","0","41","West Virginia","6/17/20","40","1","54031","2.5"
"Harrison","1","49","West Virginia","6/17/20","41","8","54033","19.51"
"Jackson","0","141","West Virginia","6/17/20","141","0","54035","0"
"Jefferson","1","213","West Virginia","6/17/20","204","9","54037","4.41"
"Kanawha","2","253","West Virginia","6/17/20","241","12","54039","4.98"
"Lewis","0","8","West Virginia","6/17/20","8","0","54041","0"
"Lincoln","0","5","West Virginia","6/17/20","5","0","54043","0"
"Logan","0","21","West Virginia","6/17/20","20","1","54045","5"
"Marion","0","53","West Virginia","6/17/20","53","0","54049","0"
"Marshall","1","38","West Virginia","6/17/20","34","4","54051","11.76"
"Mason","0","15","West Virginia","6/17/20","15","0","54053","0"
"McDowell","0","6","West Virginia","6/17/20","6","0","54047","0"
"Mercer","0","15","West Virginia","6/17/20","13","2","54055","15.38"
"Mineral","0","52","West Virginia","6/17/20","51","1","54057","1.96"
"Mingo","0","12","West Virginia","6/17/20","10","2","54059","20"
"Monongalia","1","147","West Virginia","6/17/20","142","5","54061","3.52"
"Monroe","0","9","West Virginia","6/17/20","8","1","54063","12.5"
"Morgan","0","19","West Virginia","6/17/20","19","0","54065","0"
"Nicholas","0","7","West Virginia","6/17/20","7","0","54067","0"
"Ohio","1","58","West Virginia","6/17/20","52","6","54069","11.54"
"Pendleton","0","13","West Virginia","6/17/20","13","0","54071","0"
"Pleasants","0","4","West Virginia","6/17/20","4","0","54073","0"
"Pocahontas","0","21","West Virginia","6/17/20","21","0","54075","0"
"Preston","1","29","West Virginia","6/17/20","24","5","54077","20.83"
"Putnam","0","40","West Virginia","6/17/20","41","-1","54079","-2.44"
"Raleigh","1","27","West Virginia","6/17/20","18","9","54081","50"
"Randolph","1","144","West Virginia","6/17/20","140","4","54083","2.86"
"Ritchie","0","2","West Virginia","6/17/20","2","0","54085","0"
"Roane","0","11","West Virginia","6/17/20","10","1","54087","10"
"Summers","0","1","West Virginia","6/17/20","1","0","54089","0"
"Taylor","0","12","West Virginia","6/17/20","9","3","54091","33.33"
"Tucker","0","5","West Virginia","6/17/20","4","1","54093","25"
"Tyler","0","3","West Virginia","6/17/20","3","0","54095","0"
"Upshur","0","9","West Virginia","6/17/20","7","2","54097","28.57"
"Wayne","0","106","West Virginia","6/17/20","103","3","54099","2.91"
"Wetzel","0","9","West Virginia","6/17/20","9","0","54103","0"
"Wirt","0","4","West Virginia","6/17/20","4","0","54105","0"
"Wood","0","56","West Virginia","6/17/20","54","2","54107","3.7"
"Wyoming","0","5","West Virginia","6/17/20","3","2","54109","66.67"
"Adams","0","9","Wisconsin","6/17/20","6","3","55001","50"
"Ashland","0","3","Wisconsin","6/17/20","3","0","55003","0"
"Barron","1","26","Wisconsin","6/17/20","21","5","55005","23.81"
"Bayfield","0","3","Wisconsin","6/17/20","3","0","55007","0"
"Brown","15","2507","Wisconsin","6/17/20","2405","102","55009","4.24"
"Buffalo","0","7","Wisconsin","6/17/20","6","1","55011","16.67"
"Burnett","0","3","Wisconsin","6/17/20","1","2","55013","200"
"Calumet","1","88","Wisconsin","6/17/20","81","7","55015","8.64"
"Chippewa","0","63","Wisconsin","6/17/20","60","3","55017","5"
"Clark","1","53","Wisconsin","6/17/20","45","8","55019","17.78"
"Columbia","1","59","Wisconsin","6/17/20","49","10","55021","20.41"
"Crawford","0","27","Wisconsin","6/17/20","26","1","55023","3.85"
"Dane","17","1000","Wisconsin","6/17/20","884","116","55025","13.12"
"Dodge","2","425","Wisconsin","6/17/20","410","15","55027","3.66"
"Door","0","39","Wisconsin","6/17/20","39","0","55029","0"
"Douglas","0","20","Wisconsin","6/17/20","20","0","55031","0"
"Dunn","0","29","Wisconsin","6/17/20","29","0","55033","0"
"Eau Claire","2","140","Wisconsin","6/17/20","126","14","55035","11.11"
"Florence","0","2","Wisconsin","6/17/20","2","0","55037","0"
"Fond du Lac","4","274","Wisconsin","6/17/20","247","27","55039","10.93"
"Forest","0","34","Wisconsin","6/17/20","34","0","55041","0"
"Grant","2","113","Wisconsin","6/17/20","99","14","55043","14.14"
"Green","1","78","Wisconsin","6/17/20","71","7","55045","9.86"
"Green Lake","0","24","Wisconsin","6/17/20","23","1","55047","4.35"
"Iowa","0","18","Wisconsin","6/17/20","16","2","55049","12.5"
"Iron","0","2","Wisconsin","6/17/20","2","0","55051","0"
"Jackson","0","22","Wisconsin","6/17/20","20","2","55053","10"
"Jefferson","3","161","Wisconsin","6/17/20","138","23","55055","16.67"
"Juneau","0","25","Wisconsin","6/17/20","23","2","55057","8.7"
"Kenosha","11","1382","Wisconsin","6/17/20","1308","74","55059","5.66"
"Kewaunee","0","39","Wisconsin","6/17/20","37","2","55061","5.41"
"La Crosse","10","152","Wisconsin","6/17/20","81","71","55063","87.65"
"Lafayette","1","43","Wisconsin","6/17/20","36","7","55065","19.44"
"Langlade","0","6","Wisconsin","6/17/20","5","1","55067","20"
"Lincoln","0","8","Wisconsin","6/17/20","7","1","55069","14.29"
"Manitowoc","1","50","Wisconsin","6/17/20","40","10","55071","25"
"Marathon","3","88","Wisconsin","6/17/20","69","19","55073","27.54"
"Marinette","0","40","Wisconsin","6/17/20","37","3","55075","8.11"
"Marquette","0","9","Wisconsin","6/17/20","7","2","55077","28.57"
"Menominee","0","4","Wisconsin","6/17/20","3","1","55078","33.33"
"Milwaukee","93","9750","Wisconsin","6/17/20","9096","654","55079","7.19"
"Monroe","2","38","Wisconsin","6/17/20","23","15","55081","65.22"
"Oconto","0","45","Wisconsin","6/17/20","42","3","55083","7.14"
"Oneida","1","17","Wisconsin","6/17/20","13","4","55085","30.77"
"Outagamie","9","354","Wisconsin","6/17/20","294","60","55087","20.41"
"Ozaukee","2","199","Wisconsin","6/17/20","185","14","55089","7.57"
"Pepin","0","1","Wisconsin","6/17/20","1","0","55091","0"
"Pierce","1","57","Wisconsin","6/17/20","51","6","55093","11.76"
"Polk","0","37","Wisconsin","6/17/20","36","1","55095","2.78"
"Portage","4","82","Wisconsin","6/17/20","51","31","55097","60.78"
"Price","0","2","Wisconsin","6/17/20","2","0","55099","0"
"Racine","12","2039","Wisconsin","6/17/20","1952","87","55101","4.46"
"Richland","0","14","Wisconsin","6/17/20","14","0","55103","0"
"Rock","6","767","Wisconsin","6/17/20","724","43","55105","5.94"
"Rusk","1","10","Wisconsin","6/17/20","5","5","55107","100"
"Sauk","0","87","Wisconsin","6/17/20","84","3","55111","3.57"
"Sawyer","0","9","Wisconsin","6/17/20","9","0","55113","0"
"Shawano","1","64","Wisconsin","6/17/20","60","4","55115","6.67"
"Sheboygan","7","171","Wisconsin","6/17/20","120","51","55117","42.5"
"St. Croix","1","116","Wisconsin","6/17/20","108","8","55109","7.41"
"Taylor","0","5","Wisconsin","6/17/20","2","3","55119","150"
"Trempealeau","5","80","Wisconsin","6/17/20","44","36","55121","81.82"
"Vernon","1","26","Wisconsin","6/17/20","22","4","55123","18.18"
"Vilas","0","8","Wisconsin","6/17/20","8","0","55125","0"
"Walworth","4","481","Wisconsin","6/17/20","456","25","55127","5.48"
"Washburn","0","3","Wisconsin","6/17/20","3","0","55129","0"
"Washington","2","299","Wisconsin","6/17/20","283","16","55131","5.65"
"Waukesha","14","942","Wisconsin","6/17/20","842","100","55133","11.88"
"Waupaca","3","82","Wisconsin","6/17/20","61","21","55135","34.43"
"Waushara","1","20","Wisconsin","6/17/20","13","7","55137","53.85"
"Winnebago","13","551","Wisconsin","6/17/20","457","94","55139","20.57"
"Wood","2","25","Wisconsin","6/17/20","13","12","55141","92.31"
"Albany","0","28","Wyoming","6/17/20","26","2","56001","7.69"
"Big Horn","0","11","Wyoming","6/17/20","9","2","56003","22.22"
"Campbell","1","46","Wyoming","6/17/20","37","9","56005","24.32"
"Carbon","1","21","Wyoming","6/17/20","16","5","56007","31.25"
"Converse","0","24","Wyoming","6/17/20","24","0","56009","0"
"Crook","0","6","Wyoming","6/17/20","5","1","56011","20"
"Fremont","3","315","Wyoming","6/17/20","296","19","56013","6.42"
"Goshen","0","5","Wyoming","6/17/20","5","0","56015","0"
"Hot Springs","0","12","Wyoming","6/17/20","12","0","56017","0"
"Johnson","0","19","Wyoming","6/17/20","18","1","56019","5.56"
"Laramie","1","197","Wyoming","6/17/20","188","9","56021","4.79"
"Lincoln","0","15","Wyoming","6/17/20","15","0","56023","0"
"Natrona","0","88","Wyoming","6/17/20","87","1","56025","1.15"
"Niobrara","0","2","Wyoming","6/17/20","2","0","56027","0"
"Park","1","8","Wyoming","6/17/20","2","6","56029","300"
"Platte","0","1","Wyoming","6/17/20","1","0","56031","0"
"Sheridan","0","19","Wyoming","6/17/20","19","0","56033","0"
"Sublette","0","3","Wyoming","6/17/20","3","0","56035","0"
"Sweetwater","1","43","Wyoming","6/17/20","35","8","56037","22.86"
"Teton","1","107","Wyoming","6/17/20","101","6","56039","5.94"
"Uinta","9","104","Wyoming","6/17/20","39","65","56041","166.67"
"Washakie","0","39","Wyoming","6/17/20","39","0","56043","0"
"Weston","0","1","Wyoming","6/17/20","1","0","56045","0"
