"Locality","DailyAvgNewCasesPast7Days","TotalCases","State","Date","TotalCases7DaysAgo","NewCasesPast7Days","FIPS-Code","PercentIncreaseTotalCasesPast7Days"
"Autauga","12","367","Alabama","6/16/20","282","85","01001","30.14"
"Baldwin","7","374","Alabama","6/16/20","325","49","01003","15.08"
"Barbour","6","244","Alabama","6/16/20","199","45","01005","22.61"
"Bibb","4","113","Alabama","6/16/20","85","28","01007","32.94"
"Blount","6","119","Alabama","6/16/20","75","44","01009","58.67"
"Bullock","9","308","Alabama","6/16/20","243","65","01011","26.75"
"Butler","12","548","Alabama","6/16/20","464","84","01013","18.1"
"Calhoun","3","198","Alabama","6/16/20","180","18","01015","10"
"Chambers","11","471","Alabama","6/16/20","391","80","01017","20.46"
"Cherokee","1","51","Alabama","6/16/20","42","9","01019","21.43"
"Chilton","3","138","Alabama","6/16/20","117","21","01021","17.95"
"Choctaw","3","177","Alabama","6/16/20","157","20","01023","12.74"
"Clarke","5","194","Alabama","6/16/20","161","33","01025","20.5"
"Clay","0","30","Alabama","6/16/20","30","0","01027","0"
"Cleburne","0","22","Alabama","6/16/20","19","3","01029","15.79"
"Coffee","7","296","Alabama","6/16/20","249","47","01031","18.88"
"Colbert","8","269","Alabama","6/16/20","216","53","01033","24.54"
"Conecuh","7","107","Alabama","6/16/20","55","52","01035","94.55"
"Coosa","1","46","Alabama","6/16/20","40","6","01037","15"
"Covington","13","180","Alabama","6/16/20","89","91","01039","102.25"
"Crenshaw","3","112","Alabama","6/16/20","89","23","01041","25.84"
"Cullman","11","278","Alabama","6/16/20","203","75","01043","36.95"
"Dale","6","182","Alabama","6/16/20","138","44","01045","31.88"
"Dallas","24","523","Alabama","6/16/20","353","170","01047","48.16"
"DeKalb","8","335","Alabama","6/16/20","276","59","01049","21.38"
"Elmore","19","568","Alabama","6/16/20","437","131","01051","29.98"
"Escambia","3","112","Alabama","6/16/20","88","24","01053","27.27"
"Etowah","9","339","Alabama","6/16/20","277","62","01055","22.38"
"Fayette","4","47","Alabama","6/16/20","21","26","01057","123.81"
"Franklin","15","737","Alabama","6/16/20","631","106","01059","16.8"
"Geneva","0","48","Alabama","6/16/20","46","2","01061","4.35"
"Greene","5","135","Alabama","6/16/20","102","33","01063","32.35"
"Hale","4","236","Alabama","6/16/20","209","27","01065","12.92"
"Henry","3","109","Alabama","6/16/20","89","20","01067","22.47"
"Houston","9","319","Alabama","6/16/20","253","66","01069","26.09"
"Jackson","4","125","Alabama","6/16/20","97","28","01071","28.87"
"Jefferson","67","2599","Alabama","6/16/20","2131","468","01073","21.96"
"Lamar","3","49","Alabama","6/16/20","29","20","01075","68.97"
"Lauderdale","10","260","Alabama","6/16/20","192","68","01077","35.42"
"Lawrence","1","66","Alabama","6/16/20","56","10","01079","17.86"
"Lee","20","739","Alabama","6/16/20","599","140","01081","23.37"
"Limestone","13","236","Alabama","6/16/20","144","92","01083","63.89"
"Lowndes","14","398","Alabama","6/16/20","298","100","01085","33.56"
"Macon","4","132","Alabama","6/16/20","104","28","01087","26.92"
"Madison","26","577","Alabama","6/16/20","397","180","01089","45.34"
"Marengo","5","222","Alabama","6/16/20","187","35","01091","18.72"
"Marion","3","145","Alabama","6/16/20","126","19","01093","15.08"
"Marshall","25","926","Alabama","6/16/20","752","174","01095","23.14"
"Mobile","41","2771","Alabama","6/16/20","2487","284","01097","11.42"
"Monroe","11","144","Alabama","6/16/20","68","76","01099","111.76"
"Montgomery","100","2922","Alabama","6/16/20","2221","701","01101","31.56"
"Morgan","34","664","Alabama","6/16/20","429","235","01103","54.78"
"Perry","4","79","Alabama","6/16/20","52","27","01105","51.92"
"Pickens","2","142","Alabama","6/16/20","126","16","01107","12.7"
"Pike","12","340","Alabama","6/16/20","259","81","01109","31.27"
"Randolph","1","141","Alabama","6/16/20","132","9","01111","6.82"
"Russell","11","301","Alabama","6/16/20","221","80","01113","36.2"
"Shelby","16","674","Alabama","6/16/20","560","114","01117","20.36"
"St. Clair","5","176","Alabama","6/16/20","141","35","01115","24.82"
"Sumter","2","263","Alabama","6/16/20","248","15","01119","6.05"
"Talladega","4","165","Alabama","6/16/20","136","29","01121","21.32"
"Tallapoosa","4","474","Alabama","6/16/20","448","26","01123","5.8"
"Tuscaloosa","61","1405","Alabama","6/16/20","976","429","01125","43.95"
"Walker","21","611","Alabama","6/16/20","467","144","01127","30.84"
"Washington","1","88","Alabama","6/16/20","82","6","01129","7.32"
"Wilcox","7","226","Alabama","6/16/20","179","47","01131","26.26"
"Winston","5","132","Alabama","6/16/20","96","36","01133","37.5"
"Anchorage","5","326","Alaska","6/16/20","288","38","02020","13.19"
"Bethel","0","5","Alaska","6/16/20","3","2","02050","66.67"
"Fairbanks North Star","2","96","Alaska","6/16/20","85","11","02090","12.94"
"Haines","0","1","Alaska","6/16/20","1","0","02100","0"
"Juneau","0","37","Alaska","6/16/20","35","2","02110","5.71"
"Kenai Peninsula","4","113","Alaska","6/16/20","85","28","02122","32.94"
"Ketchikan Gateway","0","19","Alaska","6/16/20","16","3","02130","18.75"
"Kodiak Island","0","2","Alaska","6/16/20","1","1","02150","100"
"Matanuska-Susitna","1","46","Alaska","6/16/20","37","9","02170","24.32"
"Nome","0","5","Alaska","6/16/20","4","1","02180","25"
"North Slope","0","1","Alaska","6/16/20","1","0","02185","0"
"Northwest Arctic","0","4","Alaska","6/16/20","3","1","02188","33.33"
"Petersburg","0","4","Alaska","6/16/20","4","0","02195","0"
"Prince of Wales-Hyder","0","2","Alaska","6/16/20","2","0","02198","0"
"Sitka","1","8","Alaska","6/16/20","2","6","02220","300"
"Southeast Fairbanks","0","3","Alaska","6/16/20","3","0","02240","0"
"Wrangell","0","2","Alaska","6/16/20","1","1","02275","100"
"Yukon-Koyukuk","0","1","Alaska","6/16/20","1","0","02290","0"
"Apache","36","1996","Arizona","6/16/20","1747","249","04001","14.25"
"Cochise","12","241","Arizona","6/16/20","156","85","04003","54.49"
"Coconino","15","1393","Arizona","6/16/20","1289","104","04005","8.07"
"Gila","6","91","Arizona","6/16/20","47","44","04007","93.62"
"Graham","2","55","Arizona","6/16/20","42","13","04009","30.95"
"Greenlee","0","12","Arizona","6/16/20","10","2","04011","20"
"La Paz","7","238","Arizona","6/16/20","189","49","04012","25.93"
"Maricopa","914","20775","Arizona","6/16/20","14374","6401","04013","44.53"
"Mohave","16","624","Arizona","6/16/20","513","111","04015","21.64"
"Navajo","71","2749","Arizona","6/16/20","2253","496","04017","22.02"
"Pima","167","4329","Arizona","6/16/20","3161","1168","04019","36.95"
"Pinal","80","1727","Arizona","6/16/20","1164","563","04021","48.37"
"Santa Cruz","67","1104","Arizona","6/16/20","633","471","04023","74.41"
"Yavapai","6","384","Arizona","6/16/20","340","44","04025","12.94"
"Yuma","156","3467","Arizona","6/16/20","2378","1089","04027","45.79"
"Arkansas","0","8","Arkansas","6/16/20","7","1","05001","14.29"
"Ashley","2","47","Arkansas","6/16/20","34","13","05003","38.24"
"Baxter","0","14","Arkansas","6/16/20","13","1","05005","7.69"
"Benton","61","1514","Arkansas","6/16/20","1090","424","05007","38.9"
"Boone","0","10","Arkansas","6/16/20","7","3","05009","42.86"
"Bradley","0","35","Arkansas","6/16/20","32","3","05011","9.38"
"Carroll","7","92","Arkansas","6/16/20","40","52","05015","130"
"Chicot","5","58","Arkansas","6/16/20","26","32","05017","123.08"
"Clark","1","48","Arkansas","6/16/20","41","7","05019","17.07"
"Clay","2","22","Arkansas","6/16/20","7","15","05021","214.29"
"Cleburne","0","75","Arkansas","6/16/20","75","0","05023","0"
"Cleveland","0","20","Arkansas","6/16/20","19","1","05025","5.26"
"Columbia","0","29","Arkansas","6/16/20","26","3","05027","11.54"
"Conway","1","24","Arkansas","6/16/20","16","8","05029","50"
"Craighead","7","365","Arkansas","6/16/20","318","47","05031","14.78"
"Crawford","3","65","Arkansas","6/16/20","43","22","05033","51.16"
"Crittenden","10","545","Arkansas","6/16/20","473","72","05035","15.22"
"Cross","2","79","Arkansas","6/16/20","65","14","05037","21.54"
"Dallas","0","4","Arkansas","6/16/20","3","1","05039","33.33"
"Desha","0","23","Arkansas","6/16/20","20","3","05041","15"
"Drew","1","26","Arkansas","6/16/20","21","5","05043","23.81"
"Faulkner","9","180","Arkansas","6/16/20","119","61","05045","51.26"
"Franklin","1","9","Arkansas","6/16/20","5","4","05047","80"
"Fulton","0","9","Arkansas","6/16/20","7","2","05049","28.57"
"Garland","2","165","Arkansas","6/16/20","150","15","05051","10"
"Grant","0","24","Arkansas","6/16/20","22","2","05053","9.09"
"Greene","1","74","Arkansas","6/16/20","67","7","05055","10.45"
"Hempstead","1","40","Arkansas","6/16/20","33","7","05057","21.21"
"Hot Spring","1","43","Arkansas","6/16/20","34","9","05059","26.47"
"Howard","1","42","Arkansas","6/16/20","36","6","05061","16.67"
"Independence","1","43","Arkansas","6/16/20","36","7","05063","19.44"
"Izard","0","20","Arkansas","6/16/20","17","3","05065","17.65"
"Jackson","1","16","Arkansas","6/16/20","7","9","05067","128.57"
"Jefferson","11","633","Arkansas","6/16/20","559","74","05069","13.24"
"Johnson","3","93","Arkansas","6/16/20","69","24","05071","34.78"
"Lafayette","0","11","Arkansas","6/16/20","10","1","05073","10"
"Lawrence","0","91","Arkansas","6/16/20","89","2","05075","2.25"
"Lee","64","545","Arkansas","6/16/20","97","448","05077","461.86"
"Lincoln","1","995","Arkansas","6/16/20","985","10","05079","1.02"
"Little River","1","34","Arkansas","6/16/20","28","6","05081","21.43"
"Logan","1","20","Arkansas","6/16/20","14","6","05083","42.86"
"Lonoke","2","75","Arkansas","6/16/20","63","12","05085","19.05"
"Madison","9","122","Arkansas","6/16/20","57","65","05087","114.04"
"Marion","0","2","Arkansas","6/16/20","2","0","05089","0"
"Miller","2","73","Arkansas","6/16/20","59","14","05091","23.73"
"Mississippi","2","98","Arkansas","6/16/20","85","13","05093","15.29"
"Monroe","0","7","Arkansas","6/16/20","5","2","05095","40"
"Montgomery","0","2","Arkansas","6/16/20","3","-1","05097","-33.33"
"Nevada","2","83","Arkansas","6/16/20","68","15","05099","22.06"
"Newton","0","3","Arkansas","6/16/20","3","0","05101","0"
"Ouachita","0","16","Arkansas","6/16/20","13","3","05103","23.08"
"Perry","0","16","Arkansas","6/16/20","15","1","05105","6.67"
"Phillips","3","52","Arkansas","6/16/20","30","22","05107","73.33"
"Pike","0","7","Arkansas","6/16/20","6","1","05109","16.67"
"Poinsett","1","51","Arkansas","6/16/20","44","7","05111","15.91"
"Polk","2","58","Arkansas","6/16/20","45","13","05113","28.89"
"Pope","10","285","Arkansas","6/16/20","218","67","05115","30.73"
"Prairie","1","9","Arkansas","6/16/20","5","4","05117","80"
"Pulaski","30","1343","Arkansas","6/16/20","1131","212","05119","18.74"
"Randolph","0","29","Arkansas","6/16/20","26","3","05121","11.54"
"Saline","5","184","Arkansas","6/16/20","150","34","05125","22.67"
"Scott","0","5","Arkansas","6/16/20","2","3","05127","150"
"Searcy","0","7","Arkansas","6/16/20","7","0","05129","0"
"Sebastian","10","169","Arkansas","6/16/20","98","71","05131","72.45"
"Sevier","16","478","Arkansas","6/16/20","366","112","05133","30.6"
"Sharp","0","50","Arkansas","6/16/20","49","1","05135","2.04"
"St. Francis","3","779","Arkansas","6/16/20","761","18","05123","2.37"
"Stone","0","11","Arkansas","6/16/20","11","0","05137","0"
"Union","3","209","Arkansas","6/16/20","190","19","05139","10"
"Van Buren","0","30","Arkansas","6/16/20","30","0","05141","0"
"Washington","113","1977","Arkansas","6/16/20","1185","792","05143","66.84"
"White","2","61","Arkansas","6/16/20","50","11","05145","22"
"Woodruff","1","5","Arkansas","6/16/20","1","4","05147","400"
"Yell","9","309","Arkansas","6/16/20","248","61","05149","24.6"
"Alameda","71","4481","California","6/16/20","3985","496","06001","12.45"
"Alpine","0","2","California","6/16/20","2","0","06003","0"
"Amador","0","12","California","6/16/20","10","2","06005","20"
"Butte","2","88","California","6/16/20","71","17","06007","23.94"
"Calaveras","1","26","California","6/16/20","19","7","06009","36.84"
"Colusa","0","7","California","6/16/20","7","0","06011","0"
"Contra Costa","36","2026","California","6/16/20","1774","252","06013","14.21"
"Del Norte","0","48","California","6/16/20","47","1","06015","2.13"
"El Dorado","1","118","California","6/16/20","111","7","06017","6.31"
"Fresno","82","2788","California","6/16/20","2216","572","06019","25.81"
"Glenn","2","34","California","6/16/20","19","15","06021","78.95"
"Humboldt","0","107","California","6/16/20","105","2","06023","1.9"
"Imperial","179","4389","California","6/16/20","3133","1256","06025","40.09"
"Inyo","0","24","California","6/16/20","22","2","06027","9.09"
"Kern","83","3452","California","6/16/20","2870","582","06029","20.28"
"Kings","36","1831","California","6/16/20","1576","255","06031","16.18"
"Lake","1","34","California","6/16/20","30","4","06033","13.33"
"Lassen","0","9","California","6/16/20","8","1","06035","12.5"
"Los Angeles","1317","75162","California","6/16/20","65945","9217","06037","13.98"
"Madera","11","250","California","6/16/20","172","78","06039","45.35"
"Marin","20","772","California","6/16/20","635","137","06041","21.57"
"Mariposa","0","17","California","6/16/20","16","1","06043","6.25"
"Mendocino","2","47","California","6/16/20","36","11","06045","30.56"
"Merced","15","470","California","6/16/20","367","103","06047","28.07"
"Mono","0","37","California","6/16/20","38","-1","06051","-2.63"
"Monterey","36","1015","California","6/16/20","763","252","06053","33.03"
"Napa","6","199","California","6/16/20","157","42","06055","26.75"
"Nevada","1","57","California","6/16/20","50","7","06057","14"
"Orange","198","8999","California","6/16/20","7614","1385","06059","18.19"
"Placer","15","411","California","6/16/20","304","107","06061","35.2"
"Plumas","0","5","California","6/16/20","4","1","06063","25"
"Riverside","301","11694","California","6/16/20","9590","2104","06065","21.94"
"Sacramento","29","1825","California","6/16/20","1624","201","06067","12.38"
"San Benito","3","129","California","6/16/20","109","20","06069","18.35"
"San Bernardino","197","7796","California","6/16/20","6417","1379","06071","21.49"
"San Diego","159","9730","California","6/16/20","8619","1111","06073","12.89"
"San Francisco","25","2971","California","6/16/20","2793","178","06075","6.37"
"San Joaquin","70","1749","California","6/16/20","1259","490","06077","38.92"
"San Luis Obispo","8","356","California","6/16/20","302","54","06079","17.88"
"San Mateo","27","2625","California","6/16/20","2437","188","06081","7.71"
"Santa Barbara","43","2115","California","6/16/20","1817","298","06083","16.4"
"Santa Clara","34","3254","California","6/16/20","3017","237","06085","7.86"
"Santa Cruz","4","260","California","6/16/20","235","25","06087","10.64"
"Shasta","1","51","California","6/16/20","46","5","06089","10.87"
"Sierra","0","1","California","6/16/20","1","0","06091","0"
"Siskiyou","1","20","California","6/16/20","13","7","06093","53.85"
"Solano","14","687","California","6/16/20","590","97","06095","16.44"
"Sonoma","14","765","California","6/16/20","664","101","06097","15.21"
"Stanislaus","47","1267","California","6/16/20","937","330","06099","35.22"
"Sutter","3","89","California","6/16/20","65","24","06101","36.92"
"Tehama","2","28","California","6/16/20","11","17","06103","154.55"
"Trinity","0","2","California","6/16/20","2","0","06105","0"
"Tulare","40","2664","California","6/16/20","2381","283","06107","11.89"
"Tuolumne","0","9","California","6/16/20","7","2","06109","28.57"
"Ventura","45","1655","California","6/16/20","1341","314","06111","23.42"
"Yolo","6","265","California","6/16/20","226","39","06113","17.26"
"Yuba","1","37","California","6/16/20","32","5","06115","15.62"
"Adams","21","3771","Colorado","6/16/20","3627","144","08001","3.97"
"Alamosa","4","129","Colorado","6/16/20","101","28","08003","27.72"
"Arapahoe","20","4826","Colorado","6/16/20","4687","139","08005","2.97"
"Archuleta","0","8","Colorado","6/16/20","8","0","08007","0"
"Baca","0","12","Colorado","6/16/20","12","0","08009","0"
"Bent","0","3","Colorado","6/16/20","3","0","08011","0"
"Boulder","10","1100","Colorado","6/16/20","1027","73","08013","7.11"
"Broomfield","1","268","Colorado","6/16/20","258","10","08014","3.88"
"Chaffee","0","78","Colorado","6/16/20","78","0","08015","0"
"Cheyenne","0","5","Colorado","6/16/20","5","0","08017","0"
"Clear Creek","0","17","Colorado","6/16/20","17","0","08019","0"
"Conejos","0","7","Colorado","6/16/20","5","2","08021","40"
"Costilla","1","15","Colorado","6/16/20","8","7","08023","87.5"
"Crowley","0","68","Colorado","6/16/20","66","2","08025","3.03"
"Custer","0","2","Colorado","6/16/20","2","0","08027","0"
"Delta","0","78","Colorado","6/16/20","76","2","08029","2.63"
"Denver","32","6401","Colorado","6/16/20","6176","225","08031","3.64"
"Douglas","7","815","Colorado","6/16/20","764","51","08035","6.68"
"Eagle","2","628","Colorado","6/16/20","612","16","08037","2.61"
"El Paso","11","1960","Colorado","6/16/20","1880","80","08041","4.26"
"Elbert","0","54","Colorado","6/16/20","57","-3","08039","-5.26"
"Fremont","0","29","Colorado","6/16/20","26","3","08043","11.54"
"Garfield","4","195","Colorado","6/16/20","166","29","08045","17.47"
"Gilpin","0","6","Colorado","6/16/20","5","1","08047","20"
"Grand","0","17","Colorado","6/16/20","15","2","08049","13.33"
"Gunnison","0","182","Colorado","6/16/20","181","1","08051","0.55"
"Hinsdale","0","3","Colorado","6/16/20","3","0","08053","0"
"Huerfano","0","3","Colorado","6/16/20","3","0","08055","0"
"Jefferson","11","2477","Colorado","6/16/20","2398","79","08059","3.29"
"Kit Carson","0","31","Colorado","6/16/20","30","1","08063","3.33"
"La Plata","0","86","Colorado","6/16/20","84","2","08067","2.38"
"Lake","0","39","Colorado","6/16/20","38","1","08065","2.63"
"Larimer","4","659","Colorado","6/16/20","632","27","08069","4.27"
"Las Animas","0","7","Colorado","6/16/20","6","1","08071","16.67"
"Lincoln","0","3","Colorado","6/16/20","3","0","08073","0"
"Logan","0","633","Colorado","6/16/20","631","2","08075","0.32"
"Mesa","2","81","Colorado","6/16/20","64","17","08077","26.56"
"Mineral","0","2","Colorado","6/16/20","2","0","08079","0"
"Moffat","0","8","Colorado","6/16/20","8","0","08081","0"
"Montezuma","1","65","Colorado","6/16/20","58","7","08083","12.07"
"Montrose","1","197","Colorado","6/16/20","190","7","08085","3.68"
"Morgan","0","646","Colorado","6/16/20","644","2","08087","0.31"
"Otero","0","22","Colorado","6/16/20","22","0","08089","0"
"Ouray","0","8","Colorado","6/16/20","8","0","08091","0"
"Park","0","23","Colorado","6/16/20","23","0","08093","0"
"Phillips","0","15","Colorado","6/16/20","15","0","08095","0"
"Pitkin","1","72","Colorado","6/16/20","62","10","08097","16.13"
"Prowers","0","16","Colorado","6/16/20","16","0","08099","0"
"Pueblo","4","351","Colorado","6/16/20","323","28","08101","8.67"
"Rio Blanco","0","2","Colorado","6/16/20","1","1","08103","100"
"Rio Grande","1","55","Colorado","6/16/20","47","8","08105","17.02"
"Routt","0","63","Colorado","6/16/20","62","1","08107","1.61"
"Saguache","1","99","Colorado","6/16/20","94","5","08109","5.32"
"San Juan","0","1","Colorado","6/16/20","1","0","08111","0"
"San Miguel","0","25","Colorado","6/16/20","23","2","08113","8.7"
"Summit","1","258","Colorado","6/16/20","248","10","08117","4.03"
"Teller","0","39","Colorado","6/16/20","37","2","08119","5.41"
"Washington","0","44","Colorado","6/16/20","43","1","08121","2.33"
"Weld","10","2671","Colorado","6/16/20","2604","67","08123","2.57"
"Yuma","0","49","Colorado","6/16/20","48","1","08125","2.08"
"Fairfield","36","16359","Connecticut","6/16/20","16108","251","09001","1.56"
"Hartford","57","11261","Connecticut","6/16/20","10859","402","09003","3.7"
"Litchfield","2","1443","Connecticut","6/16/20","1432","11","09005","0.77"
"Middlesex","6","1235","Connecticut","6/16/20","1194","41","09007","3.43"
"New Haven","29","12078","Connecticut","6/16/20","11875","203","09009","1.71"
"New London","22","1276","Connecticut","6/16/20","1122","154","09011","13.73"
"Tolland","2","888","Connecticut","6/16/20","873","15","09013","1.72"
"Windham","6","469","Connecticut","6/16/20","430","39","09015","9.07"
"Kent","7","1573","Delaware","6/16/20","1522","51","10001","3.35"
"New Castle","37","4386","Delaware","6/16/20","4125","261","10003","6.33"
"Sussex","10","4428","Delaware","6/16/20","4361","67","10005","1.54"
"","0","49","Diamond Princess","6/16/20","49","0",,"0"
"District of Columbia","49","9818","District of Columbia","6/16/20","9474","344","11001","3.63"
"Alachua","23","564","Florida","6/16/20","404","160","12001","39.6"
"Baker","1","34","Florida","6/16/20","29","5","12003","17.24"
"Bay","3","157","Florida","6/16/20","133","24","12005","18.05"
"Bradford","0","53","Florida","6/16/20","52","1","12007","1.92"
"Brevard","20","608","Florida","6/16/20","471","137","12009","29.09"
"Broward","209","9498","Florida","6/16/20","8035","1463","12011","18.21"
"Calhoun","0","66","Florida","6/16/20","64","2","12013","3.12"
"Charlotte","6","543","Florida","6/16/20","501","42","12015","8.38"
"Citrus","3","152","Florida","6/16/20","128","24","12017","18.75"
"Clay","5","443","Florida","6/16/20","411","32","12019","7.79"
"Collier","86","2729","Florida","6/16/20","2128","601","12021","28.24"
"Columbia","2","187","Florida","6/16/20","174","13","12023","7.47"
"DeSoto","15","402","Florida","6/16/20","296","106","12027","35.81"
"Dixie","0","60","Florida","6/16/20","60","0","12029","0"
"Duval","41","2112","Florida","6/16/20","1824","288","12031","15.79"
"Escambia","16","1020","Florida","6/16/20","907","113","12033","12.46"
"Flagler","2","208","Florida","6/16/20","195","13","12035","6.67"
"Franklin","0","2","Florida","6/16/20","2","0","12037","0"
"Gadsden","2","309","Florida","6/16/20","296","13","12039","4.39"
"Gilchrist","8","73","Florida","6/16/20","19","54","12041","284.21"
"Glades","5","118","Florida","6/16/20","86","32","12043","37.21"
"Gulf","1","11","Florida","6/16/20","7","4","12045","57.14"
"Hamilton","2","277","Florida","6/16/20","263","14","12047","5.32"
"Hardee","9","213","Florida","6/16/20","153","60","12049","39.22"
"Hendry","12","659","Florida","6/16/20","572","87","12051","15.21"
"Hernando","3","146","Florida","6/16/20","127","19","12053","14.96"
"Highlands","6","192","Florida","6/16/20","150","42","12055","28"
"Hillsborough","158","4029","Florida","6/16/20","2923","1106","12057","37.84"
"Holmes","0","31","Florida","6/16/20","30","1","12059","3.33"
"Indian River","10","234","Florida","6/16/20","167","67","12061","40.12"
"Jackson","2","326","Florida","6/16/20","310","16","12063","5.16"
"Jefferson","0","33","Florida","6/16/20","31","2","12065","6.45"
"Lafayette","0","15","Florida","6/16/20","13","2","12067","15.38"
"Lake","23","498","Florida","6/16/20","339","159","12069","46.9"
"Lee","90","3015","Florida","6/16/20","2388","627","12071","26.26"
"Leon","5","483","Florida","6/16/20","448","35","12073","7.81"
"Levy","5","127","Florida","6/16/20","90","37","12075","41.11"
"Liberty","0","220","Florida","6/16/20","218","2","12077","0.92"
"Madison","2","84","Florida","6/16/20","71","13","12079","18.31"
"Manatee","36","1483","Florida","6/16/20","1229","254","12081","20.67"
"Marion","6","325","Florida","6/16/20","284","41","12083","14.44"
"Martin","52","1296","Florida","6/16/20","934","362","12085","38.76"
"Miami-Dade","394","22741","Florida","6/16/20","19980","2761","12086","13.82"
"Monroe","2","131","Florida","6/16/20","114","17","12087","14.91"
"Nassau","2","94","Florida","6/16/20","83","11","12089","13.25"
"Okaloosa","10","344","Florida","6/16/20","274","70","12091","25.55"
"Okeechobee","7","195","Florida","6/16/20","143","52","12093","36.36"
"Orange","141","3437","Florida","6/16/20","2449","988","12095","40.34"
"Osceola","15","866","Florida","6/16/20","762","104","12097","13.65"
"Palm Beach","249","9262","Florida","6/16/20","7518","1744","12099","23.2"
"Pasco","17","560","Florida","6/16/20","442","118","12101","26.7"
"Pinellas","121","2523","Florida","6/16/20","1679","844","12103","50.27"
"Polk","46","1566","Florida","6/16/20","1243","323","12105","25.99"
"Putnam","3","198","Florida","6/16/20","175","23","12107","13.14"
"Santa Rosa","5","297","Florida","6/16/20","261","36","12113","13.79"
"Sarasota","14","789","Florida","6/16/20","694","95","12115","13.69"
"Seminole","40","836","Florida","6/16/20","556","280","12117","50.36"
"St. Johns","7","333","Florida","6/16/20","287","46","12109","16.03"
"St. Lucie","45","981","Florida","6/16/20","669","312","12111","46.64"
"Sumter","1","268","Florida","6/16/20","264","4","12119","1.52"
"Suwannee","5","208","Florida","6/16/20","176","32","12121","18.18"
"Taylor","2","60","Florida","6/16/20","48","12","12123","25"
"Union","0","38","Florida","6/16/20","38","0","12125","0"
"Volusia","19","969","Florida","6/16/20","837","132","12127","15.77"
"Wakulla","0","35","Florida","6/16/20","35","0","12129","0"
"Walton","3","152","Florida","6/16/20","133","19","12131","14.29"
"Washington","1","94","Florida","6/16/20","85","9","12133","10.59"
"Appling","1","207","Georgia","6/16/20","197","10","13001","5.08"
"Atkinson","2","77","Georgia","6/16/20","62","15","13003","24.19"
"Bacon","4","181","Georgia","6/16/20","152","29","13005","19.08"
"Baker","0","36","Georgia","6/16/20","37","-1","13007","-2.7"
"Baldwin","5","430","Georgia","6/16/20","393","37","13009","9.41"
"Banks","2","110","Georgia","6/16/20","99","11","13011","11.11"
"Barrow","6","395","Georgia","6/16/20","356","39","13013","10.96"
"Bartow","5","562","Georgia","6/16/20","527","35","13015","6.64"
"Ben Hill","2","104","Georgia","6/16/20","93","11","13017","11.83"
"Berrien","3","77","Georgia","6/16/20","59","18","13019","30.51"
"Bibb","7","560","Georgia","6/16/20","511","49","13021","9.59"
"Bleckley","0","52","Georgia","6/16/20","53","-1","13023","-1.89"
"Brantley","1","70","Georgia","6/16/20","63","7","13025","11.11"
"Brooks","2","99","Georgia","6/16/20","84","15","13027","17.86"
"Bryan","1","87","Georgia","6/16/20","80","7","13029","8.75"
"Bulloch","4","110","Georgia","6/16/20","84","26","13031","30.95"
"Burke","0","126","Georgia","6/16/20","125","1","13033","0.8"
"Butts","-1","246","Georgia","6/16/20","253","-7","13035","-2.77"
"Calhoun","1","149","Georgia","6/16/20","140","9","13037","6.43"
"Camden","1","75","Georgia","6/16/20","70","5","13039","7.14"
"Candler","0","17","Georgia","6/16/20","15","2","13043","13.33"
"Carroll","5","619","Georgia","6/16/20","587","32","13045","5.45"
"Catoosa","12","249","Georgia","6/16/20","164","85","13047","51.83"
"Charlton","0","37","Georgia","6/16/20","36","1","13049","2.78"
"Chatham","14","651","Georgia","6/16/20","556","95","13051","17.09"
"Chattahoochee","13","272","Georgia","6/16/20","180","92","13053","51.11"
"Chattooga","2","41","Georgia","6/16/20","27","14","13055","51.85"
"Cherokee","11","1052","Georgia","6/16/20","978","74","13057","7.57"
"Clarke","4","353","Georgia","6/16/20","328","25","13059","7.62"
"Clay","1","53","Georgia","6/16/20","49","4","13061","8.16"
"Clayton","14","1461","Georgia","6/16/20","1362","99","13063","7.27"
"Clinch","1","80","Georgia","6/16/20","72","8","13065","11.11"
"Cobb","49","3679","Georgia","6/16/20","3337","342","13067","10.25"
"Coffee","7","359","Georgia","6/16/20","307","52","13069","16.94"
"Colquitt","15","697","Georgia","6/16/20","589","108","13071","18.34"
"Columbia","2","305","Georgia","6/16/20","288","17","13073","5.9"
"Cook","3","78","Georgia","6/16/20","57","21","13075","36.84"
"Coweta","6","519","Georgia","6/16/20","474","45","13077","9.49"
"Crawford","0","32","Georgia","6/16/20","31","1","13079","3.23"
"Crisp","1","246","Georgia","6/16/20","239","7","13081","2.93"
"Dade","1","51","Georgia","6/16/20","41","10","13083","24.39"
"Dawson","1","121","Georgia","6/16/20","114","7","13085","6.14"
"Decatur","3","236","Georgia","6/16/20","218","18","13087","8.26"
"DeKalb","42","4411","Georgia","6/16/20","4120","291","13089","7.06"
"Dodge","1","59","Georgia","6/16/20","53","6","13091","11.32"
"Dooly","0","193","Georgia","6/16/20","193","0","13093","0"
"Dougherty","3","1841","Georgia","6/16/20","1818","23","13095","1.27"
"Douglas","8","669","Georgia","6/16/20","612","57","13097","9.31"
"Early","0","255","Georgia","6/16/20","252","3","13099","1.19"
"Echols","2","162","Georgia","6/16/20","146","16","13101","10.96"
"Effingham","1","86","Georgia","6/16/20","81","5","13103","6.17"
"Elbert","1","87","Georgia","6/16/20","82","5","13105","6.1"
"Emanuel","2","47","Georgia","6/16/20","33","14","13107","42.42"
"Evans","1","10","Georgia","6/16/20","6","4","13109","66.67"
"Fannin","2","69","Georgia","6/16/20","57","12","13111","21.05"
"Fayette","2","270","Georgia","6/16/20","254","16","13113","6.3"
"Floyd","6","375","Georgia","6/16/20","335","40","13115","11.94"
"Forsyth","4","603","Georgia","6/16/20","575","28","13117","4.87"
"Franklin","1","142","Georgia","6/16/20","134","8","13119","5.97"
"Fulton","32","5148","Georgia","6/16/20","4925","223","13121","4.53"
"Gilmer","2","172","Georgia","6/16/20","161","11","13123","6.83"
"Glascock","0","1","Georgia","6/16/20","1","0","13125","0"
"Glynn","5","196","Georgia","6/16/20","164","32","13127","19.51"
"Gordon","7","260","Georgia","6/16/20","209","51","13129","24.4"
"Grady","3","147","Georgia","6/16/20","127","20","13131","15.75"
"Greene","0","86","Georgia","6/16/20","83","3","13133","3.61"
"Gwinnett","108","5451","Georgia","6/16/20","4692","759","13135","16.18"
"Habersham","5","600","Georgia","6/16/20","568","32","13137","5.63"
"Hall","18","2787","Georgia","6/16/20","2664","123","13139","4.62"
"Hancock","0","203","Georgia","6/16/20","200","3","13141","1.5"
"Haralson","1","58","Georgia","6/16/20","54","4","13143","7.41"
"Harris","10","210","Georgia","6/16/20","143","67","13145","46.85"
"Hart","1","44","Georgia","6/16/20","39","5","13147","12.82"
"Heard","1","45","Georgia","6/16/20","37","8","13149","21.62"
"Henry","11","856","Georgia","6/16/20","779","77","13151","9.88"
"Houston","7","456","Georgia","6/16/20","406","50","13153","12.32"
"Irwin","1","38","Georgia","6/16/20","34","4","13155","11.76"
"Jackson","4","266","Georgia","6/16/20","237","29","13157","12.24"
"Jasper","1","56","Georgia","6/16/20","51","5","13159","9.8"
"Jeff Davis","2","62","Georgia","6/16/20","48","14","13161","29.17"
"Jefferson","1","58","Georgia","6/16/20","52","6","13163","11.54"
"Jenkins","2","47","Georgia","6/16/20","33","14","13165","42.42"
"Johnson","-1","78","Georgia","6/16/20","83","-5","13167","-6.02"
"Jones","0","51","Georgia","6/16/20","49","2","13169","4.08"
"Lamar","0","79","Georgia","6/16/20","76","3","13171","3.95"
"Lanier","9","98","Georgia","6/16/20","34","64","13173","188.24"
"Laurens","0","118","Georgia","6/16/20","116","2","13175","1.72"
"Lee","1","374","Georgia","6/16/20","368","6","13177","1.63"
"Liberty","1","96","Georgia","6/16/20","86","10","13179","11.63"
"Lincoln","0","18","Georgia","6/16/20","16","2","13181","12.5"
"Long","1","25","Georgia","6/16/20","17","8","13183","47.06"
"Lowndes","31","689","Georgia","6/16/20","474","215","13185","45.36"
"Lumpkin","1","109","Georgia","6/16/20","103","6","13187","5.83"
"Macon","1","112","Georgia","6/16/20","106","6","13193","5.66"
"Madison","1","74","Georgia","6/16/20","66","8","13195","12.12"
"Marion","1","63","Georgia","6/16/20","59","4","13197","6.78"
"McDuffie","0","75","Georgia","6/16/20","73","2","13189","2.74"
"McIntosh","1","19","Georgia","6/16/20","15","4","13191","26.67"
"Meriwether","3","133","Georgia","6/16/20","110","23","13199","20.91"
"Miller","0","45","Georgia","6/16/20","43","2","13201","4.65"
"Mitchell","1","433","Georgia","6/16/20","425","8","13205","1.88"
"Monroe","1","133","Georgia","6/16/20","124","9","13207","7.26"
"Montgomery","1","22","Georgia","6/16/20","14","8","13209","57.14"
"Morgan","0","41","Georgia","6/16/20","40","1","13211","2.5"
"Murray","5","148","Georgia","6/16/20","114","34","13213","29.82"
"Muscogee","30","1078","Georgia","6/16/20","868","210","13215","24.19"
"Newton","4","425","Georgia","6/16/20","396","29","13217","7.32"
"Oconee","0","130","Georgia","6/16/20","127","3","13219","2.36"
"Oglethorpe","1","77","Georgia","6/16/20","70","7","13221","10"
"Out of GA","42","2776","Georgia","6/16/20","2480","296","80013","11.94"
"Paulding","6","415","Georgia","6/16/20","371","44","13223","11.86"
"Peach","2","91","Georgia","6/16/20","80","11","13225","13.75"
"Pickens","3","71","Georgia","6/16/20","53","18","13227","33.96"
"Pierce","2","132","Georgia","6/16/20","121","11","13229","9.09"
"Pike","1","71","Georgia","6/16/20","64","7","13231","10.94"
"Polk","2","167","Georgia","6/16/20","152","15","13233","9.87"
"Pulaski","0","46","Georgia","6/16/20","46","0","13235","0"
"Putnam","1","111","Georgia","6/16/20","103","8","13237","7.77"
"Quitman","0","14","Georgia","6/16/20","14","0","13239","0"
"Rabun","1","33","Georgia","6/16/20","27","6","13241","22.22"
"Randolph","1","191","Georgia","6/16/20","187","4","13243","2.14"
"Richmond","5","687","Georgia","6/16/20","652","35","13245","5.37"
"Rockdale","4","347","Georgia","6/16/20","320","27","13247","8.44"
"Schley","0","20","Georgia","6/16/20","18","2","13249","11.11"
"Screven","1","65","Georgia","6/16/20","59","6","13251","10.17"
"Seminole","0","48","Georgia","6/16/20","47","1","13253","2.13"
"Spalding","4","326","Georgia","6/16/20","301","25","13255","8.31"
"Stephens","2","158","Georgia","6/16/20","147","11","13257","7.48"
"Stewart","1","68","Georgia","6/16/20","58","10","13259","17.24"
"Sumter","4","523","Georgia","6/16/20","498","25","13261","5.02"
"Talbot","1","50","Georgia","6/16/20","43","7","13263","16.28"
"Taliaferro","0","2","Georgia","6/16/20","1","1","13265","100"
"Tattnall","3","58","Georgia","6/16/20","34","24","13267","70.59"
"Taylor","0","26","Georgia","6/16/20","23","3","13269","13.04"
"Telfair","2","54","Georgia","6/16/20","39","15","13271","38.46"
"Terrell","0","218","Georgia","6/16/20","217","1","13273","0.46"
"Thomas","1","365","Georgia","6/16/20","357","8","13275","2.24"
"Tift","15","433","Georgia","6/16/20","327","106","13277","32.42"
"Toombs","7","126","Georgia","6/16/20","77","49","13279","63.64"
"Towns","1","35","Georgia","6/16/20","30","5","13281","16.67"
"Treutlen","0","17","Georgia","6/16/20","14","3","13283","21.43"
"Troup","47","805","Georgia","6/16/20","476","329","13285","69.12"
"Turner","2","155","Georgia","6/16/20","141","14","13287","9.93"
"Twiggs","0","22","Georgia","6/16/20","19","3","13289","15.79"
"Union","1","55","Georgia","6/16/20","50","5","13291","10"
"Upson","1","300","Georgia","6/16/20","290","10","13293","3.45"
"Walker","5","236","Georgia","6/16/20","203","33","13295","16.26"
"Walton","3","331","Georgia","6/16/20","307","24","13297","7.82"
"Ware","5","290","Georgia","6/16/20","252","38","13299","15.08"
"Warren","0","20","Georgia","6/16/20","18","2","13301","11.11"
"Washington","0","76","Georgia","6/16/20","75","1","13303","1.33"
"Wayne","1","39","Georgia","6/16/20","30","9","13305","30"
"Webster","0","15","Georgia","6/16/20","14","1","13307","7.14"
"Wheeler","2","30","Georgia","6/16/20","14","16","13309","114.29"
"White","1","124","Georgia","6/16/20","117","7","13311","5.98"
"Whitfield","18","637","Georgia","6/16/20","509","128","13313","25.15"
"Wilcox","0","119","Georgia","6/16/20","117","2","13315","1.71"
"Wilkes","1","41","Georgia","6/16/20","34","7","13317","20.59"
"Wilkinson","0","74","Georgia","6/16/20","72","2","13319","2.78"
"Worth","3","265","Georgia","6/16/20","243","22","13321","9.05"
"","0","103","Grand Princess","6/16/20","103","0",,"0"
"","1","186","Guam","6/16/20","180","6",,"3.33"
"Hawaii","0","82","Hawaii","6/16/20","81","1","15001","1.23"
"Honolulu","8","501","Hawaii","6/16/20","448","53","15003","11.83"
"Kauai","0","21","Hawaii","6/16/20","21","0","15007","0"
"Maui","0","120","Hawaii","6/16/20","120","0","15009","0"
"Out of HI","0","12","Hawaii","6/16/20","12","0","80015","0"
"Ada","10","915","Idaho","6/16/20","848","67","16001","7.9"
"Adams","0","6","Idaho","6/16/20","3","3","16003","100"
"Bannock","2","64","Idaho","6/16/20","49","15","16005","30.61"
"Benewah","0","18","Idaho","6/16/20","18","0","16009","0"
"Bingham","0","25","Idaho","6/16/20","23","2","16011","8.7"
"Blaine","0","515","Idaho","6/16/20","514","1","16013","0.19"
"Bonner","0","7","Idaho","6/16/20","7","0","16017","0"
"Bonneville","3","86","Idaho","6/16/20","68","18","16019","26.47"
"Camas","0","1","Idaho","6/16/20","1","0","16025","0"
"Canyon","2","360","Idaho","6/16/20","345","15","16027","4.35"
"Caribou","0","5","Idaho","6/16/20","3","2","16029","66.67"
"Cassia","4","143","Idaho","6/16/20","118","25","16031","21.19"
"Custer","0","2","Idaho","6/16/20","2","0","16037","0"
"Elmore","0","35","Idaho","6/16/20","33","2","16039","6.06"
"Franklin","1","15","Idaho","6/16/20","9","6","16041","66.67"
"Fremont","0","4","Idaho","6/16/20","4","0","16043","0"
"Gem","0","17","Idaho","6/16/20","17","0","16045","0"
"Gooding","0","59","Idaho","6/16/20","57","2","16047","3.51"
"Idaho","0","3","Idaho","6/16/20","3","0","16049","0"
"Jefferson","0","12","Idaho","6/16/20","9","3","16051","33.33"
"Jerome","1","208","Idaho","6/16/20","201","7","16053","3.48"
"Kootenai","1","101","Idaho","6/16/20","91","10","16055","10.99"
"Latah","0","8","Idaho","6/16/20","7","1","16057","14.29"
"Lemhi","0","2","Idaho","6/16/20","1","1","16059","100"
"Lincoln","0","35","Idaho","6/16/20","34","1","16063","2.94"
"Madison","0","29","Idaho","6/16/20","27","2","16065","7.41"
"Minidoka","3","103","Idaho","6/16/20","80","23","16067","28.75"
"Nez Perce","0","84","Idaho","6/16/20","83","1","16069","1.2"
"Owyhee","0","9","Idaho","6/16/20","8","1","16073","12.5"
"Payette","0","28","Idaho","6/16/20","26","2","16075","7.69"
"Power","0","9","Idaho","6/16/20","9","0","16077","0"
"Teton","0","11","Idaho","6/16/20","11","0","16081","0"
"Twin Falls","3","483","Idaho","6/16/20","463","20","16083","4.32"
"Valley","0","3","Idaho","6/16/20","3","0","16085","0"
"Washington","2","57","Idaho","6/16/20","46","11","16087","23.91"
"Adams","0","45","Illinois","6/16/20","45","0","17001","0"
"Alexander","0","17","Illinois","6/16/20","15","2","17003","13.33"
"Bond","0","12","Illinois","6/16/20","12","0","17005","0"
"Boone","4","537","Illinois","6/16/20","507","30","17007","5.92"
"Brown","0","10","Illinois","6/16/20","10","0","17009","0"
"Bureau","0","24","Illinois","6/16/20","21","3","17011","14.29"
"Calhoun","0","1","Illinois","6/16/20","1","0","17013","0"
"Carroll","0","20","Illinois","6/16/20","19","1","17015","5.26"
"Cass","0","76","Illinois","6/16/20","74","2","17017","2.7"
"Champaign","6","740","Illinois","6/16/20","695","45","17019","6.47"
"Christian","1","39","Illinois","6/16/20","35","4","17021","11.43"
"Clark","0","13","Illinois","6/16/20","12","1","17023","8.33"
"Clay","0","2","Illinois","6/16/20","2","0","17025","0"
"Clinton","3","214","Illinois","6/16/20","196","18","17027","9.18"
"Coles","0","143","Illinois","6/16/20","140","3","17029","2.14"
"Cook","324","85538","Illinois","6/16/20","83271","2267","17031","2.72"
"Crawford","1","17","Illinois","6/16/20","11","6","17033","54.55"
"Cumberland","0","10","Illinois","6/16/20","10","0","17035","0"
"De Witt","0","4","Illinois","6/16/20","4","0","17039","0"
"DeKalb","5","490","Illinois","6/16/20","457","33","17037","7.22"
"Douglas","1","38","Illinois","6/16/20","29","9","17041","31.03"
"DuPage","40","8495","Illinois","6/16/20","8215","280","17043","3.41"
"Edgar","0","2","Illinois","6/16/20","1","1","17045","100"
"Edwards","0","2","Illinois","6/16/20","2","0","17047","0"
"Effingham","0","9","Illinois","6/16/20","8","1","17049","12.5"
"Fayette","0","22","Illinois","6/16/20","21","1","17051","4.76"
"Ford","0","22","Illinois","6/16/20","21","1","17053","4.76"
"Franklin","0","12","Illinois","6/16/20","12","0","17055","0"
"Fulton","0","12","Illinois","6/16/20","12","0","17057","0"
"Gallatin","0","2","Illinois","6/16/20","2","0","17059","0"
"Greene","0","8","Illinois","6/16/20","7","1","17061","14.29"
"Grundy","1","129","Illinois","6/16/20","124","5","17063","4.03"
"Hamilton","0","2","Illinois","6/16/20","2","0","17065","0"
"Hancock","0","18","Illinois","6/16/20","18","0","17067","0"
"Hardin","0","1","Illinois","6/16/20","1","0","17069","0"
"Henderson","0","8","Illinois","6/16/20","8","0","17071","0"
"Henry","0","72","Illinois","6/16/20","71","1","17073","1.41"
"Iroquois","0","139","Illinois","6/16/20","137","2","17075","1.46"
"Jackson","2","320","Illinois","6/16/20","304","16","17077","5.26"
"Jasper","0","46","Illinois","6/16/20","46","0","17079","0"
"Jefferson","0","104","Illinois","6/16/20","101","3","17081","2.97"
"Jersey","0","29","Illinois","6/16/20","26","3","17083","11.54"
"Jo Daviess","0","35","Illinois","6/16/20","33","2","17085","6.06"
"Johnson","1","19","Illinois","6/16/20","13","6","17087","46.15"
"Kane","39","7167","Illinois","6/16/20","6897","270","17089","3.91"
"Kankakee","11","1096","Illinois","6/16/20","1019","77","17091","7.56"
"Kendall","5","891","Illinois","6/16/20","853","38","17093","4.45"
"Knox","1","113","Illinois","6/16/20","105","8","17095","7.62"
"Lake","39","9133","Illinois","6/16/20","8861","272","17097","3.07"
"LaSalle","2","183","Illinois","6/16/20","168","15","17099","8.93"
"Lawrence","0","4","Illinois","6/16/20","4","0","17101","0"
"Lee","0","89","Illinois","6/16/20","89","0","17103","0"
"Livingston","0","35","Illinois","6/16/20","36","-1","17105","-2.78"
"Logan","0","11","Illinois","6/16/20","10","1","17107","10"
"Macon","1","212","Illinois","6/16/20","203","9","17115","4.43"
"Macoupin","0","45","Illinois","6/16/20","46","-1","17117","-2.17"
"Madison","13","740","Illinois","6/16/20","647","93","17119","14.37"
"Marion","0","55","Illinois","6/16/20","55","0","17121","0"
"Marshall","0","5","Illinois","6/16/20","5","0","17123","0"
"Mason","0","18","Illinois","6/16/20","18","0","17125","0"
"Massac","0","7","Illinois","6/16/20","7","0","17127","0"
"McDonough","2","103","Illinois","6/16/20","92","11","17109","11.96"
"McHenry","16","1864","Illinois","6/16/20","1752","112","17111","6.39"
"McLean","2","243","Illinois","6/16/20","230","13","17113","5.65"
"Menard","0","23","Illinois","6/16/20","22","1","17129","4.55"
"Mercer","0","19","Illinois","6/16/20","18","1","17131","5.56"
"Monroe","1","111","Illinois","6/16/20","105","6","17133","5.71"
"Montgomery","0","42","Illinois","6/16/20","41","1","17135","2.44"
"Morgan","8","108","Illinois","6/16/20","55","53","17137","96.36"
"Moultrie","0","15","Illinois","6/16/20","13","2","17139","15.38"
"Ogle","1","229","Illinois","6/16/20","224","5","17141","2.23"
"Out of IL","-1","111","Illinois","6/16/20","118","-7","80017","-5.93"
"Peoria","10","397","Illinois","6/16/20","328","69","17143","21.04"
"Perry","0","44","Illinois","6/16/20","42","2","17145","4.76"
"Piatt","0","11","Illinois","6/16/20","11","0","17147","0"
"Pike","0","2","Illinois","6/16/20","1","1","17149","100"
"Pope","0","1","Illinois","6/16/20","1","0","17151","0"
"Pulaski","0","61","Illinois","6/16/20","60","1","17153","1.67"
"Putnam","0","1","Illinois","6/16/20","1","0","17155","0"
"Randolph","0","279","Illinois","6/16/20","276","3","17157","1.09"
"Richland","0","4","Illinois","6/16/20","4","0","17159","0"
"Rock Island","6","757","Illinois","6/16/20","717","40","17161","5.58"
"Saline","0","7","Illinois","6/16/20","7","0","17165","0"
"Sangamon","2","382","Illinois","6/16/20","366","16","17167","4.37"
"Schuyler","0","13","Illinois","6/16/20","13","0","17169","0"
"Shelby","0","16","Illinois","6/16/20","16","0","17173","0"
"St. Clair","22","1492","Illinois","6/16/20","1340","152","17163","11.34"
"Stark","0","3","Illinois","6/16/20","3","0","17175","0"
"Stephenson","2","231","Illinois","6/16/20","220","11","17177","5"
"Tazewell","2","95","Illinois","6/16/20","82","13","17179","15.85"
"Union","1","174","Illinois","6/16/20","170","4","17181","2.35"
"Vermilion","0","46","Illinois","6/16/20","43","3","17183","6.98"
"Wabash","0","14","Illinois","6/16/20","12","2","17185","16.67"
"Warren","0","127","Illinois","6/16/20","127","0","17187","0"
"Washington","0","19","Illinois","6/16/20","19","0","17189","0"
"Wayne","0","9","Illinois","6/16/20","9","0","17191","0"
"White","0","3","Illinois","6/16/20","2","1","17193","50"
"Whiteside","1","163","Illinois","6/16/20","156","7","17195","4.49"
"Will","33","6191","Illinois","6/16/20","5961","230","17197","3.86"
"Williamson","1","87","Illinois","6/16/20","81","6","17199","7.41"
"Winnebago","23","2763","Illinois","6/16/20","2602","161","17201","6.19"
"Woodford","1","28","Illinois","6/16/20","22","6","17203","27.27"
"Adams","1","28","Indiana","6/16/20","23","5","18001","21.74"
"Allen","44","2261","Indiana","6/16/20","1956","305","18003","15.59"
"Bartholomew","3","558","Indiana","6/16/20","539","19","18005","3.53"
"Benton","1","38","Indiana","6/16/20","33","5","18007","15.15"
"Blackford","0","29","Indiana","6/16/20","29","0","18009","0"
"Boone","6","382","Indiana","6/16/20","337","45","18011","13.35"
"Brown","0","36","Indiana","6/16/20","35","1","18013","2.86"
"Carroll","1","102","Indiana","6/16/20","95","7","18015","7.37"
"Cass","2","1608","Indiana","6/16/20","1593","15","18017","0.94"
"Clark","4","577","Indiana","6/16/20","547","30","18019","5.48"
"Clay","0","56","Indiana","6/16/20","55","1","18021","1.82"
"Clinton","2","261","Indiana","6/16/20","250","11","18023","4.4"
"Crawford","0","27","Indiana","6/16/20","27","0","18025","0"
"Daviess","2","126","Indiana","6/16/20","111","15","18027","13.51"
"Dearborn","1","180","Indiana","6/16/20","175","5","18029","2.86"
"Decatur","0","237","Indiana","6/16/20","235","2","18031","0.85"
"DeKalb","6","123","Indiana","6/16/20","79","44","18033","55.7"
"Delaware","0","402","Indiana","6/16/20","401","1","18035","0.25"
"Dubois","2","242","Indiana","6/16/20","231","11","18037","4.76"
"Elkhart","64","2248","Indiana","6/16/20","1800","448","18039","24.89"
"Fayette","1","84","Indiana","6/16/20","80","4","18041","5"
"Floyd","1","337","Indiana","6/16/20","327","10","18043","3.06"
"Fountain","0","24","Indiana","6/16/20","23","1","18045","4.35"
"Franklin","0","120","Indiana","6/16/20","118","2","18047","1.69"
"Fulton","1","56","Indiana","6/16/20","51","5","18049","9.8"
"Gibson","0","24","Indiana","6/16/20","21","3","18051","14.29"
"Grant","3","264","Indiana","6/16/20","244","20","18053","8.2"
"Greene","1","181","Indiana","6/16/20","175","6","18055","3.43"
"Hamilton","21","1368","Indiana","6/16/20","1221","147","18057","12.04"
"Hancock","2","381","Indiana","6/16/20","367","14","18059","3.81"
"Harrison","0","199","Indiana","6/16/20","198","1","18061","0.51"
"Hendricks","8","1281","Indiana","6/16/20","1223","58","18063","4.74"
"Henry","2","204","Indiana","6/16/20","190","14","18065","7.37"
"Howard","4","476","Indiana","6/16/20","449","27","18067","6.01"
"Huntington","1","55","Indiana","6/16/20","46","9","18069","19.57"
"Jackson","2","421","Indiana","6/16/20","406","15","18071","3.69"
"Jasper","1","85","Indiana","6/16/20","80","5","18073","6.25"
"Jay","0","62","Indiana","6/16/20","59","3","18075","5.08"
"Jefferson","0","53","Indiana","6/16/20","52","1","18077","1.92"
"Jennings","1","142","Indiana","6/16/20","133","9","18079","6.77"
"Johnson","4","1174","Indiana","6/16/20","1143","31","18081","2.71"
"Knox","1","37","Indiana","6/16/20","33","4","18083","12.12"
"Kosciusko","13","330","Indiana","6/16/20","242","88","18085","36.36"
"LaGrange","16","294","Indiana","6/16/20","181","113","18087","62.43"
"Lake","29","4211","Indiana","6/16/20","4005","206","18089","5.14"
"LaPorte","1","471","Indiana","6/16/20","462","9","18091","1.95"
"Lawrence","1","182","Indiana","6/16/20","172","10","18093","5.81"
"Madison","1","615","Indiana","6/16/20","605","10","18095","1.65"
"Marion","56","10834","Indiana","6/16/20","10444","390","18097","3.73"
"Marshall","12","315","Indiana","6/16/20","230","85","18099","36.96"
"Martin","0","16","Indiana","6/16/20","15","1","18101","6.67"
"Miami","3","176","Indiana","6/16/20","152","24","18103","15.79"
"Monroe","2","190","Indiana","6/16/20","179","11","18105","6.15"
"Montgomery","1","267","Indiana","6/16/20","259","8","18107","3.09"
"Morgan","1","300","Indiana","6/16/20","294","6","18109","2.04"
"Newton","1","88","Indiana","6/16/20","81","7","18111","8.64"
"Noble","5","341","Indiana","6/16/20","305","36","18113","11.8"
"Ohio","0","13","Indiana","6/16/20","13","0","18115","0"
"Orange","0","132","Indiana","6/16/20","132","0","18117","0"
"Owen","0","37","Indiana","6/16/20","36","1","18119","2.78"
"Parke","0","20","Indiana","6/16/20","19","1","18121","5.26"
"Perry","6","92","Indiana","6/16/20","47","45","18123","95.74"
"Pike","0","6","Indiana","6/16/20","6","0","18125","0"
"Porter","3","593","Indiana","6/16/20","575","18","18127","3.13"
"Posey","0","20","Indiana","6/16/20","17","3","18129","17.65"
"Pulaski","0","53","Indiana","6/16/20","52","1","18131","1.92"
"Putnam","2","159","Indiana","6/16/20","147","12","18133","8.16"
"Randolph","2","68","Indiana","6/16/20","57","11","18135","19.3"
"Ripley","0","111","Indiana","6/16/20","110","1","18137","0.91"
"Rush","0","51","Indiana","6/16/20","50","1","18139","2"
"Scott","2","146","Indiana","6/16/20","131","15","18143","11.45"
"Shelby","1","408","Indiana","6/16/20","402","6","18145","1.49"
"Spencer","0","23","Indiana","6/16/20","22","1","18147","4.55"
"St. Joseph","19","1571","Indiana","6/16/20","1437","134","18141","9.32"
"Starke","1","54","Indiana","6/16/20","46","8","18149","17.39"
"Steuben","2","106","Indiana","6/16/20","95","11","18151","11.58"
"Sullivan","0","41","Indiana","6/16/20","39","2","18153","5.13"
"Switzerland","0","22","Indiana","6/16/20","21","1","18155","4.76"
"Tippecanoe","5","492","Indiana","6/16/20","460","32","18157","6.96"
"Tipton","0","28","Indiana","6/16/20","27","1","18159","3.7"
"Union","0","12","Indiana","6/16/20","12","0","18161","0"
"Vanderburgh","3","329","Indiana","6/16/20","308","21","18163","6.82"
"Vermillion","0","12","Indiana","6/16/20","10","2","18165","20"
"Vigo","1","201","Indiana","6/16/20","197","4","18167","2.03"
"Wabash","0","88","Indiana","6/16/20","86","2","18169","2.33"
"Warren","0","14","Indiana","6/16/20","13","1","18171","7.69"
"Warrick","1","176","Indiana","6/16/20","168","8","18173","4.76"
"Washington","1","58","Indiana","6/16/20","52","6","18175","11.54"
"Wayne","2","103","Indiana","6/16/20","90","13","18177","14.44"
"Wells","3","62","Indiana","6/16/20","43","19","18179","44.19"
"White","0","242","Indiana","6/16/20","242","0","18181","0"
"Whitley","1","64","Indiana","6/16/20","55","9","18183","16.36"
"Adair","0","11","Iowa","6/16/20","9","2","19001","22.22"
"Adams","0","8","Iowa","6/16/20","7","1","19003","14.29"
"Allamakee","0","121","Iowa","6/16/20","120","1","19005","0.83"
"Appanoose","0","17","Iowa","6/16/20","16","1","19007","6.25"
"Audubon","0","14","Iowa","6/16/20","13","1","19009","7.69"
"Benton","0","46","Iowa","6/16/20","46","0","19011","0"
"Black Hawk","5","1838","Iowa","6/16/20","1802","36","19013","2"
"Boone","3","101","Iowa","6/16/20","78","23","19015","29.49"
"Bremer","0","74","Iowa","6/16/20","74","0","19017","0"
"Buchanan","0","35","Iowa","6/16/20","34","1","19019","2.94"
"Buena Vista","49","1600","Iowa","6/16/20","1257","343","19021","27.29"
"Butler","1","23","Iowa","6/16/20","16","7","19023","43.75"
"Calhoun","1","24","Iowa","6/16/20","14","10","19025","71.43"
"Carroll","5","49","Iowa","6/16/20","17","32","19027","188.24"
"Cass","0","14","Iowa","6/16/20","13","1","19029","7.69"
"Cedar","0","54","Iowa","6/16/20","52","2","19031","3.85"
"Cerro Gordo","2","48","Iowa","6/16/20","32","16","19033","50"
"Cherokee","2","59","Iowa","6/16/20","48","11","19035","22.92"
"Chickasaw","0","15","Iowa","6/16/20","15","0","19037","0"
"Clarke","2","89","Iowa","6/16/20","78","11","19039","14.1"
"Clay","7","83","Iowa","6/16/20","36","47","19041","130.56"
"Clayton","0","35","Iowa","6/16/20","34","1","19043","2.94"
"Clinton","0","68","Iowa","6/16/20","67","1","19045","1.49"
"Crawford","6","622","Iowa","6/16/20","582","40","19047","6.87"
"Dallas","9","1029","Iowa","6/16/20","969","60","19049","6.19"
"Davis","1","34","Iowa","6/16/20","29","5","19051","17.24"
"Decatur","1","9","Iowa","6/16/20","3","6","19053","200"
"Delaware","1","27","Iowa","6/16/20","20","7","19055","35"
"Des Moines","0","66","Iowa","6/16/20","68","-2","19057","-2.94"
"Dickinson","14","158","Iowa","6/16/20","63","95","19059","150.79"
"Dubuque","2","390","Iowa","6/16/20","373","17","19061","4.56"
"Emmet","1","41","Iowa","6/16/20","34","7","19063","20.59"
"Fayette","0","28","Iowa","6/16/20","28","0","19065","0"
"Floyd","0","21","Iowa","6/16/20","19","2","19067","10.53"
"Franklin","2","50","Iowa","6/16/20","35","15","19069","42.86"
"Fremont","0","4","Iowa","6/16/20","4","0","19071","0"
"Greene","1","21","Iowa","6/16/20","14","7","19073","50"
"Grundy","0","23","Iowa","6/16/20","20","3","19075","15"
"Guthrie","1","59","Iowa","6/16/20","55","4","19077","7.27"
"Hamilton","4","125","Iowa","6/16/20","96","29","19079","30.21"
"Hancock","1","32","Iowa","6/16/20","22","10","19081","45.45"
"Hardin","2","45","Iowa","6/16/20","32","13","19083","40.62"
"Harrison","2","40","Iowa","6/16/20","27","13","19085","48.15"
"Henry","0","74","Iowa","6/16/20","73","1","19087","1.37"
"Howard","0","12","Iowa","6/16/20","12","0","19089","0"
"Humboldt","1","34","Iowa","6/16/20","24","10","19091","41.67"
"Ida","0","18","Iowa","6/16/20","15","3","19093","20"
"Iowa","0","34","Iowa","6/16/20","33","1","19095","3.03"
"Jackson","0","14","Iowa","6/16/20","14","0","19097","0"
"Jasper","1","282","Iowa","6/16/20","274","8","19099","2.92"
"Jefferson","1","46","Iowa","6/16/20","40","6","19101","15"
"Johnson","3","650","Iowa","6/16/20","630","20","19103","3.17"
"Jones","0","41","Iowa","6/16/20","38","3","19105","7.89"
"Keokuk","0","16","Iowa","6/16/20","15","1","19107","6.67"
"Kossuth","0","19","Iowa","6/16/20","16","3","19109","18.75"
"Lee","1","40","Iowa","6/16/20","34","6","19111","17.65"
"Linn","3","1021","Iowa","6/16/20","1001","20","19113","2"
"Louisa","1","355","Iowa","6/16/20","351","4","19115","1.14"
"Lucas","0","25","Iowa","6/16/20","22","3","19117","13.64"
"Lyon","1","31","Iowa","6/16/20","26","5","19119","19.23"
"Madison","1","34","Iowa","6/16/20","29","5","19121","17.24"
"Mahaska","1","108","Iowa","6/16/20","103","5","19123","4.85"
"Marion","1","41","Iowa","6/16/20","37","4","19125","10.81"
"Marshall","2","942","Iowa","6/16/20","931","11","19127","1.18"
"Mills","0","24","Iowa","6/16/20","21","3","19129","14.29"
"Mitchell","0","8","Iowa","6/16/20","5","3","19131","60"
"Monona","3","49","Iowa","6/16/20","27","22","19133","81.48"
"Monroe","0","47","Iowa","6/16/20","45","2","19135","4.44"
"Montgomery","0","9","Iowa","6/16/20","9","0","19137","0"
"Muscatine","1","574","Iowa","6/16/20","568","6","19139","1.06"
"O'Brien","2","66","Iowa","6/16/20","55","11","19141","20"
"Osceola","1","49","Iowa","6/16/20","41","8","19143","19.51"
"Page","0","17","Iowa","6/16/20","16","1","19145","6.25"
"Palo Alto","1","16","Iowa","6/16/20","9","7","19147","77.78"
"Plymouth","4","203","Iowa","6/16/20","172","31","19149","18.02"
"Pocahontas","1","30","Iowa","6/16/20","21","9","19151","42.86"
"Polk","48","5199","Iowa","6/16/20","4863","336","19153","6.91"
"Pottawattamie","19","517","Iowa","6/16/20","385","132","19155","34.29"
"Poweshiek","0","95","Iowa","6/16/20","94","1","19157","1.06"
"Ringgold","0","8","Iowa","6/16/20","6","2","19159","33.33"
"Sac","1","38","Iowa","6/16/20","34","4","19161","11.76"
"Scott","2","408","Iowa","6/16/20","393","15","19163","3.82"
"Shelby","1","50","Iowa","6/16/20","40","10","19165","25"
"Sioux","6","362","Iowa","6/16/20","323","39","19167","12.07"
"Story","15","259","Iowa","6/16/20","157","102","19169","64.97"
"Tama","2","429","Iowa","6/16/20","417","12","19171","2.88"
"Taylor","1","74","Iowa","6/16/20","68","6","19173","8.82"
"Union","0","10","Iowa","6/16/20","11","-1","19175","-9.09"
"Van Buren","0","12","Iowa","6/16/20","10","2","19177","20"
"Wapello","3","675","Iowa","6/16/20","657","18","19179","2.74"
"Warren","3","197","Iowa","6/16/20","176","21","19181","11.93"
"Washington","1","208","Iowa","6/16/20","202","6","19183","2.97"
"Wayne","0","5","Iowa","6/16/20","3","2","19185","66.67"
"Webster","2","101","Iowa","6/16/20","87","14","19187","16.09"
"Winnebago","0","13","Iowa","6/16/20","12","1","19189","8.33"
"Winneshiek","0","24","Iowa","6/16/20","24","0","19191","0"
"Woodbury","10","3015","Iowa","6/16/20","2945","70","19193","2.38"
"Worth","0","5","Iowa","6/16/20","3","2","19195","66.67"
"Wright","7","291","Iowa","6/16/20","245","46","19197","18.78"
"Allen","0","2","Kansas","6/16/20","1","1","20001","100"
"Anderson","0","2","Kansas","6/16/20","1","1","20003","100"
"Atchison","0","27","Kansas","6/16/20","25","2","20005","8"
"Barber","0","1","Kansas","6/16/20","1","0","20007","0"
"Barton","0","49","Kansas","6/16/20","46","3","20009","6.52"
"Bourbon","0","8","Kansas","6/16/20","8","0","20011","0"
"Brown","0","10","Kansas","6/16/20","9","1","20013","11.11"
"Butler","0","37","Kansas","6/16/20","37","0","20015","0"
"Chase","0","3","Kansas","6/16/20","3","0","20017","0"
"Chautauqua","0","4","Kansas","6/16/20","4","0","20019","0"
"Cherokee","1","17","Kansas","6/16/20","11","6","20021","54.55"
"Cheyenne","0","2","Kansas","6/16/20","2","0","20023","0"
"Clark","0","34","Kansas","6/16/20","33","1","20025","3.03"
"Clay","0","6","Kansas","6/16/20","5","1","20027","20"
"Cloud","0","5","Kansas","6/16/20","5","0","20029","0"
"Coffey","0","52","Kansas","6/16/20","52","0","20031","0"
"Comanche","0","2","Kansas","6/16/20","2","0","20033","0"
"Cowley","2","41","Kansas","6/16/20","28","13","20035","46.43"
"Crawford","13","98","Kansas","6/16/20","10","88","20037","880"
"Dickinson","0","6","Kansas","6/16/20","5","1","20041","20"
"Doniphan","0","20","Kansas","6/16/20","20","0","20043","0"
"Douglas","1","83","Kansas","6/16/20","74","9","20045","12.16"
"Edwards","0","5","Kansas","6/16/20","5","0","20047","0"
"Ellis","0","13","Kansas","6/16/20","10","3","20051","30"
"Ellsworth","0","3","Kansas","6/16/20","2","1","20053","50"
"Finney","1","1543","Kansas","6/16/20","1536","7","20055","0.46"
"Ford","3","1863","Kansas","6/16/20","1840","23","20057","1.25"
"Franklin","2","51","Kansas","6/16/20","38","13","20059","34.21"
"Geary","0","29","Kansas","6/16/20","26","3","20061","11.54"
"Gove","0","1","Kansas","6/16/20","1","0","20063","0"
"Grant","0","18","Kansas","6/16/20","18","0","20067","0"
"Gray","0","23","Kansas","6/16/20","23","0","20069","0"
"Greenwood","0","11","Kansas","6/16/20","9","2","20073","22.22"
"Hamilton","1","28","Kansas","6/16/20","23","5","20075","21.74"
"Harper","0","2","Kansas","6/16/20","2","0","20077","0"
"Harvey","0","12","Kansas","6/16/20","11","1","20079","9.09"
"Haskell","0","22","Kansas","6/16/20","22","0","20081","0"
"Hodgeman","0","6","Kansas","6/16/20","6","0","20083","0"
"Jackson","0","103","Kansas","6/16/20","102","1","20085","0.98"
"Jefferson","0","22","Kansas","6/16/20","23","-1","20087","-4.35"
"Jewell","0","4","Kansas","6/16/20","4","0","20089","0"
"Johnson","17","1080","Kansas","6/16/20","959","121","20091","12.62"
"Kearny","0","46","Kansas","6/16/20","46","0","20093","0"
"Kiowa","0","3","Kansas","6/16/20","3","0","20097","0"
"Labette","0","27","Kansas","6/16/20","26","1","20099","3.85"
"Lane","0","4","Kansas","6/16/20","4","0","20101","0"
"Leavenworth","1","1111","Kansas","6/16/20","1103","8","20103","0.73"
"Linn","0","12","Kansas","6/16/20","11","1","20107","9.09"
"Lyon","9","465","Kansas","6/16/20","400","65","20111","16.25"
"Marion","0","5","Kansas","6/16/20","5","0","20115","0"
"McPherson","0","39","Kansas","6/16/20","38","1","20113","2.63"
"Meade","0","30","Kansas","6/16/20","30","0","20119","0"
"Miami","1","16","Kansas","6/16/20","7","9","20121","128.57"
"Mitchell","0","4","Kansas","6/16/20","4","0","20123","0"
"Montgomery","1","25","Kansas","6/16/20","20","5","20125","25"
"Morris","0","5","Kansas","6/16/20","5","0","20127","0"
"Morton","0","6","Kansas","6/16/20","6","0","20129","0"
"Nemaha","0","21","Kansas","6/16/20","19","2","20131","10.53"
"Neosho","1","8","Kansas","6/16/20","3","5","20133","166.67"
"Ness","0","4","Kansas","6/16/20","4","0","20135","0"
"Norton","0","3","Kansas","6/16/20","2","1","20137","50"
"Osage","0","10","Kansas","6/16/20","9","1","20139","11.11"
"Osborne","0","2","Kansas","6/16/20","2","0","20141","0"
"Ottawa","0","4","Kansas","6/16/20","4","0","20143","0"
"Pawnee","0","3","Kansas","6/16/20","4","-1","20145","-25"
"Phillips","0","2","Kansas","6/16/20","2","0","20147","0"
"Pottawatomie","1","34","Kansas","6/16/20","27","7","20149","25.93"
"Pratt","1","6","Kansas","6/16/20","2","4","20151","200"
"Reno","1","50","Kansas","6/16/20","46","4","20155","8.7"
"Republic","0","4","Kansas","6/16/20","4","0","20157","0"
"Rice","0","4","Kansas","6/16/20","4","0","20159","0"
"Riley","1","80","Kansas","6/16/20","71","9","20161","12.68"
"Rooks","0","6","Kansas","6/16/20","6","0","20163","0"
"Saline","1","32","Kansas","6/16/20","26","6","20169","23.08"
"Scott","0","16","Kansas","6/16/20","15","1","20171","6.67"
"Sedgwick","15","791","Kansas","6/16/20","689","102","20173","14.8"
"Seward","4","934","Kansas","6/16/20","904","30","20175","3.32"
"Shawnee","8","452","Kansas","6/16/20","394","58","20177","14.72"
"Sheridan","0","2","Kansas","6/16/20","2","0","20179","0"
"Sherman","0","7","Kansas","6/16/20","7","0","20181","0"
"Smith","0","3","Kansas","6/16/20","2","1","20183","50"
"Stafford","0","1","Kansas","6/16/20","1","0","20185","0"
"Stanton","0","9","Kansas","6/16/20","9","0","20187","0"
"Stevens","0","30","Kansas","6/16/20","30","0","20189","0"
"Sumner","0","9","Kansas","6/16/20","9","0","20191","0"
"Trego","0","1","Kansas","6/16/20","1","0","20195","0"
"Wabaunsee","0","31","Kansas","6/16/20","31","0","20197","0"
"Washington","0","1","Kansas","6/16/20","1","0","20201","0"
"Wilson","0","1","Kansas","6/16/20","1","0","20205","0"
"Woodson","0","6","Kansas","6/16/20","6","0","20207","0"
"Wyandotte","25","1698","Kansas","6/16/20","1522","176","20209","11.56"
"Adair","0","101","Kentucky","6/16/20","100","1","21001","1"
"Allen","3","135","Kentucky","6/16/20","116","19","21003","16.38"
"Anderson","0","25","Kentucky","6/16/20","25","0","21005","0"
"Ballard","0","14","Kentucky","6/16/20","13","1","21007","7.69"
"Barren","1","66","Kentucky","6/16/20","56","10","21009","17.86"
"Bath","0","10","Kentucky","6/16/20","9","1","21011","11.11"
"Bell","0","4","Kentucky","6/16/20","3","1","21013","33.33"
"Boone","2","541","Kentucky","6/16/20","527","14","21015","2.66"
"Bourbon","1","25","Kentucky","6/16/20","19","6","21017","31.58"
"Boyd","0","44","Kentucky","6/16/20","43","1","21019","2.33"
"Boyle","0","30","Kentucky","6/16/20","28","2","21021","7.14"
"Bracken","0","14","Kentucky","6/16/20","14","0","21023","0"
"Breathitt","0","4","Kentucky","6/16/20","3","1","21025","33.33"
"Breckinridge","1","23","Kentucky","6/16/20","19","4","21027","21.05"
"Bullitt","2","135","Kentucky","6/16/20","124","11","21029","8.87"
"Butler","1","244","Kentucky","6/16/20","239","5","21031","2.09"
"Caldwell","0","12","Kentucky","6/16/20","12","0","21033","0"
"Calloway","1","60","Kentucky","6/16/20","56","4","21035","7.14"
"Campbell","1","207","Kentucky","6/16/20","197","10","21037","5.08"
"Carlisle","0","5","Kentucky","6/16/20","5","0","21039","0"
"Carroll","0","17","Kentucky","6/16/20","16","1","21041","6.25"
"Carter","0","18","Kentucky","6/16/20","17","1","21043","5.88"
"Casey","0","10","Kentucky","6/16/20","8","2","21045","25"
"Christian","1","138","Kentucky","6/16/20","131","7","21047","5.34"
"Clark","2","77","Kentucky","6/16/20","60","17","21049","28.33"
"Clay","1","17","Kentucky","6/16/20","10","7","21051","70"
"Clinton","0","5","Kentucky","6/16/20","5","0","21053","0"
"Crittenden","0","7","Kentucky","6/16/20","7","0","21055","0"
"Cumberland","0","5","Kentucky","6/16/20","5","0","21057","0"
"Daviess","3","360","Kentucky","6/16/20","341","19","21059","5.57"
"Edmonson","1","67","Kentucky","6/16/20","62","5","21061","8.06"
"Elliott","0","2","Kentucky","6/16/20","1","1","21063","100"
"Estill","1","5","Kentucky","6/16/20","1","4","21065","400"
"Fayette","21","1064","Kentucky","6/16/20","920","144","21067","15.65"
"Fleming","1","6","Kentucky","6/16/20","2","4","21069","200"
"Floyd","0","19","Kentucky","6/16/20","17","2","21071","11.76"
"Franklin","2","98","Kentucky","6/16/20","84","14","21073","16.67"
"Fulton","0","12","Kentucky","6/16/20","12","0","21075","0"
"Gallatin","1","57","Kentucky","6/16/20","49","8","21077","16.33"
"Garrard","1","11","Kentucky","6/16/20","6","5","21079","83.33"
"Grant","0","53","Kentucky","6/16/20","51","2","21081","3.92"
"Graves","1","175","Kentucky","6/16/20","167","8","21083","4.79"
"Grayson","0","137","Kentucky","6/16/20","135","2","21085","1.48"
"Green","0","3","Kentucky","6/16/20","2","1","21087","50"
"Greenup","0","16","Kentucky","6/16/20","14","2","21089","14.29"
"Hancock","0","9","Kentucky","6/16/20","7","2","21091","28.57"
"Hardin","2","133","Kentucky","6/16/20","122","11","21093","9.02"
"Harlan","1","13","Kentucky","6/16/20","8","5","21095","62.5"
"Harrison","1","34","Kentucky","6/16/20","28","6","21097","21.43"
"Hart","0","30","Kentucky","6/16/20","27","3","21099","11.11"
"Henderson","2","133","Kentucky","6/16/20","119","14","21101","11.76"
"Henry","0","26","Kentucky","6/16/20","24","2","21103","8.33"
"Hickman","0","5","Kentucky","6/16/20","5","0","21105","0"
"Hopkins","1","229","Kentucky","6/16/20","224","5","21107","2.23"
"Jackson","0","63","Kentucky","6/16/20","61","2","21109","3.28"
"Jefferson","25","3363","Kentucky","6/16/20","3186","177","21111","5.56"
"Jessamine","1","83","Kentucky","6/16/20","74","9","21113","12.16"
"Johnson","0","6","Kentucky","6/16/20","5","1","21115","20"
"Kenton","1","690","Kentucky","6/16/20","680","10","21117","1.47"
"Knott","0","4","Kentucky","6/16/20","4","0","21119","0"
"Knox","0","11","Kentucky","6/16/20","10","1","21121","10"
"Larue","0","11","Kentucky","6/16/20","11","0","21123","0"
"Laurel","1","30","Kentucky","6/16/20","22","8","21125","36.36"
"Lawrence","0","5","Kentucky","6/16/20","5","0","21127","0"
"Lee","0","1","Kentucky","6/16/20","1","0","21129","0"
"Leslie","0","6","Kentucky","6/16/20","6","0","21131","0"
"Letcher","0","4","Kentucky","6/16/20","3","1","21133","33.33"
"Lewis","1","14","Kentucky","6/16/20","7","7","21135","100"
"Lincoln","0","15","Kentucky","6/16/20","14","1","21137","7.14"
"Livingston","0","9","Kentucky","6/16/20","9","0","21139","0"
"Logan","4","199","Kentucky","6/16/20","173","26","21141","15.03"
"Lyon","0","18","Kentucky","6/16/20","17","1","21143","5.88"
"Madison","1","77","Kentucky","6/16/20","70","7","21151","10"
"Magoffin","0","4","Kentucky","6/16/20","2","2","21153","100"
"Marion","1","42","Kentucky","6/16/20","36","6","21155","16.67"
"Marshall","1","44","Kentucky","6/16/20","37","7","21157","18.92"
"Martin","0","3","Kentucky","6/16/20","3","0","21159","0"
"Mason","0","16","Kentucky","6/16/20","13","3","21161","23.08"
"McCracken","1","123","Kentucky","6/16/20","113","10","21145","8.85"
"McCreary","0","13","Kentucky","6/16/20","13","0","21147","0"
"McLean","0","23","Kentucky","6/16/20","22","1","21149","4.55"
"Meade","0","24","Kentucky","6/16/20","23","1","21163","4.35"
"Menifee","0","10","Kentucky","6/16/20","10","0","21165","0"
"Mercer","0","16","Kentucky","6/16/20","15","1","21167","6.67"
"Metcalfe","0","8","Kentucky","6/16/20","7","1","21169","14.29"
"Monroe","1","31","Kentucky","6/16/20","27","4","21171","14.81"
"Montgomery","1","37","Kentucky","6/16/20","30","7","21173","23.33"
"Morgan","0","6","Kentucky","6/16/20","4","2","21175","50"
"Muhlenberg","-1","482","Kentucky","6/16/20","486","-4","21177","-0.82"
"Nelson","0","48","Kentucky","6/16/20","45","3","21179","6.67"
"Nicholas","0","4","Kentucky","6/16/20","4","0","21181","0"
"Ohio","1","164","Kentucky","6/16/20","154","10","21183","6.49"
"Oldham","0","113","Kentucky","6/16/20","112","1","21185","0.89"
"Owen","0","4","Kentucky","6/16/20","4","0","21187","0"
"Owsley","0","2","Kentucky","6/16/20","2","0","21189","0"
"Pendleton","0","14","Kentucky","6/16/20","14","0","21191","0"
"Perry","0","24","Kentucky","6/16/20","22","2","21193","9.09"
"Pike","1","48","Kentucky","6/16/20","38","10","21195","26.32"
"Powell","0","5","Kentucky","6/16/20","2","3","21197","150"
"Pulaski","1","72","Kentucky","6/16/20","65","7","21199","10.77"
"Rockcastle","0","14","Kentucky","6/16/20","13","1","21203","7.69"
"Rowan","1","15","Kentucky","6/16/20","11","4","21205","36.36"
"Russell","1","38","Kentucky","6/16/20","32","6","21207","18.75"
"Scott","1","43","Kentucky","6/16/20","38","5","21209","13.16"
"Shelby","6","277","Kentucky","6/16/20","233","44","21211","18.88"
"Simpson","0","59","Kentucky","6/16/20","56","3","21213","5.36"
"Spencer","0","26","Kentucky","6/16/20","25","1","21215","4"
"Taylor","0","17","Kentucky","6/16/20","15","2","21217","13.33"
"Todd","0","23","Kentucky","6/16/20","23","0","21219","0"
"Trigg","1","17","Kentucky","6/16/20","12","5","21221","41.67"
"Trimble","0","4","Kentucky","6/16/20","6","-2","21223","-33.33"
"Union","1","19","Kentucky","6/16/20","15","4","21225","26.67"
"Warren","17","1275","Kentucky","6/16/20","1157","118","21227","10.2"
"Washington","1","14","Kentucky","6/16/20","8","6","21229","75"
"Wayne","0","10","Kentucky","6/16/20","9","1","21231","11.11"
"Webster","0","37","Kentucky","6/16/20","34","3","21233","8.82"
"Whitley","0","17","Kentucky","6/16/20","14","3","21235","21.43"
"Wolfe","0","1","Kentucky","6/16/20","1","0","21237","0"
"Woodford","1","51","Kentucky","6/16/20","42","9","21239","21.43"
"Acadia","12","604","Louisiana","6/16/20","517","87","22001","16.83"
"Allen","6","230","Louisiana","6/16/20","189","41","22003","21.69"
"Ascension","8","957","Louisiana","6/16/20","900","57","22005","6.33"
"Assumption","3","276","Louisiana","6/16/20","258","18","22007","6.98"
"Avoyelles","2","188","Louisiana","6/16/20","175","13","22009","7.43"
"Beauregard","3","136","Louisiana","6/16/20","114","22","22011","19.3"
"Bienville","3","176","Louisiana","6/16/20","157","19","22013","12.1"
"Bossier","6","513","Louisiana","6/16/20","473","40","22015","8.46"
"Caddo","19","2888","Louisiana","6/16/20","2755","133","22017","4.83"
"Calcasieu","18","789","Louisiana","6/16/20","661","128","22019","19.36"
"Caldwell","1","83","Louisiana","6/16/20","74","9","22021","12.16"
"Cameron","0","11","Louisiana","6/16/20","10","1","22023","10"
"Catahoula","6","162","Louisiana","6/16/20","121","41","22025","33.88"
"Claiborne","2","81","Louisiana","6/16/20","70","11","22027","15.71"
"Concordia","2","109","Louisiana","6/16/20","97","12","22029","12.37"
"De Soto","1","273","Louisiana","6/16/20","263","10","22031","3.8"
"East Baton Rouge","40","4301","Louisiana","6/16/20","4023","278","22033","6.91"
"East Carroll","5","243","Louisiana","6/16/20","205","38","22035","18.54"
"East Feliciana","3","229","Louisiana","6/16/20","207","22","22037","10.63"
"Evangeline","1","93","Louisiana","6/16/20","85","8","22039","9.41"
"Franklin","5","425","Louisiana","6/16/20","390","35","22041","8.97"
"Grant","2","61","Louisiana","6/16/20","48","13","22043","27.08"
"Iberia","7","476","Louisiana","6/16/20","428","48","22045","11.21"
"Iberville","2","617","Louisiana","6/16/20","603","14","22047","2.32"
"Jackson","4","169","Louisiana","6/16/20","139","30","22049","21.58"
"Jefferson","75","8468","Louisiana","6/16/20","7940","528","22051","6.65"
"Jefferson Davis","7","147","Louisiana","6/16/20","96","51","22053","53.12"
"Lafayette","48","1243","Louisiana","6/16/20","908","335","22055","36.89"
"Lafourche","11","999","Louisiana","6/16/20","922","77","22057","8.35"
"LaSalle","3","85","Louisiana","6/16/20","66","19","22059","28.79"
"Lincoln","9","248","Louisiana","6/16/20","184","64","22061","34.78"
"Livingston","11","561","Louisiana","6/16/20","481","80","22063","16.63"
"Madison","10","287","Louisiana","6/16/20","219","68","22065","31.05"
"Morehouse","4","165","Louisiana","6/16/20","135","30","22067","22.22"
"Natchitoches","2","195","Louisiana","6/16/20","179","16","22069","8.94"
"Orleans","26","7428","Louisiana","6/16/20","7247","181","22071","2.5"
"Ouachita","41","1832","Louisiana","6/16/20","1543","289","22073","18.73"
"Plaquemines","1","228","Louisiana","6/16/20","219","9","22075","4.11"
"Pointe Coupee","1","223","Louisiana","6/16/20","215","8","22077","3.72"
"Rapides","31","1209","Louisiana","6/16/20","992","217","22079","21.88"
"Red River","0","52","Louisiana","6/16/20","52","0","22081","0"
"Richland","1","164","Louisiana","6/16/20","157","7","22083","4.46"
"Sabine","1","62","Louisiana","6/16/20","52","10","22085","19.23"
"St. Bernard","3","575","Louisiana","6/16/20","555","20","22087","3.6"
"St. Charles","2","665","Louisiana","6/16/20","652","13","22089","1.99"
"St. Helena","1","60","Louisiana","6/16/20","55","5","22091","9.09"
"St. James","1","309","Louisiana","6/16/20","305","4","22093","1.31"
"St. John the Baptist","2","894","Louisiana","6/16/20","881","13","22095","1.48"
"St. Landry","9","379","Louisiana","6/16/20","316","63","22097","19.94"
"St. Martin","13","381","Louisiana","6/16/20","291","90","22099","30.93"
"St. Mary","3","360","Louisiana","6/16/20","342","18","22101","5.26"
"St. Tammany","14","1962","Louisiana","6/16/20","1863","99","22103","5.31"
"Tangipahoa","14","1062","Louisiana","6/16/20","965","97","22105","10.05"
"Tensas","0","22","Louisiana","6/16/20","21","1","22107","4.76"
"Terrebonne","9","818","Louisiana","6/16/20","756","62","22109","8.2"
"Union","8","422","Louisiana","6/16/20","366","56","22111","15.3"
"Vermilion","3","85","Louisiana","6/16/20","61","24","22113","39.34"
"Vernon","3","58","Louisiana","6/16/20","39","19","22115","48.72"
"Washington","10","556","Louisiana","6/16/20","489","67","22117","13.7"
"Webster","8","252","Louisiana","6/16/20","195","57","22119","29.23"
"West Baton Rouge","2","204","Louisiana","6/16/20","192","12","22121","6.25"
"West Carroll","3","114","Louisiana","6/16/20","90","24","22123","26.67"
"West Feliciana","1","234","Louisiana","6/16/20","224","10","22125","4.46"
"Winn","4","215","Louisiana","6/16/20","190","25","22127","13.16"
"Androscoggin","7","428","Maine","6/16/20","381","47","23001","12.34"
"Aroostook","0","10","Maine","6/16/20","10","0","23003","0"
"Cumberland","18","1450","Maine","6/16/20","1324","126","23005","9.52"
"Franklin","0","37","Maine","6/16/20","36","1","23007","2.78"
"Hancock","0","13","Maine","6/16/20","12","1","23009","8.33"
"Kennebec","1","137","Maine","6/16/20","131","6","23011","4.58"
"Knox","0","23","Maine","6/16/20","21","2","23013","9.52"
"Lincoln","0","21","Maine","6/16/20","20","1","23015","5"
"Oxford","0","34","Maine","6/16/20","31","3","23017","9.68"
"Penobscot","0","101","Maine","6/16/20","101","0","23019","0"
"Piscataquis","0","1","Maine","6/16/20","1","0","23021","0"
"Sagadahoc","0","30","Maine","6/16/20","30","0","23023","0"
"Somerset","0","25","Maine","6/16/20","24","1","23025","4.17"
"Waldo","0","55","Maine","6/16/20","53","2","23027","3.77"
"Washington","0","1","Maine","6/16/20","1","0","23029","0"
"York","3","450","Maine","6/16/20","428","22","23031","5.14"
"Allegany","0","188","Maryland","6/16/20","186","2","24001","1.08"
"Anne Arundel","63","4751","Maryland","6/16/20","4309","442","24003","10.26"
"Baltimore","57","7248","Maryland","6/16/20","6852","396","24005","5.78"
"Baltimore City","61","6782","Maryland","6/16/20","6355","427","24510","6.72"
"Calvert","2","380","Maryland","6/16/20","363","17","24009","4.68"
"Caroline","2","284","Maryland","6/16/20","273","11","24011","4.03"
"Carroll","3","987","Maryland","6/16/20","963","24","24013","2.49"
"Cecil","5","450","Maryland","6/16/20","417","33","24015","7.91"
"Charles","9","1277","Maryland","6/16/20","1216","61","24017","5.02"
"Dorchester","1","166","Maryland","6/16/20","157","9","24019","5.73"
"Frederick","22","2308","Maryland","6/16/20","2152","156","24021","7.25"
"Garrett","0","10","Maryland","6/16/20","10","0","24023","0"
"Harford","8","1023","Maryland","6/16/20","969","54","24025","5.57"
"Howard","19","2327","Maryland","6/16/20","2191","136","24027","6.21"
"Kent","1","193","Maryland","6/16/20","188","5","24029","2.66"
"Montgomery","106","13709","Maryland","6/16/20","12968","741","24031","5.71"
"Prince George's","123","17499","Maryland","6/16/20","16636","863","24033","5.19"
"Queen Anne's","1","183","Maryland","6/16/20","177","6","24035","3.39"
"Somerset","1","82","Maryland","6/16/20","77","5","24039","6.49"
"St. Mary's","3","585","Maryland","6/16/20","561","24","24037","4.28"
"Talbot","0","109","Maryland","6/16/20","108","1","24041","0.93"
"Washington","5","579","Maryland","6/16/20","545","34","24043","6.24"
"Wicomico","6","1031","Maryland","6/16/20","990","41","24045","4.14"
"Worcester","2","258","Maryland","6/16/20","241","17","24047","7.05"
"Barnstable","5","1494","Massachusetts","6/16/20","1462","32","25001","2.19"
"Berkshire","0","578","Massachusetts","6/16/20","575","3","25003","0.52"
"Bristol","30","7940","Massachusetts","6/16/20","7728","212","25005","2.74"
"Dukes and Nantucket","0","57","Massachusetts","6/16/20","56","1","00000","1.79"
"Essex","57","15667","Massachusetts","6/16/20","15271","396","25009","2.59"
"Franklin","2","353","Massachusetts","6/16/20","341","12","25011","3.52"
"Hampden","18","6503","Massachusetts","6/16/20","6380","123","25013","1.93"
"Hampshire","4","930","Massachusetts","6/16/20","905","25","25015","2.76"
"Middlesex","61","23269","Massachusetts","6/16/20","22845","424","25017","1.86"
"Norfolk","20","8892","Massachusetts","6/16/20","8753","139","25021","1.59"
"Plymouth","16","8514","Massachusetts","6/16/20","8404","110","25023","1.31"
"Suffolk","43","19367","Massachusetts","6/16/20","19067","300","25025","1.57"
"Worcester","30","12014","Massachusetts","6/16/20","11803","211","25027","1.79"
"Alcona","0","21","Michigan","6/16/20","20","1","26001","5"
"Alger","0","1","Michigan","6/16/20","1","0","26003","0"
"Allegan","2","288","Michigan","6/16/20","274","14","26005","5.11"
"Alpena","0","114","Michigan","6/16/20","112","2","26007","1.79"
"Antrim","0","14","Michigan","6/16/20","14","0","26009","0"
"Arenac","0","38","Michigan","6/16/20","38","0","26011","0"
"Baraga","0","1","Michigan","6/16/20","1","0","26013","0"
"Barry","0","91","Michigan","6/16/20","89","2","26015","2.25"
"Bay","1","376","Michigan","6/16/20","372","4","26017","1.08"
"Benzie","0","5","Michigan","6/16/20","5","0","26019","0"
"Berrien","3","827","Michigan","6/16/20","808","19","26021","2.35"
"Branch","12","237","Michigan","6/16/20","155","82","26023","52.9"
"Calhoun","3","492","Michigan","6/16/20","474","18","26025","3.8"
"Cass","1","116","Michigan","6/16/20","110","6","26027","5.45"
"Charlevoix","0","22","Michigan","6/16/20","19","3","26029","15.79"
"Cheboygan","0","26","Michigan","6/16/20","26","0","26031","0"
"Chippewa","0","4","Michigan","6/16/20","3","1","26033","33.33"
"Clare","0","25","Michigan","6/16/20","24","1","26035","4.17"
"Clinton","0","190","Michigan","6/16/20","187","3","26037","1.6"
"Crawford","0","65","Michigan","6/16/20","63","2","26039","3.17"
"Delta","0","21","Michigan","6/16/20","20","1","26041","5"
"Dickinson","0","7","Michigan","6/16/20","6","1","26043","16.67"
"Eaton","0","258","Michigan","6/16/20","255","3","26045","1.18"
"Emmet","0","26","Michigan","6/16/20","26","0","26047","0"
"Federal Correctional Institution (FCI)","1","166","Michigan","6/16/20","159","7","00000","4.4"
"Genesee","4","2589","Michigan","6/16/20","2558","31","26049","1.21"
"Gladwin","0","20","Michigan","6/16/20","20","0","26051","0"
"Gogebic","0","5","Michigan","6/16/20","5","0","26053","0"
"Grand Traverse","0","37","Michigan","6/16/20","35","2","26055","5.71"
"Gratiot","0","90","Michigan","6/16/20","88","2","26057","2.27"
"Hillsdale","0","182","Michigan","6/16/20","179","3","26059","1.68"
"Houghton","0","8","Michigan","6/16/20","8","0","26061","0"
"Huron","0","60","Michigan","6/16/20","60","0","26063","0"
"Ingham","1","817","Michigan","6/16/20","810","7","26065","0.86"
"Ionia","1","180","Michigan","6/16/20","176","4","26067","2.27"
"Iosco","0","111","Michigan","6/16/20","110","1","26069","0.91"
"Iron","0","3","Michigan","6/16/20","2","1","26071","50"
"Isabella","1","99","Michigan","6/16/20","95","4","26073","4.21"
"Jackson","0","486","Michigan","6/16/20","484","2","26075","0.41"
"Kalamazoo","3","958","Michigan","6/16/20","940","18","26077","1.91"
"Kalkaska","0","30","Michigan","6/16/20","30","0","26079","0"
"Kent","31","4471","Michigan","6/16/20","4256","215","26081","5.05"
"Keweenaw","0","1","Michigan","6/16/20","1","0","26083","0"
"Lake","0","7","Michigan","6/16/20","7","0","26085","0"
"Lapeer","1","230","Michigan","6/16/20","225","5","26087","2.22"
"Leelanau","0","12","Michigan","6/16/20","12","0","26089","0"
"Lenawee","1","201","Michigan","6/16/20","191","10","26091","5.24"
"Livingston","1","526","Michigan","6/16/20","519","7","26093","1.35"
"Luce","0","3","Michigan","6/16/20","3","0","26095","0"
"Mackinac","0","8","Michigan","6/16/20","8","0","26097","0"
"Macomb","13","7091","Michigan","6/16/20","7000","91","26099","1.3"
"Manistee","0","12","Michigan","6/16/20","12","0","26101","0"
"Marquette","0","59","Michigan","6/16/20","59","0","26103","0"
"Mason","0","38","Michigan","6/16/20","38","0","26105","0"
"Mecosta","0","26","Michigan","6/16/20","24","2","26107","8.33"
"Menominee","0","9","Michigan","6/16/20","9","0","26109","0"
"Michigan Department of Corrections (MDOC)","-10","4058","Michigan","6/16/20","4129","-71","00000","-1.72"
"Midland","2","152","Michigan","6/16/20","138","14","26111","10.14"
"Missaukee","0","24","Michigan","6/16/20","23","1","26113","4.35"
"Monroe","2","571","Michigan","6/16/20","560","11","26115","1.96"
"Montcalm","0","81","Michigan","6/16/20","81","0","26117","0"
"Montmorency","0","5","Michigan","6/16/20","5","0","26119","0"
"Muskegon","2","742","Michigan","6/16/20","725","17","26121","2.34"
"Newaygo","0","128","Michigan","6/16/20","125","3","26123","2.4"
"Oakland","16","11372","Michigan","6/16/20","11262","110","26125","0.98"
"Oceana","2","116","Michigan","6/16/20","103","13","26127","12.62"
"Ogemaw","0","32","Michigan","6/16/20","31","1","26129","3.23"
"Osceola","1","22","Michigan","6/16/20","18","4","26133","22.22"
"Oscoda","0","8","Michigan","6/16/20","8","0","26135","0"
"Otsego","0","120","Michigan","6/16/20","120","0","26137","0"
"Ottawa","5","936","Michigan","6/16/20","900","36","26139","4"
"Out of MI","2","35","Michigan","6/16/20","23","12","80026","52.17"
"Presque Isle","0","12","Michigan","6/16/20","11","1","26141","9.09"
"Roscommon","0","25","Michigan","6/16/20","24","1","26143","4.17"
"Saginaw","4","1168","Michigan","6/16/20","1138","30","26145","2.64"
"Sanilac","0","43","Michigan","6/16/20","42","1","26151","2.38"
"Schoolcraft","0","4","Michigan","6/16/20","4","0","26153","0"
"Shiawassee","0","265","Michigan","6/16/20","262","3","26155","1.15"
"St. Clair","1","518","Michigan","6/16/20","514","4","26147","0.78"
"St. Joseph","5","193","Michigan","6/16/20","160","33","26149","20.62"
"Tuscola","1","216","Michigan","6/16/20","206","10","26157","4.85"
"Van Buren","2","207","Michigan","6/16/20","195","12","26159","6.15"
"Washtenaw","5","1584","Michigan","6/16/20","1551","33","26161","2.13"
"Wayne","35","21805","Michigan","6/16/20","21562","243","26163","1.13"
"Wexford","0","17","Michigan","6/16/20","14","3","26165","21.43"
"Aitkin","0","13","Minnesota","6/16/20","13","0","27001","0"
"Anoka","20","1770","Minnesota","6/16/20","1627","143","27003","8.79"
"Becker","1","50","Minnesota","6/16/20","45","5","27005","11.11"
"Beltrami","0","23","Minnesota","6/16/20","21","2","27007","9.52"
"Benton","0","193","Minnesota","6/16/20","190","3","27009","1.58"
"Big Stone","0","13","Minnesota","6/16/20","12","1","27011","8.33"
"Blue Earth","2","164","Minnesota","6/16/20","153","11","27013","7.19"
"Brown","0","20","Minnesota","6/16/20","17","3","27015","17.65"
"Carlton","0","80","Minnesota","6/16/20","78","2","27017","2.56"
"Carver","3","276","Minnesota","6/16/20","257","19","27019","7.39"
"Cass","0","11","Minnesota","6/16/20","12","-1","27021","-8.33"
"Chippewa","1","57","Minnesota","6/16/20","53","4","27023","7.55"
"Chisago","1","80","Minnesota","6/16/20","70","10","27025","14.29"
"Clay","4","506","Minnesota","6/16/20","481","25","27027","5.2"
"Clearwater","0","5","Minnesota","6/16/20","3","2","27029","66.67"
"Cook","0","1","Minnesota","6/16/20","0","1","27031","1"
"Cottonwood","2","111","Minnesota","6/16/20","94","17","27033","18.09"
"Crow Wing","1","90","Minnesota","6/16/20","86","4","27035","4.65"
"Dakota","29","1758","Minnesota","6/16/20","1554","204","27037","13.13"
"Dodge","1","59","Minnesota","6/16/20","55","4","27039","7.27"
"Douglas","0","48","Minnesota","6/16/20","48","0","27041","0"
"Faribault","0","28","Minnesota","6/16/20","25","3","27043","12"
"Fillmore","0","20","Minnesota","6/16/20","20","0","27045","0"
"Freeborn","5","222","Minnesota","6/16/20","188","34","27047","18.09"
"Goodhue","2","94","Minnesota","6/16/20","83","11","27049","13.25"
"Grant","0","6","Minnesota","6/16/20","5","1","27051","20"
"Hennepin","108","10323","Minnesota","6/16/20","9567","756","27053","7.9"
"Houston","0","5","Minnesota","6/16/20","5","0","27055","0"
"Hubbard","0","5","Minnesota","6/16/20","5","0","27057","0"
"Isanti","1","50","Minnesota","6/16/20","43","7","27059","16.28"
"Itasca","0","59","Minnesota","6/16/20","57","2","27061","3.51"
"Jackson","1","48","Minnesota","6/16/20","42","6","27063","14.29"
"Kanabec","0","13","Minnesota","6/16/20","12","1","27065","8.33"
"Kandiyohi","3","548","Minnesota","6/16/20","526","22","27067","4.18"
"Kittson","0","1","Minnesota","6/16/20","1","0","27069","0"
"Koochiching","0","9","Minnesota","6/16/20","9","0","27071","0"
"Lac qui Parle","0","3","Minnesota","6/16/20","3","0","27073","0"
"Lake","0","2","Minnesota","6/16/20","1","1","27075","100"
"Le Sueur","0","52","Minnesota","6/16/20","50","2","27079","4"
"Lincoln","0","6","Minnesota","6/16/20","6","0","27081","0"
"Lyon","11","222","Minnesota","6/16/20","145","77","27083","53.1"
"Mahnomen","0","6","Minnesota","6/16/20","6","0","27087","0"
"Marshall","0","12","Minnesota","6/16/20","12","0","27089","0"
"Martin","1","147","Minnesota","6/16/20","142","5","27091","3.52"
"McLeod","1","54","Minnesota","6/16/20","45","9","27085","20"
"Meeker","0","50","Minnesota","6/16/20","47","3","27093","6.38"
"Mille Lacs","1","28","Minnesota","6/16/20","24","4","27095","16.67"
"Morrison","0","54","Minnesota","6/16/20","51","3","27097","5.88"
"Mower","18","661","Minnesota","6/16/20","537","124","27099","23.09"
"Murray","0","43","Minnesota","6/16/20","41","2","27101","4.88"
"Nicollet","1","95","Minnesota","6/16/20","91","4","27103","4.4"
"Nobles","3","1620","Minnesota","6/16/20","1597","23","27105","1.44"
"Norman","0","17","Minnesota","6/16/20","16","1","27107","6.25"
"Olmsted","8","781","Minnesota","6/16/20","727","54","27109","7.43"
"Otter Tail","1","83","Minnesota","6/16/20","78","5","27111","6.41"
"Pennington","2","51","Minnesota","6/16/20","37","14","27113","37.84"
"Pine","0","96","Minnesota","6/16/20","94","2","27115","2.13"
"Pipestone","0","14","Minnesota","6/16/20","14","0","27117","0"
"Polk","0","67","Minnesota","6/16/20","67","0","27119","0"
"Pope","0","10","Minnesota","6/16/20","10","0","27121","0"
"Ramsey","58","4033","Minnesota","6/16/20","3626","407","27123","11.22"
"Red Lake","0","4","Minnesota","6/16/20","4","0","27125","0"
"Redwood","1","12","Minnesota","6/16/20","8","4","27127","50"
"Renville","1","12","Minnesota","6/16/20","8","4","27129","50"
"Rice","15","697","Minnesota","6/16/20","593","104","27131","17.54"
"Rock","0","25","Minnesota","6/16/20","23","2","27133","8.7"
"Roseau","0","6","Minnesota","6/16/20","5","1","27135","20"
"Scott","6","541","Minnesota","6/16/20","496","45","27139","9.07"
"Sherburne","1","270","Minnesota","6/16/20","261","9","27141","3.45"
"Sibley","1","25","Minnesota","6/16/20","19","6","27143","31.58"
"St. Louis","1","124","Minnesota","6/16/20","119","5","27137","4.2"
"Stearns","5","2109","Minnesota","6/16/20","2076","33","27145","1.59"
"Steele","0","175","Minnesota","6/16/20","173","2","27147","1.16"
"Stevens","0","1","Minnesota","6/16/20","1","0","27149","0"
"Swift","0","20","Minnesota","6/16/20","19","1","27151","5.26"
"Todd","2","375","Minnesota","6/16/20","361","14","27153","3.88"
"Traverse","0","5","Minnesota","6/16/20","5","0","27155","0"
"Wabasha","0","21","Minnesota","6/16/20","20","1","27157","5"
"Wadena","0","10","Minnesota","6/16/20","10","0","27159","0"
"Waseca","0","34","Minnesota","6/16/20","32","2","27161","6.25"
"Washington","10","802","Minnesota","6/16/20","732","70","27163","9.56"
"Watonwan","2","99","Minnesota","6/16/20","84","15","27165","17.86"
"Wilkin","1","15","Minnesota","6/16/20","11","4","27167","36.36"
"Winona","0","85","Minnesota","6/16/20","85","0","27169","0"
"Wright","3","383","Minnesota","6/16/20","361","22","27171","6.09"
"Yellow Medicine","1","11","Minnesota","6/16/20","7","4","27173","57.14"
"Adams","1","226","Mississippi","6/16/20","222","4","28001","1.8"
"Alcorn","1","32","Mississippi","6/16/20","23","9","28003","39.13"
"Amite","1","71","Mississippi","6/16/20","66","5","28005","7.58"
"Attala","2","333","Mississippi","6/16/20","319","14","28007","4.39"
"Benton","0","19","Mississippi","6/16/20","16","3","28009","18.75"
"Bolivar","2","194","Mississippi","6/16/20","179","15","28011","8.38"
"Calhoun","1","82","Mississippi","6/16/20","74","8","28013","10.81"
"Carroll","0","122","Mississippi","6/16/20","121","1","28015","0.83"
"Chickasaw","2","168","Mississippi","6/16/20","154","14","28017","9.09"
"Choctaw","1","66","Mississippi","6/16/20","62","4","28019","6.45"
"Claiborne","2","142","Mississippi","6/16/20","129","13","28021","10.08"
"Clarke","0","166","Mississippi","6/16/20","163","3","28023","1.84"
"Clay","5","174","Mississippi","6/16/20","137","37","28025","27.01"
"Coahoma","2","153","Mississippi","6/16/20","141","12","28027","8.51"
"Copiah","8","418","Mississippi","6/16/20","360","58","28029","16.11"
"Covington","3","209","Mississippi","6/16/20","190","19","28031","10"
"DeSoto","14","740","Mississippi","6/16/20","642","98","28033","15.26"
"Forrest","6","689","Mississippi","6/16/20","649","40","28035","6.16"
"Franklin","0","30","Mississippi","6/16/20","29","1","28037","3.45"
"George","1","40","Mississippi","6/16/20","32","8","28039","25"
"Greene","1","56","Mississippi","6/16/20","47","9","28041","19.15"
"Grenada","5","167","Mississippi","6/16/20","133","34","28043","25.56"
"Hancock","1","100","Mississippi","6/16/20","93","7","28045","7.53"
"Harrison","11","377","Mississippi","6/16/20","299","78","28047","26.09"
"Hinds","23","1349","Mississippi","6/16/20","1186","163","28049","13.74"
"Holmes","2","474","Mississippi","6/16/20","461","13","28051","2.82"
"Humphreys","1","83","Mississippi","6/16/20","75","8","28053","10.67"
"Itawamba","2","106","Mississippi","6/16/20","93","13","28057","13.98"
"Jackson","6","378","Mississippi","6/16/20","338","40","28059","11.83"
"Jasper","2","200","Mississippi","6/16/20","185","15","28061","8.11"
"Jefferson","1","54","Mississippi","6/16/20","50","4","28063","8"
"Jefferson Davis","0","84","Mississippi","6/16/20","85","-1","28065","-1.18"
"Jones","15","899","Mississippi","6/16/20","792","107","28067","13.51"
"Kemper","1","170","Mississippi","6/16/20","166","4","28069","2.41"
"Lafayette","5","195","Mississippi","6/16/20","157","38","28071","24.2"
"Lamar","3","292","Mississippi","6/16/20","272","20","28073","7.35"
"Lauderdale","3","816","Mississippi","6/16/20","793","23","28075","2.9"
"Lawrence","2","120","Mississippi","6/16/20","109","11","28077","10.09"
"Leake","3","491","Mississippi","6/16/20","469","22","28079","4.69"
"Lee","9","310","Mississippi","6/16/20","248","62","28081","25"
"Leflore","8","376","Mississippi","6/16/20","322","54","28083","16.77"
"Lincoln","3","329","Mississippi","6/16/20","308","21","28085","6.82"
"Lowndes","8","335","Mississippi","6/16/20","277","58","28087","20.94"
"Madison","10","905","Mississippi","6/16/20","832","73","28089","8.77"
"Marion","3","152","Mississippi","6/16/20","129","23","28091","17.83"
"Marshall","2","110","Mississippi","6/16/20","96","14","28093","14.58"
"Monroe","2","297","Mississippi","6/16/20","285","12","28095","4.21"
"Montgomery","1","98","Mississippi","6/16/20","88","10","28097","11.36"
"Neshoba","13","895","Mississippi","6/16/20","805","90","28099","11.18"
"Newton","2","324","Mississippi","6/16/20","307","17","28101","5.54"
"Noxubee","1","216","Mississippi","6/16/20","206","10","28103","4.85"
"Oktibbeha","10","374","Mississippi","6/16/20","307","67","28105","21.82"
"Panola","5","137","Mississippi","6/16/20","105","32","28107","30.48"
"Pearl River","0","223","Mississippi","6/16/20","221","2","28109","0.9"
"Perry","0","54","Mississippi","6/16/20","52","2","28111","3.85"
"Pike","5","247","Mississippi","6/16/20","211","36","28113","17.06"
"Pontotoc","2","79","Mississippi","6/16/20","62","17","28115","27.42"
"Prentiss","1","68","Mississippi","6/16/20","62","6","28117","9.68"
"Quitman","3","51","Mississippi","6/16/20","32","19","28119","59.38"
"Rankin","7","550","Mississippi","6/16/20","498","52","28121","10.44"
"Scott","2","692","Mississippi","6/16/20","677","15","28123","2.22"
"Sharkey","0","8","Mississippi","6/16/20","7","1","28125","14.29"
"Simpson","2","123","Mississippi","6/16/20","112","11","28127","9.82"
"Smith","1","182","Mississippi","6/16/20","172","10","28129","5.81"
"Stone","0","34","Mississippi","6/16/20","34","0","28131","0"
"Sunflower","3","127","Mississippi","6/16/20","105","22","28133","20.95"
"Tallahatchie","1","45","Mississippi","6/16/20","35","10","28135","28.57"
"Tate","3","135","Mississippi","6/16/20","112","23","28137","20.54"
"Tippah","1","95","Mississippi","6/16/20","87","8","28139","9.2"
"Tishomingo","1","47","Mississippi","6/16/20","42","5","28141","11.9"
"Tunica","1","67","Mississippi","6/16/20","60","7","28143","11.67"
"Union","2","108","Mississippi","6/16/20","92","16","28145","17.39"
"Walthall","4","107","Mississippi","6/16/20","82","25","28147","30.49"
"Warren","6","262","Mississippi","6/16/20","223","39","28149","17.49"
"Washington","7","269","Mississippi","6/16/20","221","48","28151","21.72"
"Wayne","9","398","Mississippi","6/16/20","335","63","28153","18.81"
"Webster","2","109","Mississippi","6/16/20","98","11","28155","11.22"
"Wilkinson","0","85","Mississippi","6/16/20","85","0","28157","0"
"Winston","3","155","Mississippi","6/16/20","136","19","28159","13.97"
"Yalobusha","2","139","Mississippi","6/16/20","123","16","28161","13.01"
"Yazoo","4","350","Mississippi","6/16/20","321","29","28163","9.03"
"Adair","1","84","Missouri","6/16/20","74","10","29001","13.51"
"Andrew","0","35","Missouri","6/16/20","33","2","29003","6.06"
"Atchison","0","3","Missouri","6/16/20","3","0","29005","0"
"Audrain","1","122","Missouri","6/16/20","117","5","29007","4.27"
"Barry","1","15","Missouri","6/16/20","9","6","29009","66.67"
"Barton","1","9","Missouri","6/16/20","0","9","29011","1"
"Bates","0","12","Missouri","6/16/20","12","0","29013","0"
"Benton","0","14","Missouri","6/16/20","13","1","29015","7.69"
"Bollinger","0","10","Missouri","6/16/20","7","3","29017","42.86"
"Boone","3","216","Missouri","6/16/20","194","22","29019","11.34"
"Buchanan","5","791","Missouri","6/16/20","755","36","29021","4.77"
"Butler","0","48","Missouri","6/16/20","51","-3","29023","-5.88"
"Caldwell","0","7","Missouri","6/16/20","8","-1","29025","-12.5"
"Callaway","1","40","Missouri","6/16/20","34","6","29027","17.65"
"Camden","1","43","Missouri","6/16/20","38","5","29029","13.16"
"Cape Girardeau","3","110","Missouri","6/16/20","87","23","29031","26.44"
"Carroll","0","11","Missouri","6/16/20","9","2","29033","22.22"
"Carter","0","5","Missouri","6/16/20","5","0","29035","0"
"Cass","1","115","Missouri","6/16/20","105","10","29037","9.52"
"Cedar","0","9","Missouri","6/16/20","9","0","29039","0"
"Chariton","0","6","Missouri","6/16/20","6","0","29041","0"
"Christian","0","30","Missouri","6/16/20","29","1","29043","3.45"
"Clark","0","1","Missouri","6/16/20","1","0","29045","0"
"Clay","7","299","Missouri","6/16/20","249","50","29047","20.08"
"Clinton","0","21","Missouri","6/16/20","20","1","29049","5"
"Cole","-1","57","Missouri","6/16/20","61","-4","29051","-6.56"
"Cooper","0","9","Missouri","6/16/20","9","0","29053","0"
"Crawford","0","9","Missouri","6/16/20","9","0","29055","0"
"Dade","0","1","Missouri","6/16/20","0","1","29057","1"
"Dallas","0","6","Missouri","6/16/20","6","0","29059","0"
"Daviess","0","7","Missouri","6/16/20","6","1","29061","16.67"
"DeKalb","0","9","Missouri","6/16/20","7","2","29063","28.57"
"Dent","0","1","Missouri","6/16/20","0","1","29065","1"
"Douglas","0","3","Missouri","6/16/20","0","3","29067","1"
"Dunklin","2","64","Missouri","6/16/20","49","15","29069","30.61"
"Franklin","2","172","Missouri","6/16/20","156","16","29071","10.26"
"Gasconade","0","2","Missouri","6/16/20","2","0","29073","0"
"Gentry","0","54","Missouri","6/16/20","54","0","29075","0"
"Greene","3","197","Missouri","6/16/20","179","18","29077","10.06"
"Grundy","2","11","Missouri","6/16/20","0","11","29079","1"
"Harrison","0","9","Missouri","6/16/20","9","0","29081","0"
"Henry","1","17","Missouri","6/16/20","12","5","29083","41.67"
"Holt","0","1","Missouri","6/16/20","2","-1","29087","-50"
"Howard","0","3","Missouri","6/16/20","3","0","29089","0"
"Howell","2","27","Missouri","6/16/20","15","12","29091","80"
"Iron","0","2","Missouri","6/16/20","3","-1","29093","-33.33"
"Jackson","23","889","Missouri","6/16/20","727","162","29095","22.28"
"Jasper","15","178","Missouri","6/16/20","70","108","29097","154.29"
"Jefferson","-4","381","Missouri","6/16/20","411","-30","29099","-7.3"
"Johnson","0","81","Missouri","6/16/20","78","3","29101","3.85"
"Kansas City","24","1762","Missouri","6/16/20","1594","168","00000","10.54"
"Knox","0","2","Missouri","6/16/20","0","2","29103","1"
"Laclede","0","9","Missouri","6/16/20","7","2","29105","28.57"
"Lafayette","0","85","Missouri","6/16/20","83","2","29107","2.41"
"Lawrence","0","8","Missouri","6/16/20","8","0","29109","0"
"Lewis","0","7","Missouri","6/16/20","7","0","29111","0"
"Lincoln","-5","87","Missouri","6/16/20","121","-34","29113","-28.1"
"Linn","0","11","Missouri","6/16/20","10","1","29115","10"
"Livingston","0","6","Missouri","6/16/20","5","1","29117","20"
"Macon","0","7","Missouri","6/16/20","6","1","29121","16.67"
"Madison","0","3","Missouri","6/16/20","3","0","29123","0"
"Maries","0","2","Missouri","6/16/20","2","0","29125","0"
"Marion","0","8","Missouri","6/16/20","6","2","29127","33.33"
"McDonald","8","98","Missouri","6/16/20","40","58","29119","145"
"Mercer","1","5","Missouri","6/16/20","0","5","29129","1"
"Miller","0","7","Missouri","6/16/20","4","3","29131","75"
"Mississippi","1","75","Missouri","6/16/20","65","10","29133","15.38"
"Moniteau","0","49","Missouri","6/16/20","49","0","29135","0"
"Monroe","0","3","Missouri","6/16/20","0","3","29137","1"
"Montgomery","0","12","Missouri","6/16/20","13","-1","29139","-7.69"
"Morgan","0","9","Missouri","6/16/20","9","0","29141","0"
"New Madrid","2","34","Missouri","6/16/20","23","11","29143","47.83"
"Newton","7","84","Missouri","6/16/20","36","48","29145","133.33"
"Nodaway","0","15","Missouri","6/16/20","14","1","29147","7.14"
"Oregon","0","4","Missouri","6/16/20","2","2","29149","100"
"Osage","0","5","Missouri","6/16/20","6","-1","29151","-16.67"
"Pemiscot","1","104","Missouri","6/16/20","97","7","29155","7.22"
"Perry","2","86","Missouri","6/16/20","75","11","29157","14.67"
"Pettis","1","89","Missouri","6/16/20","83","6","29159","7.23"
"Phelps","0","6","Missouri","6/16/20","5","1","29161","20"
"Pike","0","31","Missouri","6/16/20","28","3","29163","10.71"
"Platte","3","99","Missouri","6/16/20","80","19","29165","23.75"
"Polk","1","9","Missouri","6/16/20","4","5","29167","125"
"Pulaski","0","106","Missouri","6/16/20","109","-3","29169","-2.75"
"Putnam","0","2","Missouri","6/16/20","0","2","29171","1"
"Ralls","0","5","Missouri","6/16/20","5","0","29173","0"
"Randolph","0","11","Missouri","6/16/20","10","1","29175","10"
"Ray","0","25","Missouri","6/16/20","24","1","29177","4.17"
"Reynolds","0","2","Missouri","6/16/20","2","0","29179","0"
"Ripley","0","11","Missouri","6/16/20","11","0","29181","0"
"Saline","-2","272","Missouri","6/16/20","283","-11","29195","-3.89"
"Schuyler","0","1","Missouri","6/16/20","0","1","29197","1"
"Scotland","0","8","Missouri","6/16/20","9","-1","29199","-11.11"
"Scott","3","145","Missouri","6/16/20","127","18","29201","14.17"
"Shannon","1","6","Missouri","6/16/20","0","6","29203","1"
"Shelby","0","1","Missouri","6/16/20","1","0","29205","0"
"St. Charles","10","922","Missouri","6/16/20","852","70","29183","8.22"
"St. Clair","0","2","Missouri","6/16/20","3","-1","29185","-33.33"
"St. Francois","0","43","Missouri","6/16/20","41","2","29187","4.88"
"St. Louis","32","5653","Missouri","6/16/20","5427","226","29189","4.16"
"St. Louis City","15","2234","Missouri","6/16/20","2132","102","29510","4.78"
"Ste. Genevieve","0","14","Missouri","6/16/20","12","2","29186","16.67"
"Stoddard","2","121","Missouri","6/16/20","109","12","29207","11.01"
"Stone","0","7","Missouri","6/16/20","10","-3","29209","-30"
"Sullivan","1","78","Missouri","6/16/20","68","10","29211","14.71"
"Taney","2","26","Missouri","6/16/20","14","12","29213","85.71"
"Texas","0","1","Missouri","6/16/20","1","0","29215","0"
"Vernon","0","12","Missouri","6/16/20","12","0","29217","0"
"Warren","0","32","Missouri","6/16/20","30","2","29219","6.67"
"Washington","0","13","Missouri","6/16/20","13","0","29221","0"
"Webster","0","18","Missouri","6/16/20","18","0","29225","0"
"Worth","0","4","Missouri","6/16/20","4","0","29227","0"
"Wright","0","14","Missouri","6/16/20","14","0","29229","0"
"Beaverhead","0","1","Montana","6/16/20","1","0","30001","0"
"Big Horn","1","47","Montana","6/16/20","41","6","30003","14.63"
"Broadwater","0","4","Montana","6/16/20","4","0","30007","0"
"Carbon","0","6","Montana","6/16/20","6","0","30009","0"
"Cascade","0","19","Montana","6/16/20","17","2","30013","11.76"
"Custer","2","13","Montana","6/16/20","0","13","30017","1"
"Deer Lodge","0","3","Montana","6/16/20","3","0","30023","0"
"Flathead","0","39","Montana","6/16/20","37","2","30029","5.41"
"Gallatin","3","188","Montana","6/16/20","168","20","30031","11.9"
"Glacier","0","6","Montana","6/16/20","6","0","30035","0"
"Golden Valley","0","3","Montana","6/16/20","3","0","30037","0"
"Hill","0","1","Montana","6/16/20","1","0","30041","0"
"Jefferson","0","3","Montana","6/16/20","3","0","30043","0"
"Lake","1","9","Montana","6/16/20","5","4","30047","80"
"Lewis and Clark","0","20","Montana","6/16/20","18","2","30049","11.11"
"Liberty","0","1","Montana","6/16/20","1","0","30051","0"
"Lincoln","0","7","Montana","6/16/20","7","0","30053","0"
"Madison","0","8","Montana","6/16/20","8","0","30057","0"
"Meagher","0","1","Montana","6/16/20","1","0","30059","0"
"Missoula","0","42","Montana","6/16/20","40","2","30063","5"
"Musselshell","0","1","Montana","6/16/20","1","0","30065","0"
"Park","0","8","Montana","6/16/20","8","0","30067","0"
"Pondera","0","2","Montana","6/16/20","2","0","30073","0"
"Ravalli","1","18","Montana","6/16/20","14","4","30081","28.57"
"Richland","0","3","Montana","6/16/20","3","0","30083","0"
"Roosevelt","0","7","Montana","6/16/20","7","0","30085","0"
"Rosebud","0","1","Montana","6/16/20","1","0","30087","0"
"Silver Bow","0","11","Montana","6/16/20","11","0","30093","0"
"Stillwater","0","3","Montana","6/16/20","2","1","30095","50"
"Toole","0","29","Montana","6/16/20","29","0","30101","0"
"Wheatland","0","1","Montana","6/16/20","1","0","30107","0"
"Yellowstone","1","109","Montana","6/16/20","105","4","30111","3.81"
"Adams","0","278","Nebraska","6/16/20","277","1","31001","0.36"
"Antelope","0","8","Nebraska","6/16/20","8","0","31003","0"
"Banner","0","1","Nebraska","6/16/20","0","1","31007","1"
"Boone","0","7","Nebraska","6/16/20","7","0","31011","0"
"Box Butte","0","3","Nebraska","6/16/20","3","0","31013","0"
"Boyd","0","1","Nebraska","6/16/20","1","0","31015","0"
"Buffalo","0","176","Nebraska","6/16/20","175","1","31019","0.57"
"Burt","0","11","Nebraska","6/16/20","10","1","31021","10"
"Butler","0","51","Nebraska","6/16/20","51","0","31023","0"
"Cass","0","60","Nebraska","6/16/20","57","3","31025","5.26"
"Cedar","0","8","Nebraska","6/16/20","8","0","31027","0"
"Chase","0","1","Nebraska","6/16/20","1","0","31029","0"
"Cherry","0","1","Nebraska","6/16/20","1","0","31031","0"
"Cheyenne","0","11","Nebraska","6/16/20","10","1","31033","10"
"Clay","0","24","Nebraska","6/16/20","24","0","31035","0"
"Colfax","2","651","Nebraska","6/16/20","639","12","31037","1.88"
"Cuming","0","34","Nebraska","6/16/20","34","0","31039","0"
"Custer","0","34","Nebraska","6/16/20","34","0","31041","0"
"Dakota","1","1725","Nebraska","6/16/20","1716","9","31043","0.52"
"Dawes","0","1","Nebraska","6/16/20","1","0","31045","0"
"Dawson","0","846","Nebraska","6/16/20","843","3","31047","0.36"
"Dixon","1","40","Nebraska","6/16/20","32","8","31051","25"
"Dodge","8","639","Nebraska","6/16/20","582","57","31053","9.79"
"Douglas","98","5850","Nebraska","6/16/20","5164","686","31055","13.28"
"Fillmore","1","13","Nebraska","6/16/20","7","6","31059","85.71"
"Franklin","0","6","Nebraska","6/16/20","6","0","31061","0"
"Frontier","0","1","Nebraska","6/16/20","1","0","31063","0"
"Furnas","0","9","Nebraska","6/16/20","9","0","31065","0"
"Gage","0","45","Nebraska","6/16/20","45","0","31067","0"
"Garden","0","4","Nebraska","6/16/20","4","0","31069","0"
"Garfield","0","1","Nebraska","6/16/20","1","0","31071","0"
"Gosper","0","13","Nebraska","6/16/20","13","0","31073","0"
"Greeley","0","3","Nebraska","6/16/20","3","0","31077","0"
"Hall","2","1564","Nebraska","6/16/20","1550","14","31079","0.9"
"Hamilton","0","56","Nebraska","6/16/20","56","0","31081","0"
"Hitchcock","0","1","Nebraska","6/16/20","1","0","31087","0"
"Holt","0","1","Nebraska","6/16/20","1","0","31089","0"
"Howard","0","44","Nebraska","6/16/20","43","1","31093","2.33"
"Jefferson","0","9","Nebraska","6/16/20","9","0","31095","0"
"Johnson","0","6","Nebraska","6/16/20","6","0","31097","0"
"Kearney","0","12","Nebraska","6/16/20","12","0","31099","0"
"Keith","0","2","Nebraska","6/16/20","2","0","31101","0"
"Kimball","0","8","Nebraska","6/16/20","8","0","31105","0"
"Knox","0","13","Nebraska","6/16/20","11","2","31107","18.18"
"Lancaster","20","1516","Nebraska","6/16/20","1376","140","31109","10.17"
"Lincoln","0","53","Nebraska","6/16/20","50","3","31111","6"
"Madison","1","334","Nebraska","6/16/20","328","6","31119","1.83"
"Merrick","0","36","Nebraska","6/16/20","36","0","31121","0"
"Morrill","0","12","Nebraska","6/16/20","11","1","31123","9.09"
"Nance","0","4","Nebraska","6/16/20","4","0","31125","0"
"Nemaha","0","4","Nebraska","6/16/20","4","0","31127","0"
"Nuckolls","0","1","Nebraska","6/16/20","1","0","31129","0"
"Otoe","0","13","Nebraska","6/16/20","11","2","31131","18.18"
"Phelps","0","20","Nebraska","6/16/20","20","0","31137","0"
"Pierce","0","6","Nebraska","6/16/20","6","0","31139","0"
"Platte","3","648","Nebraska","6/16/20","630","18","31141","2.86"
"Polk","0","12","Nebraska","6/16/20","12","0","31143","0"
"Red Willow","0","6","Nebraska","6/16/20","5","1","31145","20"
"Richardson","0","1","Nebraska","6/16/20","1","0","31147","0"
"Saline","1","523","Nebraska","6/16/20","518","5","31151","0.97"
"Sarpy","18","920","Nebraska","6/16/20","796","124","31153","15.58"
"Saunders","0","57","Nebraska","6/16/20","54","3","31155","5.56"
"Scotts Bluff","4","178","Nebraska","6/16/20","149","29","31157","19.46"
"Seward","0","32","Nebraska","6/16/20","29","3","31159","10.34"
"Sherman","0","5","Nebraska","6/16/20","5","0","31163","0"
"Sioux","0","1","Nebraska","6/16/20","0","1","31165","1"
"Stanton","0","21","Nebraska","6/16/20","21","0","31167","0"
"Thayer","0","1","Nebraska","6/16/20","1","0","31169","0"
"Thomas","0","1","Nebraska","6/16/20","1","0","31171","0"
"Thurston","2","68","Nebraska","6/16/20","56","12","31173","21.43"
"Valley","0","7","Nebraska","6/16/20","6","1","31175","16.67"
"Washington","1","41","Nebraska","6/16/20","36","5","31177","13.89"
"Wayne","0","26","Nebraska","6/16/20","26","0","31179","0"
"Webster","0","6","Nebraska","6/16/20","5","1","31181","20"
"York","0","37","Nebraska","6/16/20","37","0","31185","0"
"Carson City","1","124","Nevada","6/16/20","114","10","32510","8.77"
"Churchill","0","10","Nevada","6/16/20","10","0","32001","0"
"Clark","194","9157","Nevada","6/16/20","7799","1358","32003","17.41"
"Douglas","1","47","Nevada","6/16/20","38","9","32005","23.68"
"Elko","3","47","Nevada","6/16/20","27","20","32007","74.07"
"Humboldt","0","78","Nevada","6/16/20","78","0","32013","0"
"Lander","0","23","Nevada","6/16/20","23","0","32015","0"
"Lincoln","0","2","Nevada","6/16/20","2","0","32017","0"
"Lyon","0","92","Nevada","6/16/20","89","3","32019","3.37"
"Mineral","0","4","Nevada","6/16/20","4","0","32021","0"
"Nye","1","74","Nevada","6/16/20","66","8","32023","12.12"
"Pershing","0","5","Nevada","6/16/20","3","2","32027","66.67"
"Storey","0","1","Nevada","6/16/20","1","0","32029","0"
"Washoe","33","2016","Nevada","6/16/20","1788","228","32031","12.75"
"White Pine","0","3","Nevada","6/16/20","3","0","32033","0"
"Belknap","1","74","New Hampshire","6/16/20","70","4","33001","5.71"
"Carroll","0","49","New Hampshire","6/16/20","48","1","33003","2.08"
"Cheshire","0","62","New Hampshire","6/16/20","59","3","33005","5.08"
"Coos","0","6","New Hampshire","6/16/20","6","0","33007","0"
"Grafton","0","75","New Hampshire","6/16/20","76","-1","33009","-1.32"
"Hillsborough","33","2981","New Hampshire","6/16/20","2753","228","33011","8.28"
"Merrimack","2","392","New Hampshire","6/16/20","375","17","33013","4.53"
"Rockingham","5","1418","New Hampshire","6/16/20","1386","32","33015","2.31"
"Strafford","0","279","New Hampshire","6/16/20","277","2","33017","0.72"
"Sullivan","1","24","New Hampshire","6/16/20","20","4","33019","20"
"Atlantic","20","2539","New Jersey","6/16/20","2401","138","34001","5.75"
"Bergen","47","18901","New Jersey","6/16/20","18573","328","34003","1.77"
"Burlington","17","4929","New Jersey","6/16/20","4808","121","34005","2.52"
"Camden","27","7040","New Jersey","6/16/20","6849","191","34007","2.79"
"Cape May","4","681","New Jersey","6/16/20","654","27","34009","4.13"
"Cumberland","21","2728","New Jersey","6/16/20","2583","145","34011","5.61"
"Essex","34","18388","New Jersey","6/16/20","18151","237","34013","1.31"
"Gloucester","12","2423","New Jersey","6/16/20","2340","83","34015","3.55"
"Hudson","34","19238","New Jersey","6/16/20","19000","238","34017","1.25"
"Hunterdon","2","1042","New Jersey","6/16/20","1027","15","34019","1.46"
"Mercer","25","7381","New Jersey","6/16/20","7204","177","34021","2.46"
"Middlesex","32","16474","New Jersey","6/16/20","16251","223","34023","1.37"
"Monmouth","39","8786","New Jersey","6/16/20","8512","274","34025","3.22"
"Morris","-1","6599","New Jersey","6/16/20","6605","-6","34027","-0.09"
"Ocean","31","9279","New Jersey","6/16/20","9059","220","34029","2.43"
"Passaic","25","16664","New Jersey","6/16/20","16492","172","34031","1.04"
"Salem","4","711","New Jersey","6/16/20","686","25","34033","3.64"
"Somerset","13","4767","New Jersey","6/16/20","4679","88","34035","1.88"
"Sussex","3","1190","New Jersey","6/16/20","1172","18","34037","1.54"
"Union","3","16320","New Jersey","6/16/20","16302","18","34039","0.11"
"Warren","2","1205","New Jersey","6/16/20","1193","12","34041","1.01"
"Bernalillo","17","1733","New Mexico","6/16/20","1612","121","35001","7.51"
"Catron","0","2","New Mexico","6/16/20","2","0","35003","0"
"Chaves","2","59","New Mexico","6/16/20","48","11","35005","22.92"
"Cibola","2","186","New Mexico","6/16/20","169","17","35006","10.06"
"Colfax","0","8","New Mexico","6/16/20","5","3","35007","60"
"Curry","4","89","New Mexico","6/16/20","64","25","35009","39.06"
"Dona Ana","10","659","New Mexico","6/16/20","589","70","35013","11.88"
"Eddy","1","48","New Mexico","6/16/20","38","10","35015","26.32"
"Grant","0","16","New Mexico","6/16/20","15","1","35017","6.67"
"Guadalupe","0","20","New Mexico","6/16/20","20","0","35019","0"
"Harding","0","1","New Mexico","6/16/20","1","0","35021","0"
"Hidalgo","3","23","New Mexico","6/16/20","1","22","35023","2200"
"Lea","2","49","New Mexico","6/16/20","33","16","35025","48.48"
"Lincoln","0","6","New Mexico","6/16/20","5","1","35027","20"
"Los Alamos","0","7","New Mexico","6/16/20","6","1","35028","16.67"
"Luna","3","32","New Mexico","6/16/20","12","20","35029","166.67"
"McKinley","27","2949","New Mexico","6/16/20","2757","192","35031","6.96"
"Otero","0","30","New Mexico","6/16/20","28","2","35035","7.14"
"Quay","0","4","New Mexico","6/16/20","4","0","35037","0"
"Rio Arriba","0","59","New Mexico","6/16/20","57","2","35039","3.51"
"Roosevelt","1","53","New Mexico","6/16/20","45","8","35041","17.78"
"San Juan","19","2129","New Mexico","6/16/20","1999","130","35045","6.5"
"San Miguel","0","16","New Mexico","6/16/20","16","0","35047","0"
"Sandoval","5","642","New Mexico","6/16/20","604","38","35043","6.29"
"Santa Fe","3","178","New Mexico","6/16/20","155","23","35049","14.84"
"Sierra","0","4","New Mexico","6/16/20","1","3","35051","300"
"Socorro","0","55","New Mexico","6/16/20","55","0","35053","0"
"Taos","0","33","New Mexico","6/16/20","31","2","35055","6.45"
"Torrance","0","34","New Mexico","6/16/20","35","-1","35057","-2.86"
"Union","0","5","New Mexico","6/16/20","5","0","35059","0"
"Valencia","2","93","New Mexico","6/16/20","81","12","35061","14.81"
"Albany","6","2026","New York","6/16/20","1983","43","36001","2.17"
"Allegany","1","55","New York","6/16/20","51","4","36003","7.84"
"Broome","4","656","New York","6/16/20","627","29","36007","4.63"
"Cattaraugus","2","107","New York","6/16/20","95","12","36009","12.63"
"Cayuga","1","106","New York","6/16/20","102","4","36011","3.92"
"Chautauqua","1","108","New York","6/16/20","103","5","36013","4.85"
"Chemung","0","138","New York","6/16/20","138","0","36015","0"
"Chenango","1","139","New York","6/16/20","135","4","36017","2.96"
"Clinton","0","99","New York","6/16/20","97","2","36019","2.06"
"Columbia","4","442","New York","6/16/20","414","28","36021","6.76"
"Cortland","0","42","New York","6/16/20","42","0","36023","0"
"Delaware","0","88","New York","6/16/20","86","2","36025","2.33"
"Dutchess","8","4075","New York","6/16/20","4016","59","36027","1.47"
"Erie","37","6852","New York","6/16/20","6595","257","36029","3.9"
"Essex","0","40","New York","6/16/20","40","0","36031","0"
"Franklin","0","25","New York","6/16/20","23","2","36033","8.7"
"Fulton","1","236","New York","6/16/20","228","8","36035","3.51"
"Genesee","0","213","New York","6/16/20","210","3","36037","1.43"
"Greene","1","252","New York","6/16/20","248","4","36039","1.61"
"Hamilton","0","6","New York","6/16/20","5","1","36041","20"
"Herkimer","0","128","New York","6/16/20","125","3","36043","2.4"
"Jefferson","0","81","New York","6/16/20","79","2","36045","2.53"
"Lewis","0","20","New York","6/16/20","20","0","36049","0"
"Livingston","0","123","New York","6/16/20","121","2","36051","1.65"
"Madison","1","336","New York","6/16/20","331","5","36053","1.51"
"Monroe","23","3402","New York","6/16/20","3243","159","36055","4.9"
"Montgomery","1","104","New York","6/16/20","100","4","36057","4"
"Nassau","44","41290","New York","6/16/20","40980","310","36059","0.76"
"New York","414","210591","New York","6/16/20","207693","2898","36061","1.4"
"Niagara","7","1171","New York","6/16/20","1125","46","36063","4.09"
"Oneida","17","1301","New York","6/16/20","1185","116","36065","9.79"
"Onondaga","17","2545","New York","6/16/20","2427","118","36067","4.86"
"Ontario","2","234","New York","6/16/20","222","12","36069","5.41"
"Orange","7","10580","New York","6/16/20","10533","47","36071","0.45"
"Orleans","2","268","New York","6/16/20","257","11","36073","4.28"
"Oswego","3","139","New York","6/16/20","115","24","36075","20.87"
"Otsego","1","81","New York","6/16/20","75","6","36077","8"
"Putnam","2","1292","New York","6/16/20","1280","12","36079","0.94"
"Rensselaer","1","514","New York","6/16/20","505","9","36083","1.78"
"Rockland","15","13460","New York","6/16/20","13353","107","36087","0.8"
"Saratoga","2","522","New York","6/16/20","511","11","36091","2.15"
"Schenectady","3","735","New York","6/16/20","715","20","36093","2.8"
"Schoharie","0","54","New York","6/16/20","54","0","36095","0"
"Schuyler","0","12","New York","6/16/20","12","0","36097","0"
"Seneca","0","64","New York","6/16/20","61","3","36099","4.92"
"St. Lawrence","1","215","New York","6/16/20","209","6","36089","2.87"
"Steuben","1","257","New York","6/16/20","252","5","36101","1.98"
"Suffolk","45","40738","New York","6/16/20","40426","312","36103","0.77"
"Sullivan","2","1433","New York","6/16/20","1418","15","36105","1.06"
"Tioga","1","140","New York","6/16/20","134","6","36107","4.48"
"Tompkins","0","173","New York","6/16/20","171","2","36109","1.17"
"Ulster","3","1742","New York","6/16/20","1724","18","36111","1.04"
"Warren","0","257","New York","6/16/20","257","0","36113","0"
"Washington","0","243","New York","6/16/20","240","3","36115","1.25"
"Wayne","1","134","New York","6/16/20","126","8","36117","6.35"
"Westchester","46","34358","New York","6/16/20","34035","323","36119","0.95"
"Wyoming","0","93","New York","6/16/20","91","2","36121","2.2"
"Yates","0","40","New York","6/16/20","39","1","36123","2.56"
"Alamance","35","796","North Carolina","6/16/20","553","243","37001","43.94"
"Alexander","1","50","North Carolina","6/16/20","43","7","37003","16.28"
"Alleghany","0","30","North Carolina","6/16/20","29","1","37005","3.45"
"Anson","2","89","North Carolina","6/16/20","78","11","37007","14.1"
"Ashe","0","43","North Carolina","6/16/20","40","3","37009","7.5"
"Avery","0","6","North Carolina","6/16/20","4","2","37011","50"
"Beaufort","1","52","North Carolina","6/16/20","44","8","37013","18.18"
"Bertie","0","135","North Carolina","6/16/20","134","1","37015","0.75"
"Bladen","5","199","North Carolina","6/16/20","165","34","37017","20.61"
"Brunswick","15","263","North Carolina","6/16/20","160","103","37019","64.38"
"Buncombe","9","461","North Carolina","6/16/20","401","60","37021","14.96"
"Burke","30","775","North Carolina","6/16/20","567","208","37023","36.68"
"Cabarrus","16","729","North Carolina","6/16/20","617","112","37025","18.15"
"Caldwell","6","252","North Carolina","6/16/20","209","43","37027","20.57"
"Camden","1","7","North Carolina","6/16/20","3","4","37029","133.33"
"Carteret","1","48","North Carolina","6/16/20","40","8","37031","20"
"Caswell","1","104","North Carolina","6/16/20","97","7","37033","7.22"
"Catawba","18","452","North Carolina","6/16/20","327","125","37035","38.23"
"Chatham","11","813","North Carolina","6/16/20","733","80","37037","10.91"
"Cherokee","0","30","North Carolina","6/16/20","30","0","37039","0"
"Chowan","0","19","North Carolina","6/16/20","17","2","37041","11.76"
"Clay","0","9","North Carolina","6/16/20","8","1","37043","12.5"
"Cleveland","6","164","North Carolina","6/16/20","121","43","37045","35.54"
"Columbus","8","429","North Carolina","6/16/20","373","56","37047","15.01"
"Craven","5","276","North Carolina","6/16/20","240","36","37049","15"
"Cumberland","15","904","North Carolina","6/16/20","802","102","37051","12.72"
"Currituck","0","16","North Carolina","6/16/20","15","1","37053","6.67"
"Dare","0","25","North Carolina","6/16/20","25","0","37055","0"
"Davidson","20","664","North Carolina","6/16/20","527","137","37057","26"
"Davie","4","144","North Carolina","6/16/20","119","25","37059","21.01"
"Duplin","26","1228","North Carolina","6/16/20","1047","181","37061","17.29"
"Durham","79","2800","North Carolina","6/16/20","2247","553","37063","24.61"
"Edgecombe","4","254","North Carolina","6/16/20","229","25","37065","10.92"
"Forsyth","55","2283","North Carolina","6/16/20","1898","385","37067","20.28"
"Franklin","6","232","North Carolina","6/16/20","190","42","37069","22.11"
"Gaston","24","549","North Carolina","6/16/20","383","166","37071","43.34"
"Gates","0","25","North Carolina","6/16/20","24","1","37073","4.17"
"Graham","0","6","North Carolina","6/16/20","4","2","37075","50"
"Granville","23","688","North Carolina","6/16/20","530","158","37077","29.81"
"Greene","3","124","North Carolina","6/16/20","104","20","37079","19.23"
"Guilford","46","2103","North Carolina","6/16/20","1779","324","37081","18.21"
"Halifax","3","241","North Carolina","6/16/20","219","22","37083","10.05"
"Harnett","11","417","North Carolina","6/16/20","340","77","37085","22.65"
"Haywood","1","65","North Carolina","6/16/20","60","5","37087","8.33"
"Henderson","10","459","North Carolina","6/16/20","389","70","37089","17.99"
"Hertford","2","152","North Carolina","6/16/20","135","17","37091","12.59"
"Hoke","4","303","North Carolina","6/16/20","278","25","37093","8.99"
"Hyde","0","3","North Carolina","6/16/20","2","1","37095","50"
"Iredell","15","454","North Carolina","6/16/20","348","106","37097","30.46"
"Jackson","1","59","North Carolina","6/16/20","50","9","37099","18"
"Johnston","33","903","North Carolina","6/16/20","669","234","37101","34.98"
"Jones","0","28","North Carolina","6/16/20","28","0","37103","0"
"Lee","10","604","North Carolina","6/16/20","534","70","37105","13.11"
"Lenoir","7","303","North Carolina","6/16/20","257","46","37107","17.9"
"Lincoln","6","148","North Carolina","6/16/20","105","43","37109","40.95"
"Macon","13","237","North Carolina","6/16/20","146","91","37113","62.33"
"Madison","0","5","North Carolina","6/16/20","4","1","37115","25"
"Martin","3","101","North Carolina","6/16/20","77","24","37117","31.17"
"McDowell","9","163","North Carolina","6/16/20","101","62","37111","61.39"
"Mecklenburg","255","7468","North Carolina","6/16/20","5682","1786","37119","31.43"
"Mitchell","0","18","North Carolina","6/16/20","17","1","37121","5.88"
"Montgomery","7","211","North Carolina","6/16/20","165","46","37123","27.88"
"Moore","8","319","North Carolina","6/16/20","266","53","37125","19.92"
"Nash","7","294","North Carolina","6/16/20","242","52","37127","21.49"
"New Hanover","19","413","North Carolina","6/16/20","278","135","37129","48.56"
"Northampton","0","171","North Carolina","6/16/20","170","1","37131","0.59"
"Onslow","5","166","North Carolina","6/16/20","134","32","37133","23.88"
"Orange","11","479","North Carolina","6/16/20","405","74","37135","18.27"
"Pamlico","0","15","North Carolina","6/16/20","13","2","37137","15.38"
"Pasquotank","2","131","North Carolina","6/16/20","119","12","37139","10.08"
"Pender","4","143","North Carolina","6/16/20","113","30","37141","26.55"
"Perquimans","1","30","North Carolina","6/16/20","26","4","37143","15.38"
"Person","3","82","North Carolina","6/16/20","61","21","37145","34.43"
"Pitt","15","500","North Carolina","6/16/20","397","103","37147","25.94"
"Polk","1","55","North Carolina","6/16/20","48","7","37149","14.58"
"Randolph","17","947","North Carolina","6/16/20","829","118","37151","14.23"
"Richmond","4","215","North Carolina","6/16/20","184","31","37153","16.85"
"Robeson","8","1040","North Carolina","6/16/20","983","57","37155","5.8"
"Rockingham","4","141","North Carolina","6/16/20","116","25","37157","21.55"
"Rowan","21","921","North Carolina","6/16/20","772","149","37159","19.3"
"Rutherford","4","226","North Carolina","6/16/20","200","26","37161","13"
"Sampson","23","783","North Carolina","6/16/20","621","162","37163","26.09"
"Scotland","2","114","North Carolina","6/16/20","98","16","37165","16.33"
"Stanly","7","167","North Carolina","6/16/20","118","49","37167","41.53"
"Stokes","1","95","North Carolina","6/16/20","86","9","37169","10.47"
"Surry","9","342","North Carolina","6/16/20","279","63","37171","22.58"
"Swain","2","39","North Carolina","6/16/20","25","14","37173","56"
"Transylvania","0","17","North Carolina","6/16/20","16","1","37175","6.25"
"Tyrrell","0","5","North Carolina","6/16/20","4","1","37177","25"
"Union","22","758","North Carolina","6/16/20","604","154","37179","25.5"
"Vance","6","417","North Carolina","6/16/20","375","42","37181","11.2"
"Wake","112","3163","North Carolina","6/16/20","2378","785","37183","33.01"
"Warren","6","136","North Carolina","6/16/20","93","43","37185","46.24"
"Washington","0","35","North Carolina","6/16/20","32","3","37187","9.38"
"Watauga","0","44","North Carolina","6/16/20","41","3","37189","7.32"
"Wayne","28","1535","North Carolina","6/16/20","1339","196","37191","14.64"
"Wilkes","5","547","North Carolina","6/16/20","511","36","37193","7.05"
"Wilson","11","524","North Carolina","6/16/20","447","77","37195","17.23"
"Yadkin","4","251","North Carolina","6/16/20","221","30","37197","13.57"
"Yancey","1","29","North Carolina","6/16/20","21","8","37199","38.1"
"Barnes","0","9","North Dakota","6/16/20","9","0","38003","0"
"Benson","0","3","North Dakota","6/16/20","3","0","38005","0"
"Bottineau","0","4","North Dakota","6/16/20","4","0","38009","0"
"Bowman","0","1","North Dakota","6/16/20","1","0","38011","0"
"Burke","0","5","North Dakota","6/16/20","5","0","38013","0"
"Burleigh","5","176","North Dakota","6/16/20","144","32","38015","22.22"
"Cass","20","2067","North Dakota","6/16/20","1930","137","38017","7.1"
"Dickey","0","3","North Dakota","6/16/20","1","2","38021","200"
"Divide","0","1","North Dakota","6/16/20","1","0","38023","0"
"Dunn","0","11","North Dakota","6/16/20","11","0","38025","0"
"Eddy","0","5","North Dakota","6/16/20","5","0","38027","0"
"Emmons","0","4","North Dakota","6/16/20","4","0","38029","0"
"Foster","0","1","North Dakota","6/16/20","1","0","38031","0"
"Grand Forks","1","346","North Dakota","6/16/20","339","7","38035","2.06"
"Grant","0","2","North Dakota","6/16/20","2","0","38037","0"
"Griggs","0","1","North Dakota","6/16/20","1","0","38039","0"
"Kidder","0","2","North Dakota","6/16/20","1","1","38043","100"
"LaMoure","1","10","North Dakota","6/16/20","1","9","38045","900"
"McHenry","0","2","North Dakota","6/16/20","2","0","38049","0"
"McIntosh","0","1","North Dakota","6/16/20","1","0","38051","0"
"McKenzie","0","21","North Dakota","6/16/20","18","3","38053","16.67"
"McLean","0","11","North Dakota","6/16/20","8","3","38055","37.5"
"Mercer","0","6","North Dakota","6/16/20","6","0","38057","0"
"Morton","1","68","North Dakota","6/16/20","60","8","38059","13.33"
"Mountrail","0","43","North Dakota","6/16/20","43","0","38061","0"
"Nelson","0","1","North Dakota","6/16/20","1","0","38063","0"
"Oliver","0","1","North Dakota","6/16/20","1","0","38065","0"
"Pembina","0","7","North Dakota","6/16/20","6","1","38067","16.67"
"Pierce","0","3","North Dakota","6/16/20","3","0","38069","0"
"Ramsey","0","8","North Dakota","6/16/20","8","0","38071","0"
"Ransom","0","13","North Dakota","6/16/20","11","2","38073","18.18"
"Renville","0","3","North Dakota","6/16/20","3","0","38075","0"
"Richland","1","37","North Dakota","6/16/20","30","7","38077","23.33"
"Rolette","0","7","North Dakota","6/16/20","7","0","38079","0"
"Sargent","0","4","North Dakota","6/16/20","4","0","38081","0"
"Sheridan","0","1","North Dakota","6/16/20","1","0","38083","0"
"Sioux","0","4","North Dakota","6/16/20","2","2","38085","100"
"Slope","0","3","North Dakota","6/16/20","3","0","38087","0"
"Stark","0","63","North Dakota","6/16/20","63","0","38089","0"
"Steele","0","1","North Dakota","6/16/20","1","0","38091","0"
"Stutsman","0","52","North Dakota","6/16/20","49","3","38093","6.12"
"Traill","0","15","North Dakota","6/16/20","14","1","38097","7.14"
"Walsh","0","17","North Dakota","6/16/20","16","1","38099","6.25"
"Ward","0","47","North Dakota","6/16/20","44","3","38101","6.82"
"Wells","0","8","North Dakota","6/16/20","8","0","38103","0"
"Williams","0","26","North Dakota","6/16/20","25","1","38105","4"
"","0","30","Northern Mariana Islands","6/16/20","30","0",,"0"
"Adams","1","17","Ohio","6/16/20","11","6","39001","54.55"
"Allen","2","241","Ohio","6/16/20","227","14","39003","6.17"
"Ashland","1","29","Ohio","6/16/20","25","4","39005","16"
"Ashtabula","2","392","Ohio","6/16/20","375","17","39007","4.53"
"Athens","1","23","Ohio","6/16/20","18","5","39009","27.78"
"Auglaize","1","86","Ohio","6/16/20","80","6","39011","7.5"
"Belmont","2","469","Ohio","6/16/20","455","14","39013","3.08"
"Brown","1","38","Ohio","6/16/20","32","6","39015","18.75"
"Butler","12","1120","Ohio","6/16/20","1034","86","39017","8.32"
"Carroll","0","37","Ohio","6/16/20","36","1","39019","2.78"
"Champaign","0","36","Ohio","6/16/20","35","1","39021","2.86"
"Clark","12","460","Ohio","6/16/20","377","83","39023","22.02"
"Clermont","1","244","Ohio","6/16/20","234","10","39025","4.27"
"Clinton","1","54","Ohio","6/16/20","48","6","39027","12.5"
"Columbiana","3","921","Ohio","6/16/20","901","20","39029","2.22"
"Coshocton","1","52","Ohio","6/16/20","48","4","39031","8.33"
"Crawford","0","123","Ohio","6/16/20","121","2","39033","1.65"
"Cuyahoga","47","5271","Ohio","6/16/20","4939","332","39035","6.72"
"Darke","4","222","Ohio","6/16/20","194","28","39037","14.43"
"Defiance","0","40","Ohio","6/16/20","38","2","39039","5.26"
"Delaware","4","403","Ohio","6/16/20","378","25","39041","6.61"
"Erie","3","215","Ohio","6/16/20","191","24","39043","12.57"
"Fairfield","5","374","Ohio","6/16/20","336","38","39045","11.31"
"Fayette","0","45","Ohio","6/16/20","43","2","39047","4.65"
"Franklin","89","7289","Ohio","6/16/20","6667","622","39049","9.33"
"Fulton","0","53","Ohio","6/16/20","51","2","39051","3.92"
"Gallia","0","9","Ohio","6/16/20","9","0","39053","0"
"Geauga","4","342","Ohio","6/16/20","317","25","39055","7.89"
"Greene","4","151","Ohio","6/16/20","120","31","39057","25.83"
"Guernsey","0","44","Ohio","6/16/20","44","0","39059","0"
"Hamilton","57","3316","Ohio","6/16/20","2918","398","39061","13.64"
"Hancock","0","61","Ohio","6/16/20","60","1","39063","1.67"
"Hardin","2","94","Ohio","6/16/20","77","17","39065","22.08"
"Harrison","0","11","Ohio","6/16/20","10","1","39067","10"
"Henry","0","20","Ohio","6/16/20","19","1","39069","5.26"
"Highland","1","34","Ohio","6/16/20","30","4","39071","13.33"
"Hocking","0","73","Ohio","6/16/20","73","0","39073","0"
"Holmes","3","92","Ohio","6/16/20","69","23","39075","33.33"
"Huron","2","79","Ohio","6/16/20","64","15","39077","23.44"
"Jackson","0","16","Ohio","6/16/20","16","0","39079","0"
"Jefferson","0","71","Ohio","6/16/20","69","2","39081","2.9"
"Knox","1","33","Ohio","6/16/20","29","4","39083","13.79"
"Lake","2","350","Ohio","6/16/20","337","13","39085","3.86"
"Lawrence","1","35","Ohio","6/16/20","30","5","39087","16.67"
"Licking","5","317","Ohio","6/16/20","284","33","39089","11.62"
"Logan","0","48","Ohio","6/16/20","46","2","39091","4.35"
"Lorain","7","807","Ohio","6/16/20","757","50","39093","6.61"
"Lucas","13","2460","Ohio","6/16/20","2372","88","39095","3.71"
"Madison","0","168","Ohio","6/16/20","167","1","39097","0.6"
"Mahoning","12","1607","Ohio","6/16/20","1522","85","39099","5.58"
"Marion","2","2712","Ohio","6/16/20","2695","17","39101","0.63"
"Medina","1","400","Ohio","6/16/20","390","10","39103","2.56"
"Meigs","0","7","Ohio","6/16/20","6","1","39105","16.67"
"Mercer","1","247","Ohio","6/16/20","237","10","39107","4.22"
"Miami","2","388","Ohio","6/16/20","376","12","39109","3.19"
"Monroe","0","82","Ohio","6/16/20","81","1","39111","1.23"
"Montgomery","27","1026","Ohio","6/16/20","835","191","39113","22.87"
"Morgan","0","6","Ohio","6/16/20","6","0","39115","0"
"Morrow","0","110","Ohio","6/16/20","108","2","39117","1.85"
"Muskingum","0","58","Ohio","6/16/20","57","1","39119","1.75"
"Noble","0","6","Ohio","6/16/20","6","0","39121","0"
"Ottawa","1","118","Ohio","6/16/20","112","6","39123","5.36"
"Paulding","0","17","Ohio","6/16/20","14","3","39125","21.43"
"Perry","0","24","Ohio","6/16/20","21","3","39127","14.29"
"Pickaway","2","2125","Ohio","6/16/20","2109","16","39129","0.76"
"Pike","0","9","Ohio","6/16/20","9","0","39131","0"
"Portage","1","354","Ohio","6/16/20","344","10","39133","2.91"
"Preble","1","44","Ohio","6/16/20","39","5","39135","12.82"
"Putnam","0","101","Ohio","6/16/20","98","3","39137","3.06"
"Richland","3","253","Ohio","6/16/20","232","21","39139","9.05"
"Ross","1","81","Ohio","6/16/20","75","6","39141","8"
"Sandusky","1","104","Ohio","6/16/20","98","6","39143","6.12"
"Scioto","0","21","Ohio","6/16/20","19","2","39145","10.53"
"Seneca","0","29","Ohio","6/16/20","28","1","39147","3.57"
"Shelby","0","49","Ohio","6/16/20","49","0","39149","0"
"Stark","8","881","Ohio","6/16/20","827","54","39151","6.53"
"Summit","16","1706","Ohio","6/16/20","1592","114","39153","7.16"
"Trumbull","7","665","Ohio","6/16/20","618","47","39155","7.61"
"Tuscarawas","3","406","Ohio","6/16/20","382","24","39157","6.28"
"Union","0","62","Ohio","6/16/20","61","1","39159","1.64"
"Van Wert","1","14","Ohio","6/16/20","8","6","39161","75"
"Vinton","0","22","Ohio","6/16/20","21","1","39163","4.76"
"Warren","12","525","Ohio","6/16/20","443","82","39165","18.51"
"Washington","0","118","Ohio","6/16/20","118","0","39167","0"
"Wayne","1","311","Ohio","6/16/20","301","10","39169","3.32"
"Williams","0","59","Ohio","6/16/20","58","1","39171","1.72"
"Wood","3","329","Ohio","6/16/20","308","21","39173","6.82"
"Wyandot","0","49","Ohio","6/16/20","48","1","39175","2.08"
"Adair","0","96","Oklahoma","6/16/20","95","1","40001","1.05"
"Alfalfa","0","1","Oklahoma","6/16/20","1","0","40003","0"
"Atoka","1","9","Oklahoma","6/16/20","5","4","40005","80"
"Beaver","0","30","Oklahoma","6/16/20","27","3","40007","11.11"
"Beckham","0","8","Oklahoma","6/16/20","7","1","40009","14.29"
"Blaine","0","11","Oklahoma","6/16/20","10","1","40011","10"
"Bryan","2","51","Oklahoma","6/16/20","40","11","40013","27.5"
"Caddo","0","176","Oklahoma","6/16/20","174","2","40015","1.15"
"Canadian","2","160","Oklahoma","6/16/20","143","17","40017","11.89"
"Carter","1","60","Oklahoma","6/16/20","55","5","40019","9.09"
"Cherokee","2","50","Oklahoma","6/16/20","37","13","40021","35.14"
"Choctaw","1","105","Oklahoma","6/16/20","100","5","40023","5"
"Cimarron","0","1","Oklahoma","6/16/20","1","0","40025","0"
"Cleveland","5","564","Oklahoma","6/16/20","529","35","40027","6.62"
"Coal","0","6","Oklahoma","6/16/20","5","1","40029","20"
"Comanche","4","339","Oklahoma","6/16/20","311","28","40031","9"
"Cotton","0","5","Oklahoma","6/16/20","5","0","40033","0"
"Craig","0","16","Oklahoma","6/16/20","16","0","40035","0"
"Creek","1","108","Oklahoma","6/16/20","101","7","40037","6.93"
"Custer","1","42","Oklahoma","6/16/20","35","7","40039","20"
"Delaware","1","111","Oklahoma","6/16/20","103","8","40041","7.77"
"Dewey","0","4","Oklahoma","6/16/20","2","2","40043","100"
"Garfield","3","51","Oklahoma","6/16/20","31","20","40047","64.52"
"Garvin","2","33","Oklahoma","6/16/20","20","13","40049","65"
"Grady","0","118","Oklahoma","6/16/20","115","3","40051","2.61"
"Grant","0","2","Oklahoma","6/16/20","2","0","40053","0"
"Greer","0","66","Oklahoma","6/16/20","66","0","40055","0"
"Harper","0","1","Oklahoma","6/16/20","1","0","40059","0"
"Haskell","0","6","Oklahoma","6/16/20","6","0","40061","0"
"Hughes","0","3","Oklahoma","6/16/20","3","0","40063","0"
"Jackson","0","32","Oklahoma","6/16/20","29","3","40065","10.34"
"Jefferson","0","4","Oklahoma","6/16/20","4","0","40067","0"
"Johnston","0","5","Oklahoma","6/16/20","3","2","40069","66.67"
"Kay","1","69","Oklahoma","6/16/20","60","9","40071","15"
"Kingfisher","0","13","Oklahoma","6/16/20","12","1","40073","8.33"
"Kiowa","0","6","Oklahoma","6/16/20","6","0","40075","0"
"Latimer","0","7","Oklahoma","6/16/20","5","2","40077","40"
"Le Flore","1","20","Oklahoma","6/16/20","16","4","40079","25"
"Lincoln","1","27","Oklahoma","6/16/20","22","5","40081","22.73"
"Logan","0","24","Oklahoma","6/16/20","21","3","40083","14.29"
"Love","1","26","Oklahoma","6/16/20","21","5","40085","23.81"
"Major","0","6","Oklahoma","6/16/20","6","0","40093","0"
"Marshall","1","20","Oklahoma","6/16/20","11","9","40095","81.82"
"Mayes","3","59","Oklahoma","6/16/20","35","24","40097","68.57"
"McClain","1","118","Oklahoma","6/16/20","110","8","40087","7.27"
"McCurtain","7","158","Oklahoma","6/16/20","109","49","40089","44.95"
"McIntosh","1","21","Oklahoma","6/16/20","14","7","40091","50"
"Murray","1","11","Oklahoma","6/16/20","6","5","40099","83.33"
"Muskogee","1","77","Oklahoma","6/16/20","67","10","40101","14.93"
"Noble","2","18","Oklahoma","6/16/20","7","11","40103","157.14"
"Nowata","0","26","Oklahoma","6/16/20","24","2","40105","8.33"
"Okfuskee","0","6","Oklahoma","6/16/20","6","0","40107","0"
"Oklahoma","38","1673","Oklahoma","6/16/20","1404","269","40109","19.16"
"Okmulgee","0","31","Oklahoma","6/16/20","29","2","40111","6.9"
"Osage","2","114","Oklahoma","6/16/20","102","12","40113","11.76"
"Ottawa","1","41","Oklahoma","6/16/20","35","6","40115","17.14"
"Pawnee","1","41","Oklahoma","6/16/20","34","7","40117","20.59"
"Payne","13","142","Oklahoma","6/16/20","52","90","40119","173.08"
"Pittsburg","0","43","Oklahoma","6/16/20","43","0","40121","0"
"Pontotoc","0","21","Oklahoma","6/16/20","20","1","40123","5"
"Pottawatomie","1","75","Oklahoma","6/16/20","65","10","40125","15.38"
"Pushmataha","0","7","Oklahoma","6/16/20","5","2","40127","40"
"Rogers","2","100","Oklahoma","6/16/20","89","11","40131","12.36"
"Seminole","0","31","Oklahoma","6/16/20","30","1","40133","3.33"
"Sequoyah","0","21","Oklahoma","6/16/20","18","3","40135","16.67"
"Stephens","1","47","Oklahoma","6/16/20","43","4","40137","9.3"
"Texas","3","975","Oklahoma","6/16/20","954","21","40139","2.2"
"Tillman","0","23","Oklahoma","6/16/20","23","0","40141","0"
"Tulsa","67","1729","Oklahoma","6/16/20","1261","468","40143","37.11"
"Wagoner","2","173","Oklahoma","6/16/20","158","15","40145","9.49"
"Washington","1","353","Oklahoma","6/16/20","343","10","40147","2.92"
"Washita","0","3","Oklahoma","6/16/20","2","1","40149","50"
"Woods","0","5","Oklahoma","6/16/20","5","0","40151","0"
"Woodward","0","11","Oklahoma","6/16/20","8","3","40153","37.5"
"Baker","0","1","Oregon","6/16/20","1","0","41001","0"
"Benton","0","63","Oregon","6/16/20","63","0","41003","0"
"Clackamas","17","509","Oregon","6/16/20","393","116","41005","29.52"
"Clatsop","0","46","Oregon","6/16/20","45","1","41007","2.22"
"Columbia","1","22","Oregon","6/16/20","17","5","41009","29.41"
"Coos","0","32","Oregon","6/16/20","32","0","41011","0"
"Crook","0","9","Oregon","6/16/20","6","3","41013","50"
"Curry","0","7","Oregon","6/16/20","7","0","41015","0"
"Deschutes","0","137","Oregon","6/16/20","134","3","41017","2.24"
"Douglas","0","29","Oregon","6/16/20","29","0","41019","0"
"Grant","0","1","Oregon","6/16/20","1","0","41023","0"
"Harney","0","1","Oregon","6/16/20","1","0","41025","0"
"Hood River","3","83","Oregon","6/16/20","65","18","41027","27.69"
"Jackson","2","83","Oregon","6/16/20","71","12","41029","16.9"
"Jefferson","2","69","Oregon","6/16/20","58","11","41031","18.97"
"Josephine","0","24","Oregon","6/16/20","23","1","41033","4.35"
"Klamath","2","61","Oregon","6/16/20","46","15","41035","32.61"
"Lake","0","5","Oregon","6/16/20","2","3","41037","150"
"Lane","1","90","Oregon","6/16/20","81","9","41039","11.11"
"Lincoln","9","223","Oregon","6/16/20","157","66","41041","42.04"
"Linn","0","126","Oregon","6/16/20","124","2","41043","1.61"
"Malheur","1","38","Oregon","6/16/20","33","5","41045","15.15"
"Marion","19","1201","Oregon","6/16/20","1066","135","41047","12.66"
"Morrow","1","17","Oregon","6/16/20","13","4","41049","30.77"
"Multnomah","38","1598","Oregon","6/16/20","1329","269","41051","20.24"
"Polk","3","127","Oregon","6/16/20","104","23","41053","22.12"
"Sherman","0","1","Oregon","6/16/20","1","0","41055","0"
"Tillamook","0","6","Oregon","6/16/20","6","0","41057","0"
"Umatilla","5","181","Oregon","6/16/20","144","37","41059","25.69"
"Union","33","240","Oregon","6/16/20","7","233","41061","3328.57"
"Wallowa","0","4","Oregon","6/16/20","3","1","41063","33.33"
"Wasco","1","42","Oregon","6/16/20","34","8","41065","23.53"
"Washington","17","928","Oregon","6/16/20","807","121","41067","14.99"
"Yamhill","1","94","Oregon","6/16/20","85","9","41071","10.59"
"Adams","3","298","Pennsylvania","6/16/20","275","23","42001","8.36"
"Allegheny","12","2113","Pennsylvania","6/16/20","2027","86","42003","4.24"
"Armstrong","0","68","Pennsylvania","6/16/20","65","3","42005","4.62"
"Beaver","1","613","Pennsylvania","6/16/20","608","5","42007","0.82"
"Bedford","1","53","Pennsylvania","6/16/20","45","8","42009","17.78"
"Berks","15","4341","Pennsylvania","6/16/20","4236","105","42011","2.48"
"Blair","0","55","Pennsylvania","6/16/20","53","2","42013","3.77"
"Bradford","0","47","Pennsylvania","6/16/20","46","1","42015","2.17"
"Bucks","21","5452","Pennsylvania","6/16/20","5304","148","42017","2.79"
"Butler","2","260","Pennsylvania","6/16/20","249","11","42019","4.42"
"Cambria","0","61","Pennsylvania","6/16/20","60","1","42021","1.67"
"Cameron","0","2","Pennsylvania","6/16/20","2","0","42023","0"
"Carbon","1","259","Pennsylvania","6/16/20","253","6","42025","2.37"
"Centre","3","177","Pennsylvania","6/16/20","157","20","42027","12.74"
"Chester","30","3343","Pennsylvania","6/16/20","3134","209","42029","6.67"
"Clarion","0","31","Pennsylvania","6/16/20","29","2","42031","6.9"
"Clearfield","1","57","Pennsylvania","6/16/20","48","9","42033","18.75"
"Clinton","0","64","Pennsylvania","6/16/20","61","3","42035","4.92"
"Columbia","3","385","Pennsylvania","6/16/20","367","18","42037","4.9"
"Crawford","1","35","Pennsylvania","6/16/20","31","4","42039","12.9"
"Cumberland","9","746","Pennsylvania","6/16/20","683","63","42041","9.22"
"Dauphin","21","1674","Pennsylvania","6/16/20","1525","149","42043","9.77"
"Delaware","29","6936","Pennsylvania","6/16/20","6733","203","42045","3.02"
"Elk","0","6","Pennsylvania","6/16/20","6","0","42047","0"
"Erie","11","472","Pennsylvania","6/16/20","396","76","42049","19.19"
"Fayette","0","95","Pennsylvania","6/16/20","95","0","42051","0"
"Forest","0","7","Pennsylvania","6/16/20","7","0","42053","0"
"Franklin","7","849","Pennsylvania","6/16/20","800","49","42055","6.12"
"Fulton","0","17","Pennsylvania","6/16/20","16","1","42057","6.25"
"Greene","0","30","Pennsylvania","6/16/20","28","2","42059","7.14"
"Huntingdon","0","239","Pennsylvania","6/16/20","236","3","42061","1.27"
"Indiana","0","95","Pennsylvania","6/16/20","92","3","42063","3.26"
"Jefferson","0","19","Pennsylvania","6/16/20","16","3","42065","18.75"
"Juniata","1","108","Pennsylvania","6/16/20","101","7","42067","6.93"
"Lackawanna","3","1608","Pennsylvania","6/16/20","1587","21","42069","1.32"
"Lancaster","35","3802","Pennsylvania","6/16/20","3554","248","42071","6.98"
"Lawrence","0","87","Pennsylvania","6/16/20","85","2","42073","2.35"
"Lebanon","15","1193","Pennsylvania","6/16/20","1086","107","42075","9.85"
"Lehigh","12","3973","Pennsylvania","6/16/20","3890","83","42077","2.13"
"Luzerne","6","2840","Pennsylvania","6/16/20","2798","42","42079","1.5"
"Lycoming","1","172","Pennsylvania","6/16/20","168","4","42081","2.38"
"McKean","0","13","Pennsylvania","6/16/20","13","0","42083","0"
"Mercer","1","117","Pennsylvania","6/16/20","113","4","42085","3.54"
"Mifflin","0","60","Pennsylvania","6/16/20","59","1","42087","1.69"
"Monroe","2","1356","Pennsylvania","6/16/20","1342","14","42089","1.04"
"Montgomery","40","7950","Pennsylvania","6/16/20","7672","278","42091","3.62"
"Montour","2","65","Pennsylvania","6/16/20","53","12","42093","22.64"
"Northampton","11","3250","Pennsylvania","6/16/20","3175","75","42095","2.36"
"Northumberland","3","231","Pennsylvania","6/16/20","211","20","42097","9.48"
"Perry","1","73","Pennsylvania","6/16/20","68","5","42099","7.35"
"Philadelphia","110","24591","Pennsylvania","6/16/20","23822","769","42101","3.23"
"Pike","0","485","Pennsylvania","6/16/20","482","3","42103","0.62"
"Potter","0","13","Pennsylvania","6/16/20","11","2","42105","18.18"
"Schuylkill","5","696","Pennsylvania","6/16/20","659","37","42107","5.61"
"Snyder","0","60","Pennsylvania","6/16/20","57","3","42109","5.26"
"Somerset","0","41","Pennsylvania","6/16/20","39","2","42111","5.13"
"Sullivan","0","3","Pennsylvania","6/16/20","3","0","42113","0"
"Susquehanna","3","172","Pennsylvania","6/16/20","154","18","42115","11.69"
"Tioga","0","20","Pennsylvania","6/16/20","19","1","42117","5.26"
"Union","1","84","Pennsylvania","6/16/20","74","10","42119","13.51"
"Venango","0","17","Pennsylvania","6/16/20","16","1","42121","6.25"
"Warren","0","5","Pennsylvania","6/16/20","5","0","42123","0"
"Washington","1","156","Pennsylvania","6/16/20","150","6","42125","4"
"Wayne","0","126","Pennsylvania","6/16/20","124","2","42127","1.61"
"Westmoreland","4","493","Pennsylvania","6/16/20","467","26","42129","5.57"
"Wyoming","0","36","Pennsylvania","6/16/20","36","0","42131","0"
"York","13","1183","Pennsylvania","6/16/20","1094","89","42133","8.14"
"","109","5951","Puerto Rico","6/16/20","5185","766",,"14.77"
"Bristol","1","240","Rhode Island","6/16/20","231","9","44001","3.9"
"Kent","3","1128","Rhode Island","6/16/20","1105","23","44003","2.08"
"Newport","1","277","Rhode Island","6/16/20","269","8","44005","2.97"
"Providence","58","12363","Rhode Island","6/16/20","11959","404","44007","3.38"
"Washington","0","516","Rhode Island","6/16/20","513","3","44009","0.58"
"Abbeville","2","73","South Carolina","6/16/20","60","13","45001","21.67"
"Aiken","4","240","South Carolina","6/16/20","213","27","45003","12.68"
"Allendale","0","41","South Carolina","6/16/20","39","2","45005","5.13"
"Anderson","9","352","South Carolina","6/16/20","289","63","45007","21.8"
"Bamberg","2","50","South Carolina","6/16/20","36","14","45009","38.89"
"Barnwell","0","56","South Carolina","6/16/20","54","2","45011","3.7"
"Beaufort","26","647","South Carolina","6/16/20","464","183","45013","39.44"
"Berkeley","19","427","South Carolina","6/16/20","291","136","45015","46.74"
"Calhoun","3","46","South Carolina","6/16/20","23","23","45017","100"
"Charleston","56","1230","South Carolina","6/16/20","835","395","45019","47.31"
"Cherokee","3","93","South Carolina","6/16/20","74","19","45021","25.68"
"Chester","2","125","South Carolina","6/16/20","110","15","45023","13.64"
"Chesterfield","5","293","South Carolina","6/16/20","256","37","45025","14.45"
"Clarendon","5","342","South Carolina","6/16/20","309","33","45027","10.68"
"Colleton","9","209","South Carolina","6/16/20","148","61","45029","41.22"
"Darlington","3","357","South Carolina","6/16/20","333","24","45031","7.21"
"Dillon","2","202","South Carolina","6/16/20","189","13","45033","6.88"
"Dorchester","8","277","South Carolina","6/16/20","219","58","45035","26.48"
"Edgefield","1","61","South Carolina","6/16/20","55","6","45037","10.91"
"Fairfield","2","232","South Carolina","6/16/20","216","16","45039","7.41"
"Florence","15","833","South Carolina","6/16/20","727","106","45041","14.58"
"Georgetown","11","180","South Carolina","6/16/20","100","80","45043","80"
"Greenville","121","3072","South Carolina","6/16/20","2222","850","45045","38.25"
"Greenwood","17","315","South Carolina","6/16/20","198","117","45047","59.09"
"Hampton","1","50","South Carolina","6/16/20","46","4","45049","8.7"
"Horry","82","1297","South Carolina","6/16/20","720","577","45051","80.14"
"Jasper","1","56","South Carolina","6/16/20","50","6","45053","12"
"Kershaw","10","461","South Carolina","6/16/20","391","70","45055","17.9"
"Lancaster","6","259","South Carolina","6/16/20","214","45","45057","21.03"
"Laurens","11","171","South Carolina","6/16/20","97","74","45059","76.29"
"Lee","1","238","South Carolina","6/16/20","231","7","45061","3.03"
"Lexington","43","1216","South Carolina","6/16/20","913","303","45063","33.19"
"Marion","4","108","South Carolina","6/16/20","83","25","45067","30.12"
"Marlboro","4","237","South Carolina","6/16/20","211","26","45069","12.32"
"McCormick","0","11","South Carolina","6/16/20","11","0","45065","0"
"Newberry","3","108","South Carolina","6/16/20","87","21","45071","24.14"
"Oconee","5","94","South Carolina","6/16/20","61","33","45073","54.1"
"Orangeburg","19","415","South Carolina","6/16/20","283","132","45075","46.64"
"Pickens","16","326","South Carolina","6/16/20","212","114","45077","53.77"
"Richland","63","2316","South Carolina","6/16/20","1873","443","45079","23.65"
"Saluda","2","170","South Carolina","6/16/20","154","16","45081","10.39"
"Spartanburg","29","1026","South Carolina","6/16/20","825","201","45083","24.36"
"Sumter","22","648","South Carolina","6/16/20","494","154","45085","31.17"
"Union","1","49","South Carolina","6/16/20","41","8","45087","19.51"
"Williamsburg","5","296","South Carolina","6/16/20","261","35","45089","13.41"
"York","25","685","South Carolina","6/16/20","510","175","45091","34.31"
"Aurora","1","33","South Dakota","6/16/20","29","4","46003","13.79"
"Beadle","9","452","South Dakota","6/16/20","386","66","46005","17.1"
"Bennett","0","1","South Dakota","6/16/20","0","1","46007","1"
"Bon Homme","0","9","South Dakota","6/16/20","8","1","46009","12.5"
"Brookings","2","38","South Dakota","6/16/20","24","14","46011","58.33"
"Brown","1","313","South Dakota","6/16/20","303","10","46013","3.3"
"Brule","1","10","South Dakota","6/16/20","2","8","46015","400"
"Buffalo","4","54","South Dakota","6/16/20","29","25","46017","86.21"
"Charles Mix","2","32","South Dakota","6/16/20","20","12","46023","60"
"Clark","1","11","South Dakota","6/16/20","5","6","46025","120"
"Clay","4","67","South Dakota","6/16/20","39","28","46027","71.79"
"Codington","0","46","South Dakota","6/16/20","43","3","46029","6.98"
"Corson","1","11","South Dakota","6/16/20","4","7","46031","175"
"Custer","0","2","South Dakota","6/16/20","1","1","46033","100"
"Davison","0","33","South Dakota","6/16/20","30","3","46035","10"
"Day","0","13","South Dakota","6/16/20","13","0","46037","0"
"Deuel","0","1","South Dakota","6/16/20","1","0","46039","0"
"Dewey","0","4","South Dakota","6/16/20","1","3","46041","300"
"Douglas","0","4","South Dakota","6/16/20","4","0","46043","0"
"Edmunds","0","4","South Dakota","6/16/20","4","0","46045","0"
"Fall River","0","6","South Dakota","6/16/20","6","0","46047","0"
"Faulk","2","20","South Dakota","6/16/20","6","14","46049","233.33"
"Grant","0","13","South Dakota","6/16/20","13","0","46051","0"
"Gregory","0","1","South Dakota","6/16/20","1","0","46053","0"
"Hamlin","0","11","South Dakota","6/16/20","8","3","46057","37.5"
"Hand","0","6","South Dakota","6/16/20","5","1","46059","20"
"Hanson","0","3","South Dakota","6/16/20","3","0","46061","0"
"Hughes","0","23","South Dakota","6/16/20","21","2","46065","9.52"
"Hutchinson","0","9","South Dakota","6/16/20","6","3","46067","50"
"Hyde","0","3","South Dakota","6/16/20","3","0","46069","0"
"Jackson","0","6","South Dakota","6/16/20","4","2","46071","50"
"Jerauld","0","40","South Dakota","6/16/20","40","0","46073","0"
"Kingsbury","0","5","South Dakota","6/16/20","5","0","46077","0"
"Lake","0","16","South Dakota","6/16/20","13","3","46079","23.08"
"Lawrence","0","12","South Dakota","6/16/20","12","0","46081","0"
"Lincoln","2","271","South Dakota","6/16/20","255","16","46083","6.27"
"Lyman","1","33","South Dakota","6/16/20","27","6","46085","22.22"
"Marshall","0","5","South Dakota","6/16/20","4","1","46091","25"
"McCook","0","8","South Dakota","6/16/20","6","2","46087","33.33"
"McPherson","0","3","South Dakota","6/16/20","3","0","46089","0"
"Meade","2","39","South Dakota","6/16/20","26","13","46093","50"
"Mellette","0","2","South Dakota","6/16/20","0","2","46095","1"
"Miner","0","3","South Dakota","6/16/20","3","0","46097","0"
"Minnehaha","10","3488","South Dakota","6/16/20","3418","70","46099","2.05"
"Moody","0","20","South Dakota","6/16/20","19","1","46101","5.26"
"Oglala Lakota","1","48","South Dakota","6/16/20","40","8","46102","20"
"Pennington","12","402","South Dakota","6/16/20","321","81","46103","25.23"
"Roberts","0","40","South Dakota","6/16/20","39","1","46109","2.56"
"Sanborn","0","13","South Dakota","6/16/20","13","0","46111","0"
"Spink","0","5","South Dakota","6/16/20","5","0","46115","0"
"Stanley","0","11","South Dakota","6/16/20","10","1","46117","10"
"Sully","0","1","South Dakota","6/16/20","1","0","46119","0"
"Todd","1","48","South Dakota","6/16/20","42","6","46121","14.29"
"Tripp","0","8","South Dakota","6/16/20","6","2","46123","33.33"
"Turner","0","25","South Dakota","6/16/20","25","0","46125","0"
"Union","1","113","South Dakota","6/16/20","103","10","46127","9.71"
"Walworth","0","6","South Dakota","6/16/20","5","1","46129","20"
"Yankton","0","60","South Dakota","6/16/20","58","2","46135","3.45"
"Ziebach","0","2","South Dakota","6/16/20","2","0","46137","0"
"Anderson","2","65","Tennessee","6/16/20","50","15","47001","30"
"Bedford","7","392","Tennessee","6/16/20","341","51","47003","14.96"
"Benton","0","8","Tennessee","6/16/20","8","0","47005","0"
"Bledsoe","0","614","Tennessee","6/16/20","611","3","47007","0.49"
"Blount","2","110","Tennessee","6/16/20","96","14","47009","14.58"
"Bradley","10","302","Tennessee","6/16/20","233","69","47011","29.61"
"Campbell","1","25","Tennessee","6/16/20","18","7","47013","38.89"
"Cannon","0","34","Tennessee","6/16/20","34","0","47015","0"
"Carroll","1","36","Tennessee","6/16/20","28","8","47017","28.57"
"Carter","0","22","Tennessee","6/16/20","19","3","47019","15.79"
"Cheatham","2","158","Tennessee","6/16/20","146","12","47021","8.22"
"Chester","0","12","Tennessee","6/16/20","12","0","47023","0"
"Claiborne","0","15","Tennessee","6/16/20","14","1","47025","7.14"
"Clay","0","11","Tennessee","6/16/20","9","2","47027","22.22"
"Cocke","1","27","Tennessee","6/16/20","22","5","47029","22.73"
"Coffee","2","96","Tennessee","6/16/20","84","12","47031","14.29"
"Crockett","0","19","Tennessee","6/16/20","16","3","47033","18.75"
"Cumberland","2","137","Tennessee","6/16/20","126","11","47035","8.73"
"Davidson","127","7016","Tennessee","6/16/20","6125","891","47037","14.55"
"Decatur","1","14","Tennessee","6/16/20","6","8","47039","133.33"
"DeKalb","0","41","Tennessee","6/16/20","41","0","47041","0"
"Dickson","2","138","Tennessee","6/16/20","127","11","47043","8.66"
"Dyer","5","106","Tennessee","6/16/20","70","36","47045","51.43"
"Fayette","3","183","Tennessee","6/16/20","159","24","47047","15.09"
"Fentress","0","15","Tennessee","6/16/20","13","2","47049","15.38"
"Franklin","1","63","Tennessee","6/16/20","55","8","47051","14.55"
"Gibson","1","69","Tennessee","6/16/20","64","5","47053","7.81"
"Giles","0","22","Tennessee","6/16/20","19","3","47055","15.79"
"Grainger","1","22","Tennessee","6/16/20","16","6","47057","37.5"
"Greene","0","55","Tennessee","6/16/20","52","3","47059","5.77"
"Grundy","1","36","Tennessee","6/16/20","32","4","47061","12.5"
"Hamblen","4","88","Tennessee","6/16/20","62","26","47063","41.94"
"Hamilton","102","1836","Tennessee","6/16/20","1122","714","47065","63.64"
"Hancock","0","1","Tennessee","6/16/20","1","0","47067","0"
"Hardeman","2","225","Tennessee","6/16/20","212","13","47069","6.13"
"Hardin","1","40","Tennessee","6/16/20","30","10","47071","33.33"
"Hawkins","0","35","Tennessee","6/16/20","34","1","47073","2.94"
"Haywood","0","37","Tennessee","6/16/20","35","2","47075","5.71"
"Henderson","0","19","Tennessee","6/16/20","16","3","47077","18.75"
"Henry","0","35","Tennessee","6/16/20","33","2","47079","6.06"
"Hickman","0","62","Tennessee","6/16/20","60","2","47081","3.33"
"Houston","0","10","Tennessee","6/16/20","9","1","47083","11.11"
"Humphreys","0","18","Tennessee","6/16/20","18","0","47085","0"
"Jackson","0","20","Tennessee","6/16/20","19","1","47087","5.26"
"Jefferson","2","46","Tennessee","6/16/20","31","15","47089","48.39"
"Johnson","0","25","Tennessee","6/16/20","22","3","47091","13.64"
"Knox","11","569","Tennessee","6/16/20","491","78","47093","15.89"
"Lake","-6","689","Tennessee","6/16/20","730","-41","47095","-5.62"
"Lauderdale","1","68","Tennessee","6/16/20","60","8","47097","13.33"
"Lawrence","4","70","Tennessee","6/16/20","41","29","47099","70.73"
"Lewis","0","5","Tennessee","6/16/20","4","1","47101","25"
"Lincoln","2","47","Tennessee","6/16/20","33","14","47103","42.42"
"Loudon","6","210","Tennessee","6/16/20","171","39","47105","22.81"
"Macon","3","209","Tennessee","6/16/20","185","24","47111","12.97"
"Madison","0","183","Tennessee","6/16/20","181","2","47113","1.1"
"Marion","1","49","Tennessee","6/16/20","45","4","47115","8.89"
"Marshall","1","43","Tennessee","6/16/20","37","6","47117","16.22"
"Maury","7","171","Tennessee","6/16/20","124","47","47119","37.9"
"McMinn","1","169","Tennessee","6/16/20","159","10","47107","6.29"
"McNairy","1","31","Tennessee","6/16/20","23","8","47109","34.78"
"Meigs","0","30","Tennessee","6/16/20","27","3","47121","11.11"
"Monroe","2","91","Tennessee","6/16/20","75","16","47123","21.33"
"Montgomery","4","341","Tennessee","6/16/20","310","31","47125","10"
"Moore","0","5","Tennessee","6/16/20","5","0","47127","0"
"Morgan","0","21","Tennessee","6/16/20","19","2","47129","10.53"
"Obion","2","67","Tennessee","6/16/20","53","14","47131","26.42"
"Out of TN","1","463","Tennessee","6/16/20","457","6","80047","1.31"
"Overton","0","38","Tennessee","6/16/20","35","3","47133","8.57"
"Perry","1","28","Tennessee","6/16/20","24","4","47135","16.67"
"Pickett","0","4","Tennessee","6/16/20","4","0","47137","0"
"Polk","1","29","Tennessee","6/16/20","24","5","47139","20.83"
"Putnam","6","613","Tennessee","6/16/20","569","44","47141","7.73"
"Rhea","3","239","Tennessee","6/16/20","219","20","47143","9.13"
"Roane","1","32","Tennessee","6/16/20","23","9","47145","39.13"
"Robertson","11","657","Tennessee","6/16/20","580","77","47147","13.28"
"Rutherford","36","1820","Tennessee","6/16/20","1568","252","47149","16.07"
"Scott","0","14","Tennessee","6/16/20","13","1","47151","7.69"
"Sequatchie","0","22","Tennessee","6/16/20","21","1","47153","4.76"
"Sevier","18","285","Tennessee","6/16/20","158","127","47155","80.38"
"Shelby","140","7104","Tennessee","6/16/20","6125","979","47157","15.98"
"Smith","1","43","Tennessee","6/16/20","37","6","47159","16.22"
"Stewart","0","16","Tennessee","6/16/20","14","2","47161","14.29"
"Sullivan","1","70","Tennessee","6/16/20","66","4","47163","6.06"
"Sumner","14","1112","Tennessee","6/16/20","1011","101","47165","9.99"
"Tipton","5","525","Tennessee","6/16/20","487","38","47167","7.8"
"Trousdale","9","1460","Tennessee","6/16/20","1397","63","47169","4.51"
"Unicoi","0","52","Tennessee","6/16/20","52","0","47171","0"
"Union","1","9","Tennessee","6/16/20","5","4","47173","80"
"Van Buren","0","5","Tennessee","6/16/20","4","1","47175","25"
"Warren","0","35","Tennessee","6/16/20","32","3","47177","9.38"
"Washington","1","91","Tennessee","6/16/20","86","5","47179","5.81"
"Wayne","0","64","Tennessee","6/16/20","64","0","47181","0"
"Weakley","1","32","Tennessee","6/16/20","26","6","47183","23.08"
"White","1","49","Tennessee","6/16/20","45","4","47185","8.89"
"Williamson","11","723","Tennessee","6/16/20","648","75","47187","11.57"
"Wilson","7","537","Tennessee","6/16/20","488","49","47189","10.04"
"Anderson","2","102","Texas","6/16/20","91","11","48001","12.09"
"Andrews","0","30","Texas","6/16/20","27","3","48003","11.11"
"Angelina","13","331","Texas","6/16/20","237","94","48005","39.66"
"Aransas","0","7","Texas","6/16/20","5","2","48007","40"
"Archer","0","3","Texas","6/16/20","3","0","48009","0"
"Armstrong","0","2","Texas","6/16/20","3","-1","48011","-33.33"
"Atascosa","0","42","Texas","6/16/20","42","0","48013","0"
"Austin","1","36","Texas","6/16/20","32","4","48015","12.5"
"Bailey","2","40","Texas","6/16/20","26","14","48017","53.85"
"Bandera","0","7","Texas","6/16/20","6","1","48019","16.67"
"Bastrop","6","313","Texas","6/16/20","270","43","48021","15.93"
"Baylor","0","1","Texas","6/16/20","1","0","48023","0"
"Bee","1","32","Texas","6/16/20","24","8","48025","33.33"
"Bell","25","651","Texas","6/16/20","473","178","48027","37.63"
"Bexar","158","4437","Texas","6/16/20","3333","1104","48029","33.12"
"Blanco","0","11","Texas","6/16/20","12","-1","48031","-8.33"
"Bosque","0","7","Texas","6/16/20","7","0","48035","0"
"Bowie","4","377","Texas","6/16/20","351","26","48037","7.41"
"Brazoria","104","1495","Texas","6/16/20","770","725","48039","94.16"
"Brazos","27","821","Texas","6/16/20","634","187","48041","29.5"
"Brewster","2","13","Texas","6/16/20","1","12","48043","1200"
"Briscoe","0","1","Texas","6/16/20","1","0","48045","0"
"Brooks","0","3","Texas","6/16/20","1","2","48047","200"
"Brown","0","61","Texas","6/16/20","60","1","48049","1.67"
"Burleson","1","45","Texas","6/16/20","35","10","48051","28.57"
"Burnet","1","62","Texas","6/16/20","55","7","48053","12.73"
"Caldwell","11","157","Texas","6/16/20","79","78","48055","98.73"
"Calhoun","1","46","Texas","6/16/20","41","5","48057","12.2"
"Callahan","0","13","Texas","6/16/20","10","3","48059","30"
"Cameron","37","1178","Texas","6/16/20","919","259","48061","28.18"
"Camp","2","109","Texas","6/16/20","95","14","48063","14.74"
"Carson","0","6","Texas","6/16/20","6","0","48065","0"
"Cass","0","34","Texas","6/16/20","32","2","48067","6.25"
"Castro","2","48","Texas","6/16/20","36","12","48069","33.33"
"Chambers","5","116","Texas","6/16/20","83","33","48071","39.76"
"Cherokee","1","61","Texas","6/16/20","54","7","48073","12.96"
"Childress","0","6","Texas","6/16/20","4","2","48075","50"
"Clay","0","5","Texas","6/16/20","5","0","48077","0"
"Cochran","0","1","Texas","6/16/20","1","0","48079","0"
"Coke","0","4","Texas","6/16/20","1","3","48081","300"
"Coleman","0","3","Texas","6/16/20","3","0","48083","0"
"Collin","37","1787","Texas","6/16/20","1528","259","48085","16.95"
"Collingsworth","0","5","Texas","6/16/20","5","0","48087","0"
"Colorado","1","36","Texas","6/16/20","26","10","48089","38.46"
"Comal","5","159","Texas","6/16/20","121","38","48091","31.4"
"Comanche","0","14","Texas","6/16/20","12","2","48093","16.67"
"Concho","0","1","Texas","6/16/20","1","0","48095","0"
"Cooke","1","24","Texas","6/16/20","20","4","48097","20"
"Coryell","1","300","Texas","6/16/20","296","4","48099","1.35"
"Cottle","0","4","Texas","6/16/20","4","0","48101","0"
"Crane","2","39","Texas","6/16/20","28","11","48103","39.29"
"Crockett","0","5","Texas","6/16/20","4","1","48105","25"
"Crosby","1","7","Texas","6/16/20","3","4","48107","133.33"
"Dallam","1","36","Texas","6/16/20","29","7","48111","24.14"
"Dallas","314","14843","Texas","6/16/20","12645","2198","48113","17.38"
"Dawson","0","45","Texas","6/16/20","45","0","48115","0"
"Deaf Smith","6","222","Texas","6/16/20","183","39","48117","21.31"
"Delta","0","2","Texas","6/16/20","2","0","48119","0"
"Denton","35","1772","Texas","6/16/20","1524","248","48121","16.27"
"DeWitt","1","31","Texas","6/16/20","23","8","48123","34.78"
"Dickens","0","2","Texas","6/16/20","1","1","48125","100"
"Dimmit","0","1","Texas","6/16/20","1","0","48127","0"
"Donley","0","28","Texas","6/16/20","27","1","48129","3.7"
"Duval","0","5","Texas","6/16/20","5","0","48131","0"
"Eastland","0","7","Texas","6/16/20","7","0","48133","0"
"Ector","8","260","Texas","6/16/20","206","54","48135","26.21"
"El Paso","62","3948","Texas","6/16/20","3512","436","48141","12.41"
"Ellis","8","458","Texas","6/16/20","399","59","48139","14.79"
"Erath","1","37","Texas","6/16/20","29","8","48143","27.59"
"Falls","1","18","Texas","6/16/20","13","5","48145","38.46"
"Fannin","1","55","Texas","6/16/20","49","6","48147","12.24"
"Fayette","1","45","Texas","6/16/20","38","7","48149","18.42"
"Fisher","0","2","Texas","6/16/20","2","0","48151","0"
"Floyd","0","16","Texas","6/16/20","16","0","48153","0"
"Fort Bend","38","2402","Texas","6/16/20","2138","264","48157","12.35"
"Franklin","1","27","Texas","6/16/20","22","5","48159","22.73"
"Freestone","1","17","Texas","6/16/20","12","5","48161","41.67"
"Frio","4","79","Texas","6/16/20","50","29","48163","58"
"Gaines","1","14","Texas","6/16/20","9","5","48165","55.56"
"Galveston","41","1312","Texas","6/16/20","1026","286","48167","27.88"
"Garza","0","7","Texas","6/16/20","6","1","48169","16.67"
"Gillespie","1","9","Texas","6/16/20","5","4","48171","80"
"Glasscock","0","3","Texas","6/16/20","1","2","48173","200"
"Goliad","0","7","Texas","6/16/20","7","0","48175","0"
"Gonzales","2","169","Texas","6/16/20","153","16","48177","10.46"
"Gray","1","111","Texas","6/16/20","105","6","48179","5.71"
"Grayson","8","440","Texas","6/16/20","384","56","48181","14.58"
"Gregg","2","285","Texas","6/16/20","272","13","48183","4.78"
"Grimes","5","281","Texas","6/16/20","245","36","48185","14.69"
"Guadalupe","4","175","Texas","6/16/20","147","28","48187","19.05"
"Hale","6","100","Texas","6/16/20","61","39","48189","63.93"
"Hall","0","2","Texas","6/16/20","2","0","48191","0"
"Hamilton","1","15","Texas","6/16/20","10","5","48193","50"
"Hansford","0","23","Texas","6/16/20","20","3","48195","15"
"Hardeman","0","4","Texas","6/16/20","4","0","48197","0"
"Hardin","1","147","Texas","6/16/20","142","5","48199","3.52"
"Harris","353","17707","Texas","6/16/20","15238","2469","48201","16.2"
"Harrison","2","269","Texas","6/16/20","258","11","48203","4.26"
"Hartley","0","13","Texas","6/16/20","12","1","48205","8.33"
"Haskell","0","4","Texas","6/16/20","3","1","48207","33.33"
"Hays","71","938","Texas","6/16/20","441","497","48209","112.7"
"Hemphill","0","1","Texas","6/16/20","1","0","48211","0"
"Henderson","2","82","Texas","6/16/20","71","11","48213","15.49"
"Hidalgo","50","1112","Texas","6/16/20","759","353","48215","46.51"
"Hill","1","38","Texas","6/16/20","30","8","48217","26.67"
"Hockley","0","28","Texas","6/16/20","27","1","48219","3.7"
"Hood","1","35","Texas","6/16/20","31","4","48221","12.9"
"Hopkins","1","44","Texas","6/16/20","39","5","48223","12.82"
"Houston","-1","147","Texas","6/16/20","152","-5","48225","-3.29"
"Howard","1","23","Texas","6/16/20","15","8","48227","53.33"
"Hudspeth","1","13","Texas","6/16/20","4","9","48229","225"
"Hunt","9","185","Texas","6/16/20","121","64","48231","52.89"
"Hutchinson","0","45","Texas","6/16/20","44","1","48233","2.27"
"Irion","0","1","Texas","6/16/20","1","0","48235","0"
"Jack","0","4","Texas","6/16/20","4","0","48237","0"
"Jackson","0","21","Texas","6/16/20","19","2","48239","10.53"
"Jasper","0","32","Texas","6/16/20","31","1","48241","3.23"
"Jefferson","90","1279","Texas","6/16/20","647","632","48245","97.68"
"Jim Hogg","0","4","Texas","6/16/20","4","0","48247","0"
"Jim Wells","1","18","Texas","6/16/20","13","5","48249","38.46"
"Johnson","3","232","Texas","6/16/20","209","23","48251","11"
"Jones","-1","630","Texas","6/16/20","637","-7","48253","-1.1"
"Karnes","0","4","Texas","6/16/20","4","0","48255","0"
"Kaufman","9","339","Texas","6/16/20","275","64","48257","23.27"
"Kendall","0","36","Texas","6/16/20","33","3","48259","9.09"
"Kerr","0","20","Texas","6/16/20","20","0","48265","0"
"Kimble","0","1","Texas","6/16/20","1","0","48267","0"
"Kinney","0","1","Texas","6/16/20","1","0","48271","0"
"Kleberg","0","20","Texas","6/16/20","20","0","48273","0"
"Knox","0","1","Texas","6/16/20","1","0","48275","0"
"La Salle","0","4","Texas","6/16/20","4","0","48283","0"
"Lamar","3","174","Texas","6/16/20","156","18","48277","11.54"
"Lamb","0","20","Texas","6/16/20","17","3","48279","17.65"
"Lampasas","0","11","Texas","6/16/20","9","2","48281","22.22"
"Lavaca","0","22","Texas","6/16/20","19","3","48285","15.79"
"Lee","1","36","Texas","6/16/20","26","10","48287","38.46"
"Leon","0","12","Texas","6/16/20","11","1","48289","9.09"
"Liberty","4","137","Texas","6/16/20","108","29","48291","26.85"
"Limestone","1","40","Texas","6/16/20","34","6","48293","17.65"
"Lipscomb","0","9","Texas","6/16/20","7","2","48295","28.57"
"Live Oak","0","10","Texas","6/16/20","9","1","48297","11.11"
"Llano","0","5","Texas","6/16/20","3","2","48299","66.67"
"Lubbock","20","894","Texas","6/16/20","756","138","48303","18.25"
"Lynn","2","21","Texas","6/16/20","8","13","48305","162.5"
"Madison","1","22","Texas","6/16/20","16","6","48313","37.5"
"Marion","0","21","Texas","6/16/20","18","3","48315","16.67"
"Martin","0","4","Texas","6/16/20","3","1","48317","33.33"
"Mason","0","33","Texas","6/16/20","32","1","48319","3.12"
"Matagorda","1","85","Texas","6/16/20","77","8","48321","10.39"
"Maverick","8","199","Texas","6/16/20","146","53","48323","36.3"
"McCulloch","0","4","Texas","6/16/20","3","1","48307","33.33"
"McLennan","7","178","Texas","6/16/20","132","46","48309","34.85"
"Medina","1","221","Texas","6/16/20","216","5","48325","2.31"
"Midland","8","222","Texas","6/16/20","169","53","48329","31.36"
"Milam","1","44","Texas","6/16/20","35","9","48331","25.71"
"Mills","0","1","Texas","6/16/20","1","0","48333","0"
"Mitchell","0","2","Texas","6/16/20","1","1","48335","100"
"Montague","0","9","Texas","6/16/20","9","0","48337","0"
"Montgomery","34","1359","Texas","6/16/20","1122","237","48339","21.12"
"Moore","1","872","Texas","6/16/20","864","8","48341","0.93"
"Morris","1","31","Texas","6/16/20","27","4","48343","14.81"
"Motley","0","1","Texas","6/16/20","1","0","48345","0"
"Nacogdoches","3","326","Texas","6/16/20","305","21","48347","6.89"
"Navarro","4","98","Texas","6/16/20","70","28","48349","40"
"Newton","0","6","Texas","6/16/20","6","0","48351","0"
"Nolan","-1","5","Texas","6/16/20","9","-4","48353","-44.44"
"Nueces","9","360","Texas","6/16/20","300","60","48355","20"
"Ochiltree","0","53","Texas","6/16/20","52","1","48357","1.92"
"Oldham","0","4","Texas","6/16/20","4","0","48359","0"
"Orange","1","107","Texas","6/16/20","100","7","48361","7"
"Palo Pinto","0","14","Texas","6/16/20","13","1","48363","7.69"
"Panola","-1","209","Texas","6/16/20","214","-5","48365","-2.34"
"Parker","2","116","Texas","6/16/20","104","12","48367","11.54"
"Parmer","4","124","Texas","6/16/20","98","26","48369","26.53"
"Pecos","1","112","Texas","6/16/20","105","7","48371","6.67"
"Polk","1","71","Texas","6/16/20","61","10","48373","16.39"
"Potter","4","2789","Texas","6/16/20","2763","26","48375","0.94"
"Presidio","0","2","Texas","6/16/20","2","0","48377","0"
"Rains","0","5","Texas","6/16/20","4","1","48379","25"
"Randall","3","758","Texas","6/16/20","737","21","48381","2.85"
"Reagan","0","2","Texas","6/16/20","2","0","48383","0"
"Real","0","1","Texas","6/16/20","1","0","48385","0"
"Red River","2","95","Texas","6/16/20","81","14","48387","17.28"
"Reeves","0","14","Texas","6/16/20","11","3","48389","27.27"
"Refugio","0","6","Texas","6/16/20","5","1","48391","20"
"Roberts","0","2","Texas","6/16/20","2","0","48393","0"
"Robertson","0","18","Texas","6/16/20","17","1","48395","5.88"
"Rockwall","4","233","Texas","6/16/20","202","31","48397","15.35"
"Runnels","0","2","Texas","6/16/20","3","-1","48399","-33.33"
"Rusk","24","232","Texas","6/16/20","67","165","48401","246.27"
"Sabine","0","15","Texas","6/16/20","15","0","48403","0"
"San Augustine","2","61","Texas","6/16/20","45","16","48405","35.56"
"San Jacinto","0","19","Texas","6/16/20","19","0","48407","0"
"San Patricio","2","58","Texas","6/16/20","41","17","48409","41.46"
"San Saba","0","2","Texas","6/16/20","1","1","48411","100"
"Schleicher","1","6","Texas","6/16/20","0","6","48413","1"
"Scurry","0","28","Texas","6/16/20","26","2","48415","7.69"
"Shackelford","0","1","Texas","6/16/20","1","0","48417","0"
"Shelby","2","230","Texas","6/16/20","214","16","48419","7.48"
"Sherman","0","28","Texas","6/16/20","28","0","48421","0"
"Smith","7","283","Texas","6/16/20","235","48","48423","20.43"
"Somervell","0","3","Texas","6/16/20","1","2","48425","200"
"Starr","13","153","Texas","6/16/20","59","94","48427","159.32"
"Stephens","0","5","Texas","6/16/20","4","1","48429","25"
"Swisher","0","21","Texas","6/16/20","18","3","48437","16.67"
"Tarrant","182","7642","Texas","6/16/20","6369","1273","48439","19.99"
"Taylor","1","255","Texas","6/16/20","247","8","48441","3.24"
"Terry","0","13","Texas","6/16/20","13","0","48445","0"
"Throckmorton","0","1","Texas","6/16/20","1","0","48447","0"
"Titus","12","717","Texas","6/16/20","635","82","48449","12.91"
"Tom Green","6","164","Texas","6/16/20","119","45","48451","37.82"
"Travis","121","4664","Texas","6/16/20","3815","849","48453","22.25"
"Trinity","-1","17","Texas","6/16/20","22","-5","48455","-22.73"
"Tyler","0","14","Texas","6/16/20","16","-2","48457","-12.5"
"Upshur","1","41","Texas","6/16/20","35","6","48459","17.14"
"Upton","0","1","Texas","6/16/20","0","1","48461","1"
"Uvalde","1","26","Texas","6/16/20","20","6","48463","30"
"Val Verde","2","36","Texas","6/16/20","25","11","48465","44"
"Van Zandt","2","52","Texas","6/16/20","40","12","48467","30"
"Victoria","4","202","Texas","6/16/20","174","28","48469","16.09"
"Walker","1","1873","Texas","6/16/20","1868","5","48471","0.27"
"Waller","2","92","Texas","6/16/20","77","15","48473","19.48"
"Ward","1","7","Texas","6/16/20","2","5","48475","250"
"Washington","1","218","Texas","6/16/20","208","10","48477","4.81"
"Webb","16","718","Texas","6/16/20","608","110","48479","18.09"
"Wharton","2","98","Texas","6/16/20","84","14","48481","16.67"
"Wheeler","0","15","Texas","6/16/20","15","0","48483","0"
"Wichita","4","117","Texas","6/16/20","90","27","48485","30"
"Wilbarger","0","7","Texas","6/16/20","7","0","48487","0"
"Willacy","3","61","Texas","6/16/20","42","19","48489","45.24"
"Williamson","39","1021","Texas","6/16/20","745","276","48491","37.05"
"Wilson","1","53","Texas","6/16/20","45","8","48493","17.78"
"Winkler","0","4","Texas","6/16/20","3","1","48495","33.33"
"Wise","0","56","Texas","6/16/20","53","3","48497","5.66"
"Wood","1","56","Texas","6/16/20","51","5","48499","9.8"
"Yoakum","1","10","Texas","6/16/20","5","5","48501","100"
"Young","1","15","Texas","6/16/20","6","9","48503","150"
"Zapata","2","23","Texas","6/16/20","12","11","48505","91.67"
"Zavala","0","13","Texas","6/16/20","12","1","48507","8.33"
"Bear River","35","1039","Utah","6/16/20","795","244","00000","30.69"
"Central Utah","4","79","Utah","6/16/20","48","31","00000","64.58"
"Davis","16","691","Utah","6/16/20","580","111","49011","19.14"
"Salt Lake","171","7616","Utah","6/16/20","6421","1195","49035","18.61"
"San Juan","4","365","Utah","6/16/20","337","28","49037","8.31"
"Southeast Utah","0","29","Utah","6/16/20","28","1","00000","3.57"
"Southwest Utah","29","855","Utah","6/16/20","655","200","00000","30.53"
"Summit","1","448","Utah","6/16/20","440","8","49043","1.82"
"Tooele","4","178","Utah","6/16/20","153","25","49045","16.34"
"TriCounty","1","31","Utah","6/16/20","22","9","00000","40.91"
"Utah","53","2711","Utah","6/16/20","2337","374","49049","16"
"Wasatch","3","356","Utah","6/16/20","335","21","49051","6.27"
"Weber-Morgan","19","539","Utah","6/16/20","408","131","00000","32.11"
"Addison","0","66","Vermont","6/16/20","66","0","50001","0"
"Bennington","0","67","Vermont","6/16/20","66","1","50003","1.52"
"Caledonia","0","16","Vermont","6/16/20","16","0","50005","0"
"Chittenden","5","573","Vermont","6/16/20","535","38","50007","7.1"
"Essex","0","3","Vermont","6/16/20","3","0","50009","0"
"Franklin","0","102","Vermont","6/16/20","100","2","50011","2"
"Grand Isle","0","8","Vermont","6/16/20","7","1","50013","14.29"
"Lamoille","0","29","Vermont","6/16/20","29","0","50015","0"
"Orange","0","9","Vermont","6/16/20","9","0","50017","0"
"Orleans","0","13","Vermont","6/16/20","13","0","50019","0"
"Rutland","0","59","Vermont","6/16/20","57","2","50021","3.51"
"Washington","0","41","Vermont","6/16/20","39","2","50023","5.13"
"Windham","0","85","Vermont","6/16/20","83","2","50025","2.41"
"Windsor","0","55","Vermont","6/16/20","56","-1","50027","-1.79"
"","0","72","Virgin Islands","6/16/20","71","1",,"1.41"
"Accomack","3","1007","Virginia","6/16/20","983","24","51001","2.44"
"Albemarle","5","293","Virginia","6/16/20","258","35","51003","13.57"
"Alexandria","8","2168","Virginia","6/16/20","2115","53","51510","2.51"
"Alleghany","1","30","Virginia","6/16/20","26","4","51005","15.38"
"Amelia","1","38","Virginia","6/16/20","33","5","51007","15.15"
"Amherst","0","28","Virginia","6/16/20","27","1","51009","3.7"
"Appomattox","0","34","Virginia","6/16/20","33","1","51011","3.03"
"Arlington","14","2363","Virginia","6/16/20","2265","98","51013","4.33"
"Augusta","2","152","Virginia","6/16/20","137","15","51015","10.95"
"Bedford","2","94","Virginia","6/16/20","81","13","51019","16.05"
"Botetourt","1","50","Virginia","6/16/20","40","10","51023","25"
"Bristol","0","4","Virginia","6/16/20","4","0","51520","0"
"Brunswick","2","54","Virginia","6/16/20","41","13","51025","31.71"
"Buchanan","0","18","Virginia","6/16/20","18","0","51027","0"
"Buckingham","7","534","Virginia","6/16/20","484","50","51029","10.33"
"Buena Vista","0","12","Virginia","6/16/20","13","-1","51530","-7.69"
"Campbell","1","28","Virginia","6/16/20","20","8","51031","40"
"Caroline","2","113","Virginia","6/16/20","97","16","51033","16.49"
"Carroll","4","175","Virginia","6/16/20","149","26","51035","17.45"
"Charles City","1","33","Virginia","6/16/20","28","5","51036","17.86"
"Charlotte","0","30","Virginia","6/16/20","29","1","51037","3.45"
"Charlottesville","3","160","Virginia","6/16/20","141","19","51540","13.48"
"Chesapeake","10","678","Virginia","6/16/20","605","73","51550","12.07"
"Chesterfield","45","2259","Virginia","6/16/20","1942","317","51041","16.32"
"Clarke","1","40","Virginia","6/16/20","35","5","51043","14.29"
"Colonial Heights","2","117","Virginia","6/16/20","104","13","51570","12.5"
"Covington","0","4","Virginia","6/16/20","4","0","51580","0"
"Craig","0","6","Virginia","6/16/20","6","0","51045","0"
"Culpeper","2","787","Virginia","6/16/20","772","15","51047","1.94"
"Cumberland","1","50","Virginia","6/16/20","45","5","51049","11.11"
"Danville","1","66","Virginia","6/16/20","60","6","51590","10"
"Dickenson","0","1","Virginia","6/16/20","0","1","51051","1"
"Dinwiddie","2","110","Virginia","6/16/20","99","11","51053","11.11"
"Emporia","1","101","Virginia","6/16/20","91","10","51595","10.99"
"Essex","0","53","Virginia","6/16/20","53","0","51057","0"
"Fairfax","58","13103","Virginia","6/16/20","12695","408","51059","3.21"
"Fairfax City","0","67","Virginia","6/16/20","69","-2","51600","-2.9"
"Falls Church","0","58","Virginia","6/16/20","56","2","51610","3.57"
"Fauquier","4","393","Virginia","6/16/20","365","28","51061","7.67"
"Floyd","0","10","Virginia","6/16/20","8","2","51063","25"
"Fluvanna","1","102","Virginia","6/16/20","95","7","51065","7.37"
"Franklin","0","43","Virginia","6/16/20","41","2","51067","4.88"
"Franklin City","0","44","Virginia","6/16/20","42","2","51620","4.76"
"Frederick","3","435","Virginia","6/16/20","413","22","51069","5.33"
"Fredericksburg","3","213","Virginia","6/16/20","193","20","51630","10.36"
"Galax","8","206","Virginia","6/16/20","148","58","51640","39.19"
"Giles","0","6","Virginia","6/16/20","5","1","51071","20"
"Gloucester","1","38","Virginia","6/16/20","33","5","51073","15.15"
"Goochland","1","116","Virginia","6/16/20","108","8","51075","7.41"
"Grayson","2","66","Virginia","6/16/20","55","11","51077","20"
"Greene","0","45","Virginia","6/16/20","44","1","51079","2.27"
"Greensville","9","342","Virginia","6/16/20","277","65","51081","23.47"
"Halifax","1","38","Virginia","6/16/20","32","6","51083","18.75"
"Hampton","3","246","Virginia","6/16/20","228","18","51650","7.89"
"Hanover","3","375","Virginia","6/16/20","351","24","51085","6.84"
"Harrisonburg","3","859","Virginia","6/16/20","837","22","51660","2.63"
"Henrico","24","2311","Virginia","6/16/20","2146","165","51087","7.69"
"Henry","5","210","Virginia","6/16/20","174","36","51089","20.69"
"Highland","0","3","Virginia","6/16/20","3","0","51091","0"
"Hopewell","4","144","Virginia","6/16/20","118","26","51670","22.03"
"Isle of Wight","1","158","Virginia","6/16/20","149","9","51093","6.04"
"James City","2","236","Virginia","6/16/20","224","12","51095","5.36"
"King and Queen","0","24","Virginia","6/16/20","23","1","51097","4.35"
"King George","2","91","Virginia","6/16/20","79","12","51099","15.19"
"King William","0","33","Virginia","6/16/20","32","1","51101","3.12"
"Lancaster","0","11","Virginia","6/16/20","10","1","51103","10"
"Lee","0","9","Virginia","6/16/20","9","0","51105","0"
"Lexington","0","8","Virginia","6/16/20","8","0","51678","0"
"Loudoun","38","3439","Virginia","6/16/20","3174","265","51107","8.35"
"Louisa","1","99","Virginia","6/16/20","94","5","51109","5.32"
"Lunenburg","0","21","Virginia","6/16/20","18","3","51111","16.67"
"Lynchburg","1","96","Virginia","6/16/20","89","7","51680","7.87"
"Madison","0","42","Virginia","6/16/20","41","1","51113","2.44"
"Manassas","9","1317","Virginia","6/16/20","1254","63","51683","5.02"
"Manassas Park","4","388","Virginia","6/16/20","359","29","51685","8.08"
"Martinsville","1","56","Virginia","6/16/20","50","6","51690","12"
"Mathews","0","5","Virginia","6/16/20","5","0","51115","0"
"Mecklenburg","1","231","Virginia","6/16/20","224","7","51117","3.12"
"Middlesex","0","14","Virginia","6/16/20","14","0","51119","0"
"Montgomery","0","97","Virginia","6/16/20","95","2","51121","2.11"
"Nelson","0","18","Virginia","6/16/20","17","1","51125","5.88"
"New Kent","0","46","Virginia","6/16/20","45","1","51127","2.22"
"Newport News","10","390","Virginia","6/16/20","323","67","51700","20.74"
"Norfolk","12","681","Virginia","6/16/20","596","85","51710","14.26"
"Northampton","1","264","Virginia","6/16/20","256","8","51131","3.12"
"Northumberland","0","27","Virginia","6/16/20","25","2","51133","8"
"Norton","0","2","Virginia","6/16/20","2","0","51720","0"
"Nottoway","3","68","Virginia","6/16/20","50","18","51135","36"
"Orange","2","133","Virginia","6/16/20","118","15","51137","12.71"
"Page","1","256","Virginia","6/16/20","246","10","51139","4.07"
"Patrick","1","32","Virginia","6/16/20","28","4","51141","14.29"
"Petersburg","3","192","Virginia","6/16/20","170","22","51730","12.94"
"Pittsylvania","3","70","Virginia","6/16/20","50","20","51143","40"
"Poquoson","0","12","Virginia","6/16/20","9","3","51735","33.33"
"Portsmouth","5","387","Virginia","6/16/20","351","36","51740","10.26"
"Powhatan","1","53","Virginia","6/16/20","47","6","51145","12.77"
"Prince Edward","3","171","Virginia","6/16/20","151","20","51147","13.25"
"Prince George","2","168","Virginia","6/16/20","153","15","51149","9.8"
"Prince William","41","6621","Virginia","6/16/20","6336","285","51153","4.5"
"Pulaski","0","30","Virginia","6/16/20","28","2","51155","7.14"
"Radford","0","9","Virginia","6/16/20","7","2","51750","28.57"
"Rappahannock","0","17","Virginia","6/16/20","16","1","51157","6.25"
"Richmond","1","294","Virginia","6/16/20","289","5","51159","1.73"
"Richmond City","26","1848","Virginia","6/16/20","1667","181","51760","10.86"
"Roanoke","2","141","Virginia","6/16/20","126","15","51161","11.9"
"Roanoke City","9","270","Virginia","6/16/20","204","66","51770","32.35"
"Rockbridge","0","18","Virginia","6/16/20","19","-1","51163","-5.26"
"Rockingham","5","631","Virginia","6/16/20","596","35","51165","5.87"
"Russell","0","8","Virginia","6/16/20","8","0","51167","0"
"Salem","1","47","Virginia","6/16/20","41","6","51775","14.63"
"Scott","0","8","Virginia","6/16/20","7","1","51169","14.29"
"Shenandoah","4","516","Virginia","6/16/20","487","29","51171","5.95"
"Smyth","1","22","Virginia","6/16/20","15","7","51173","46.67"
"Southampton","0","155","Virginia","6/16/20","153","2","51175","1.31"
"Spotsylvania","20","849","Virginia","6/16/20","712","137","51177","19.24"
"Stafford","11","900","Virginia","6/16/20","824","76","51179","9.22"
"Staunton","0","60","Virginia","6/16/20","58","2","51790","3.45"
"Suffolk","3","347","Virginia","6/16/20","325","22","51800","6.77"
"Surry","0","13","Virginia","6/16/20","10","3","51181","30"
"Sussex","1","183","Virginia","6/16/20","175","8","51183","4.57"
"Tazewell","0","9","Virginia","6/16/20","9","0","51185","0"
"Virginia Beach","13","909","Virginia","6/16/20","815","94","51810","11.53"
"Warren","2","233","Virginia","6/16/20","222","11","51187","4.95"
"Washington","0","58","Virginia","6/16/20","57","1","51191","1.75"
"Waynesboro","1","55","Virginia","6/16/20","50","5","51820","10"
"Westmoreland","1","87","Virginia","6/16/20","83","4","51193","4.82"
"Williamsburg","1","53","Virginia","6/16/20","48","5","51830","10.42"
"Winchester","4","269","Virginia","6/16/20","238","31","51840","13.03"
"Wise","0","27","Virginia","6/16/20","27","0","51195","0"
"Wythe","1","42","Virginia","6/16/20","38","4","51197","10.53"
"York","1","94","Virginia","6/16/20","86","8","51199","9.3"
"Adams","3","100","Washington","6/16/20","80","20","53001","25"
"Asotin","0","20","Washington","6/16/20","19","1","53003","5.26"
"Benton","34","1218","Washington","6/16/20","979","239","53005","24.41"
"Chelan","1","273","Washington","6/16/20","264","9","53007","3.41"
"Clallam","0","29","Washington","6/16/20","27","2","53009","7.41"
"Clark","8","629","Washington","6/16/20","571","58","53011","10.16"
"Columbia","0","1","Washington","6/16/20","1","0","53013","0"
"Cowlitz","4","118","Washington","6/16/20","89","29","53015","32.58"
"Douglas","1","183","Washington","6/16/20","178","5","53017","2.81"
"Ferry","0","1","Washington","6/16/20","1","0","53019","0"
"Franklin","34","1005","Washington","6/16/20","764","241","53021","31.54"
"Grant","7","268","Washington","6/16/20","222","46","53025","20.72"
"Grays Harbor","0","20","Washington","6/16/20","19","1","53027","5.26"
"Island","0","183","Washington","6/16/20","181","2","53029","1.1"
"Jefferson","0","32","Washington","6/16/20","31","1","53031","3.23"
"King","46","8850","Washington","6/16/20","8529","321","53033","3.76"
"Kitsap","1","178","Washington","6/16/20","170","8","53035","4.71"
"Kittitas","0","92","Washington","6/16/20","90","2","53037","2.22"
"Klickitat","2","49","Washington","6/16/20","37","12","53039","32.43"
"Lewis","0","40","Washington","6/16/20","37","3","53041","8.11"
"Lincoln","0","2","Washington","6/16/20","2","0","53043","0"
"Mason","0","40","Washington","6/16/20","39","1","53045","2.56"
"Okanogan","0","58","Washington","6/16/20","56","2","53047","3.57"
"Pacific","0","12","Washington","6/16/20","10","2","53049","20"
"Pend Oreille","0","3","Washington","6/16/20","3","0","53051","0"
"Pierce","16","2161","Washington","6/16/20","2050","111","53053","5.41"
"San Juan","0","16","Washington","6/16/20","15","1","53055","6.67"
"Skagit","2","464","Washington","6/16/20","450","14","53057","3.11"
"Skamania","0","3","Washington","6/16/20","3","0","53059","0"
"Snohomish","15","3171","Washington","6/16/20","3064","107","53061","3.49"
"Spokane","11","846","Washington","6/16/20","769","77","53063","10.01"
"Stevens","0","15","Washington","6/16/20","13","2","53065","15.38"
"Thurston","4","197","Washington","6/16/20","171","26","53067","15.2"
"Wahkiakum","0","4","Washington","6/16/20","4","0","53069","0"
"Walla Walla","1","122","Washington","6/16/20","117","5","53071","4.27"
"Whatcom","5","455","Washington","6/16/20","420","35","53073","8.33"
"Whitman","1","29","Washington","6/16/20","20","9","53075","45"
"Yakima","109","5597","Washington","6/16/20","4834","763","53077","15.78"
"Barbour","0","10","West Virginia","6/16/20","8","2","54001","25"
"Berkeley","7","399","West Virginia","6/16/20","350","49","54003","14"
"Boone","0","19","West Virginia","6/16/20","16","3","54005","18.75"
"Braxton","0","3","West Virginia","6/16/20","2","1","54007","50"
"Brooke","0","6","West Virginia","6/16/20","5","1","54009","20"
"Cabell","1","75","West Virginia","6/16/20","70","5","54011","7.14"
"Calhoun","0","2","West Virginia","6/16/20","2","0","54013","0"
"Clay","0","10","West Virginia","6/16/20","7","3","54015","42.86"
"Fayette","0","54","West Virginia","6/16/20","54","0","54019","0"
"Gilmer","0","10","West Virginia","6/16/20","10","0","54021","0"
"Grant","0","16","West Virginia","6/16/20","14","2","54023","14.29"
"Greenbrier","4","37","West Virginia","6/16/20","9","28","54025","311.11"
"Hampshire","1","40","West Virginia","6/16/20","33","7","54027","21.21"
"Hancock","0","20","West Virginia","6/16/20","20","0","54029","0"
"Hardy","0","40","West Virginia","6/16/20","40","0","54031","0"
"Harrison","1","49","West Virginia","6/16/20","40","9","54033","22.5"
"Jackson","0","141","West Virginia","6/16/20","141","0","54035","0"
"Jefferson","1","211","West Virginia","6/16/20","204","7","54037","3.43"
"Kanawha","1","249","West Virginia","6/16/20","241","8","54039","3.32"
"Lewis","0","8","West Virginia","6/16/20","8","0","54041","0"
"Lincoln","0","5","West Virginia","6/16/20","5","0","54043","0"
"Logan","0","21","West Virginia","6/16/20","20","1","54045","5"
"Marion","0","53","West Virginia","6/16/20","53","0","54049","0"
"Marshall","1","38","West Virginia","6/16/20","32","6","54051","18.75"
"Mason","0","15","West Virginia","6/16/20","15","0","54053","0"
"McDowell","0","6","West Virginia","6/16/20","6","0","54047","0"
"Mercer","0","14","West Virginia","6/16/20","13","1","54055","7.69"
"Mineral","0","51","West Virginia","6/16/20","50","1","54057","2"
"Mingo","0","12","West Virginia","6/16/20","9","3","54059","33.33"
"Monongalia","1","145","West Virginia","6/16/20","141","4","54061","2.84"
"Monroe","0","9","West Virginia","6/16/20","8","1","54063","12.5"
"Morgan","0","19","West Virginia","6/16/20","19","0","54065","0"
"Nicholas","0","7","West Virginia","6/16/20","7","0","54067","0"
"Ohio","1","56","West Virginia","6/16/20","51","5","54069","9.8"
"Pendleton","0","13","West Virginia","6/16/20","13","0","54071","0"
"Pleasants","0","4","West Virginia","6/16/20","4","0","54073","0"
"Pocahontas","0","21","West Virginia","6/16/20","21","0","54075","0"
"Preston","0","25","West Virginia","6/16/20","24","1","54077","4.17"
"Putnam","0","42","West Virginia","6/16/20","40","2","54079","5"
"Raleigh","1","25","West Virginia","6/16/20","18","7","54081","38.89"
"Randolph","1","141","West Virginia","6/16/20","137","4","54083","2.92"
"Ritchie","0","2","West Virginia","6/16/20","1","1","54085","100"
"Roane","0","11","West Virginia","6/16/20","10","1","54087","10"
"Summers","0","1","West Virginia","6/16/20","1","0","54089","0"
"Taylor","0","10","West Virginia","6/16/20","9","1","54091","11.11"
"Tucker","0","5","West Virginia","6/16/20","6","-1","54093","-16.67"
"Tyler","0","3","West Virginia","6/16/20","3","0","54095","0"
"Upshur","0","7","West Virginia","6/16/20","7","0","54097","0"
"Wayne","0","106","West Virginia","6/16/20","103","3","54099","2.91"
"Wetzel","0","9","West Virginia","6/16/20","9","0","54103","0"
"Wirt","0","4","West Virginia","6/16/20","4","0","54105","0"
"Wood","0","56","West Virginia","6/16/20","53","3","54107","5.66"
"Wyoming","0","5","West Virginia","6/16/20","3","2","54109","66.67"
"Adams","0","8","Wisconsin","6/16/20","6","2","55001","33.33"
"Ashland","0","3","Wisconsin","6/16/20","3","0","55003","0"
"Barron","1","26","Wisconsin","6/16/20","20","6","55005","30"
"Bayfield","0","3","Wisconsin","6/16/20","3","0","55007","0"
"Brown","13","2492","Wisconsin","6/16/20","2399","93","55009","3.88"
"Buffalo","0","7","Wisconsin","6/16/20","6","1","55011","16.67"
"Burnett","0","3","Wisconsin","6/16/20","1","2","55013","200"
"Calumet","1","87","Wisconsin","6/16/20","81","6","55015","7.41"
"Chippewa","1","63","Wisconsin","6/16/20","59","4","55017","6.78"
"Clark","1","51","Wisconsin","6/16/20","45","6","55019","13.33"
"Columbia","2","58","Wisconsin","6/16/20","47","11","55021","23.4"
"Crawford","0","27","Wisconsin","6/16/20","26","1","55023","3.85"
"Dane","16","980","Wisconsin","6/16/20","871","109","55025","12.51"
"Dodge","3","424","Wisconsin","6/16/20","406","18","55027","4.43"
"Door","0","39","Wisconsin","6/16/20","39","0","55029","0"
"Douglas","0","20","Wisconsin","6/16/20","20","0","55031","0"
"Dunn","0","29","Wisconsin","6/16/20","29","0","55033","0"
"Eau Claire","2","138","Wisconsin","6/16/20","124","14","55035","11.29"
"Florence","0","2","Wisconsin","6/16/20","2","0","55037","0"
"Fond du Lac","4","272","Wisconsin","6/16/20","241","31","55039","12.86"
"Forest","0","34","Wisconsin","6/16/20","34","0","55041","0"
"Grant","1","107","Wisconsin","6/16/20","99","8","55043","8.08"
"Green","1","77","Wisconsin","6/16/20","71","6","55045","8.45"
"Green Lake","0","24","Wisconsin","6/16/20","23","1","55047","4.35"
"Iowa","0","17","Wisconsin","6/16/20","16","1","55049","6.25"
"Iron","0","2","Wisconsin","6/16/20","2","0","55051","0"
"Jackson","0","21","Wisconsin","6/16/20","19","2","55053","10.53"
"Jefferson","4","161","Wisconsin","6/16/20","134","27","55055","20.15"
"Juneau","0","25","Wisconsin","6/16/20","23","2","55057","8.7"
"Kenosha","11","1374","Wisconsin","6/16/20","1295","79","55059","6.1"
"Kewaunee","0","39","Wisconsin","6/16/20","37","2","55061","5.41"
"La Crosse","8","132","Wisconsin","6/16/20","77","55","55063","71.43"
"Lafayette","1","43","Wisconsin","6/16/20","35","8","55065","22.86"
"Langlade","0","6","Wisconsin","6/16/20","5","1","55067","20"
"Lincoln","0","7","Wisconsin","6/16/20","7","0","55069","0"
"Manitowoc","1","48","Wisconsin","6/16/20","40","8","55071","20"
"Marathon","2","83","Wisconsin","6/16/20","66","17","55073","25.76"
"Marinette","0","40","Wisconsin","6/16/20","37","3","55075","8.11"
"Marquette","0","9","Wisconsin","6/16/20","6","3","55077","50"
"Menominee","0","4","Wisconsin","6/16/20","3","1","55078","33.33"
"Milwaukee","98","9658","Wisconsin","6/16/20","8973","685","55079","7.63"
"Monroe","2","36","Wisconsin","6/16/20","19","17","55081","89.47"
"Oconto","0","45","Wisconsin","6/16/20","42","3","55083","7.14"
"Oneida","1","17","Wisconsin","6/16/20","13","4","55085","30.77"
"Outagamie","8","345","Wisconsin","6/16/20","289","56","55087","19.38"
"Ozaukee","2","199","Wisconsin","6/16/20","184","15","55089","8.15"
"Pepin","0","1","Wisconsin","6/16/20","1","0","55091","0"
"Pierce","1","57","Wisconsin","6/16/20","51","6","55093","11.76"
"Polk","0","36","Wisconsin","6/16/20","34","2","55095","5.88"
"Portage","6","82","Wisconsin","6/16/20","39","43","55097","110.26"
"Price","0","2","Wisconsin","6/16/20","2","0","55099","0"
"Racine","13","2033","Wisconsin","6/16/20","1939","94","55101","4.85"
"Richland","0","14","Wisconsin","6/16/20","14","0","55103","0"
"Rock","7","761","Wisconsin","6/16/20","714","47","55105","6.58"
"Rusk","1","10","Wisconsin","6/16/20","5","5","55107","100"
"Sauk","0","87","Wisconsin","6/16/20","84","3","55111","3.57"
"Sawyer","0","9","Wisconsin","6/16/20","9","0","55113","0"
"Shawano","1","64","Wisconsin","6/16/20","60","4","55115","6.67"
"Sheboygan","7","166","Wisconsin","6/16/20","118","48","55117","40.68"
"St. Croix","1","116","Wisconsin","6/16/20","107","9","55109","8.41"
"Taylor","0","5","Wisconsin","6/16/20","2","3","55119","150"
"Trempealeau","4","71","Wisconsin","6/16/20","43","28","55121","65.12"
"Vernon","0","24","Wisconsin","6/16/20","22","2","55123","9.09"
"Vilas","0","8","Wisconsin","6/16/20","8","0","55125","0"
"Walworth","4","480","Wisconsin","6/16/20","452","28","55127","6.19"
"Washburn","0","3","Wisconsin","6/16/20","3","0","55129","0"
"Washington","2","296","Wisconsin","6/16/20","281","15","55131","5.34"
"Waukesha","14","928","Wisconsin","6/16/20","829","99","55133","11.94"
"Waupaca","3","80","Wisconsin","6/16/20","58","22","55135","37.93"
"Waushara","1","20","Wisconsin","6/16/20","13","7","55137","53.85"
"Winnebago","15","537","Wisconsin","6/16/20","431","106","55139","24.59"
"Wood","2","23","Wisconsin","6/16/20","12","11","55141","91.67"
"Albany","0","28","Wyoming","6/16/20","26","2","56001","7.69"
"Big Horn","0","11","Wyoming","6/16/20","9","2","56003","22.22"
"Campbell","2","46","Wyoming","6/16/20","35","11","56005","31.43"
"Carbon","1","22","Wyoming","6/16/20","16","6","56007","37.5"
"Converse","0","24","Wyoming","6/16/20","24","0","56009","0"
"Crook","0","6","Wyoming","6/16/20","5","1","56011","20"
"Fremont","2","310","Wyoming","6/16/20","295","15","56013","5.08"
"Goshen","0","5","Wyoming","6/16/20","5","0","56015","0"
"Hot Springs","0","12","Wyoming","6/16/20","12","0","56017","0"
"Johnson","0","18","Wyoming","6/16/20","18","0","56019","0"
"Laramie","1","196","Wyoming","6/16/20","188","8","56021","4.26"
"Lincoln","0","15","Wyoming","6/16/20","15","0","56023","0"
"Natrona","0","88","Wyoming","6/16/20","87","1","56025","1.15"
"Niobrara","0","2","Wyoming","6/16/20","2","0","56027","0"
"Park","1","7","Wyoming","6/16/20","2","5","56029","250"
"Platte","0","1","Wyoming","6/16/20","1","0","56031","0"
"Sheridan","0","19","Wyoming","6/16/20","18","1","56033","5.56"
"Sublette","0","3","Wyoming","6/16/20","3","0","56035","0"
"Sweetwater","1","40","Wyoming","6/16/20","34","6","56037","17.65"
"Teton","1","105","Wyoming","6/16/20","100","5","56039","5"
"Uinta","8","91","Wyoming","6/16/20","35","56","56041","160"
"Washakie","0","39","Wyoming","6/16/20","39","0","56043","0"
"Weston","0","1","Wyoming","6/16/20","1","0","56045","0"
