"Locality","DailyAvgNewCasesPast7Days","TotalCases","State","Date","TotalCases7DaysAgo","NewCasesPast7Days","FIPS-Code","PercentIncreaseTotalCasesPast7Days"
"Autauga","12","405","Alabama","6/19/20","323","82","01001","25.39"
"Baldwin","6","398","Alabama","6/19/20","353","45","01003","12.75"
"Barbour","6","265","Alabama","6/19/20","221","44","01005","19.91"
"Bibb","4","123","Alabama","6/19/20","97","26","01007","26.8"
"Blount","6","136","Alabama","6/19/20","95","41","01009","43.16"
"Bullock","9","318","Alabama","6/19/20","258","60","01011","23.26"
"Butler","10","567","Alabama","6/19/20","499","68","01013","13.63"
"Calhoun","2","202","Alabama","6/19/20","188","14","01015","7.45"
"Chambers","9","493","Alabama","6/19/20","427","66","01017","15.46"
"Cherokee","1","56","Alabama","6/19/20","46","10","01019","21.74"
"Chilton","4","151","Alabama","6/19/20","122","29","01021","23.77"
"Choctaw","3","185","Alabama","6/19/20","166","19","01023","11.45"
"Clarke","5","208","Alabama","6/19/20","175","33","01025","18.86"
"Clay","0","30","Alabama","6/19/20","30","0","01027","0"
"Cleburne","0","22","Alabama","6/19/20","20","2","01029","10"
"Coffee","6","310","Alabama","6/19/20","265","45","01031","16.98"
"Colbert","7","290","Alabama","6/19/20","241","49","01033","20.33"
"Conecuh","8","132","Alabama","6/19/20","76","56","01035","73.68"
"Coosa","1","48","Alabama","6/19/20","43","5","01037","11.63"
"Covington","15","212","Alabama","6/19/20","106","106","01039","100"
"Crenshaw","1","112","Alabama","6/19/20","105","7","01041","6.67"
"Cullman","8","298","Alabama","6/19/20","239","59","01043","24.69"
"Dale","4","195","Alabama","6/19/20","164","31","01045","18.9"
"Dallas","24","590","Alabama","6/19/20","421","169","01047","40.14"
"DeKalb","13","394","Alabama","6/19/20","303","91","01049","30.03"
"Elmore","21","633","Alabama","6/19/20","485","148","01051","30.52"
"Escambia","5","137","Alabama","6/19/20","99","38","01053","38.38"
"Etowah","10","371","Alabama","6/19/20","298","73","01055","24.5"
"Fayette","4","57","Alabama","6/19/20","26","31","01057","119.23"
"Franklin","15","769","Alabama","6/19/20","665","104","01059","15.64"
"Geneva","0","49","Alabama","6/19/20","46","3","01061","6.52"
"Greene","5","151","Alabama","6/19/20","117","34","01063","29.06"
"Hale","5","256","Alabama","6/19/20","223","33","01065","14.8"
"Henry","2","111","Alabama","6/19/20","97","14","01067","14.43"
"Houston","9","341","Alabama","6/19/20","279","62","01069","22.22"
"Jackson","5","147","Alabama","6/19/20","113","34","01071","30.09"
"Jefferson","65","2791","Alabama","6/19/20","2339","452","01073","19.32"
"Lamar","3","54","Alabama","6/19/20","34","20","01075","58.82"
"Lauderdale","10","288","Alabama","6/19/20","216","72","01077","33.33"
"Lawrence","2","72","Alabama","6/19/20","60","12","01079","20"
"Lee","24","811","Alabama","6/19/20","642","169","01081","26.32"
"Limestone","12","260","Alabama","6/19/20","175","85","01083","48.57"
"Lowndes","10","409","Alabama","6/19/20","336","73","01085","21.73"
"Macon","3","138","Alabama","6/19/20","117","21","01087","17.95"
"Madison","28","649","Alabama","6/19/20","456","193","01089","42.32"
"Marengo","5","237","Alabama","6/19/20","204","33","01091","16.18"
"Marion","5","165","Alabama","6/19/20","132","33","01093","25"
"Marshall","31","1031","Alabama","6/19/20","811","220","01095","27.13"
"Mobile","39","2899","Alabama","6/19/20","2623","276","01097","10.52"
"Monroe","7","153","Alabama","6/19/20","107","46","01099","42.99"
"Montgomery","80","3106","Alabama","6/19/20","2543","563","01101","22.14"
"Morgan","28","710","Alabama","6/19/20","516","194","01103","37.6"
"Perry","3","86","Alabama","6/19/20","62","24","01105","38.71"
"Pickens","2","153","Alabama","6/19/20","137","16","01107","11.68"
"Pike","8","352","Alabama","6/19/20","298","54","01109","18.12"
"Randolph","1","142","Alabama","6/19/20","138","4","01111","2.9"
"Russell","12","346","Alabama","6/19/20","265","81","01113","30.57"
"Shelby","21","740","Alabama","6/19/20","596","144","01117","24.16"
"St. Clair","5","193","Alabama","6/19/20","158","35","01115","22.15"
"Sumter","1","267","Alabama","6/19/20","257","10","01119","3.89"
"Talladega","3","170","Alabama","6/19/20","149","21","01121","14.09"
"Tallapoosa","7","506","Alabama","6/19/20","455","51","01123","11.21"
"Tuscaloosa","53","1526","Alabama","6/19/20","1156","370","01125","32.01"
"Walker","20","664","Alabama","6/19/20","523","141","01127","26.96"
"Washington","1","91","Alabama","6/19/20","86","5","01129","5.81"
"Wilcox","6","240","Alabama","6/19/20","200","40","01131","20"
"Winston","9","172","Alabama","6/19/20","111","61","01133","54.95"
"Anchorage","4","338","Alaska","6/19/20","307","31","02020","10.1"
"Bethel","0","6","Alaska","6/19/20","3","3","02050","100"
"Fairbanks North Star","3","107","Alaska","6/19/20","89","18","02090","20.22"
"Haines","0","2","Alaska","6/19/20","1","1","02100","100"
"Juneau","0","39","Alaska","6/19/20","37","2","02110","5.41"
"Kenai Peninsula","2","117","Alaska","6/19/20","102","15","02122","14.71"
"Ketchikan Gateway","1","21","Alaska","6/19/20","16","5","02130","31.25"
"Kodiak Island","0","3","Alaska","6/19/20","2","1","02150","50"
"Matanuska-Susitna","2","53","Alaska","6/19/20","41","12","02170","29.27"
"Nome","0","5","Alaska","6/19/20","4","1","02180","25"
"North Slope","0","3","Alaska","6/19/20","1","2","02185","200"
"Northwest Arctic","0","4","Alaska","6/19/20","4","0","02188","0"
"Petersburg","0","4","Alaska","6/19/20","4","0","02195","0"
"Prince of Wales-Hyder","0","2","Alaska","6/19/20","2","0","02198","0"
"Sitka","0","9","Alaska","6/19/20","6","3","02220","50"
"Southeast Fairbanks","0","3","Alaska","6/19/20","3","0","02240","0"
"Wrangell","0","3","Alaska","6/19/20","1","2","02275","200"
"Yukon-Koyukuk","0","1","Alaska","6/19/20","1","0","02290","0"
"Apache","25","2103","Arizona","6/19/20","1927","176","04001","9.13"
"Cochise","22","332","Arizona","6/19/20","178","154","04003","86.52"
"Coconino","18","1470","Arizona","6/19/20","1345","125","04005","9.29"
"Gila","10","125","Arizona","6/19/20","54","71","04007","131.48"
"Graham","2","59","Arizona","6/19/20","48","11","04009","22.92"
"Greenlee","0","14","Arizona","6/19/20","11","3","04011","27.27"
"La Paz","6","257","Arizona","6/19/20","217","40","04012","18.43"
"Maricopa","1284","25999","Arizona","6/19/20","17010","8989","04013","52.85"
"Mohave","15","686","Arizona","6/19/20","584","102","04015","17.47"
"Navajo","59","2928","Arizona","6/19/20","2512","416","04017","16.56"
"Pima","199","5019","Arizona","6/19/20","3628","1391","04019","38.34"
"Pinal","110","2130","Arizona","6/19/20","1363","767","04021","56.27"
"Santa Cruz","66","1293","Arizona","6/19/20","833","460","04023","55.22"
"Yavapai","7","417","Arizona","6/19/20","367","50","04025","13.62"
"Yuma","159","4078","Arizona","6/19/20","2962","1116","04027","37.68"
"Arkansas","2","18","Arkansas","6/19/20","7","11","05001","157.14"
"Ashley","2","51","Arkansas","6/19/20","38","13","05003","34.21"
"Baxter","0","14","Arkansas","6/19/20","14","0","05005","0"
"Benton","76","1841","Arkansas","6/19/20","1306","535","05007","40.96"
"Boone","0","10","Arkansas","6/19/20","9","1","05009","11.11"
"Bradley","0","35","Arkansas","6/19/20","34","1","05011","2.94"
"Carroll","5","102","Arkansas","6/19/20","66","36","05015","54.55"
"Chicot","4","67","Arkansas","6/19/20","40","27","05017","67.5"
"Clark","1","50","Arkansas","6/19/20","45","5","05019","11.11"
"Clay","3","31","Arkansas","6/19/20","9","22","05021","244.44"
"Cleburne","0","76","Arkansas","6/19/20","74","2","05023","2.7"
"Cleveland","0","22","Arkansas","6/19/20","19","3","05025","15.79"
"Columbia","1","31","Arkansas","6/19/20","27","4","05027","14.81"
"Conway","1","26","Arkansas","6/19/20","19","7","05029","36.84"
"Craighead","6","385","Arkansas","6/19/20","346","39","05031","11.27"
"Crawford","5","83","Arkansas","6/19/20","51","32","05033","62.75"
"Crittenden","9","573","Arkansas","6/19/20","508","65","05035","12.8"
"Cross","1","82","Arkansas","6/19/20","74","8","05037","10.81"
"Dallas","0","4","Arkansas","6/19/20","3","1","05039","33.33"
"Desha","1","26","Arkansas","6/19/20","20","6","05041","30"
"Drew","1","32","Arkansas","6/19/20","25","7","05043","28"
"Faulkner","12","227","Arkansas","6/19/20","142","85","05045","59.86"
"Franklin","1","10","Arkansas","6/19/20","6","4","05047","66.67"
"Fulton","0","9","Arkansas","6/19/20","9","0","05049","0"
"Garland","3","172","Arkansas","6/19/20","154","18","05051","11.69"
"Grant","0","24","Arkansas","6/19/20","23","1","05053","4.35"
"Greene","3","87","Arkansas","6/19/20","69","18","05055","26.09"
"Hempstead","1","43","Arkansas","6/19/20","33","10","05057","30.3"
"Hot Spring","1","46","Arkansas","6/19/20","37","9","05059","24.32"
"Howard","2","54","Arkansas","6/19/20","38","16","05061","42.11"
"Independence","1","44","Arkansas","6/19/20","39","5","05063","12.82"
"Izard","0","20","Arkansas","6/19/20","17","3","05065","17.65"
"Jackson","1","20","Arkansas","6/19/20","15","5","05067","33.33"
"Jefferson","2","640","Arkansas","6/19/20","625","15","05069","2.4"
"Johnson","6","121","Arkansas","6/19/20","78","43","05071","55.13"
"Lafayette","0","13","Arkansas","6/19/20","10","3","05073","30"
"Lawrence","0","93","Arkansas","6/19/20","90","3","05075","3.33"
"Lee","36","570","Arkansas","6/19/20","317","253","05077","79.81"
"Lincoln","5","1023","Arkansas","6/19/20","986","37","05079","3.75"
"Little River","0","35","Arkansas","6/19/20","33","2","05081","6.06"
"Logan","1","21","Arkansas","6/19/20","17","4","05083","23.53"
"Lonoke","2","84","Arkansas","6/19/20","69","15","05085","21.74"
"Madison","5","137","Arkansas","6/19/20","99","38","05087","38.38"
"Marion","0","2","Arkansas","6/19/20","2","0","05089","0"
"Miller","2","78","Arkansas","6/19/20","66","12","05091","18.18"
"Mississippi","3","107","Arkansas","6/19/20","89","18","05093","20.22"
"Monroe","0","7","Arkansas","6/19/20","5","2","05095","40"
"Montgomery","0","2","Arkansas","6/19/20","2","0","05097","0"
"Nevada","2","87","Arkansas","6/19/20","73","14","05099","19.18"
"Newton","0","3","Arkansas","6/19/20","3","0","05101","0"
"Ouachita","1","17","Arkansas","6/19/20","13","4","05103","30.77"
"Perry","1","24","Arkansas","6/19/20","15","9","05105","60"
"Phillips","6","75","Arkansas","6/19/20","32","43","05107","134.38"
"Pike","0","7","Arkansas","6/19/20","6","1","05109","16.67"
"Poinsett","0","52","Arkansas","6/19/20","50","2","05111","4"
"Polk","2","62","Arkansas","6/19/20","48","14","05113","29.17"
"Pope","10","304","Arkansas","6/19/20","234","70","05115","29.91"
"Prairie","1","12","Arkansas","6/19/20","6","6","05117","100"
"Pulaski","29","1445","Arkansas","6/19/20","1241","204","05119","16.44"
"Randolph","0","31","Arkansas","6/19/20","28","3","05121","10.71"
"Saline","4","195","Arkansas","6/19/20","166","29","05125","17.47"
"Scott","1","7","Arkansas","6/19/20","2","5","05127","250"
"Searcy","0","7","Arkansas","6/19/20","7","0","05129","0"
"Sebastian","12","219","Arkansas","6/19/20","133","86","05131","64.66"
"Sevier","22","550","Arkansas","6/19/20","393","157","05133","39.95"
"Sharp","0","50","Arkansas","6/19/20","51","-1","05135","-1.96"
"St. Francis","2","783","Arkansas","6/19/20","767","16","05123","2.09"
"Stone","0","11","Arkansas","6/19/20","11","0","05137","0"
"Union","3","220","Arkansas","6/19/20","199","21","05139","10.55"
"Van Buren","0","30","Arkansas","6/19/20","30","0","05141","0"
"Washington","88","2222","Arkansas","6/19/20","1605","617","05143","38.44"
"White","2","70","Arkansas","6/19/20","54","16","05145","29.63"
"Woodruff","1","6","Arkansas","6/19/20","1","5","05147","500"
"Yell","12","361","Arkansas","6/19/20","275","86","05149","31.27"
"Alameda","69","4702","California","6/19/20","4216","486","06001","11.53"
"Alpine","0","2","California","6/19/20","2","0","06003","0"
"Amador","0","12","California","6/19/20","10","2","06005","20"
"Butte","3","94","California","6/19/20","74","20","06007","27.03"
"Calaveras","0","28","California","6/19/20","25","3","06009","12"
"Colusa","0","7","California","6/19/20","7","0","06011","0"
"Contra Costa","39","2148","California","6/19/20","1877","271","06013","14.44"
"Del Norte","0","48","California","6/19/20","47","1","06015","2.13"
"El Dorado","2","130","California","6/19/20","113","17","06017","15.04"
"Fresno","113","3187","California","6/19/20","2395","792","06019","33.07"
"Glenn","3","42","California","6/19/20","24","18","06021","75"
"Humboldt","0","108","California","6/19/20","105","3","06023","2.86"
"Imperial","146","4744","California","6/19/20","3724","1020","06025","27.39"
"Inyo","0","24","California","6/19/20","22","2","06027","9.09"
"Kern","82","3706","California","6/19/20","3130","576","06029","18.4"
"Kings","48","2057","California","6/19/20","1724","333","06031","19.32"
"Lake","0","34","California","6/19/20","32","2","06033","6.25"
"Lassen","0","9","California","6/19/20","9","0","06035","0"
"Los Angeles","1304","79655","California","6/19/20","70529","9126","06037","12.94"
"Madera","18","314","California","6/19/20","188","126","06039","67.02"
"Marin","36","917","California","6/19/20","664","253","06041","38.1"
"Mariposa","0","18","California","6/19/20","16","2","06043","12.5"
"Mendocino","2","54","California","6/19/20","38","16","06045","42.11"
"Merced","25","564","California","6/19/20","391","173","06047","44.25"
"Mono","0","37","California","6/19/20","37","0","06051","0"
"Monterey","42","1156","California","6/19/20","865","291","06053","33.64"
"Napa","7","216","California","6/19/20","168","48","06055","28.57"
"Nevada","3","75","California","6/19/20","52","23","06057","44.23"
"Orange","203","9576","California","6/19/20","8153","1423","06059","17.45"
"Placer","19","476","California","6/19/20","344","132","06061","38.37"
"Plumas","0","6","California","6/19/20","4","2","06063","50"
"Riverside","327","12778","California","6/19/20","10490","2288","06065","21.81"
"Sacramento","39","1976","California","6/19/20","1704","272","06067","15.96"
"San Benito","7","161","California","6/19/20","112","49","06069","43.75"
"San Bernardino","248","8714","California","6/19/20","6976","1738","06071","24.91"
"San Diego","193","10350","California","6/19/20","8998","1352","06073","15.03"
"San Francisco","26","3057","California","6/19/20","2878","179","06075","6.22"
"San Joaquin","69","1926","California","6/19/20","1444","482","06077","33.38"
"San Luis Obispo","11","404","California","6/19/20","324","80","06079","24.69"
"San Mateo","27","2721","California","6/19/20","2533","188","06081","7.42"
"Santa Barbara","58","2319","California","6/19/20","1910","409","06083","21.41"
"Santa Clara","40","3398","California","6/19/20","3117","281","06085","9.02"
"Santa Cruz","4","283","California","6/19/20","254","29","06087","11.42"
"Shasta","4","76","California","6/19/20","48","28","06089","58.33"
"Sierra","0","1","California","6/19/20","1","0","06091","0"
"Siskiyou","1","21","California","6/19/20","14","7","06093","50"
"Solano","31","860","California","6/19/20","643","217","06095","33.75"
"Sonoma","17","822","California","6/19/20","701","121","06097","17.26"
"Stanislaus","57","1473","California","6/19/20","1072","401","06099","37.41"
"Sutter","4","99","California","6/19/20","69","30","06101","43.48"
"Tehama","2","34","California","6/19/20","20","14","06103","70"
"Trinity","0","2","California","6/19/20","2","0","06105","0"
"Tulare","69","3046","California","6/19/20","2564","482","06107","18.8"
"Tuolumne","0","9","California","6/19/20","8","1","06109","12.5"
"Ventura","45","1835","California","6/19/20","1518","317","06111","20.88"
"Yolo","10","310","California","6/19/20","240","70","06113","29.17"
"Yuba","1","41","California","6/19/20","34","7","06115","20.59"
"Adams","22","3852","Colorado","6/19/20","3698","154","08001","4.16"
"Alamosa","5","150","Colorado","6/19/20","114","36","08003","31.58"
"Arapahoe","22","4905","Colorado","6/19/20","4754","151","08005","3.18"
"Archuleta","0","8","Colorado","6/19/20","8","0","08007","0"
"Baca","0","12","Colorado","6/19/20","12","0","08009","0"
"Bent","0","3","Colorado","6/19/20","3","0","08011","0"
"Boulder","23","1211","Colorado","6/19/20","1049","162","08013","15.44"
"Broomfield","2","274","Colorado","6/19/20","261","13","08014","4.98"
"Chaffee","0","78","Colorado","6/19/20","78","0","08015","0"
"Cheyenne","0","5","Colorado","6/19/20","5","0","08017","0"
"Clear Creek","0","18","Colorado","6/19/20","17","1","08019","5.88"
"Conejos","1","10","Colorado","6/19/20","5","5","08021","100"
"Costilla","1","17","Colorado","6/19/20","12","5","08023","41.67"
"Crowley","0","68","Colorado","6/19/20","66","2","08025","3.03"
"Custer","0","2","Colorado","6/19/20","2","0","08027","0"
"Delta","1","80","Colorado","6/19/20","76","4","08029","5.26"
"Denver","44","6565","Colorado","6/19/20","6257","308","08031","4.92"
"Douglas","6","831","Colorado","6/19/20","790","41","08035","5.19"
"Eagle","3","639","Colorado","6/19/20","621","18","08037","2.9"
"El Paso","20","2063","Colorado","6/19/20","1920","143","08041","7.45"
"Elbert","0","54","Colorado","6/19/20","54","0","08039","0"
"Fremont","1","30","Colorado","6/19/20","26","4","08043","15.38"
"Garfield","5","214","Colorado","6/19/20","177","37","08045","20.9"
"Gilpin","0","6","Colorado","6/19/20","6","0","08047","0"
"Grand","0","18","Colorado","6/19/20","15","3","08049","20"
"Gunnison","0","182","Colorado","6/19/20","181","1","08051","0.55"
"Hinsdale","0","3","Colorado","6/19/20","3","0","08053","0"
"Huerfano","0","3","Colorado","6/19/20","3","0","08055","0"
"Jefferson","11","2522","Colorado","6/19/20","2445","77","08059","3.15"
"Kit Carson","0","31","Colorado","6/19/20","30","1","08063","3.33"
"La Plata","0","85","Colorado","6/19/20","84","1","08067","1.19"
"Lake","1","46","Colorado","6/19/20","38","8","08065","21.05"
"Larimer","4","668","Colorado","6/19/20","637","31","08069","4.87"
"Las Animas","0","7","Colorado","6/19/20","6","1","08071","16.67"
"Lincoln","0","3","Colorado","6/19/20","3","0","08073","0"
"Logan","0","635","Colorado","6/19/20","632","3","08075","0.47"
"Mesa","2","78","Colorado","6/19/20","66","12","08077","18.18"
"Mineral","0","2","Colorado","6/19/20","2","0","08079","0"
"Moffat","0","9","Colorado","6/19/20","8","1","08081","12.5"
"Montezuma","1","67","Colorado","6/19/20","59","8","08083","13.56"
"Montrose","1","198","Colorado","6/19/20","191","7","08085","3.66"
"Morgan","1","649","Colorado","6/19/20","645","4","08087","0.62"
"Otero","0","22","Colorado","6/19/20","22","0","08089","0"
"Ouray","0","9","Colorado","6/19/20","8","1","08091","12.5"
"Park","0","23","Colorado","6/19/20","23","0","08093","0"
"Phillips","0","15","Colorado","6/19/20","15","0","08095","0"
"Pitkin","2","80","Colorado","6/19/20","63","17","08097","26.98"
"Prowers","0","16","Colorado","6/19/20","17","-1","08099","-5.88"
"Pueblo","3","351","Colorado","6/19/20","332","19","08101","5.72"
"Rio Blanco","0","2","Colorado","6/19/20","1","1","08103","100"
"Rio Grande","1","62","Colorado","6/19/20","53","9","08105","16.98"
"Routt","0","63","Colorado","6/19/20","64","-1","08107","-1.56"
"Saguache","0","100","Colorado","6/19/20","97","3","08109","3.09"
"San Juan","0","1","Colorado","6/19/20","1","0","08111","0"
"San Miguel","1","28","Colorado","6/19/20","23","5","08113","21.74"
"Summit","1","262","Colorado","6/19/20","254","8","08117","3.15"
"Teller","0","39","Colorado","6/19/20","38","1","08119","2.63"
"Washington","0","44","Colorado","6/19/20","44","0","08121","0"
"Weld","8","2705","Colorado","6/19/20","2646","59","08123","2.23"
"Yuma","0","49","Colorado","6/19/20","47","2","08125","4.26"
"Fairfield","35","16425","Connecticut","6/19/20","16178","247","09001","1.53"
"Hartford","36","11358","Connecticut","6/19/20","11103","255","09003","2.3"
"Litchfield","2","1448","Connecticut","6/19/20","1435","13","09005","0.91"
"Middlesex","5","1254","Connecticut","6/19/20","1216","38","09007","3.12"
"New Haven","22","12136","Connecticut","6/19/20","11979","157","09009","1.31"
"New London","8","1203","Connecticut","6/19/20","1150","53","09011","4.61"
"Tolland","1","893","Connecticut","6/19/20","886","7","09013","0.79"
"Windham","16","567","Connecticut","6/19/20","453","114","09015","25.17"
"Kent","8","1602","Delaware","6/19/20","1544","58","10001","3.76"
"New Castle","43","4522","Delaware","6/19/20","4224","298","10003","7.05"
"Sussex","12","4470","Delaware","6/19/20","4389","81","10005","1.85"
"","0","49","Diamond Princess","6/19/20","49","0",,"0"
"District of Columbia","43","9952","District of Columbia","6/19/20","9654","298","11001","3.09"
"Alachua","18","633","Florida","6/19/20","506","127","12001","25.1"
"Baker","1","39","Florida","6/19/20","30","9","12003","30"
"Bay","5","175","Florida","6/19/20","139","36","12005","25.9"
"Bradford","1","58","Florida","6/19/20","52","6","12007","11.54"
"Brevard","33","748","Florida","6/19/20","519","229","12009","44.12"
"Broward","266","10448","Florida","6/19/20","8589","1859","12011","21.64"
"Calhoun","0","65","Florida","6/19/20","65","0","12013","0"
"Charlotte","7","570","Florida","6/19/20","522","48","12015","9.2"
"Citrus","5","168","Florida","6/19/20","135","33","12017","24.44"
"Clay","6","468","Florida","6/19/20","429","39","12019","9.09"
"Collier","90","2992","Florida","6/19/20","2364","628","12021","26.57"
"Columbia","4","205","Florida","6/19/20","177","28","12023","15.82"
"DeSoto","15","431","Florida","6/19/20","329","102","12027","31"
"Dixie","0","61","Florida","6/19/20","60","1","12029","1.67"
"Duval","80","2484","Florida","6/19/20","1923","561","12031","29.17"
"Escambia","24","1127","Florida","6/19/20","956","171","12033","17.89"
"Flagler","2","216","Florida","6/19/20","202","14","12035","6.93"
"Franklin","0","2","Florida","6/19/20","2","0","12037","0"
"Gadsden","2","319","Florida","6/19/20","302","17","12039","5.63"
"Gilchrist","8","75","Florida","6/19/20","22","53","12041","240.91"
"Glades","2","121","Florida","6/19/20","109","12","12043","11.01"
"Gulf","0","11","Florida","6/19/20","8","3","12045","37.5"
"Hamilton","2","285","Florida","6/19/20","268","17","12047","6.34"
"Hardee","10","244","Florida","6/19/20","177","67","12049","37.85"
"Hendry","18","724","Florida","6/19/20","597","127","12051","21.27"
"Hernando","4","158","Florida","6/19/20","132","26","12053","19.7"
"Highlands","5","206","Florida","6/19/20","169","37","12055","21.89"
"Hillsborough","241","4982","Florida","6/19/20","3295","1687","12057","51.2"
"Holmes","2","45","Florida","6/19/20","31","14","12059","45.16"
"Indian River","18","317","Florida","6/19/20","190","127","12061","66.84"
"Jackson","2","329","Florida","6/19/20","316","13","12063","4.11"
"Jefferson","1","36","Florida","6/19/20","31","5","12065","16.13"
"Lafayette","1","18","Florida","6/19/20","12","6","12067","50"
"Lake","38","646","Florida","6/19/20","383","263","12069","68.67"
"Lee","130","3475","Florida","6/19/20","2563","912","12071","35.58"
"Leon","6","508","Florida","6/19/20","464","44","12073","9.48"
"Levy","6","137","Florida","6/19/20","98","39","12075","39.8"
"Liberty","0","220","Florida","6/19/20","218","2","12077","0.92"
"Madison","3","98","Florida","6/19/20","75","23","12079","30.67"
"Manatee","49","1649","Florida","6/19/20","1309","340","12081","25.97"
"Marion","9","365","Florida","6/19/20","299","66","12083","22.07"
"Martin","52","1421","Florida","6/19/20","1056","365","12085","34.56"
"Miami-Dade","501","24376","Florida","6/19/20","20872","3504","12086","16.79"
"Monroe","4","150","Florida","6/19/20","121","29","12087","23.97"
"Nassau","2","101","Florida","6/19/20","87","14","12089","16.09"
"Okaloosa","11","391","Florida","6/19/20","312","79","12091","25.32"
"Okeechobee","10","230","Florida","6/19/20","158","72","12093","45.57"
"Orange","214","4274","Florida","6/19/20","2773","1501","12095","54.13"
"Osceola","23","960","Florida","6/19/20","796","164","12097","20.6"
"Palm Beach","272","10116","Florida","6/19/20","8209","1907","12099","23.23"
"Pasco","29","686","Florida","6/19/20","484","202","12101","41.74"
"Pinellas","173","3153","Florida","6/19/20","1941","1212","12103","62.44"
"Polk","69","1856","Florida","6/19/20","1373","483","12105","35.18"
"Putnam","4","213","Florida","6/19/20","183","30","12107","16.39"
"Santa Rosa","8","330","Florida","6/19/20","275","55","12113","20"
"Sarasota","21","868","Florida","6/19/20","724","144","12115","19.89"
"Seminole","63","1101","Florida","6/19/20","663","438","12117","66.06"
"St. Johns","15","398","Florida","6/19/20","292","106","12109","36.3"
"St. Lucie","48","1131","Florida","6/19/20","793","338","12111","42.62"
"Sumter","2","277","Florida","6/19/20","266","11","12119","4.14"
"Suwannee","6","229","Florida","6/19/20","185","44","12121","23.78"
"Taylor","1","62","Florida","6/19/20","52","10","12123","19.23"
"Union","0","39","Florida","6/19/20","38","1","12125","2.63"
"Volusia","33","1117","Florida","6/19/20","884","233","12127","26.36"
"Wakulla","0","37","Florida","6/19/20","35","2","12129","5.71"
"Walton","3","165","Florida","6/19/20","145","20","12131","13.79"
"Washington","1","96","Florida","6/19/20","87","9","12133","10.34"
"Appling","2","214","Georgia","6/19/20","199","15","13001","7.54"
"Atkinson","3","89","Georgia","6/19/20","70","19","13003","27.14"
"Bacon","4","194","Georgia","6/19/20","165","29","13005","17.58"
"Baker","0","36","Georgia","6/19/20","37","-1","13007","-2.7"
"Baldwin","2","435","Georgia","6/19/20","421","14","13009","3.33"
"Banks","1","113","Georgia","6/19/20","107","6","13011","5.61"
"Barrow","5","414","Georgia","6/19/20","378","36","13013","9.52"
"Bartow","6","583","Georgia","6/19/20","539","44","13015","8.16"
"Ben Hill","3","117","Georgia","6/19/20","98","19","13017","19.39"
"Berrien","3","86","Georgia","6/19/20","62","24","13019","38.71"
"Bibb","9","590","Georgia","6/19/20","530","60","13021","11.32"
"Bleckley","0","54","Georgia","6/19/20","53","1","13023","1.89"
"Brantley","1","73","Georgia","6/19/20","68","5","13025","7.35"
"Brooks","2","109","Georgia","6/19/20","93","16","13027","17.2"
"Bryan","2","94","Georgia","6/19/20","83","11","13029","13.25"
"Bulloch","7","139","Georgia","6/19/20","92","47","13031","51.09"
"Burke","1","132","Georgia","6/19/20","125","7","13033","5.6"
"Butts","1","250","Georgia","6/19/20","242","8","13035","3.31"
"Calhoun","1","155","Georgia","6/19/20","146","9","13037","6.16"
"Camden","1","81","Georgia","6/19/20","71","10","13039","14.08"
"Candler","0","20","Georgia","6/19/20","17","3","13043","17.65"
"Carroll","4","627","Georgia","6/19/20","602","25","13045","4.15"
"Catoosa","8","272","Georgia","6/19/20","217","55","13047","25.35"
"Charlton","0","38","Georgia","6/19/20","38","0","13049","0"
"Chatham","21","743","Georgia","6/19/20","597","146","13051","24.46"
"Chattahoochee","8","305","Georgia","6/19/20","246","59","13053","23.98"
"Chattooga","2","49","Georgia","6/19/20","32","17","13055","53.12"
"Cherokee","9","1079","Georgia","6/19/20","1014","65","13057","6.41"
"Clarke","5","374","Georgia","6/19/20","338","36","13059","10.65"
"Clay","1","56","Georgia","6/19/20","51","5","13061","9.8"
"Clayton","20","1550","Georgia","6/19/20","1413","137","13063","9.7"
"Clinch","1","85","Georgia","6/19/20","75","10","13065","13.33"
"Cobb","41","3807","Georgia","6/19/20","3522","285","13067","8.09"
"Coffee","10","399","Georgia","6/19/20","328","71","13069","21.65"
"Colquitt","13","722","Georgia","6/19/20","634","88","13071","13.88"
"Columbia","6","335","Georgia","6/19/20","295","40","13073","13.56"
"Cook","3","89","Georgia","6/19/20","67","22","13075","32.84"
"Coweta","6","548","Georgia","6/19/20","507","41","13077","8.09"
"Crawford","0","34","Georgia","6/19/20","31","3","13079","9.68"
"Crisp","2","257","Georgia","6/19/20","241","16","13081","6.64"
"Dade","1","57","Georgia","6/19/20","47","10","13083","21.28"
"Dawson","1","124","Georgia","6/19/20","118","6","13085","5.08"
"Decatur","3","242","Georgia","6/19/20","222","20","13087","9.01"
"DeKalb","51","4637","Georgia","6/19/20","4282","355","13089","8.29"
"Dodge","1","62","Georgia","6/19/20","54","8","13091","14.81"
"Dooly","0","194","Georgia","6/19/20","197","-3","13093","-1.52"
"Dougherty","2","1844","Georgia","6/19/20","1828","16","13095","0.88"
"Douglas","10","708","Georgia","6/19/20","641","67","13097","10.45"
"Early","0","256","Georgia","6/19/20","254","2","13099","0.79"
"Echols","2","168","Georgia","6/19/20","153","15","13101","9.8"
"Effingham","2","95","Georgia","6/19/20","83","12","13103","14.46"
"Elbert","1","89","Georgia","6/19/20","84","5","13105","5.95"
"Emanuel","2","55","Georgia","6/19/20","38","17","13107","44.74"
"Evans","1","15","Georgia","6/19/20","7","8","13109","114.29"
"Fannin","1","74","Georgia","6/19/20","65","9","13111","13.85"
"Fayette","3","278","Georgia","6/19/20","259","19","13113","7.34"
"Floyd","5","399","Georgia","6/19/20","365","34","13115","9.32"
"Forsyth","7","638","Georgia","6/19/20","589","49","13117","8.32"
"Franklin","2","154","Georgia","6/19/20","137","17","13119","12.41"
"Fulton","47","5400","Georgia","6/19/20","5069","331","13121","6.53"
"Gilmer","1","177","Georgia","6/19/20","169","8","13123","4.73"
"Glascock","0","2","Georgia","6/19/20","1","1","13125","100"
"Glynn","11","253","Georgia","6/19/20","177","76","13127","42.94"
"Gordon","6","283","Georgia","6/19/20","240","43","13129","17.92"
"Grady","3","158","Georgia","6/19/20","137","21","13131","15.33"
"Greene","0","88","Georgia","6/19/20","86","2","13133","2.33"
"Gwinnett","124","5958","Georgia","6/19/20","5089","869","13135","17.08"
"Habersham","7","630","Georgia","6/19/20","581","49","13137","8.43"
"Hall","25","2901","Georgia","6/19/20","2727","174","13139","6.38"
"Hancock","0","203","Georgia","6/19/20","201","2","13141","1"
"Haralson","1","62","Georgia","6/19/20","57","5","13143","8.77"
"Harris","7","240","Georgia","6/19/20","190","50","13145","26.32"
"Hart","1","47","Georgia","6/19/20","41","6","13147","14.63"
"Heard","0","45","Georgia","6/19/20","42","3","13149","7.14"
"Henry","13","920","Georgia","6/19/20","829","91","13151","10.98"
"Houston","9","481","Georgia","6/19/20","421","60","13153","14.25"
"Irwin","2","45","Georgia","6/19/20","34","11","13155","32.35"
"Jackson","5","294","Georgia","6/19/20","256","38","13157","14.84"
"Jasper","1","61","Georgia","6/19/20","56","5","13159","8.93"
"Jeff Davis","3","71","Georgia","6/19/20","52","19","13161","36.54"
"Jefferson","2","66","Georgia","6/19/20","52","14","13163","26.92"
"Jenkins","4","72","Georgia","6/19/20","44","28","13165","63.64"
"Johnson","0","80","Georgia","6/19/20","77","3","13167","3.9"
"Jones","0","51","Georgia","6/19/20","50","1","13169","2"
"Lamar","1","86","Georgia","6/19/20","79","7","13171","8.86"
"Lanier","11","111","Georgia","6/19/20","37","74","13173","200"
"Laurens","2","129","Georgia","6/19/20","113","16","13175","14.16"
"Lee","1","377","Georgia","6/19/20","371","6","13177","1.62"
"Liberty","1","100","Georgia","6/19/20","90","10","13179","11.11"
"Lincoln","0","19","Georgia","6/19/20","17","2","13181","11.76"
"Long","1","28","Georgia","6/19/20","19","9","13183","47.37"
"Lowndes","40","844","Georgia","6/19/20","567","277","13185","48.85"
"Lumpkin","1","117","Georgia","6/19/20","107","10","13187","9.35"
"Macon","1","112","Georgia","6/19/20","106","6","13193","5.66"
"Madison","1","77","Georgia","6/19/20","72","5","13195","6.94"
"Marion","1","69","Georgia","6/19/20","61","8","13197","13.11"
"McDuffie","1","78","Georgia","6/19/20","73","5","13189","6.85"
"McIntosh","1","22","Georgia","6/19/20","17","5","13191","29.41"
"Meriwether","3","144","Georgia","6/19/20","123","21","13199","17.07"
"Miller","0","45","Georgia","6/19/20","45","0","13201","0"
"Mitchell","1","432","Georgia","6/19/20","427","5","13205","1.17"
"Monroe","1","135","Georgia","6/19/20","127","8","13207","6.3"
"Montgomery","1","24","Georgia","6/19/20","19","5","13209","26.32"
"Morgan","1","44","Georgia","6/19/20","40","4","13211","10"
"Murray","5","163","Georgia","6/19/20","130","33","13213","25.38"
"Muscogee","27","1146","Georgia","6/19/20","955","191","13215","20"
"Newton","8","466","Georgia","6/19/20","412","54","13217","13.11"
"Oconee","0","131","Georgia","6/19/20","128","3","13219","2.34"
"Oglethorpe","1","80","Georgia","6/19/20","71","9","13221","12.68"
"Out of GA","44","2892","Georgia","6/19/20","2582","310","80013","12.01"
"Paulding","7","453","Georgia","6/19/20","401","52","13223","12.97"
"Peach","1","92","Georgia","6/19/20","86","6","13225","6.98"
"Pickens","3","78","Georgia","6/19/20","59","19","13227","32.2"
"Pierce","1","134","Georgia","6/19/20","126","8","13229","6.35"
"Pike","2","81","Georgia","6/19/20","66","15","13231","22.73"
"Polk","2","178","Georgia","6/19/20","162","16","13233","9.88"
"Pulaski","0","46","Georgia","6/19/20","46","0","13235","0"
"Putnam","1","113","Georgia","6/19/20","104","9","13237","8.65"
"Quitman","0","15","Georgia","6/19/20","14","1","13239","7.14"
"Rabun","0","33","Georgia","6/19/20","30","3","13241","10"
"Randolph","1","194","Georgia","6/19/20","190","4","13243","2.11"
"Richmond","10","736","Georgia","6/19/20","664","72","13245","10.84"
"Rockdale","4","359","Georgia","6/19/20","333","26","13247","7.81"
"Schley","0","21","Georgia","6/19/20","18","3","13249","16.67"
"Screven","2","74","Georgia","6/19/20","61","13","13251","21.31"
"Seminole","0","48","Georgia","6/19/20","48","0","13253","0"
"Spalding","4","338","Georgia","6/19/20","309","29","13255","9.39"
"Stephens","2","163","Georgia","6/19/20","152","11","13257","7.24"
"Stewart","3","82","Georgia","6/19/20","60","22","13259","36.67"
"Sumter","4","531","Georgia","6/19/20","506","25","13261","4.94"
"Talbot","1","53","Georgia","6/19/20","45","8","13263","17.78"
"Taliaferro","0","2","Georgia","6/19/20","2","0","13265","0"
"Tattnall","6","77","Georgia","6/19/20","38","39","13267","102.63"
"Taylor","0","27","Georgia","6/19/20","25","2","13269","8"
"Telfair","2","63","Georgia","6/19/20","47","16","13271","34.04"
"Terrell","0","217","Georgia","6/19/20","218","-1","13273","-0.46"
"Thomas","1","368","Georgia","6/19/20","359","9","13275","2.51"
"Tift","17","494","Georgia","6/19/20","372","122","13277","32.8"
"Toombs","6","141","Georgia","6/19/20","96","45","13279","46.88"
"Towns","0","35","Georgia","6/19/20","32","3","13281","9.38"
"Treutlen","0","18","Georgia","6/19/20","17","1","13283","5.88"
"Troup","32","922","Georgia","6/19/20","701","221","13285","31.53"
"Turner","2","165","Georgia","6/19/20","148","17","13287","11.49"
"Twiggs","0","23","Georgia","6/19/20","21","2","13289","9.52"
"Union","0","56","Georgia","6/19/20","53","3","13291","5.66"
"Upson","2","312","Georgia","6/19/20","295","17","13293","5.76"
"Walker","9","276","Georgia","6/19/20","216","60","13295","27.78"
"Walton","3","343","Georgia","6/19/20","321","22","13297","6.85"
"Ware","6","307","Georgia","6/19/20","263","44","13299","16.73"
"Warren","0","19","Georgia","6/19/20","19","0","13301","0"
"Washington","0","77","Georgia","6/19/20","76","1","13303","1.32"
"Wayne","2","44","Georgia","6/19/20","33","11","13305","33.33"
"Webster","0","17","Georgia","6/19/20","14","3","13307","21.43"
"Wheeler","3","34","Georgia","6/19/20","16","18","13309","112.5"
"White","1","128","Georgia","6/19/20","124","4","13311","3.23"
"Whitfield","23","726","Georgia","6/19/20","562","164","13313","29.18"
"Wilcox","0","120","Georgia","6/19/20","117","3","13315","2.56"
"Wilkes","1","43","Georgia","6/19/20","35","8","13317","22.86"
"Wilkinson","0","74","Georgia","6/19/20","73","1","13319","1.37"
"Worth","3","278","Georgia","6/19/20","256","22","13321","8.59"
"","0","103","Grand Princess","6/19/20","103","0",,"0"
"","2","200","Guam","6/19/20","183","17",,"9.29"
"Hawaii","0","83","Hawaii","6/19/20","81","2","15001","2.47"
"Honolulu","11","551","Hawaii","6/19/20","472","79","15003","16.74"
"Kauai","0","22","Hawaii","6/19/20","21","1","15007","4.76"
"Maui","0","121","Hawaii","6/19/20","120","1","15009","0.83"
"Out of HI","0","12","Hawaii","6/19/20","12","0","80015","0"
"Ada","32","1100","Idaho","6/19/20","877","223","16001","25.43"
"Adams","1","9","Idaho","6/19/20","4","5","16003","125"
"Bannock","3","77","Idaho","6/19/20","59","18","16005","30.51"
"Benewah","0","21","Idaho","6/19/20","19","2","16009","10.53"
"Bingham","1","27","Idaho","6/19/20","23","4","16011","17.39"
"Blaine","0","518","Idaho","6/19/20","515","3","16013","0.58"
"Bonner","1","11","Idaho","6/19/20","7","4","16017","57.14"
"Bonneville","3","91","Idaho","6/19/20","73","18","16019","24.66"
"Camas","0","1","Idaho","6/19/20","1","0","16025","0"
"Canyon","7","403","Idaho","6/19/20","356","47","16027","13.2"
"Caribou","1","8","Idaho","6/19/20","3","5","16029","166.67"
"Cassia","5","163","Idaho","6/19/20","131","32","16031","24.43"
"Custer","0","2","Idaho","6/19/20","2","0","16037","0"
"Elmore","1","38","Idaho","6/19/20","34","4","16039","11.76"
"Franklin","1","18","Idaho","6/19/20","12","6","16041","50"
"Fremont","0","4","Idaho","6/19/20","4","0","16043","0"
"Gem","0","17","Idaho","6/19/20","17","0","16045","0"
"Gooding","0","60","Idaho","6/19/20","58","2","16047","3.45"
"Idaho","0","3","Idaho","6/19/20","3","0","16049","0"
"Jefferson","0","11","Idaho","6/19/20","10","1","16051","10"
"Jerome","2","216","Idaho","6/19/20","205","11","16053","5.37"
"Kootenai","2","115","Idaho","6/19/20","98","17","16055","17.35"
"Latah","0","8","Idaho","6/19/20","7","1","16057","14.29"
"Lemhi","0","2","Idaho","6/19/20","1","1","16059","100"
"Lincoln","0","35","Idaho","6/19/20","35","0","16063","0"
"Madison","0","30","Idaho","6/19/20","29","1","16065","3.45"
"Minidoka","2","115","Idaho","6/19/20","98","17","16067","17.35"
"Nez Perce","0","84","Idaho","6/19/20","84","0","16069","0"
"Owyhee","2","22","Idaho","6/19/20","8","14","16073","175"
"Payette","2","40","Idaho","6/19/20","27","13","16075","48.15"
"Power","1","14","Idaho","6/19/20","9","5","16077","55.56"
"Teton","0","14","Idaho","6/19/20","11","3","16081","27.27"
"Twin Falls","4","507","Idaho","6/19/20","480","27","16083","5.62"
"Valley","0","3","Idaho","6/19/20","3","0","16085","0"
"Washington","5","84","Idaho","6/19/20","50","34","16087","68"
"Adams","0","47","Illinois","6/19/20","45","2","17001","4.44"
"Alexander","0","18","Illinois","6/19/20","16","2","17003","12.5"
"Bond","0","12","Illinois","6/19/20","12","0","17005","0"
"Boone","5","551","Illinois","6/19/20","518","33","17007","6.37"
"Brown","0","10","Illinois","6/19/20","10","0","17009","0"
"Bureau","0","24","Illinois","6/19/20","22","2","17011","9.09"
"Calhoun","0","1","Illinois","6/19/20","1","0","17013","0"
"Carroll","0","18","Illinois","6/19/20","18","0","17015","0"
"Cass","3","100","Illinois","6/19/20","77","23","17017","29.87"
"Champaign","6","765","Illinois","6/19/20","724","41","17019","5.66"
"Christian","1","42","Illinois","6/19/20","35","7","17021","20"
"Clark","0","13","Illinois","6/19/20","12","1","17023","8.33"
"Clay","0","2","Illinois","6/19/20","2","0","17025","0"
"Clinton","2","220","Illinois","6/19/20","203","17","17027","8.37"
"Coles","1","146","Illinois","6/19/20","142","4","17029","2.82"
"Cook","329","86551","Illinois","6/19/20","84249","2302","17031","2.73"
"Crawford","1","17","Illinois","6/19/20","13","4","17033","30.77"
"Cumberland","0","10","Illinois","6/19/20","10","0","17035","0"
"De Witt","0","4","Illinois","6/19/20","4","0","17039","0"
"DeKalb","6","513","Illinois","6/19/20","471","42","17037","8.92"
"Douglas","1","42","Illinois","6/19/20","33","9","17041","27.27"
"DuPage","36","8609","Illinois","6/19/20","8355","254","17043","3.04"
"Edgar","1","6","Illinois","6/19/20","1","5","17045","500"
"Edwards","0","2","Illinois","6/19/20","2","0","17047","0"
"Effingham","1","12","Illinois","6/19/20","8","4","17049","50"
"Fayette","0","23","Illinois","6/19/20","22","1","17051","4.55"
"Ford","0","22","Illinois","6/19/20","21","1","17053","4.76"
"Franklin","0","12","Illinois","6/19/20","12","0","17055","0"
"Fulton","0","12","Illinois","6/19/20","12","0","17057","0"
"Gallatin","0","2","Illinois","6/19/20","2","0","17059","0"
"Greene","0","8","Illinois","6/19/20","7","1","17061","14.29"
"Grundy","2","140","Illinois","6/19/20","128","12","17063","9.38"
"Hamilton","0","2","Illinois","6/19/20","2","0","17065","0"
"Hancock","0","18","Illinois","6/19/20","18","0","17067","0"
"Hardin","0","1","Illinois","6/19/20","1","0","17069","0"
"Henderson","0","8","Illinois","6/19/20","8","0","17071","0"
"Henry","0","73","Illinois","6/19/20","72","1","17073","1.39"
"Iroquois","1","143","Illinois","6/19/20","136","7","17075","5.15"
"Jackson","1","321","Illinois","6/19/20","311","10","17077","3.22"
"Jasper","0","46","Illinois","6/19/20","46","0","17079","0"
"Jefferson","0","104","Illinois","6/19/20","103","1","17081","0.97"
"Jersey","0","29","Illinois","6/19/20","28","1","17083","3.57"
"Jo Daviess","0","35","Illinois","6/19/20","34","1","17085","2.94"
"Johnson","1","20","Illinois","6/19/20","14","6","17087","42.86"
"Kane","35","7274","Illinois","6/19/20","7030","244","17089","3.47"
"Kankakee","10","1130","Illinois","6/19/20","1059","71","17091","6.7"
"Kendall","5","903","Illinois","6/19/20","869","34","17093","3.91"
"Knox","1","115","Illinois","6/19/20","111","4","17095","3.6"
"Lake","37","9242","Illinois","6/19/20","8980","262","17097","2.92"
"LaSalle","2","188","Illinois","6/19/20","177","11","17099","6.21"
"Lawrence","0","5","Illinois","6/19/20","4","1","17101","25"
"Lee","1","94","Illinois","6/19/20","88","6","17103","6.82"
"Livingston","0","36","Illinois","6/19/20","36","0","17105","0"
"Logan","0","12","Illinois","6/19/20","10","2","17107","20"
"Macon","1","216","Illinois","6/19/20","206","10","17115","4.85"
"Macoupin","0","47","Illinois","6/19/20","46","1","17117","2.17"
"Madison","15","785","Illinois","6/19/20","683","102","17119","14.93"
"Marion","0","57","Illinois","6/19/20","55","2","17121","3.64"
"Marshall","0","6","Illinois","6/19/20","5","1","17123","20"
"Mason","0","19","Illinois","6/19/20","18","1","17125","5.56"
"Massac","0","7","Illinois","6/19/20","7","0","17127","0"
"McDonough","0","101","Illinois","6/19/20","102","-1","17109","-0.98"
"McHenry","12","1891","Illinois","6/19/20","1810","81","17111","4.48"
"McLean","1","246","Illinois","6/19/20","238","8","17113","3.36"
"Menard","0","23","Illinois","6/19/20","22","1","17129","4.55"
"Mercer","0","19","Illinois","6/19/20","18","1","17131","5.56"
"Monroe","1","111","Illinois","6/19/20","106","5","17133","4.72"
"Montgomery","0","42","Illinois","6/19/20","41","1","17135","2.44"
"Morgan","2","119","Illinois","6/19/20","105","14","17137","13.33"
"Moultrie","0","15","Illinois","6/19/20","13","2","17139","15.38"
"Ogle","1","231","Illinois","6/19/20","224","7","17141","3.12"
"Out of IL","-15","7","Illinois","6/19/20","111","-104","80017","-93.69"
"Peoria","7","419","Illinois","6/19/20","367","52","17143","14.17"
"Perry","0","44","Illinois","6/19/20","43","1","17145","2.33"
"Piatt","1","16","Illinois","6/19/20","11","5","17147","45.45"
"Pike","0","2","Illinois","6/19/20","2","0","17149","0"
"Pope","0","1","Illinois","6/19/20","1","0","17151","0"
"Pulaski","1","65","Illinois","6/19/20","59","6","17153","10.17"
"Putnam","0","1","Illinois","6/19/20","1","0","17155","0"
"Randolph","0","278","Illinois","6/19/20","276","2","17157","0.72"
"Richland","0","4","Illinois","6/19/20","4","0","17159","0"
"Rock Island","5","769","Illinois","6/19/20","737","32","17161","4.34"
"Saline","0","8","Illinois","6/19/20","7","1","17165","14.29"
"Sangamon","1","387","Illinois","6/19/20","377","10","17167","2.65"
"Schuyler","0","13","Illinois","6/19/20","13","0","17169","0"
"Shelby","0","16","Illinois","6/19/20","16","0","17173","0"
"St. Clair","24","1561","Illinois","6/19/20","1392","169","17163","12.14"
"Stark","0","3","Illinois","6/19/20","3","0","17175","0"
"Stephenson","2","242","Illinois","6/19/20","226","16","17177","7.08"
"Tazewell","3","108","Illinois","6/19/20","85","23","17179","27.06"
"Union","2","183","Illinois","6/19/20","172","11","17181","6.4"
"Vermilion","0","47","Illinois","6/19/20","44","3","17183","6.82"
"Wabash","0","15","Illinois","6/19/20","12","3","17185","25"
"Warren","0","127","Illinois","6/19/20","127","0","17187","0"
"Washington","0","19","Illinois","6/19/20","19","0","17189","0"
"Wayne","0","11","Illinois","6/19/20","9","2","17191","22.22"
"White","0","3","Illinois","6/19/20","2","1","17193","50"
"Whiteside","1","171","Illinois","6/19/20","161","10","17195","6.21"
"Will","28","6284","Illinois","6/19/20","6086","198","17197","3.25"
"Williamson","2","91","Illinois","6/19/20","80","11","17199","13.75"
"Winnebago","20","2810","Illinois","6/19/20","2667","143","17201","5.36"
"Woodford","1","31","Illinois","6/19/20","22","9","17203","40.91"
"Adams","1","28","Indiana","6/19/20","24","4","18001","16.67"
"Allen","29","2331","Indiana","6/19/20","2127","204","18003","9.59"
"Bartholomew","3","566","Indiana","6/19/20","547","19","18005","3.47"
"Benton","0","38","Indiana","6/19/20","37","1","18007","2.7"
"Blackford","0","32","Indiana","6/19/20","29","3","18009","10.34"
"Boone","3","381","Indiana","6/19/20","357","24","18011","6.72"
"Brown","0","37","Indiana","6/19/20","36","1","18013","2.78"
"Carroll","1","103","Indiana","6/19/20","98","5","18015","5.1"
"Cass","2","1613","Indiana","6/19/20","1596","17","18017","1.07"
"Clark","4","586","Indiana","6/19/20","559","27","18019","4.83"
"Clay","0","56","Indiana","6/19/20","56","0","18021","0"
"Clinton","2","268","Indiana","6/19/20","253","15","18023","5.93"
"Crawford","0","27","Indiana","6/19/20","27","0","18025","0"
"Daviess","2","129","Indiana","6/19/20","117","12","18027","10.26"
"Dearborn","1","184","Indiana","6/19/20","179","5","18029","2.79"
"Decatur","0","238","Indiana","6/19/20","235","3","18031","1.28"
"DeKalb","5","133","Indiana","6/19/20","95","38","18033","40"
"Delaware","1","407","Indiana","6/19/20","399","8","18035","2.01"
"Dubois","2","249","Indiana","6/19/20","236","13","18037","5.51"
"Elkhart","78","2477","Indiana","6/19/20","1929","548","18039","28.41"
"Fayette","1","85","Indiana","6/19/20","81","4","18041","4.94"
"Floyd","1","342","Indiana","6/19/20","333","9","18043","2.7"
"Fountain","0","24","Indiana","6/19/20","23","1","18045","4.35"
"Franklin","0","120","Indiana","6/19/20","119","1","18047","0.84"
"Fulton","1","60","Indiana","6/19/20","53","7","18049","13.21"
"Gibson","0","25","Indiana","6/19/20","22","3","18051","13.64"
"Grant","3","272","Indiana","6/19/20","253","19","18053","7.51"
"Greene","1","183","Indiana","6/19/20","177","6","18055","3.39"
"Hamilton","16","1359","Indiana","6/19/20","1250","109","18057","8.72"
"Hancock","2","385","Indiana","6/19/20","371","14","18059","3.77"
"Harrison","0","200","Indiana","6/19/20","198","2","18061","1.01"
"Hendricks","5","1296","Indiana","6/19/20","1261","35","18063","2.78"
"Henry","1","205","Indiana","6/19/20","201","4","18065","1.99"
"Howard","5","494","Indiana","6/19/20","458","36","18067","7.86"
"Huntington","1","58","Indiana","6/19/20","49","9","18069","18.37"
"Jackson","2","427","Indiana","6/19/20","414","13","18071","3.14"
"Jasper","1","89","Indiana","6/19/20","81","8","18073","9.88"
"Jay","0","63","Indiana","6/19/20","60","3","18075","5"
"Jefferson","0","55","Indiana","6/19/20","52","3","18077","5.77"
"Jennings","3","158","Indiana","6/19/20","139","19","18079","13.67"
"Johnson","4","1185","Indiana","6/19/20","1160","25","18081","2.16"
"Knox","1","40","Indiana","6/19/20","34","6","18083","17.65"
"Kosciusko","12","362","Indiana","6/19/20","277","85","18085","30.69"
"LaGrange","17","354","Indiana","6/19/20","235","119","18087","50.64"
"Lake","35","4326","Indiana","6/19/20","4081","245","18089","6"
"LaPorte","2","482","Indiana","6/19/20","465","17","18091","3.66"
"Lawrence","2","187","Indiana","6/19/20","176","11","18093","6.25"
"Madison","1","618","Indiana","6/19/20","612","6","18095","0.98"
"Marion","44","10885","Indiana","6/19/20","10577","308","18097","2.91"
"Marshall","10","344","Indiana","6/19/20","276","68","18099","24.64"
"Martin","1","20","Indiana","6/19/20","15","5","18101","33.33"
"Miami","2","177","Indiana","6/19/20","161","16","18103","9.94"
"Monroe","3","207","Indiana","6/19/20","185","22","18105","11.89"
"Montgomery","1","270","Indiana","6/19/20","262","8","18107","3.05"
"Morgan","1","301","Indiana","6/19/20","296","5","18109","1.69"
"Newton","0","87","Indiana","6/19/20","87","0","18111","0"
"Noble","6","358","Indiana","6/19/20","318","40","18113","12.58"
"Ohio","0","13","Indiana","6/19/20","13","0","18115","0"
"Orange","0","132","Indiana","6/19/20","132","0","18117","0"
"Owen","0","39","Indiana","6/19/20","37","2","18119","5.41"
"Parke","0","20","Indiana","6/19/20","20","0","18121","0"
"Perry","5","101","Indiana","6/19/20","68","33","18123","48.53"
"Pike","0","6","Indiana","6/19/20","6","0","18125","0"
"Porter","4","611","Indiana","6/19/20","585","26","18127","4.44"
"Posey","1","23","Indiana","6/19/20","18","5","18129","27.78"
"Pulaski","0","53","Indiana","6/19/20","52","1","18131","1.92"
"Putnam","1","158","Indiana","6/19/20","152","6","18133","3.95"
"Randolph","1","71","Indiana","6/19/20","64","7","18135","10.94"
"Ripley","0","111","Indiana","6/19/20","109","2","18137","1.83"
"Rush","0","51","Indiana","6/19/20","49","2","18139","4.08"
"Scott","1","147","Indiana","6/19/20","142","5","18143","3.52"
"Shelby","0","408","Indiana","6/19/20","405","3","18145","0.74"
"Spencer","0","24","Indiana","6/19/20","22","2","18147","9.09"
"St. Joseph","19","1628","Indiana","6/19/20","1496","132","18141","8.82"
"Starke","1","58","Indiana","6/19/20","48","10","18149","20.83"
"Steuben","1","108","Indiana","6/19/20","102","6","18151","5.88"
"Sullivan","0","41","Indiana","6/19/20","41","0","18153","0"
"Switzerland","0","22","Indiana","6/19/20","22","0","18155","0"
"Tippecanoe","5","510","Indiana","6/19/20","472","38","18157","8.05"
"Tipton","0","28","Indiana","6/19/20","27","1","18159","3.7"
"Union","0","12","Indiana","6/19/20","12","0","18161","0"
"Vanderburgh","2","337","Indiana","6/19/20","321","16","18163","4.98"
"Vermillion","0","13","Indiana","6/19/20","11","2","18165","18.18"
"Vigo","1","207","Indiana","6/19/20","198","9","18167","4.55"
"Wabash","0","89","Indiana","6/19/20","88","1","18169","1.14"
"Warren","0","14","Indiana","6/19/20","14","0","18171","0"
"Warrick","1","178","Indiana","6/19/20","171","7","18173","4.09"
"Washington","1","61","Indiana","6/19/20","56","5","18175","8.93"
"Wayne","2","107","Indiana","6/19/20","96","11","18177","11.46"
"Wells","2","65","Indiana","6/19/20","49","16","18179","32.65"
"White","1","245","Indiana","6/19/20","240","5","18181","2.08"
"Whitley","1","69","Indiana","6/19/20","60","9","18183","15"
"Adair","0","12","Iowa","6/19/20","11","1","19001","9.09"
"Adams","0","7","Iowa","6/19/20","7","0","19003","0"
"Allamakee","0","121","Iowa","6/19/20","121","0","19005","0"
"Appanoose","0","18","Iowa","6/19/20","16","2","19007","12.5"
"Audubon","0","15","Iowa","6/19/20","13","2","19009","15.38"
"Benton","1","50","Iowa","6/19/20","46","4","19011","8.7"
"Black Hawk","7","1870","Iowa","6/19/20","1824","46","19013","2.52"
"Boone","2","107","Iowa","6/19/20","93","14","19015","15.05"
"Bremer","1","81","Iowa","6/19/20","74","7","19017","9.46"
"Buchanan","0","36","Iowa","6/19/20","34","2","19019","5.88"
"Buena Vista","24","1640","Iowa","6/19/20","1475","165","19021","11.19"
"Butler","2","31","Iowa","6/19/20","19","12","19023","63.16"
"Calhoun","1","25","Iowa","6/19/20","19","6","19025","31.58"
"Carroll","5","66","Iowa","6/19/20","33","33","19027","100"
"Cass","0","16","Iowa","6/19/20","13","3","19029","23.08"
"Cedar","0","56","Iowa","6/19/20","53","3","19031","5.66"
"Cerro Gordo","2","57","Iowa","6/19/20","40","17","19033","42.5"
"Cherokee","1","65","Iowa","6/19/20","56","9","19035","16.07"
"Chickasaw","0","17","Iowa","6/19/20","15","2","19037","13.33"
"Clarke","3","109","Iowa","6/19/20","86","23","19039","26.74"
"Clay","6","102","Iowa","6/19/20","59","43","19041","72.88"
"Clayton","0","35","Iowa","6/19/20","35","0","19043","0"
"Clinton","0","70","Iowa","6/19/20","68","2","19045","2.94"
"Crawford","6","635","Iowa","6/19/20","593","42","19047","7.08"
"Dallas","10","1062","Iowa","6/19/20","995","67","19049","6.73"
"Davis","0","36","Iowa","6/19/20","33","3","19051","9.09"
"Decatur","1","9","Iowa","6/19/20","4","5","19053","125"
"Delaware","1","32","Iowa","6/19/20","27","5","19055","18.52"
"Des Moines","0","67","Iowa","6/19/20","68","-1","19057","-1.47"
"Dickinson","10","190","Iowa","6/19/20","119","71","19059","59.66"
"Dubuque","4","411","Iowa","6/19/20","381","30","19061","7.87"
"Emmet","1","46","Iowa","6/19/20","38","8","19063","21.05"
"Fayette","0","28","Iowa","6/19/20","28","0","19065","0"
"Floyd","1","30","Iowa","6/19/20","20","10","19067","50"
"Franklin","3","61","Iowa","6/19/20","41","20","19069","48.78"
"Fremont","0","5","Iowa","6/19/20","4","1","19071","25"
"Greene","1","27","Iowa","6/19/20","20","7","19073","35"
"Grundy","0","26","Iowa","6/19/20","23","3","19075","13.04"
"Guthrie","1","61","Iowa","6/19/20","57","4","19077","7.02"
"Hamilton","5","148","Iowa","6/19/20","112","36","19079","32.14"
"Hancock","1","35","Iowa","6/19/20","26","9","19081","34.62"
"Hardin","1","52","Iowa","6/19/20","42","10","19083","23.81"
"Harrison","1","41","Iowa","6/19/20","33","8","19085","24.24"
"Henry","0","75","Iowa","6/19/20","73","2","19087","2.74"
"Howard","0","13","Iowa","6/19/20","12","1","19089","8.33"
"Humboldt","1","39","Iowa","6/19/20","30","9","19091","30"
"Ida","0","19","Iowa","6/19/20","17","2","19093","11.76"
"Iowa","0","35","Iowa","6/19/20","34","1","19095","2.94"
"Jackson","0","15","Iowa","6/19/20","14","1","19097","7.14"
"Jasper","2","290","Iowa","6/19/20","279","11","19099","3.94"
"Jefferson","0","46","Iowa","6/19/20","44","2","19101","4.55"
"Johnson","11","711","Iowa","6/19/20","635","76","19103","11.97"
"Jones","0","43","Iowa","6/19/20","40","3","19105","7.5"
"Keokuk","0","16","Iowa","6/19/20","15","1","19107","6.67"
"Kossuth","1","21","Iowa","6/19/20","16","5","19109","31.25"
"Lee","1","41","Iowa","6/19/20","37","4","19111","10.81"
"Linn","6","1057","Iowa","6/19/20","1012","45","19113","4.45"
"Louisa","0","354","Iowa","6/19/20","355","-1","19115","-0.28"
"Lucas","0","26","Iowa","6/19/20","23","3","19117","13.04"
"Lyon","0","32","Iowa","6/19/20","29","3","19119","10.34"
"Madison","0","34","Iowa","6/19/20","31","3","19121","9.68"
"Mahaska","0","109","Iowa","6/19/20","107","2","19123","1.87"
"Marion","1","45","Iowa","6/19/20","40","5","19125","12.5"
"Marshall","3","963","Iowa","6/19/20","940","23","19127","2.45"
"Mills","1","29","Iowa","6/19/20","22","7","19129","31.82"
"Mitchell","0","9","Iowa","6/19/20","6","3","19131","50"
"Monona","4","56","Iowa","6/19/20","31","25","19133","80.65"
"Monroe","0","49","Iowa","6/19/20","47","2","19135","4.26"
"Montgomery","0","10","Iowa","6/19/20","9","1","19137","11.11"
"Muscatine","1","581","Iowa","6/19/20","571","10","19139","1.75"
"O'Brien","1","70","Iowa","6/19/20","64","6","19141","9.38"
"Osceola","0","49","Iowa","6/19/20","49","0","19143","0"
"Page","0","18","Iowa","6/19/20","16","2","19145","12.5"
"Palo Alto","1","19","Iowa","6/19/20","13","6","19147","46.15"
"Plymouth","5","226","Iowa","6/19/20","190","36","19149","18.95"
"Pocahontas","1","35","Iowa","6/19/20","30","5","19151","16.67"
"Polk","49","5367","Iowa","6/19/20","5026","341","19153","6.78"
"Pottawattamie","14","578","Iowa","6/19/20","482","96","19155","19.92"
"Poweshiek","0","95","Iowa","6/19/20","95","0","19157","0"
"Ringgold","0","10","Iowa","6/19/20","8","2","19159","25"
"Sac","1","43","Iowa","6/19/20","37","6","19161","16.22"
"Scott","3","425","Iowa","6/19/20","401","24","19163","5.99"
"Shelby","4","69","Iowa","6/19/20","43","26","19165","60.47"
"Sioux","8","408","Iowa","6/19/20","349","59","19167","16.91"
"Story","24","378","Iowa","6/19/20","210","168","19169","80"
"Tama","0","429","Iowa","6/19/20","426","3","19171","0.7"
"Taylor","1","75","Iowa","6/19/20","71","4","19173","5.63"
"Union","0","12","Iowa","6/19/20","10","2","19175","20"
"Van Buren","0","11","Iowa","6/19/20","11","0","19177","0"
"Wapello","1","681","Iowa","6/19/20","672","9","19179","1.34"
"Warren","2","205","Iowa","6/19/20","191","14","19181","7.33"
"Washington","1","210","Iowa","6/19/20","206","4","19183","1.94"
"Wayne","0","5","Iowa","6/19/20","4","1","19185","25"
"Webster","2","110","Iowa","6/19/20","94","16","19187","17.02"
"Winnebago","0","13","Iowa","6/19/20","12","1","19189","8.33"
"Winneshiek","0","24","Iowa","6/19/20","24","0","19191","0"
"Woodbury","9","3052","Iowa","6/19/20","2987","65","19193","2.18"
"Worth","0","6","Iowa","6/19/20","4","2","19195","50"
"Wright","5","316","Iowa","6/19/20","278","38","19197","13.67"
"Allen","0","2","Kansas","6/19/20","2","0","20001","0"
"Anderson","0","3","Kansas","6/19/20","1","2","20003","200"
"Atchison","0","27","Kansas","6/19/20","26","1","20005","3.85"
"Barber","0","1","Kansas","6/19/20","1","0","20007","0"
"Barton","1","52","Kansas","6/19/20","48","4","20009","8.33"
"Bourbon","0","9","Kansas","6/19/20","8","1","20011","12.5"
"Brown","1","14","Kansas","6/19/20","10","4","20013","40"
"Butler","1","47","Kansas","6/19/20","37","10","20015","27.03"
"Chase","0","3","Kansas","6/19/20","3","0","20017","0"
"Chautauqua","0","4","Kansas","6/19/20","4","0","20019","0"
"Cherokee","0","17","Kansas","6/19/20","16","1","20021","6.25"
"Cheyenne","0","2","Kansas","6/19/20","2","0","20023","0"
"Clark","0","34","Kansas","6/19/20","33","1","20025","3.03"
"Clay","0","6","Kansas","6/19/20","6","0","20027","0"
"Cloud","0","7","Kansas","6/19/20","5","2","20029","40"
"Coffey","0","52","Kansas","6/19/20","52","0","20031","0"
"Comanche","0","2","Kansas","6/19/20","2","0","20033","0"
"Cowley","2","55","Kansas","6/19/20","39","16","20035","41.03"
"Crawford","21","167","Kansas","6/19/20","20","147","20037","735"
"Dickinson","0","6","Kansas","6/19/20","6","0","20041","0"
"Doniphan","1","24","Kansas","6/19/20","20","4","20043","20"
"Douglas","2","91","Kansas","6/19/20","79","12","20045","15.19"
"Edwards","0","6","Kansas","6/19/20","5","1","20047","20"
"Ellis","0","14","Kansas","6/19/20","12","2","20051","16.67"
"Ellsworth","0","3","Kansas","6/19/20","3","0","20053","0"
"Finney","1","1546","Kansas","6/19/20","1538","8","20055","0.52"
"Ford","7","1892","Kansas","6/19/20","1842","50","20057","2.71"
"Franklin","1","57","Kansas","6/19/20","49","8","20059","16.33"
"Geary","1","33","Kansas","6/19/20","29","4","20061","13.79"
"Gove","0","1","Kansas","6/19/20","1","0","20063","0"
"Grant","1","22","Kansas","6/19/20","18","4","20067","22.22"
"Gray","0","24","Kansas","6/19/20","23","1","20069","4.35"
"Greenwood","0","11","Kansas","6/19/20","11","0","20073","0"
"Hamilton","0","28","Kansas","6/19/20","27","1","20075","3.7"
"Harper","0","2","Kansas","6/19/20","2","0","20077","0"
"Harvey","0","13","Kansas","6/19/20","12","1","20079","8.33"
"Haskell","0","23","Kansas","6/19/20","22","1","20081","4.55"
"Hodgeman","0","8","Kansas","6/19/20","5","3","20083","60"
"Jackson","0","104","Kansas","6/19/20","102","2","20085","1.96"
"Jefferson","0","22","Kansas","6/19/20","22","0","20087","0"
"Jewell","0","4","Kansas","6/19/20","4","0","20089","0"
"Johnson","26","1197","Kansas","6/19/20","1015","182","20091","17.93"
"Kearny","0","46","Kansas","6/19/20","46","0","20093","0"
"Kiowa","0","3","Kansas","6/19/20","3","0","20097","0"
"Labette","0","28","Kansas","6/19/20","27","1","20099","3.7"
"Lane","0","5","Kansas","6/19/20","4","1","20101","25"
"Leavenworth","2","1122","Kansas","6/19/20","1106","16","20103","1.45"
"Linn","0","12","Kansas","6/19/20","11","1","20107","9.09"
"Lyon","10","476","Kansas","6/19/20","406","70","20111","17.24"
"Marion","0","7","Kansas","6/19/20","5","2","20115","40"
"McPherson","0","41","Kansas","6/19/20","38","3","20113","7.89"
"Meade","0","30","Kansas","6/19/20","30","0","20119","0"
"Miami","1","20","Kansas","6/19/20","16","4","20121","25"
"Mitchell","0","4","Kansas","6/19/20","4","0","20123","0"
"Montgomery","0","25","Kansas","6/19/20","22","3","20125","13.64"
"Morris","0","5","Kansas","6/19/20","5","0","20127","0"
"Morton","0","6","Kansas","6/19/20","6","0","20129","0"
"Nemaha","0","22","Kansas","6/19/20","20","2","20131","10"
"Neosho","2","17","Kansas","6/19/20","6","11","20133","183.33"
"Ness","0","4","Kansas","6/19/20","4","0","20135","0"
"Norton","0","3","Kansas","6/19/20","3","0","20137","0"
"Osage","0","10","Kansas","6/19/20","10","0","20139","0"
"Osborne","0","2","Kansas","6/19/20","2","0","20141","0"
"Ottawa","0","4","Kansas","6/19/20","4","0","20143","0"
"Pawnee","0","3","Kansas","6/19/20","3","0","20145","0"
"Phillips","0","2","Kansas","6/19/20","2","0","20147","0"
"Pottawatomie","1","42","Kansas","6/19/20","32","10","20149","31.25"
"Pratt","1","6","Kansas","6/19/20","2","4","20151","200"
"Reno","1","53","Kansas","6/19/20","48","5","20155","10.42"
"Republic","0","4","Kansas","6/19/20","4","0","20157","0"
"Rice","0","4","Kansas","6/19/20","4","0","20159","0"
"Riley","4","103","Kansas","6/19/20","74","29","20161","39.19"
"Rooks","0","6","Kansas","6/19/20","6","0","20163","0"
"Saline","2","40","Kansas","6/19/20","28","12","20169","42.86"
"Scott","0","16","Kansas","6/19/20","16","0","20171","0"
"Sedgwick","17","846","Kansas","6/19/20","728","118","20173","16.21"
"Seward","4","955","Kansas","6/19/20","924","31","20175","3.35"
"Shawnee","6","477","Kansas","6/19/20","435","42","20177","9.66"
"Sheridan","0","3","Kansas","6/19/20","2","1","20179","50"
"Sherman","0","7","Kansas","6/19/20","7","0","20181","0"
"Smith","0","3","Kansas","6/19/20","2","1","20183","50"
"Stafford","0","1","Kansas","6/19/20","1","0","20185","0"
"Stanton","0","9","Kansas","6/19/20","9","0","20187","0"
"Stevens","0","30","Kansas","6/19/20","31","-1","20189","-3.23"
"Sumner","0","9","Kansas","6/19/20","9","0","20191","0"
"Trego","0","1","Kansas","6/19/20","1","0","20195","0"
"Wabaunsee","0","32","Kansas","6/19/20","31","1","20197","3.23"
"Washington","0","1","Kansas","6/19/20","1","0","20201","0"
"Wilson","0","1","Kansas","6/19/20","1","0","20205","0"
"Woodson","0","6","Kansas","6/19/20","6","0","20207","0"
"Wyandotte","30","1834","Kansas","6/19/20","1626","208","20209","12.79"
"Adair","0","104","Kentucky","6/19/20","101","3","21001","2.97"
"Allen","3","145","Kentucky","6/19/20","127","18","21003","14.17"
"Anderson","0","27","Kentucky","6/19/20","25","2","21005","8"
"Ballard","0","14","Kentucky","6/19/20","14","0","21007","0"
"Barren","1","70","Kentucky","6/19/20","61","9","21009","14.75"
"Bath","0","10","Kentucky","6/19/20","10","0","21011","0"
"Bell","0","4","Kentucky","6/19/20","3","1","21013","33.33"
"Boone","3","561","Kentucky","6/19/20","538","23","21015","4.28"
"Bourbon","1","26","Kentucky","6/19/20","22","4","21017","18.18"
"Boyd","1","47","Kentucky","6/19/20","43","4","21019","9.3"
"Boyle","0","31","Kentucky","6/19/20","28","3","21021","10.71"
"Bracken","0","15","Kentucky","6/19/20","14","1","21023","7.14"
"Breathitt","0","4","Kentucky","6/19/20","3","1","21025","33.33"
"Breckinridge","0","23","Kentucky","6/19/20","21","2","21027","9.52"
"Bullitt","2","141","Kentucky","6/19/20","128","13","21029","10.16"
"Butler","1","247","Kentucky","6/19/20","243","4","21031","1.65"
"Caldwell","0","12","Kentucky","6/19/20","12","0","21033","0"
"Calloway","1","63","Kentucky","6/19/20","57","6","21035","10.53"
"Campbell","3","219","Kentucky","6/19/20","201","18","21037","8.96"
"Carlisle","0","5","Kentucky","6/19/20","5","0","21039","0"
"Carroll","1","26","Kentucky","6/19/20","16","10","21041","62.5"
"Carter","1","21","Kentucky","6/19/20","17","4","21043","23.53"
"Casey","0","11","Kentucky","6/19/20","10","1","21045","10"
"Christian","1","144","Kentucky","6/19/20","137","7","21047","5.11"
"Clark","2","80","Kentucky","6/19/20","68","12","21049","17.65"
"Clay","3","30","Kentucky","6/19/20","12","18","21051","150"
"Clinton","0","5","Kentucky","6/19/20","5","0","21053","0"
"Crittenden","0","7","Kentucky","6/19/20","7","0","21055","0"
"Cumberland","0","5","Kentucky","6/19/20","5","0","21057","0"
"Daviess","3","373","Kentucky","6/19/20","350","23","21059","6.57"
"Edmonson","1","71","Kentucky","6/19/20","63","8","21061","12.7"
"Elliott","0","2","Kentucky","6/19/20","1","1","21063","100"
"Estill","0","5","Kentucky","6/19/20","3","2","21065","66.67"
"Fayette","20","1135","Kentucky","6/19/20","995","140","21067","14.07"
"Fleming","1","12","Kentucky","6/19/20","4","8","21069","200"
"Floyd","1","25","Kentucky","6/19/20","17","8","21071","47.06"
"Franklin","2","108","Kentucky","6/19/20","92","16","21073","17.39"
"Fulton","0","15","Kentucky","6/19/20","12","3","21075","25"
"Gallatin","1","57","Kentucky","6/19/20","51","6","21077","11.76"
"Garrard","1","16","Kentucky","6/19/20","9","7","21079","77.78"
"Grant","0","53","Kentucky","6/19/20","52","1","21081","1.92"
"Graves","2","183","Kentucky","6/19/20","168","15","21083","8.93"
"Grayson","0","137","Kentucky","6/19/20","136","1","21085","0.74"
"Green","0","4","Kentucky","6/19/20","2","2","21087","100"
"Greenup","0","16","Kentucky","6/19/20","14","2","21089","14.29"
"Hancock","0","11","Kentucky","6/19/20","9","2","21091","22.22"
"Hardin","0","135","Kentucky","6/19/20","133","2","21093","1.5"
"Harlan","1","16","Kentucky","6/19/20","8","8","21095","100"
"Harrison","3","54","Kentucky","6/19/20","32","22","21097","68.75"
"Hart","0","33","Kentucky","6/19/20","30","3","21099","10"
"Henderson","3","143","Kentucky","6/19/20","124","19","21101","15.32"
"Henry","0","28","Kentucky","6/19/20","25","3","21103","12"
"Hickman","0","5","Kentucky","6/19/20","5","0","21105","0"
"Hopkins","1","231","Kentucky","6/19/20","225","6","21107","2.67"
"Jackson","3","85","Kentucky","6/19/20","63","22","21109","34.92"
"Jefferson","36","3528","Kentucky","6/19/20","3278","250","21111","7.63"
"Jessamine","2","95","Kentucky","6/19/20","79","16","21113","20.25"
"Johnson","0","8","Kentucky","6/19/20","5","3","21115","60"
"Kenton","4","709","Kentucky","6/19/20","681","28","21117","4.11"
"Knott","0","4","Kentucky","6/19/20","4","0","21119","0"
"Knox","0","13","Kentucky","6/19/20","10","3","21121","30"
"Larue","0","11","Kentucky","6/19/20","11","0","21123","0"
"Laurel","4","52","Kentucky","6/19/20","25","27","21125","108"
"Lawrence","0","5","Kentucky","6/19/20","5","0","21127","0"
"Lee","0","1","Kentucky","6/19/20","1","0","21129","0"
"Leslie","0","7","Kentucky","6/19/20","6","1","21131","16.67"
"Letcher","0","6","Kentucky","6/19/20","3","3","21133","100"
"Lewis","1","16","Kentucky","6/19/20","9","7","21135","77.78"
"Lincoln","0","17","Kentucky","6/19/20","15","2","21137","13.33"
"Livingston","0","8","Kentucky","6/19/20","9","-1","21139","-11.11"
"Logan","2","201","Kentucky","6/19/20","187","14","21141","7.49"
"Lyon","0","18","Kentucky","6/19/20","17","1","21143","5.88"
"Madison","3","91","Kentucky","6/19/20","72","19","21151","26.39"
"Magoffin","0","5","Kentucky","6/19/20","4","1","21153","25"
"Marion","1","45","Kentucky","6/19/20","41","4","21155","9.76"
"Marshall","1","50","Kentucky","6/19/20","41","9","21157","21.95"
"Martin","0","3","Kentucky","6/19/20","3","0","21159","0"
"Mason","0","18","Kentucky","6/19/20","16","2","21161","12.5"
"McCracken","3","134","Kentucky","6/19/20","116","18","21145","15.52"
"McCreary","0","13","Kentucky","6/19/20","13","0","21147","0"
"McLean","0","24","Kentucky","6/19/20","23","1","21149","4.35"
"Meade","0","24","Kentucky","6/19/20","23","1","21163","4.35"
"Menifee","0","10","Kentucky","6/19/20","10","0","21165","0"
"Mercer","0","17","Kentucky","6/19/20","16","1","21167","6.25"
"Metcalfe","0","8","Kentucky","6/19/20","7","1","21169","14.29"
"Monroe","1","32","Kentucky","6/19/20","27","5","21171","18.52"
"Montgomery","1","41","Kentucky","6/19/20","33","8","21173","24.24"
"Morgan","0","7","Kentucky","6/19/20","6","1","21175","16.67"
"Muhlenberg","1","491","Kentucky","6/19/20","482","9","21177","1.87"
"Nelson","0","50","Kentucky","6/19/20","47","3","21179","6.38"
"Nicholas","0","5","Kentucky","6/19/20","4","1","21181","25"
"Ohio","1","171","Kentucky","6/19/20","162","9","21183","5.56"
"Oldham","1","116","Kentucky","6/19/20","112","4","21185","3.57"
"Owen","0","5","Kentucky","6/19/20","4","1","21187","25"
"Owsley","0","2","Kentucky","6/19/20","2","0","21189","0"
"Pendleton","0","14","Kentucky","6/19/20","14","0","21191","0"
"Perry","2","38","Kentucky","6/19/20","23","15","21193","65.22"
"Pike","3","59","Kentucky","6/19/20","38","21","21195","55.26"
"Powell","0","5","Kentucky","6/19/20","4","1","21197","25"
"Pulaski","0","74","Kentucky","6/19/20","71","3","21199","4.23"
"Rockcastle","0","16","Kentucky","6/19/20","14","2","21203","14.29"
"Rowan","1","17","Kentucky","6/19/20","13","4","21205","30.77"
"Russell","0","38","Kentucky","6/19/20","37","1","21207","2.7"
"Scott","3","60","Kentucky","6/19/20","40","20","21209","50"
"Shelby","13","347","Kentucky","6/19/20","256","91","21211","35.55"
"Simpson","1","62","Kentucky","6/19/20","57","5","21213","8.77"
"Spencer","0","28","Kentucky","6/19/20","25","3","21215","12"
"Taylor","1","25","Kentucky","6/19/20","16","9","21217","56.25"
"Todd","0","23","Kentucky","6/19/20","23","0","21219","0"
"Trigg","1","20","Kentucky","6/19/20","16","4","21221","25"
"Trimble","0","4","Kentucky","6/19/20","4","0","21223","0"
"Union","1","24","Kentucky","6/19/20","16","8","21225","50"
"Warren","16","1323","Kentucky","6/19/20","1208","115","21227","9.52"
"Washington","1","17","Kentucky","6/19/20","10","7","21229","70"
"Wayne","0","10","Kentucky","6/19/20","10","0","21231","0"
"Webster","0","37","Kentucky","6/19/20","34","3","21233","8.82"
"Whitley","0","19","Kentucky","6/19/20","17","2","21235","11.76"
"Wolfe","0","2","Kentucky","6/19/20","1","1","21237","100"
"Woodford","2","60","Kentucky","6/19/20","45","15","21239","33.33"
"Acadia","15","639","Louisiana","6/19/20","535","104","22001","19.44"
"Allen","4","223","Louisiana","6/19/20","193","30","22003","15.54"
"Ascension","6","961","Louisiana","6/19/20","918","43","22005","4.68"
"Assumption","9","324","Louisiana","6/19/20","258","66","22007","25.58"
"Avoyelles","3","200","Louisiana","6/19/20","181","19","22009","10.5"
"Beauregard","3","147","Louisiana","6/19/20","127","20","22011","15.75"
"Bienville","4","196","Louisiana","6/19/20","170","26","22013","15.29"
"Bossier","22","643","Louisiana","6/19/20","488","155","22015","31.76"
"Caddo","4","2831","Louisiana","6/19/20","2803","28","22017","1"
"Calcasieu","19","831","Louisiana","6/19/20","701","130","22019","18.54"
"Caldwell","2","93","Louisiana","6/19/20","76","17","22021","22.37"
"Cameron","2","26","Louisiana","6/19/20","11","15","22023","136.36"
"Catahoula","4","151","Louisiana","6/19/20","124","27","22025","21.77"
"Claiborne","5","105","Louisiana","6/19/20","73","32","22027","43.84"
"Concordia","0","100","Louisiana","6/19/20","97","3","22029","3.09"
"De Soto","6","311","Louisiana","6/19/20","269","42","22031","15.61"
"East Baton Rouge","10","4218","Louisiana","6/19/20","4150","68","22033","1.64"
"East Carroll","6","260","Louisiana","6/19/20","216","44","22035","20.37"
"East Feliciana","7","263","Louisiana","6/19/20","216","47","22037","21.76"
"Evangeline","5","120","Louisiana","6/19/20","87","33","22039","37.93"
"Franklin","2","412","Louisiana","6/19/20","395","17","22041","4.3"
"Grant","3","76","Louisiana","6/19/20","54","22","22043","40.74"
"Iberia","3","459","Louisiana","6/19/20","435","24","22045","5.52"
"Iberville","7","662","Louisiana","6/19/20","610","52","22047","8.52"
"Jackson","5","186","Louisiana","6/19/20","154","32","22049","20.78"
"Jefferson","64","8542","Louisiana","6/19/20","8091","451","22051","5.57"
"Jefferson Davis","11","189","Louisiana","6/19/20","114","75","22053","65.79"
"Lafayette","46","1310","Louisiana","6/19/20","988","322","22055","32.59"
"Lafourche","8","998","Louisiana","6/19/20","945","53","22057","5.61"
"LaSalle","2","86","Louisiana","6/19/20","72","14","22059","19.44"
"Lincoln","10","269","Louisiana","6/19/20","202","67","22061","33.17"
"Livingston","18","638","Louisiana","6/19/20","514","124","22063","24.12"
"Madison","5","289","Louisiana","6/19/20","251","38","22065","15.14"
"Morehouse","6","182","Louisiana","6/19/20","138","44","22067","31.88"
"Natchitoches","0","190","Louisiana","6/19/20","188","2","22069","1.06"
"Orleans","18","7448","Louisiana","6/19/20","7319","129","22071","1.76"
"Ouachita","29","1881","Louisiana","6/19/20","1679","202","22073","12.03"
"Plaquemines","2","234","Louisiana","6/19/20","223","11","22075","4.93"
"Pointe Coupee","0","218","Louisiana","6/19/20","217","1","22077","0.46"
"Rapides","27","1290","Louisiana","6/19/20","1098","192","22079","17.49"
"Red River","0","54","Louisiana","6/19/20","52","2","22081","3.85"
"Richland","-2","144","Louisiana","6/19/20","160","-16","22083","-10"
"Sabine","1","63","Louisiana","6/19/20","53","10","22085","18.87"
"St. Bernard","5","598","Louisiana","6/19/20","562","36","22087","6.41"
"St. Charles","4","685","Louisiana","6/19/20","655","30","22089","4.58"
"St. Helena","4","85","Louisiana","6/19/20","56","29","22091","51.79"
"St. James","3","331","Louisiana","6/19/20","308","23","22093","7.47"
"St. John the Baptist","4","917","Louisiana","6/19/20","886","31","22095","3.5"
"St. Landry","18","453","Louisiana","6/19/20","326","127","22097","38.96"
"St. Martin","24","483","Louisiana","6/19/20","316","167","22099","52.85"
"St. Mary","4","373","Louisiana","6/19/20","348","25","22101","7.18"
"St. Tammany","9","1966","Louisiana","6/19/20","1906","60","22103","3.15"
"Tangipahoa","11","1078","Louisiana","6/19/20","1001","77","22105","7.69"
"Tensas","0","24","Louisiana","6/19/20","21","3","22107","14.29"
"Terrebonne","7","826","Louisiana","6/19/20","780","46","22109","5.9"
"Union","-2","372","Louisiana","6/19/20","385","-13","22111","-3.38"
"Vermilion","7","121","Louisiana","6/19/20","69","52","22113","75.36"
"Vernon","4","73","Louisiana","6/19/20","43","30","22115","69.77"
"Washington","7","570","Louisiana","6/19/20","520","50","22117","9.62"
"Webster","15","311","Louisiana","6/19/20","206","105","22119","50.97"
"West Baton Rouge","4","231","Louisiana","6/19/20","200","31","22121","15.5"
"West Carroll","1","103","Louisiana","6/19/20","99","4","22123","4.04"
"West Feliciana","0","226","Louisiana","6/19/20","226","0","22125","0"
"Winn","4","224","Louisiana","6/19/20","197","27","22127","13.71"
"Androscoggin","4","445","Maine","6/19/20","415","30","23001","7.23"
"Aroostook","0","11","Maine","6/19/20","10","1","23003","10"
"Cumberland","18","1516","Maine","6/19/20","1388","128","23005","9.22"
"Franklin","0","38","Maine","6/19/20","37","1","23007","2.7"
"Hancock","0","13","Maine","6/19/20","13","0","23009","0"
"Kennebec","1","138","Maine","6/19/20","134","4","23011","2.99"
"Knox","0","23","Maine","6/19/20","21","2","23013","9.52"
"Lincoln","0","21","Maine","6/19/20","21","0","23015","0"
"Oxford","0","34","Maine","6/19/20","31","3","23017","9.68"
"Penobscot","0","102","Maine","6/19/20","102","0","23019","0"
"Piscataquis","0","1","Maine","6/19/20","1","0","23021","0"
"Sagadahoc","0","30","Maine","6/19/20","30","0","23023","0"
"Somerset","0","26","Maine","6/19/20","25","1","23025","4"
"Waldo","0","55","Maine","6/19/20","55","0","23027","0"
"Washington","0","2","Maine","6/19/20","1","1","23029","100"
"York","3","457","Maine","6/19/20","433","24","23031","5.54"
"Allegany","0","187","Maryland","6/19/20","187","0","24001","0"
"Anne Arundel","58","4862","Maryland","6/19/20","4453","409","24003","9.18"
"Baltimore","50","7403","Maryland","6/19/20","7051","352","24005","4.99"
"Baltimore City","54","6938","Maryland","6/19/20","6559","379","24510","5.78"
"Calvert","3","389","Maryland","6/19/20","370","19","24009","5.14"
"Caroline","1","288","Maryland","6/19/20","279","9","24011","3.23"
"Carroll","7","1028","Maryland","6/19/20","977","51","24013","5.22"
"Cecil","3","459","Maryland","6/19/20","435","24","24015","5.52"
"Charles","7","1294","Maryland","6/19/20","1248","46","24017","3.69"
"Dorchester","2","174","Maryland","6/19/20","160","14","24019","8.75"
"Frederick","19","2361","Maryland","6/19/20","2225","136","24021","6.11"
"Garrett","0","10","Maryland","6/19/20","10","0","24023","0"
"Harford","7","1041","Maryland","6/19/20","991","50","24025","5.05"
"Howard","7","2382","Maryland","6/19/20","2332","50","24027","2.14"
"Kent","1","193","Maryland","6/19/20","189","4","24029","2.12"
"Montgomery","83","13928","Maryland","6/19/20","13348","580","24031","4.35"
"Prince George's","95","17709","Maryland","6/19/20","17042","667","24033","3.91"
"Queen Anne's","3","203","Maryland","6/19/20","179","24","24035","13.41"
"Somerset","1","83","Maryland","6/19/20","78","5","24039","6.41"
"St. Mary's","3","599","Maryland","6/19/20","575","24","24037","4.17"
"Talbot","1","113","Maryland","6/19/20","107","6","24041","5.61"
"Washington","5","601","Maryland","6/19/20","568","33","24043","5.81"
"Wicomico","5","1036","Maryland","6/19/20","1004","32","24045","3.19"
"Worcester","3","267","Maryland","6/19/20","246","21","24047","8.54"
"Barnstable","4","1508","Massachusetts","6/19/20","1479","29","25001","1.96"
"Berkshire","1","585","Massachusetts","6/19/20","575","10","25003","1.74"
"Bristol","19","8002","Massachusetts","6/19/20","7872","130","25005","1.65"
"Dukes and Nantucket","0","57","Massachusetts","6/19/20","55","2","00000","3.64"
"Essex","37","15778","Massachusetts","6/19/20","15518","260","25009","1.68"
"Franklin","1","357","Massachusetts","6/19/20","348","9","25011","2.59"
"Hampden","18","6556","Massachusetts","6/19/20","6431","125","25013","1.94"
"Hampshire","3","941","Massachusetts","6/19/20","918","23","25015","2.51"
"Middlesex","56","23464","Massachusetts","6/19/20","23075","389","25017","1.69"
"Norfolk","17","8962","Massachusetts","6/19/20","8842","120","25021","1.36"
"Plymouth","15","8566","Massachusetts","6/19/20","8462","104","25023","1.23"
"Suffolk","35","19493","Massachusetts","6/19/20","19249","244","25025","1.27"
"Worcester","21","12085","Massachusetts","6/19/20","11937","148","25027","1.24"
"Alcona","0","21","Michigan","6/19/20","20","1","26001","5"
"Alger","0","2","Michigan","6/19/20","1","1","26003","100"
"Allegan","2","292","Michigan","6/19/20","280","12","26005","4.29"
"Alpena","0","115","Michigan","6/19/20","113","2","26007","1.77"
"Antrim","0","14","Michigan","6/19/20","14","0","26009","0"
"Arenac","0","38","Michigan","6/19/20","38","0","26011","0"
"Baraga","0","1","Michigan","6/19/20","1","0","26013","0"
"Barry","0","94","Michigan","6/19/20","91","3","26015","3.3"
"Bay","0","379","Michigan","6/19/20","381","-2","26017","-0.52"
"Benzie","0","5","Michigan","6/19/20","5","0","26019","0"
"Berrien","5","848","Michigan","6/19/20","816","32","26021","3.92"
"Branch","12","247","Michigan","6/19/20","161","86","26023","53.42"
"Calhoun","3","503","Michigan","6/19/20","481","22","26025","4.57"
"Cass","1","119","Michigan","6/19/20","114","5","26027","4.39"
"Charlevoix","0","22","Michigan","6/19/20","20","2","26029","10"
"Cheboygan","0","26","Michigan","6/19/20","26","0","26031","0"
"Chippewa","0","3","Michigan","6/19/20","3","0","26033","0"
"Clare","0","26","Michigan","6/19/20","24","2","26035","8.33"
"Clinton","1","195","Michigan","6/19/20","188","7","26037","3.72"
"Crawford","0","66","Michigan","6/19/20","63","3","26039","4.76"
"Delta","0","21","Michigan","6/19/20","21","0","26041","0"
"Dickinson","0","7","Michigan","6/19/20","7","0","26043","0"
"Eaton","1","265","Michigan","6/19/20","256","9","26045","3.52"
"Emmet","0","26","Michigan","6/19/20","26","0","26047","0"
"Federal Correctional Institution (FCI)","1","168","Michigan","6/19/20","163","5","00000","3.07"
"Genesee","8","2619","Michigan","6/19/20","2566","53","26049","2.07"
"Gladwin","0","23","Michigan","6/19/20","20","3","26051","15"
"Gogebic","0","6","Michigan","6/19/20","5","1","26053","20"
"Grand Traverse","0","38","Michigan","6/19/20","36","2","26055","5.56"
"Gratiot","1","92","Michigan","6/19/20","88","4","26057","4.55"
"Hillsdale","1","183","Michigan","6/19/20","179","4","26059","2.23"
"Houghton","0","8","Michigan","6/19/20","8","0","26061","0"
"Huron","0","60","Michigan","6/19/20","60","0","26063","0"
"Ingham","2","831","Michigan","6/19/20","815","16","26065","1.96"
"Ionia","1","188","Michigan","6/19/20","179","9","26067","5.03"
"Iosco","0","111","Michigan","6/19/20","111","0","26069","0"
"Iron","0","4","Michigan","6/19/20","2","2","26071","100"
"Isabella","2","106","Michigan","6/19/20","95","11","26073","11.58"
"Jackson","1","488","Michigan","6/19/20","484","4","26075","0.83"
"Kalamazoo","5","984","Michigan","6/19/20","949","35","26077","3.69"
"Kalkaska","0","30","Michigan","6/19/20","30","0","26079","0"
"Kent","19","4551","Michigan","6/19/20","4420","131","26081","2.96"
"Keweenaw","0","1","Michigan","6/19/20","1","0","26083","0"
"Lake","0","7","Michigan","6/19/20","7","0","26085","0"
"Lapeer","2","243","Michigan","6/19/20","226","17","26087","7.52"
"Leelanau","0","12","Michigan","6/19/20","12","0","26089","0"
"Lenawee","1","199","Michigan","6/19/20","195","4","26091","2.05"
"Livingston","2","534","Michigan","6/19/20","520","14","26093","2.69"
"Luce","0","3","Michigan","6/19/20","3","0","26095","0"
"Mackinac","0","8","Michigan","6/19/20","8","0","26097","0"
"Macomb","15","7123","Michigan","6/19/20","7016","107","26099","1.53"
"Manistee","0","14","Michigan","6/19/20","12","2","26101","16.67"
"Marquette","0","61","Michigan","6/19/20","59","2","26103","3.39"
"Mason","0","40","Michigan","6/19/20","38","2","26105","5.26"
"Mecosta","0","27","Michigan","6/19/20","24","3","26107","12.5"
"Menominee","0","9","Michigan","6/19/20","9","0","26109","0"
"Michigan Department of Corrections (MDOC)","-11","4078","Michigan","6/19/20","4154","-76","00000","-1.83"
"Midland","2","156","Michigan","6/19/20","145","11","26111","7.59"
"Missaukee","0","24","Michigan","6/19/20","23","1","26113","4.35"
"Monroe","2","575","Michigan","6/19/20","562","13","26115","2.31"
"Montcalm","0","81","Michigan","6/19/20","80","1","26117","1.25"
"Montmorency","0","5","Michigan","6/19/20","5","0","26119","0"
"Muskegon","5","768","Michigan","6/19/20","733","35","26121","4.77"
"Newaygo","1","131","Michigan","6/19/20","125","6","26123","4.8"
"Oakland","28","11485","Michigan","6/19/20","11286","199","26125","1.76"
"Oceana","8","163","Michigan","6/19/20","105","58","26127","55.24"
"Ogemaw","0","32","Michigan","6/19/20","32","0","26129","0"
"Osceola","1","25","Michigan","6/19/20","18","7","26133","38.89"
"Oscoda","0","9","Michigan","6/19/20","8","1","26135","12.5"
"Otsego","0","120","Michigan","6/19/20","120","0","26137","0"
"Ottawa","4","951","Michigan","6/19/20","922","29","26139","3.15"
"Out of MI","1","41","Michigan","6/19/20","36","5","80026","13.89"
"Presque Isle","0","12","Michigan","6/19/20","12","0","26141","0"
"Roscommon","0","26","Michigan","6/19/20","25","1","26143","4"
"Saginaw","5","1182","Michigan","6/19/20","1147","35","26145","3.05"
"Sanilac","0","43","Michigan","6/19/20","43","0","26151","0"
"Schoolcraft","0","4","Michigan","6/19/20","4","0","26153","0"
"Shiawassee","0","265","Michigan","6/19/20","264","1","26155","0.38"
"St. Clair","2","524","Michigan","6/19/20","513","11","26147","2.14"
"St. Joseph","6","210","Michigan","6/19/20","171","39","26149","22.81"
"Tuscola","5","246","Michigan","6/19/20","208","38","26157","18.27"
"Van Buren","2","213","Michigan","6/19/20","200","13","26159","6.5"
"Washtenaw","6","1604","Michigan","6/19/20","1560","44","26161","2.82"
"Wayne","48","21995","Michigan","6/19/20","21660","335","26163","1.55"
"Wexford","0","18","Michigan","6/19/20","15","3","26165","20"
"Aitkin","0","13","Minnesota","6/19/20","13","0","27001","0"
"Anoka","21","1836","Minnesota","6/19/20","1691","145","27003","8.57"
"Becker","0","48","Minnesota","6/19/20","47","1","27005","2.13"
"Beltrami","0","23","Minnesota","6/19/20","21","2","27007","9.52"
"Benton","1","200","Minnesota","6/19/20","190","10","27009","5.26"
"Big Stone","0","14","Minnesota","6/19/20","12","2","27011","16.67"
"Blue Earth","2","174","Minnesota","6/19/20","159","15","27013","9.43"
"Brown","0","21","Minnesota","6/19/20","18","3","27015","16.67"
"Carlton","0","81","Minnesota","6/19/20","80","1","27017","1.25"
"Carver","3","287","Minnesota","6/19/20","268","19","27019","7.09"
"Cass","0","12","Minnesota","6/19/20","11","1","27021","9.09"
"Chippewa","1","64","Minnesota","6/19/20","55","9","27023","16.36"
"Chisago","1","82","Minnesota","6/19/20","77","5","27025","6.49"
"Clay","3","521","Minnesota","6/19/20","503","18","27027","3.58"
"Clearwater","0","6","Minnesota","6/19/20","3","3","27029","100"
"Cook","0","1","Minnesota","6/19/20","0","1","27031","1"
"Cottonwood","2","118","Minnesota","6/19/20","101","17","27033","16.83"
"Crow Wing","1","92","Minnesota","6/19/20","88","4","27035","4.55"
"Dakota","28","1847","Minnesota","6/19/20","1648","199","27037","12.08"
"Dodge","1","62","Minnesota","6/19/20","58","4","27039","6.9"
"Douglas","1","53","Minnesota","6/19/20","49","4","27041","8.16"
"Faribault","1","30","Minnesota","6/19/20","25","5","27043","20"
"Fillmore","0","21","Minnesota","6/19/20","20","1","27045","5"
"Freeborn","4","243","Minnesota","6/19/20","217","26","27047","11.98"
"Goodhue","1","101","Minnesota","6/19/20","92","9","27049","9.78"
"Grant","0","6","Minnesota","6/19/20","6","0","27051","0"
"Hennepin","96","10607","Minnesota","6/19/20","9934","673","27053","6.77"
"Houston","0","7","Minnesota","6/19/20","5","2","27055","40"
"Hubbard","0","5","Minnesota","6/19/20","5","0","27057","0"
"Isanti","1","52","Minnesota","6/19/20","48","4","27059","8.33"
"Itasca","0","59","Minnesota","6/19/20","58","1","27061","1.72"
"Jackson","1","50","Minnesota","6/19/20","43","7","27063","16.28"
"Kanabec","0","13","Minnesota","6/19/20","13","0","27065","0"
"Kandiyohi","2","554","Minnesota","6/19/20","541","13","27067","2.4"
"Kittson","0","1","Minnesota","6/19/20","1","0","27069","0"
"Koochiching","0","9","Minnesota","6/19/20","9","0","27071","0"
"Lac qui Parle","0","4","Minnesota","6/19/20","3","1","27073","33.33"
"Lake","0","4","Minnesota","6/19/20","1","3","27075","300"
"Le Sueur","0","54","Minnesota","6/19/20","51","3","27079","5.88"
"Lincoln","0","6","Minnesota","6/19/20","6","0","27081","0"
"Lyon","11","258","Minnesota","6/19/20","183","75","27083","40.98"
"Mahnomen","0","6","Minnesota","6/19/20","6","0","27087","0"
"Marshall","0","12","Minnesota","6/19/20","12","0","27089","0"
"Martin","1","147","Minnesota","6/19/20","143","4","27091","2.8"
"McLeod","2","64","Minnesota","6/19/20","52","12","27085","23.08"
"Meeker","0","51","Minnesota","6/19/20","49","2","27093","4.08"
"Mille Lacs","0","29","Minnesota","6/19/20","26","3","27095","11.54"
"Morrison","0","54","Minnesota","6/19/20","54","0","27097","0"
"Mower","17","755","Minnesota","6/19/20","638","117","27099","18.34"
"Murray","1","47","Minnesota","6/19/20","42","5","27101","11.9"
"Nicollet","1","105","Minnesota","6/19/20","95","10","27103","10.53"
"Nobles","3","1628","Minnesota","6/19/20","1607","21","27105","1.31"
"Norman","0","18","Minnesota","6/19/20","17","1","27107","5.88"
"Olmsted","12","846","Minnesota","6/19/20","765","81","27109","10.59"
"Otter Tail","0","83","Minnesota","6/19/20","80","3","27111","3.75"
"Pennington","0","50","Minnesota","6/19/20","50","0","27113","0"
"Pine","0","96","Minnesota","6/19/20","95","1","27115","1.05"
"Pipestone","0","14","Minnesota","6/19/20","15","-1","27117","-6.67"
"Polk","0","67","Minnesota","6/19/20","67","0","27119","0"
"Pope","0","10","Minnesota","6/19/20","10","0","27121","0"
"Ramsey","52","4180","Minnesota","6/19/20","3813","367","27123","9.62"
"Red Lake","0","3","Minnesota","6/19/20","4","-1","27125","-25"
"Redwood","0","12","Minnesota","6/19/20","10","2","27127","20"
"Renville","0","12","Minnesota","6/19/20","9","3","27129","33.33"
"Rice","8","740","Minnesota","6/19/20","685","55","27131","8.03"
"Rock","0","26","Minnesota","6/19/20","23","3","27133","13.04"
"Roseau","0","6","Minnesota","6/19/20","6","0","27135","0"
"Scott","4","555","Minnesota","6/19/20","525","30","27139","5.71"
"Sherburne","1","272","Minnesota","6/19/20","262","10","27141","3.82"
"Sibley","0","28","Minnesota","6/19/20","25","3","27143","12"
"St. Louis","1","132","Minnesota","6/19/20","123","9","27137","7.32"
"Stearns","4","2126","Minnesota","6/19/20","2096","30","27145","1.43"
"Steele","1","183","Minnesota","6/19/20","175","8","27147","4.57"
"Stevens","0","2","Minnesota","6/19/20","1","1","27149","100"
"Swift","0","20","Minnesota","6/19/20","19","1","27151","5.26"
"Todd","2","386","Minnesota","6/19/20","371","15","27153","4.04"
"Traverse","0","5","Minnesota","6/19/20","5","0","27155","0"
"Wabasha","1","27","Minnesota","6/19/20","21","6","27157","28.57"
"Wadena","0","10","Minnesota","6/19/20","10","0","27159","0"
"Waseca","0","36","Minnesota","6/19/20","33","3","27161","9.09"
"Washington","11","843","Minnesota","6/19/20","766","77","27163","10.05"
"Watonwan","5","128","Minnesota","6/19/20","96","32","27165","33.33"
"Wilkin","1","20","Minnesota","6/19/20","12","8","27167","66.67"
"Winona","1","93","Minnesota","6/19/20","84","9","27169","10.71"
"Wright","3","394","Minnesota","6/19/20","372","22","27171","5.91"
"Yellow Medicine","1","14","Minnesota","6/19/20","8","6","27173","75"
"Adams","0","227","Mississippi","6/19/20","225","2","28001","0.89"
"Alcorn","1","32","Mississippi","6/19/20","28","4","28003","14.29"
"Amite","1","73","Mississippi","6/19/20","67","6","28005","8.96"
"Attala","1","335","Mississippi","6/19/20","328","7","28007","2.13"
"Benton","0","18","Mississippi","6/19/20","17","1","28009","5.88"
"Bolivar","2","197","Mississippi","6/19/20","185","12","28011","6.49"
"Calhoun","1","83","Mississippi","6/19/20","77","6","28013","7.79"
"Carroll","0","122","Mississippi","6/19/20","122","0","28015","0"
"Chickasaw","2","177","Mississippi","6/19/20","163","14","28017","8.59"
"Choctaw","1","71","Mississippi","6/19/20","62","9","28019","14.52"
"Claiborne","1","144","Mississippi","6/19/20","138","6","28021","4.35"
"Clarke","0","168","Mississippi","6/19/20","165","3","28023","1.82"
"Clay","2","185","Mississippi","6/19/20","169","16","28025","9.47"
"Coahoma","2","156","Mississippi","6/19/20","145","11","28027","7.59"
"Copiah","5","425","Mississippi","6/19/20","388","37","28029","9.54"
"Covington","2","213","Mississippi","6/19/20","201","12","28031","5.97"
"DeSoto","14","790","Mississippi","6/19/20","694","96","28033","13.83"
"Forrest","4","697","Mississippi","6/19/20","672","25","28035","3.72"
"Franklin","0","30","Mississippi","6/19/20","30","0","28037","0"
"George","1","41","Mississippi","6/19/20","35","6","28039","17.14"
"Greene","1","56","Mississippi","6/19/20","49","7","28041","14.29"
"Grenada","2","170","Mississippi","6/19/20","153","17","28043","11.11"
"Hancock","0","100","Mississippi","6/19/20","98","2","28045","2.04"
"Harrison","11","393","Mississippi","6/19/20","319","74","28047","23.2"
"Hinds","21","1390","Mississippi","6/19/20","1245","145","28049","11.65"
"Holmes","2","477","Mississippi","6/19/20","463","14","28051","3.02"
"Humphreys","0","83","Mississippi","6/19/20","80","3","28053","3.75"
"Itawamba","1","106","Mississippi","6/19/20","99","7","28057","7.07"
"Jackson","6","385","Mississippi","6/19/20","344","41","28059","11.92"
"Jasper","2","203","Mississippi","6/19/20","190","13","28061","6.84"
"Jefferson","1","57","Mississippi","6/19/20","52","5","28063","9.62"
"Jefferson Davis","0","86","Mississippi","6/19/20","84","2","28065","2.38"
"Jones","9","910","Mississippi","6/19/20","845","65","28067","7.69"
"Kemper","0","169","Mississippi","6/19/20","167","2","28069","1.2"
"Lafayette","6","209","Mississippi","6/19/20","169","40","28071","23.67"
"Lamar","2","300","Mississippi","6/19/20","287","13","28073","4.53"
"Lauderdale","2","818","Mississippi","6/19/20","801","17","28075","2.12"
"Lawrence","1","121","Mississippi","6/19/20","115","6","28077","5.22"
"Leake","3","496","Mississippi","6/19/20","478","18","28079","3.77"
"Lee","6","330","Mississippi","6/19/20","287","43","28081","14.98"
"Leflore","5","385","Mississippi","6/19/20","350","35","28083","10"
"Lincoln","2","330","Mississippi","6/19/20","316","14","28085","4.43"
"Lowndes","6","352","Mississippi","6/19/20","311","41","28087","13.18"
"Madison","8","922","Mississippi","6/19/20","864","58","28089","6.71"
"Marion","4","163","Mississippi","6/19/20","137","26","28091","18.98"
"Marshall","3","122","Mississippi","6/19/20","98","24","28093","24.49"
"Monroe","1","301","Mississippi","6/19/20","291","10","28095","3.44"
"Montgomery","1","98","Mississippi","6/19/20","93","5","28097","5.38"
"Neshoba","9","921","Mississippi","6/19/20","855","66","28099","7.72"
"Newton","1","325","Mississippi","6/19/20","320","5","28101","1.56"
"Noxubee","1","218","Mississippi","6/19/20","212","6","28103","2.83"
"Oktibbeha","5","386","Mississippi","6/19/20","348","38","28105","10.92"
"Panola","4","146","Mississippi","6/19/20","118","28","28107","23.73"
"Pearl River","1","224","Mississippi","6/19/20","219","5","28109","2.28"
"Perry","0","55","Mississippi","6/19/20","53","2","28111","3.77"
"Pike","4","248","Mississippi","6/19/20","220","28","28113","12.73"
"Pontotoc","3","93","Mississippi","6/19/20","70","23","28115","32.86"
"Prentiss","1","70","Mississippi","6/19/20","65","5","28117","7.69"
"Quitman","2","52","Mississippi","6/19/20","39","13","28119","33.33"
"Rankin","5","563","Mississippi","6/19/20","529","34","28121","6.43"
"Scott","2","696","Mississippi","6/19/20","685","11","28123","1.61"
"Sharkey","0","9","Mississippi","6/19/20","8","1","28125","12.5"
"Simpson","1","126","Mississippi","6/19/20","117","9","28127","7.69"
"Smith","1","182","Mississippi","6/19/20","173","9","28129","5.2"
"Stone","0","35","Mississippi","6/19/20","34","1","28131","2.94"
"Sunflower","2","128","Mississippi","6/19/20","113","15","28133","13.27"
"Tallahatchie","1","49","Mississippi","6/19/20","39","10","28135","25.64"
"Tate","5","155","Mississippi","6/19/20","123","32","28137","26.02"
"Tippah","1","100","Mississippi","6/19/20","92","8","28139","8.7"
"Tishomingo","0","47","Mississippi","6/19/20","44","3","28141","6.82"
"Tunica","1","67","Mississippi","6/19/20","62","5","28143","8.06"
"Union","2","109","Mississippi","6/19/20","96","13","28145","13.54"
"Walthall","2","111","Mississippi","6/19/20","97","14","28147","14.43"
"Warren","5","280","Mississippi","6/19/20","245","35","28149","14.29"
"Washington","6","276","Mississippi","6/19/20","236","40","28151","16.95"
"Wayne","5","409","Mississippi","6/19/20","373","36","28153","9.65"
"Webster","0","109","Mississippi","6/19/20","109","0","28155","0"
"Wilkinson","0","85","Mississippi","6/19/20","85","0","28157","0"
"Winston","2","158","Mississippi","6/19/20","143","15","28159","10.49"
"Yalobusha","0","139","Mississippi","6/19/20","136","3","28161","2.21"
"Yazoo","2","354","Mississippi","6/19/20","337","17","28163","5.04"
"Adair","1","85","Missouri","6/19/20","75","10","29001","13.33"
"Andrew","1","39","Missouri","6/19/20","34","5","29003","14.71"
"Atchison","0","3","Missouri","6/19/20","3","0","29005","0"
"Audrain","2","133","Missouri","6/19/20","122","11","29007","9.02"
"Barry","3","28","Missouri","6/19/20","9","19","29009","211.11"
"Barton","2","15","Missouri","6/19/20","1","14","29011","1400"
"Bates","0","12","Missouri","6/19/20","12","0","29013","0"
"Benton","0","14","Missouri","6/19/20","14","0","29015","0"
"Bollinger","0","11","Missouri","6/19/20","8","3","29017","37.5"
"Boone","6","246","Missouri","6/19/20","204","42","29019","20.59"
"Buchanan","4","802","Missouri","6/19/20","772","30","29021","3.89"
"Butler","3","59","Missouri","6/19/20","40","19","29023","47.5"
"Caldwell","0","8","Missouri","6/19/20","7","1","29025","14.29"
"Callaway","1","42","Missouri","6/19/20","34","8","29027","23.53"
"Camden","1","45","Missouri","6/19/20","38","7","29029","18.42"
"Cape Girardeau","2","117","Missouri","6/19/20","101","16","29031","15.84"
"Carroll","0","11","Missouri","6/19/20","9","2","29033","22.22"
"Carter","0","6","Missouri","6/19/20","5","1","29035","20"
"Cass","0","112","Missouri","6/19/20","111","1","29037","0.9"
"Cedar","0","9","Missouri","6/19/20","9","0","29039","0"
"Chariton","0","6","Missouri","6/19/20","6","0","29041","0"
"Christian","0","31","Missouri","6/19/20","29","2","29043","6.9"
"Clark","0","1","Missouri","6/19/20","1","0","29045","0"
"Clay","7","334","Missouri","6/19/20","284","50","29047","17.61"
"Clinton","0","22","Missouri","6/19/20","19","3","29049","15.79"
"Cole","0","58","Missouri","6/19/20","57","1","29051","1.75"
"Cooper","0","12","Missouri","6/19/20","9","3","29053","33.33"
"Crawford","0","10","Missouri","6/19/20","8","2","29055","25"
"Dade","0","1","Missouri","6/19/20","0","1","29057","1"
"Dallas","0","9","Missouri","6/19/20","6","3","29059","50"
"Daviess","0","7","Missouri","6/19/20","7","0","29061","0"
"DeKalb","0","10","Missouri","6/19/20","7","3","29063","42.86"
"Dent","0","1","Missouri","6/19/20","1","0","29065","0"
"Douglas","0","3","Missouri","6/19/20","3","0","29067","0"
"Dunklin","2","66","Missouri","6/19/20","54","12","29069","22.22"
"Franklin","2","180","Missouri","6/19/20","166","14","29071","8.43"
"Gasconade","0","3","Missouri","6/19/20","2","1","29073","50"
"Gentry","0","54","Missouri","6/19/20","54","0","29075","0"
"Greene","4","214","Missouri","6/19/20","185","29","29077","15.68"
"Grundy","1","16","Missouri","6/19/20","8","8","29079","100"
"Harrison","0","9","Missouri","6/19/20","9","0","29081","0"
"Henry","0","17","Missouri","6/19/20","16","1","29083","6.25"
"Holt","0","1","Missouri","6/19/20","1","0","29087","0"
"Howard","0","3","Missouri","6/19/20","3","0","29089","0"
"Howell","2","31","Missouri","6/19/20","19","12","29091","63.16"
"Iron","0","2","Missouri","6/19/20","2","0","29093","0"
"Jackson","26","976","Missouri","6/19/20","791","185","29095","23.39"
"Jasper","13","196","Missouri","6/19/20","107","89","29097","83.18"
"Jefferson","2","391","Missouri","6/19/20","374","17","29099","4.55"
"Johnson","2","90","Missouri","6/19/20","79","11","29101","13.92"
"Kansas City","27","1872","Missouri","6/19/20","1680","192","00000","11.43"
"Knox","0","2","Missouri","6/19/20","2","0","29103","0"
"Laclede","0","12","Missouri","6/19/20","9","3","29105","33.33"
"Lafayette","0","86","Missouri","6/19/20","84","2","29107","2.38"
"Lawrence","1","11","Missouri","6/19/20","7","4","29109","57.14"
"Lewis","0","7","Missouri","6/19/20","7","0","29111","0"
"Lincoln","0","91","Missouri","6/19/20","88","3","29113","3.41"
"Linn","0","13","Missouri","6/19/20","11","2","29115","18.18"
"Livingston","0","6","Missouri","6/19/20","4","2","29117","50"
"Macon","0","7","Missouri","6/19/20","6","1","29121","16.67"
"Madison","0","3","Missouri","6/19/20","3","0","29123","0"
"Maries","0","2","Missouri","6/19/20","2","0","29125","0"
"Marion","0","10","Missouri","6/19/20","7","3","29127","42.86"
"McDonald","10","132","Missouri","6/19/20","63","69","29119","109.52"
"Mercer","0","5","Missouri","6/19/20","5","0","29129","0"
"Miller","1","8","Missouri","6/19/20","4","4","29131","100"
"Mississippi","1","77","Missouri","6/19/20","70","7","29133","10"
"Moniteau","0","49","Missouri","6/19/20","49","0","29135","0"
"Monroe","0","4","Missouri","6/19/20","3","1","29137","33.33"
"Montgomery","0","13","Missouri","6/19/20","12","1","29139","8.33"
"Morgan","0","12","Missouri","6/19/20","9","3","29141","33.33"
"New Madrid","0","34","Missouri","6/19/20","32","2","29143","6.25"
"Newton","11","123","Missouri","6/19/20","49","74","29145","151.02"
"Nodaway","0","17","Missouri","6/19/20","15","2","29147","13.33"
"Oregon","0","6","Missouri","6/19/20","3","3","29149","100"
"Osage","0","5","Missouri","6/19/20","5","0","29151","0"
"Pemiscot","1","105","Missouri","6/19/20","99","6","29155","6.06"
"Perry","1","88","Missouri","6/19/20","80","8","29157","10"
"Pettis","2","95","Missouri","6/19/20","84","11","29159","13.1"
"Phelps","0","6","Missouri","6/19/20","6","0","29161","0"
"Pike","0","33","Missouri","6/19/20","31","2","29163","6.45"
"Platte","2","102","Missouri","6/19/20","89","13","29165","14.61"
"Polk","0","10","Missouri","6/19/20","7","3","29167","42.86"
"Pulaski","0","106","Missouri","6/19/20","106","0","29169","0"
"Putnam","0","2","Missouri","6/19/20","1","1","29171","100"
"Ralls","0","5","Missouri","6/19/20","5","0","29173","0"
"Randolph","0","12","Missouri","6/19/20","10","2","29175","20"
"Ray","0","25","Missouri","6/19/20","24","1","29177","4.17"
"Reynolds","0","2","Missouri","6/19/20","2","0","29179","0"
"Ripley","0","12","Missouri","6/19/20","12","0","29181","0"
"Saline","1","278","Missouri","6/19/20","270","8","29195","2.96"
"Schuyler","0","2","Missouri","6/19/20","1","1","29197","100"
"Scotland","0","8","Missouri","6/19/20","8","0","29199","0"
"Scott","3","155","Missouri","6/19/20","134","21","29201","15.67"
"Shannon","0","6","Missouri","6/19/20","6","0","29203","0"
"Shelby","0","2","Missouri","6/19/20","1","1","29205","100"
"St. Charles","9","943","Missouri","6/19/20","882","61","29183","6.92"
"St. Clair","0","2","Missouri","6/19/20","2","0","29185","0"
"St. Francois","1","50","Missouri","6/19/20","40","10","29187","25"
"St. Louis","44","5769","Missouri","6/19/20","5460","309","29189","5.66"
"St. Louis City","20","2319","Missouri","6/19/20","2179","140","29510","6.42"
"Ste. Genevieve","0","14","Missouri","6/19/20","13","1","29186","7.69"
"Stoddard","2","127","Missouri","6/19/20","113","14","29207","12.39"
"Stone","0","10","Missouri","6/19/20","7","3","29209","42.86"
"Sullivan","3","93","Missouri","6/19/20","72","21","29211","29.17"
"Taney","2","30","Missouri","6/19/20","15","15","29213","100"
"Texas","0","1","Missouri","6/19/20","1","0","29215","0"
"Vernon","0","12","Missouri","6/19/20","12","0","29217","0"
"Warren","0","32","Missouri","6/19/20","31","1","29219","3.23"
"Washington","0","14","Missouri","6/19/20","13","1","29221","7.69"
"Webster","0","20","Missouri","6/19/20","18","2","29225","11.11"
"Worth","0","4","Missouri","6/19/20","4","0","29227","0"
"Wright","0","14","Missouri","6/19/20","14","0","29229","0"
"Beaverhead","0","1","Montana","6/19/20","1","0","30001","0"
"Big Horn","1","53","Montana","6/19/20","43","10","30003","23.26"
"Broadwater","0","4","Montana","6/19/20","4","0","30007","0"
"Carbon","1","10","Montana","6/19/20","6","4","30009","66.67"
"Cascade","0","20","Montana","6/19/20","17","3","30013","17.65"
"Custer","3","20","Montana","6/19/20","1","19","30017","1900"
"Deer Lodge","0","3","Montana","6/19/20","3","0","30023","0"
"Fergus","0","2","Montana","6/19/20","0","2","30027","1"
"Flathead","1","45","Montana","6/19/20","37","8","30029","21.62"
"Gallatin","2","197","Montana","6/19/20","182","15","30031","8.24"
"Glacier","0","6","Montana","6/19/20","6","0","30035","0"
"Golden Valley","0","3","Montana","6/19/20","3","0","30037","0"
"Hill","0","1","Montana","6/19/20","1","0","30041","0"
"Jefferson","0","3","Montana","6/19/20","3","0","30043","0"
"Lake","1","10","Montana","6/19/20","6","4","30047","66.67"
"Lewis and Clark","0","22","Montana","6/19/20","19","3","30049","15.79"
"Liberty","0","1","Montana","6/19/20","1","0","30051","0"
"Lincoln","0","7","Montana","6/19/20","7","0","30053","0"
"Madison","0","8","Montana","6/19/20","8","0","30057","0"
"Meagher","0","1","Montana","6/19/20","1","0","30059","0"
"Missoula","1","46","Montana","6/19/20","39","7","30063","17.95"
"Musselshell","0","1","Montana","6/19/20","1","0","30065","0"
"Park","0","8","Montana","6/19/20","8","0","30067","0"
"Pondera","0","2","Montana","6/19/20","2","0","30073","0"
"Ravalli","0","17","Montana","6/19/20","14","3","30081","21.43"
"Richland","0","5","Montana","6/19/20","3","2","30083","66.67"
"Roosevelt","0","7","Montana","6/19/20","7","0","30085","0"
"Rosebud","0","3","Montana","6/19/20","1","2","30087","200"
"Silver Bow","0","11","Montana","6/19/20","11","0","30093","0"
"Stillwater","0","3","Montana","6/19/20","2","1","30095","50"
"Toole","0","29","Montana","6/19/20","29","0","30101","0"
"Valley","0","1","Montana","6/19/20","0","1","30105","1"
"Wheatland","0","1","Montana","6/19/20","1","0","30107","0"
"Yellowstone","1","115","Montana","6/19/20","106","9","30111","8.49"
"Adams","0","280","Nebraska","6/19/20","278","2","31001","0.72"
"Antelope","0","8","Nebraska","6/19/20","8","0","31003","0"
"Banner","0","1","Nebraska","6/19/20","1","0","31007","0"
"Boone","0","7","Nebraska","6/19/20","7","0","31011","0"
"Box Butte","0","3","Nebraska","6/19/20","3","0","31013","0"
"Boyd","0","1","Nebraska","6/19/20","1","0","31015","0"
"Buffalo","0","178","Nebraska","6/19/20","177","1","31019","0.56"
"Burt","0","11","Nebraska","6/19/20","9","2","31021","22.22"
"Butler","0","51","Nebraska","6/19/20","51","0","31023","0"
"Cass","0","60","Nebraska","6/19/20","59","1","31025","1.69"
"Cedar","0","9","Nebraska","6/19/20","8","1","31027","12.5"
"Chase","0","1","Nebraska","6/19/20","1","0","31029","0"
"Cherry","0","1","Nebraska","6/19/20","1","0","31031","0"
"Cheyenne","0","13","Nebraska","6/19/20","10","3","31033","30"
"Clay","0","25","Nebraska","6/19/20","24","1","31035","4.17"
"Colfax","1","655","Nebraska","6/19/20","646","9","31037","1.39"
"Cuming","0","34","Nebraska","6/19/20","34","0","31039","0"
"Custer","0","34","Nebraska","6/19/20","34","0","31041","0"
"Dakota","3","1737","Nebraska","6/19/20","1719","18","31043","1.05"
"Dawes","0","2","Nebraska","6/19/20","1","1","31045","100"
"Dawson","1","848","Nebraska","6/19/20","844","4","31047","0.47"
"Dixon","0","40","Nebraska","6/19/20","38","2","31051","5.26"
"Dodge","5","652","Nebraska","6/19/20","616","36","31053","5.84"
"Douglas","90","6169","Nebraska","6/19/20","5540","629","31055","11.35"
"Fillmore","1","13","Nebraska","6/19/20","9","4","31059","44.44"
"Franklin","0","6","Nebraska","6/19/20","6","0","31061","0"
"Frontier","0","1","Nebraska","6/19/20","1","0","31063","0"
"Furnas","0","9","Nebraska","6/19/20","9","0","31065","0"
"Gage","0","46","Nebraska","6/19/20","45","1","31067","2.22"
"Garden","0","4","Nebraska","6/19/20","4","0","31069","0"
"Garfield","0","1","Nebraska","6/19/20","1","0","31071","0"
"Gosper","0","13","Nebraska","6/19/20","13","0","31073","0"
"Greeley","0","3","Nebraska","6/19/20","3","0","31077","0"
"Hall","2","1571","Nebraska","6/19/20","1560","11","31079","0.71"
"Hamilton","0","57","Nebraska","6/19/20","56","1","31081","1.79"
"Hitchcock","0","1","Nebraska","6/19/20","1","0","31087","0"
"Holt","0","1","Nebraska","6/19/20","1","0","31089","0"
"Howard","0","44","Nebraska","6/19/20","44","0","31093","0"
"Jefferson","0","9","Nebraska","6/19/20","9","0","31095","0"
"Johnson","0","6","Nebraska","6/19/20","6","0","31097","0"
"Kearney","0","12","Nebraska","6/19/20","12","0","31099","0"
"Keith","0","2","Nebraska","6/19/20","2","0","31101","0"
"Kimball","0","8","Nebraska","6/19/20","8","0","31105","0"
"Knox","1","16","Nebraska","6/19/20","11","5","31107","45.45"
"Lancaster","20","1586","Nebraska","6/19/20","1445","141","31109","9.76"
"Lincoln","0","54","Nebraska","6/19/20","52","2","31111","3.85"
"Madison","2","344","Nebraska","6/19/20","331","13","31119","3.93"
"Merrick","0","37","Nebraska","6/19/20","37","0","31121","0"
"Morrill","0","14","Nebraska","6/19/20","12","2","31123","16.67"
"Nance","0","4","Nebraska","6/19/20","4","0","31125","0"
"Nemaha","0","5","Nebraska","6/19/20","4","1","31127","25"
"Nuckolls","0","1","Nebraska","6/19/20","1","0","31129","0"
"Otoe","0","14","Nebraska","6/19/20","12","2","31131","16.67"
"Phelps","0","21","Nebraska","6/19/20","20","1","31137","5"
"Pierce","0","6","Nebraska","6/19/20","6","0","31139","0"
"Platte","2","652","Nebraska","6/19/20","639","13","31141","2.03"
"Polk","0","12","Nebraska","6/19/20","12","0","31143","0"
"Red Willow","0","6","Nebraska","6/19/20","5","1","31145","20"
"Richardson","1","5","Nebraska","6/19/20","1","4","31147","400"
"Saline","1","525","Nebraska","6/19/20","518","7","31151","1.35"
"Sarpy","16","982","Nebraska","6/19/20","868","114","31153","13.13"
"Saunders","1","60","Nebraska","6/19/20","56","4","31155","7.14"
"Scotts Bluff","2","187","Nebraska","6/19/20","170","17","31157","10"
"Seward","0","32","Nebraska","6/19/20","31","1","31159","3.23"
"Sherman","0","5","Nebraska","6/19/20","4","1","31163","25"
"Sioux","0","1","Nebraska","6/19/20","2","-1","31165","-50"
"Stanton","0","21","Nebraska","6/19/20","21","0","31167","0"
"Thayer","0","1","Nebraska","6/19/20","1","0","31169","0"
"Thomas","0","1","Nebraska","6/19/20","1","0","31171","0"
"Thurston","1","72","Nebraska","6/19/20","63","9","31173","14.29"
"Valley","0","7","Nebraska","6/19/20","7","0","31175","0"
"Washington","1","43","Nebraska","6/19/20","39","4","31177","10.26"
"Wayne","0","26","Nebraska","6/19/20","26","0","31179","0"
"Webster","0","6","Nebraska","6/19/20","6","0","31181","0"
"York","0","39","Nebraska","6/19/20","37","2","31185","5.41"
"Carson City","2","126","Nevada","6/19/20","115","11","32510","9.57"
"Churchill","0","10","Nevada","6/19/20","10","0","32001","0"
"Clark","220","9852","Nevada","6/19/20","8314","1538","32003","18.5"
"Douglas","1","49","Nevada","6/19/20","39","10","32005","25.64"
"Elko","3","56","Nevada","6/19/20","37","19","32007","51.35"
"Humboldt","0","79","Nevada","6/19/20","78","1","32013","1.28"
"Lander","1","26","Nevada","6/19/20","22","4","32015","18.18"
"Lincoln","0","2","Nevada","6/19/20","2","0","32017","0"
"Lyon","1","98","Nevada","6/19/20","91","7","32019","7.69"
"Mineral","0","4","Nevada","6/19/20","4","0","32021","0"
"Nye","1","76","Nevada","6/19/20","69","7","32023","10.14"
"Pershing","0","5","Nevada","6/19/20","5","0","32027","0"
"Storey","0","1","Nevada","6/19/20","1","0","32029","0"
"Washoe","32","2137","Nevada","6/19/20","1914","223","32031","11.65"
"White Pine","0","3","Nevada","6/19/20","3","0","32033","0"
"Belknap","1","77","New Hampshire","6/19/20","73","4","33001","5.48"
"Carroll","0","51","New Hampshire","6/19/20","49","2","33003","4.08"
"Cheshire","0","63","New Hampshire","6/19/20","60","3","33005","5"
"Coos","0","6","New Hampshire","6/19/20","6","0","33007","0"
"Grafton","0","76","New Hampshire","6/19/20","76","0","33009","0"
"Hillsborough","29","3087","New Hampshire","6/19/20","2883","204","33011","7.08"
"Merrimack","0","393","New Hampshire","6/19/20","390","3","33013","0.77"
"Rockingham","3","1427","New Hampshire","6/19/20","1406","21","33015","1.49"
"Strafford","0","281","New Hampshire","6/19/20","278","3","33017","1.08"
"Sullivan","0","24","New Hampshire","6/19/20","25","-1","33019","-4"
"Atlantic","24","2619","New Jersey","6/19/20","2453","166","34001","6.77"
"Bergen","32","18967","New Jersey","6/19/20","18743","224","34003","1.2"
"Burlington","19","4981","New Jersey","6/19/20","4848","133","34005","2.74"
"Camden","19","7088","New Jersey","6/19/20","6952","136","34007","1.96"
"Cape May","2","681","New Jersey","6/19/20","664","17","34009","2.56"
"Cumberland","17","2767","New Jersey","6/19/20","2645","122","34011","4.61"
"Essex","34","18533","New Jersey","6/19/20","18295","238","34013","1.3"
"Gloucester","10","2451","New Jersey","6/19/20","2379","72","34015","3.03"
"Hudson","15","19257","New Jersey","6/19/20","19149","108","34017","0.56"
"Hunterdon","2","1050","New Jersey","6/19/20","1034","16","34019","1.55"
"Mercer","24","7463","New Jersey","6/19/20","7295","168","34021","2.3"
"Middlesex","30","16563","New Jersey","6/19/20","16353","210","34023","1.28"
"Monmouth","31","8876","New Jersey","6/19/20","8660","216","34025","2.49"
"Morris","18","6679","New Jersey","6/19/20","6556","123","34027","1.88"
"Ocean","26","9382","New Jersey","6/19/20","9200","182","34029","1.98"
"Passaic","21","16725","New Jersey","6/19/20","16581","144","34031","0.87"
"Salem","7","745","New Jersey","6/19/20","699","46","34033","6.58"
"Somerset","9","4796","New Jersey","6/19/20","4736","60","34035","1.27"
"Sussex","5","1213","New Jersey","6/19/20","1179","34","34037","2.88"
"Union","-9","16291","New Jersey","6/19/20","16351","-60","34039","-0.37"
"Warren","1","1209","New Jersey","6/19/20","1200","9","34041","0.75"
"Bernalillo","15","1777","New Mexico","6/19/20","1669","108","35001","6.47"
"Catron","0","2","New Mexico","6/19/20","2","0","35003","0"
"Chaves","2","64","New Mexico","6/19/20","53","11","35005","20.75"
"Cibola","2","194","New Mexico","6/19/20","180","14","35006","7.78"
"Colfax","0","8","New Mexico","6/19/20","5","3","35007","60"
"Curry","4","101","New Mexico","6/19/20","71","30","35009","42.25"
"Dona Ana","8","692","New Mexico","6/19/20","637","55","35013","8.63"
"Eddy","0","49","New Mexico","6/19/20","46","3","35015","6.52"
"Grant","0","16","New Mexico","6/19/20","17","-1","35017","-5.88"
"Guadalupe","0","20","New Mexico","6/19/20","20","0","35019","0"
"Harding","0","1","New Mexico","6/19/20","1","0","35021","0"
"Hidalgo","3","26","New Mexico","6/19/20","2","24","35023","1200"
"Lea","3","58","New Mexico","6/19/20","38","20","35025","52.63"
"Lincoln","0","7","New Mexico","6/19/20","5","2","35027","40"
"Los Alamos","0","7","New Mexico","6/19/20","6","1","35028","16.67"
"Luna","4","47","New Mexico","6/19/20","20","27","35029","135"
"McKinley","20","3009","New Mexico","6/19/20","2870","139","35031","4.84"
"Otero","0","32","New Mexico","6/19/20","30","2","35035","6.67"
"Quay","0","5","New Mexico","6/19/20","4","1","35037","25"
"Rio Arriba","2","73","New Mexico","6/19/20","60","13","35039","21.67"
"Roosevelt","0","54","New Mexico","6/19/20","53","1","35041","1.89"
"San Juan","12","2165","New Mexico","6/19/20","2081","84","35045","4.04"
"San Miguel","0","18","New Mexico","6/19/20","16","2","35047","12.5"
"Sandoval","8","662","New Mexico","6/19/20","609","53","35043","8.7"
"Santa Fe","3","188","New Mexico","6/19/20","165","23","35049","13.94"
"Sierra","0","5","New Mexico","6/19/20","3","2","35051","66.67"
"Socorro","0","55","New Mexico","6/19/20","55","0","35053","0"
"Taos","0","33","New Mexico","6/19/20","32","1","35055","3.12"
"Torrance","0","34","New Mexico","6/19/20","34","0","35057","0"
"Union","0","5","New Mexico","6/19/20","5","0","35059","0"
"Valencia","1","95","New Mexico","6/19/20","87","8","35061","9.2"
"Albany","6","2049","New York","6/19/20","2007","42","36001","2.09"
"Allegany","1","58","New York","6/19/20","53","5","36003","9.43"
"Broome","3","663","New York","6/19/20","644","19","36007","2.95"
"Cattaraugus","1","109","New York","6/19/20","101","8","36009","7.92"
"Cayuga","1","107","New York","6/19/20","103","4","36011","3.88"
"Chautauqua","1","112","New York","6/19/20","106","6","36013","5.66"
"Chemung","0","139","New York","6/19/20","138","1","36015","0.72"
"Chenango","0","139","New York","6/19/20","138","1","36017","0.72"
"Clinton","0","99","New York","6/19/20","98","1","36019","1.02"
"Columbia","3","446","New York","6/19/20","428","18","36021","4.21"
"Cortland","0","44","New York","6/19/20","42","2","36023","4.76"
"Delaware","0","89","New York","6/19/20","88","1","36025","1.14"
"Dutchess","11","4110","New York","6/19/20","4035","75","36027","1.86"
"Erie","34","6955","New York","6/19/20","6717","238","36029","3.54"
"Essex","0","40","New York","6/19/20","40","0","36031","0"
"Franklin","0","27","New York","6/19/20","24","3","36033","12.5"
"Fulton","1","237","New York","6/19/20","231","6","36035","2.6"
"Genesee","1","218","New York","6/19/20","212","6","36037","2.83"
"Greene","1","254","New York","6/19/20","249","5","36039","2.01"
"Hamilton","0","6","New York","6/19/20","5","1","36041","20"
"Herkimer","1","131","New York","6/19/20","127","4","36043","3.15"
"Jefferson","0","82","New York","6/19/20","80","2","36045","2.5"
"Lewis","0","21","New York","6/19/20","20","1","36049","5"
"Livingston","0","123","New York","6/19/20","121","2","36051","1.65"
"Madison","1","342","New York","6/19/20","333","9","36053","2.7"
"Monroe","20","3461","New York","6/19/20","3320","141","36055","4.25"
"Montgomery","0","106","New York","6/19/20","103","3","36057","2.91"
"Nassau","39","41387","New York","6/19/20","41114","273","36059","0.66"
"New York","388","211670","New York","6/19/20","208954","2716","36061","1.3"
"Niagara","6","1185","New York","6/19/20","1143","42","36063","3.67"
"Oneida","17","1357","New York","6/19/20","1237","120","36065","9.7"
"Onondaga","23","2634","New York","6/19/20","2474","160","36067","6.47"
"Ontario","1","239","New York","6/19/20","230","9","36069","3.91"
"Orange","9","10620","New York","6/19/20","10558","62","36071","0.59"
"Orleans","2","274","New York","6/19/20","260","14","36073","5.38"
"Oswego","7","167","New York","6/19/20","120","47","36075","39.17"
"Otsego","1","82","New York","6/19/20","78","4","36077","5.13"
"Putnam","2","1299","New York","6/19/20","1282","17","36079","1.33"
"Rensselaer","1","519","New York","6/19/20","510","9","36083","1.76"
"Rockland","13","13486","New York","6/19/20","13396","90","36087","0.67"
"Saratoga","2","528","New York","6/19/20","514","14","36091","2.72"
"Schenectady","4","746","New York","6/19/20","721","25","36093","3.47"
"Schoharie","0","55","New York","6/19/20","54","1","36095","1.85"
"Schuyler","0","12","New York","6/19/20","12","0","36097","0"
"Seneca","0","64","New York","6/19/20","63","1","36099","1.59"
"St. Lawrence","0","215","New York","6/19/20","214","1","36089","0.47"
"Steuben","0","257","New York","6/19/20","254","3","36101","1.18"
"Suffolk","44","40864","New York","6/19/20","40559","305","36103","0.75"
"Sullivan","1","1434","New York","6/19/20","1428","6","36105","0.42"
"Tioga","0","140","New York","6/19/20","137","3","36107","2.19"
"Tompkins","0","173","New York","6/19/20","172","1","36109","0.58"
"Ulster","2","1749","New York","6/19/20","1734","15","36111","0.87"
"Warren","1","261","New York","6/19/20","257","4","36113","1.56"
"Washington","0","243","New York","6/19/20","242","1","36115","0.41"
"Wayne","2","141","New York","6/19/20","129","12","36117","9.3"
"Westchester","40","34455","New York","6/19/20","34175","280","36119","0.82"
"Wyoming","0","93","New York","6/19/20","91","2","36121","2.2"
"Yates","0","40","New York","6/19/20","39","1","36123","2.56"
"Alamance","28","838","North Carolina","6/19/20","641","197","37001","30.73"
"Alexander","1","56","North Carolina","6/19/20","46","10","37003","21.74"
"Alleghany","0","30","North Carolina","6/19/20","30","0","37005","0"
"Anson","1","91","North Carolina","6/19/20","83","8","37007","9.64"
"Ashe","0","44","North Carolina","6/19/20","43","1","37009","2.33"
"Avery","0","6","North Carolina","6/19/20","6","0","37011","0"
"Beaufort","1","55","North Carolina","6/19/20","49","6","37013","12.24"
"Bertie","0","135","North Carolina","6/19/20","135","0","37015","0"
"Bladen","5","220","North Carolina","6/19/20","186","34","37017","18.28"
"Brunswick","15","293","North Carolina","6/19/20","190","103","37019","54.21"
"Buncombe","7","478","North Carolina","6/19/20","426","52","37021","12.21"
"Burke","14","872","North Carolina","6/19/20","775","97","37023","12.52"
"Cabarrus","13","773","North Carolina","6/19/20","685","88","37025","12.85"
"Caldwell","5","273","North Carolina","6/19/20","238","35","37027","14.71"
"Camden","1","9","North Carolina","6/19/20","3","6","37029","200"
"Carteret","0","48","North Carolina","6/19/20","45","3","37031","6.67"
"Caswell","1","110","North Carolina","6/19/20","101","9","37033","8.91"
"Catawba","15","485","North Carolina","6/19/20","379","106","37035","27.97"
"Chatham","9","841","North Carolina","6/19/20","780","61","37037","7.82"
"Cherokee","0","31","North Carolina","6/19/20","30","1","37039","3.33"
"Chowan","0","19","North Carolina","6/19/20","19","0","37041","0"
"Clay","0","9","North Carolina","6/19/20","8","1","37043","12.5"
"Cleveland","7","189","North Carolina","6/19/20","143","46","37045","32.17"
"Columbus","6","446","North Carolina","6/19/20","404","42","37047","10.4"
"Craven","4","283","North Carolina","6/19/20","256","27","37049","10.55"
"Cumberland","13","948","North Carolina","6/19/20","855","93","37051","10.88"
"Currituck","0","17","North Carolina","6/19/20","15","2","37053","13.33"
"Dare","0","27","North Carolina","6/19/20","25","2","37055","8"
"Davidson","15","691","North Carolina","6/19/20","589","102","37057","17.32"
"Davie","3","152","North Carolina","6/19/20","132","20","37059","15.15"
"Duplin","18","1257","North Carolina","6/19/20","1130","127","37061","11.24"
"Durham","63","2912","North Carolina","6/19/20","2473","439","37063","17.75"
"Edgecombe","3","257","North Carolina","6/19/20","235","22","37065","9.36"
"Forsyth","46","2372","North Carolina","6/19/20","2051","321","37067","15.65"
"Franklin","5","244","North Carolina","6/19/20","209","35","37069","16.75"
"Gaston","24","621","North Carolina","6/19/20","452","169","37071","37.39"
"Gates","0","25","North Carolina","6/19/20","24","1","37073","4.17"
"Graham","0","6","North Carolina","6/19/20","6","0","37075","0"
"Granville","7","703","North Carolina","6/19/20","653","50","37077","7.66"
"Greene","2","132","North Carolina","6/19/20","117","15","37079","12.82"
"Guilford","47","2230","North Carolina","6/19/20","1899","331","37081","17.43"
"Halifax","2","244","North Carolina","6/19/20","231","13","37083","5.63"
"Harnett","8","435","North Carolina","6/19/20","381","54","37085","14.17"
"Haywood","1","69","North Carolina","6/19/20","63","6","37087","9.52"
"Henderson","8","472","North Carolina","6/19/20","415","57","37089","13.73"
"Hertford","1","153","North Carolina","6/19/20","143","10","37091","6.99"
"Hoke","2","312","North Carolina","6/19/20","296","16","37093","5.41"
"Hyde","0","3","North Carolina","6/19/20","2","1","37095","50"
"Iredell","11","479","North Carolina","6/19/20","404","75","37097","18.56"
"Jackson","1","64","North Carolina","6/19/20","59","5","37099","8.47"
"Johnston","30","968","North Carolina","6/19/20","756","212","37101","28.04"
"Jones","0","28","North Carolina","6/19/20","28","0","37103","0"
"Lee","7","625","North Carolina","6/19/20","574","51","37105","8.89"
"Lenoir","6","316","North Carolina","6/19/20","277","39","37107","14.08"
"Lincoln","7","164","North Carolina","6/19/20","118","46","37109","38.98"
"Macon","8","237","North Carolina","6/19/20","178","59","37113","33.15"
"Madison","0","5","North Carolina","6/19/20","4","1","37115","25"
"Martin","2","103","North Carolina","6/19/20","88","15","37117","17.05"
"McDowell","6","172","North Carolina","6/19/20","129","43","37111","33.33"
"Mecklenburg","181","7804","North Carolina","6/19/20","6538","1266","37119","19.36"
"Mitchell","1","23","North Carolina","6/19/20","17","6","37121","35.29"
"Montgomery","3","229","North Carolina","6/19/20","205","24","37123","11.71"
"Moore","7","335","North Carolina","6/19/20","288","47","37125","16.32"
"Nash","7","311","North Carolina","6/19/20","262","49","37127","18.7"
"New Hanover","19","449","North Carolina","6/19/20","315","134","37129","42.54"
"Northampton","1","174","North Carolina","6/19/20","170","4","37131","2.35"
"Onslow","4","180","North Carolina","6/19/20","149","31","37133","20.81"
"Orange","8","497","North Carolina","6/19/20","440","57","37135","12.95"
"Pamlico","0","15","North Carolina","6/19/20","15","0","37137","0"
"Pasquotank","3","152","North Carolina","6/19/20","128","24","37139","18.75"
"Pender","4","149","North Carolina","6/19/20","123","26","37141","21.14"
"Perquimans","0","30","North Carolina","6/19/20","29","1","37143","3.45"
"Person","2","86","North Carolina","6/19/20","72","14","37145","19.44"
"Pitt","8","507","North Carolina","6/19/20","451","56","37147","12.42"
"Polk","1","61","North Carolina","6/19/20","53","8","37149","15.09"
"Randolph","16","997","North Carolina","6/19/20","882","115","37151","13.04"
"Richmond","4","221","North Carolina","6/19/20","196","25","37153","12.76"
"Robeson","12","1127","North Carolina","6/19/20","1040","87","37155","8.37"
"Rockingham","4","150","North Carolina","6/19/20","124","26","37157","20.97"
"Rowan","17","957","North Carolina","6/19/20","835","122","37159","14.61"
"Rutherford","4","233","North Carolina","6/19/20","205","28","37161","13.66"
"Sampson","14","802","North Carolina","6/19/20","702","100","37163","14.25"
"Scotland","1","114","North Carolina","6/19/20","104","10","37165","9.62"
"Stanly","5","180","North Carolina","6/19/20","144","36","37167","25"
"Stokes","1","98","North Carolina","6/19/20","91","7","37169","7.69"
"Surry","5","353","North Carolina","6/19/20","315","38","37171","12.06"
"Swain","0","39","North Carolina","6/19/20","37","2","37173","5.41"
"Transylvania","0","17","North Carolina","6/19/20","16","1","37175","6.25"
"Tyrrell","0","5","North Carolina","6/19/20","5","0","37177","0"
"Union","19","802","North Carolina","6/19/20","672","130","37179","19.35"
"Vance","4","434","North Carolina","6/19/20","403","31","37181","7.69"
"Wake","88","3385","North Carolina","6/19/20","2769","616","37183","22.25"
"Warren","2","142","North Carolina","6/19/20","125","17","37185","13.6"
"Washington","0","35","North Carolina","6/19/20","33","2","37187","6.06"
"Watauga","0","44","North Carolina","6/19/20","41","3","37189","7.32"
"Wayne","17","1565","North Carolina","6/19/20","1448","117","37191","8.08"
"Wilkes","3","551","North Carolina","6/19/20","530","21","37193","3.96"
"Wilson","9","545","North Carolina","6/19/20","482","63","37195","13.07"
"Yadkin","4","259","North Carolina","6/19/20","228","31","37197","13.6"
"Yancey","1","33","North Carolina","6/19/20","23","10","37199","43.48"
"Barnes","1","16","North Dakota","6/19/20","9","7","38003","77.78"
"Benson","0","3","North Dakota","6/19/20","3","0","38005","0"
"Bottineau","0","4","North Dakota","6/19/20","4","0","38009","0"
"Bowman","0","1","North Dakota","6/19/20","1","0","38011","0"
"Burke","0","5","North Dakota","6/19/20","5","0","38013","0"
"Burleigh","5","188","North Dakota","6/19/20","156","32","38015","20.51"
"Cass","14","2104","North Dakota","6/19/20","2006","98","38017","4.89"
"Dickey","0","4","North Dakota","6/19/20","2","2","38021","100"
"Divide","0","1","North Dakota","6/19/20","1","0","38023","0"
"Dunn","0","12","North Dakota","6/19/20","11","1","38025","9.09"
"Eddy","0","5","North Dakota","6/19/20","5","0","38027","0"
"Emmons","0","4","North Dakota","6/19/20","4","0","38029","0"
"Foster","0","1","North Dakota","6/19/20","1","0","38031","0"
"Grand Forks","2","358","North Dakota","6/19/20","341","17","38035","4.99"
"Grant","0","2","North Dakota","6/19/20","2","0","38037","0"
"Griggs","0","1","North Dakota","6/19/20","1","0","38039","0"
"Kidder","0","2","North Dakota","6/19/20","2","0","38043","0"
"LaMoure","0","10","North Dakota","6/19/20","8","2","38045","25"
"McHenry","0","3","North Dakota","6/19/20","2","1","38049","50"
"McIntosh","0","1","North Dakota","6/19/20","1","0","38051","0"
"McKenzie","0","23","North Dakota","6/19/20","21","2","38053","9.52"
"McLean","0","11","North Dakota","6/19/20","9","2","38055","22.22"
"Mercer","0","6","North Dakota","6/19/20","6","0","38057","0"
"Morton","1","70","North Dakota","6/19/20","62","8","38059","12.9"
"Mountrail","0","43","North Dakota","6/19/20","43","0","38061","0"
"Nelson","0","1","North Dakota","6/19/20","1","0","38063","0"
"Oliver","0","1","North Dakota","6/19/20","1","0","38065","0"
"Pembina","0","7","North Dakota","6/19/20","6","1","38067","16.67"
"Pierce","0","4","North Dakota","6/19/20","3","1","38069","33.33"
"Ramsey","0","8","North Dakota","6/19/20","8","0","38071","0"
"Ransom","0","13","North Dakota","6/19/20","12","1","38073","8.33"
"Renville","0","3","North Dakota","6/19/20","3","0","38075","0"
"Richland","1","37","North Dakota","6/19/20","33","4","38077","12.12"
"Rolette","0","8","North Dakota","6/19/20","7","1","38079","14.29"
"Sargent","0","4","North Dakota","6/19/20","4","0","38081","0"
"Sheridan","0","1","North Dakota","6/19/20","1","0","38083","0"
"Sioux","1","12","North Dakota","6/19/20","3","9","38085","300"
"Slope","0","3","North Dakota","6/19/20","3","0","38087","0"
"Stark","1","68","North Dakota","6/19/20","63","5","38089","7.94"
"Steele","0","1","North Dakota","6/19/20","1","0","38091","0"
"Stutsman","1","60","North Dakota","6/19/20","51","9","38093","17.65"
"Traill","0","15","North Dakota","6/19/20","15","0","38097","0"
"Walsh","0","17","North Dakota","6/19/20","16","1","38099","6.25"
"Ward","1","51","North Dakota","6/19/20","45","6","38101","13.33"
"Wells","0","8","North Dakota","6/19/20","8","0","38103","0"
"Williams","0","26","North Dakota","6/19/20","26","0","38105","0"
"","0","30","Northern Mariana Islands","6/19/20","30","0",,"0"
"Adams","1","18","Ohio","6/19/20","12","6","39001","50"
"Allen","2","247","Ohio","6/19/20","232","15","39003","6.47"
"Ashland","2","37","Ohio","6/19/20","26","11","39005","42.31"
"Ashtabula","4","406","Ohio","6/19/20","381","25","39007","6.56"
"Athens","0","24","Ohio","6/19/20","23","1","39009","4.35"
"Auglaize","1","89","Ohio","6/19/20","84","5","39011","5.95"
"Belmont","2","476","Ohio","6/19/20","463","13","39013","2.81"
"Brown","1","41","Ohio","6/19/20","37","4","39015","10.81"
"Butler","14","1166","Ohio","6/19/20","1065","101","39017","9.48"
"Carroll","0","38","Ohio","6/19/20","36","2","39019","5.56"
"Champaign","0","37","Ohio","6/19/20","34","3","39021","8.82"
"Clark","29","606","Ohio","6/19/20","400","206","39023","51.5"
"Clermont","4","266","Ohio","6/19/20","236","30","39025","12.71"
"Clinton","0","54","Ohio","6/19/20","52","2","39027","3.85"
"Columbiana","6","954","Ohio","6/19/20","914","40","39029","4.38"
"Coshocton","1","56","Ohio","6/19/20","50","6","39031","12"
"Crawford","0","122","Ohio","6/19/20","122","0","39033","0"
"Cuyahoga","53","5481","Ohio","6/19/20","5112","369","39035","7.22"
"Darke","1","227","Ohio","6/19/20","220","7","39037","3.18"
"Defiance","0","40","Ohio","6/19/20","40","0","39039","0"
"Delaware","3","412","Ohio","6/19/20","389","23","39041","5.91"
"Erie","4","216","Ohio","6/19/20","191","25","39043","13.09"
"Fairfield","6","398","Ohio","6/19/20","353","45","39045","12.75"
"Fayette","0","45","Ohio","6/19/20","44","1","39047","2.27"
"Franklin","96","7590","Ohio","6/19/20","6918","672","39049","9.71"
"Fulton","0","53","Ohio","6/19/20","52","1","39051","1.92"
"Gallia","0","9","Ohio","6/19/20","9","0","39053","0"
"Geauga","3","353","Ohio","6/19/20","331","22","39055","6.65"
"Greene","4","158","Ohio","6/19/20","132","26","39057","19.7"
"Guernsey","0","44","Ohio","6/19/20","44","0","39059","0"
"Hamilton","79","3634","Ohio","6/19/20","3078","556","39061","18.06"
"Hancock","0","62","Ohio","6/19/20","61","1","39063","1.64"
"Hardin","3","106","Ohio","6/19/20","87","19","39065","21.84"
"Harrison","0","11","Ohio","6/19/20","10","1","39067","10"
"Henry","0","21","Ohio","6/19/20","19","2","39069","10.53"
"Highland","1","37","Ohio","6/19/20","32","5","39071","15.62"
"Hocking","0","73","Ohio","6/19/20","73","0","39073","0"
"Holmes","4","109","Ohio","6/19/20","84","25","39075","29.76"
"Huron","3","96","Ohio","6/19/20","72","24","39077","33.33"
"Jackson","0","16","Ohio","6/19/20","16","0","39079","0"
"Jefferson","1","74","Ohio","6/19/20","69","5","39081","7.25"
"Knox","0","33","Ohio","6/19/20","31","2","39083","6.45"
"Lake","2","358","Ohio","6/19/20","344","14","39085","4.07"
"Lawrence","1","42","Ohio","6/19/20","32","10","39087","31.25"
"Licking","5","329","Ohio","6/19/20","297","32","39089","10.77"
"Logan","0","48","Ohio","6/19/20","47","1","39091","2.13"
"Lorain","7","825","Ohio","6/19/20","779","46","39093","5.91"
"Lucas","10","2478","Ohio","6/19/20","2411","67","39095","2.78"
"Madison","1","172","Ohio","6/19/20","168","4","39097","2.38"
"Mahoning","8","1632","Ohio","6/19/20","1576","56","39099","3.55"
"Marion","2","2715","Ohio","6/19/20","2701","14","39101","0.52"
"Medina","1","406","Ohio","6/19/20","397","9","39103","2.27"
"Meigs","0","9","Ohio","6/19/20","6","3","39105","50"
"Mercer","2","255","Ohio","6/19/20","244","11","39107","4.51"
"Miami","2","397","Ohio","6/19/20","382","15","39109","3.93"
"Monroe","0","82","Ohio","6/19/20","83","-1","39111","-1.2"
"Montgomery","39","1174","Ohio","6/19/20","901","273","39113","30.3"
"Morgan","0","6","Ohio","6/19/20","6","0","39115","0"
"Morrow","0","110","Ohio","6/19/20","110","0","39117","0"
"Muskingum","1","61","Ohio","6/19/20","56","5","39119","8.93"
"Noble","0","6","Ohio","6/19/20","6","0","39121","0"
"Ottawa","1","118","Ohio","6/19/20","114","4","39123","3.51"
"Paulding","1","18","Ohio","6/19/20","14","4","39125","28.57"
"Perry","0","25","Ohio","6/19/20","22","3","39127","13.64"
"Pickaway","3","2135","Ohio","6/19/20","2115","20","39129","0.95"
"Pike","0","12","Ohio","6/19/20","9","3","39131","33.33"
"Portage","2","366","Ohio","6/19/20","352","14","39133","3.98"
"Preble","1","49","Ohio","6/19/20","41","8","39135","19.51"
"Putnam","0","103","Ohio","6/19/20","100","3","39137","3"
"Richland","3","266","Ohio","6/19/20","242","24","39139","9.92"
"Ross","0","82","Ohio","6/19/20","79","3","39141","3.8"
"Sandusky","1","109","Ohio","6/19/20","102","7","39143","6.86"
"Scioto","0","21","Ohio","6/19/20","19","2","39145","10.53"
"Seneca","0","30","Ohio","6/19/20","29","1","39147","3.45"
"Shelby","0","51","Ohio","6/19/20","49","2","39149","4.08"
"Stark","10","918","Ohio","6/19/20","847","71","39151","8.38"
"Summit","14","1735","Ohio","6/19/20","1638","97","39153","5.92"
"Trumbull","7","693","Ohio","6/19/20","642","51","39155","7.94"
"Tuscarawas","2","409","Ohio","6/19/20","397","12","39157","3.02"
"Union","1","69","Ohio","6/19/20","62","7","39159","11.29"
"Van Wert","1","15","Ohio","6/19/20","10","5","39161","50"
"Vinton","0","22","Ohio","6/19/20","21","1","39163","4.76"
"Warren","9","559","Ohio","6/19/20","497","62","39165","12.47"
"Washington","0","119","Ohio","6/19/20","117","2","39167","1.71"
"Wayne","2","321","Ohio","6/19/20","304","17","39169","5.59"
"Williams","0","59","Ohio","6/19/20","58","1","39171","1.72"
"Wood","2","332","Ohio","6/19/20","316","16","39173","5.06"
"Wyandot","1","55","Ohio","6/19/20","48","7","39175","14.58"
"Adair","1","103","Oklahoma","6/19/20","95","8","40001","8.42"
"Alfalfa","0","1","Oklahoma","6/19/20","1","0","40003","0"
"Atoka","0","11","Oklahoma","6/19/20","8","3","40005","37.5"
"Beaver","0","30","Oklahoma","6/19/20","30","0","40007","0"
"Beckham","0","8","Oklahoma","6/19/20","7","1","40009","14.29"
"Blaine","1","13","Oklahoma","6/19/20","9","4","40011","44.44"
"Bryan","3","68","Oklahoma","6/19/20","49","19","40013","38.78"
"Caddo","1","181","Oklahoma","6/19/20","173","8","40015","4.62"
"Canadian","6","186","Oklahoma","6/19/20","146","40","40017","27.4"
"Carter","1","63","Oklahoma","6/19/20","57","6","40019","10.53"
"Cherokee","3","60","Oklahoma","6/19/20","41","19","40021","46.34"
"Choctaw","1","107","Oklahoma","6/19/20","102","5","40023","4.9"
"Cimarron","0","1","Oklahoma","6/19/20","1","0","40025","0"
"Cleveland","12","620","Oklahoma","6/19/20","539","81","40027","15.03"
"Coal","0","6","Oklahoma","6/19/20","6","0","40029","0"
"Comanche","6","361","Oklahoma","6/19/20","319","42","40031","13.17"
"Cotton","0","5","Oklahoma","6/19/20","5","0","40033","0"
"Craig","0","17","Oklahoma","6/19/20","16","1","40035","6.25"
"Creek","3","121","Oklahoma","6/19/20","102","19","40037","18.63"
"Custer","1","45","Oklahoma","6/19/20","40","5","40039","12.5"
"Delaware","1","114","Oklahoma","6/19/20","107","7","40041","6.54"
"Dewey","0","4","Oklahoma","6/19/20","2","2","40043","100"
"Garfield","1","54","Oklahoma","6/19/20","45","9","40047","20"
"Garvin","3","41","Oklahoma","6/19/20","20","21","40049","105"
"Grady","1","123","Oklahoma","6/19/20","116","7","40051","6.03"
"Grant","0","2","Oklahoma","6/19/20","2","0","40053","0"
"Greer","0","66","Oklahoma","6/19/20","66","0","40055","0"
"Harmon","0","1","Oklahoma","6/19/20","0","1","40057","1"
"Harper","0","1","Oklahoma","6/19/20","1","0","40059","0"
"Haskell","0","7","Oklahoma","6/19/20","6","1","40061","16.67"
"Hughes","0","3","Oklahoma","6/19/20","3","0","40063","0"
"Jackson","0","32","Oklahoma","6/19/20","32","0","40065","0"
"Jefferson","0","4","Oklahoma","6/19/20","4","0","40067","0"
"Johnston","1","8","Oklahoma","6/19/20","4","4","40069","100"
"Kay","2","77","Oklahoma","6/19/20","65","12","40071","18.46"
"Kingfisher","1","17","Oklahoma","6/19/20","12","5","40073","41.67"
"Kiowa","0","6","Oklahoma","6/19/20","6","0","40075","0"
"Latimer","0","7","Oklahoma","6/19/20","5","2","40077","40"
"Le Flore","1","25","Oklahoma","6/19/20","18","7","40079","38.89"
"Lincoln","0","25","Oklahoma","6/19/20","22","3","40081","13.64"
"Logan","1","26","Oklahoma","6/19/20","22","4","40083","18.18"
"Love","1","25","Oklahoma","6/19/20","21","4","40085","19.05"
"Major","0","7","Oklahoma","6/19/20","6","1","40093","16.67"
"Marshall","1","21","Oklahoma","6/19/20","13","8","40095","61.54"
"Mayes","1","60","Oklahoma","6/19/20","50","10","40097","20"
"McClain","1","121","Oklahoma","6/19/20","114","7","40087","6.14"
"McCurtain","9","200","Oklahoma","6/19/20","137","63","40089","45.99"
"McIntosh","2","27","Oklahoma","6/19/20","15","12","40091","80"
"Murray","1","13","Oklahoma","6/19/20","6","7","40099","116.67"
"Muskogee","3","88","Oklahoma","6/19/20","70","18","40101","25.71"
"Noble","3","26","Oklahoma","6/19/20","8","18","40103","225"
"Nowata","0","27","Oklahoma","6/19/20","25","2","40105","8"
"Okfuskee","0","6","Oklahoma","6/19/20","6","0","40107","0"
"Oklahoma","61","1946","Oklahoma","6/19/20","1517","429","40109","28.28"
"Okmulgee","1","36","Oklahoma","6/19/20","29","7","40111","24.14"
"Osage","3","125","Oklahoma","6/19/20","104","21","40113","20.19"
"Ottawa","1","42","Oklahoma","6/19/20","36","6","40115","16.67"
"Pawnee","1","46","Oklahoma","6/19/20","36","10","40117","27.78"
"Payne","19","208","Oklahoma","6/19/20","72","136","40119","188.89"
"Pittsburg","0","47","Oklahoma","6/19/20","44","3","40121","6.82"
"Pontotoc","1","24","Oklahoma","6/19/20","20","4","40123","20"
"Pottawatomie","2","80","Oklahoma","6/19/20","67","13","40125","19.4"
"Pushmataha","0","8","Oklahoma","6/19/20","7","1","40127","14.29"
"Rogers","4","122","Oklahoma","6/19/20","93","29","40131","31.18"
"Seminole","0","33","Oklahoma","6/19/20","31","2","40133","6.45"
"Sequoyah","0","22","Oklahoma","6/19/20","19","3","40135","15.79"
"Stephens","1","48","Oklahoma","6/19/20","44","4","40137","9.09"
"Texas","2","977","Oklahoma","6/19/20","963","14","40139","1.45"
"Tillman","0","23","Oklahoma","6/19/20","23","0","40141","0"
"Tulsa","90","2070","Oklahoma","6/19/20","1443","627","40143","43.45"
"Wagoner","4","194","Oklahoma","6/19/20","165","29","40145","17.58"
"Washington","3","365","Oklahoma","6/19/20","345","20","40147","5.8"
"Washita","0","3","Oklahoma","6/19/20","2","1","40149","50"
"Woods","0","5","Oklahoma","6/19/20","5","0","40151","0"
"Woodward","0","12","Oklahoma","6/19/20","9","3","40153","33.33"
"Baker","0","1","Oregon","6/19/20","1","0","41001","0"
"Benton","0","66","Oregon","6/19/20","63","3","41003","4.76"
"Clackamas","15","561","Oregon","6/19/20","455","106","41005","23.3"
"Clatsop","0","46","Oregon","6/19/20","46","0","41007","0"
"Columbia","1","26","Oregon","6/19/20","20","6","41009","30"
"Coos","0","33","Oregon","6/19/20","32","1","41011","3.12"
"Crook","0","9","Oregon","6/19/20","8","1","41013","12.5"
"Curry","0","7","Oregon","6/19/20","7","0","41015","0"
"Deschutes","1","142","Oregon","6/19/20","137","5","41017","3.65"
"Douglas","0","32","Oregon","6/19/20","29","3","41019","10.34"
"Grant","0","1","Oregon","6/19/20","1","0","41023","0"
"Harney","0","1","Oregon","6/19/20","1","0","41025","0"
"Hood River","2","87","Oregon","6/19/20","71","16","41027","22.54"
"Jackson","1","85","Oregon","6/19/20","78","7","41029","8.97"
"Jefferson","2","77","Oregon","6/19/20","65","12","41031","18.46"
"Josephine","0","26","Oregon","6/19/20","23","3","41033","13.04"
"Klamath","5","80","Oregon","6/19/20","48","32","41035","66.67"
"Lake","0","6","Oregon","6/19/20","4","2","41037","50"
"Lane","1","93","Oregon","6/19/20","85","8","41039","9.41"
"Lincoln","11","261","Oregon","6/19/20","184","77","41041","41.85"
"Linn","0","127","Oregon","6/19/20","124","3","41043","2.42"
"Malheur","1","43","Oregon","6/19/20","33","10","41045","30.3"
"Marion","19","1264","Oregon","6/19/20","1134","130","41047","11.46"
"Morrow","2","27","Oregon","6/19/20","13","14","41049","107.69"
"Multnomah","39","1714","Oregon","6/19/20","1440","274","41051","19.03"
"Polk","2","131","Oregon","6/19/20","117","14","41053","11.97"
"Sherman","0","1","Oregon","6/19/20","1","0","41055","0"
"Tillamook","0","6","Oregon","6/19/20","6","0","41057","0"
"Umatilla","10","230","Oregon","6/19/20","157","73","41059","46.5"
"Union","34","253","Oregon","6/19/20","12","241","41061","2008.33"
"Wallowa","0","5","Oregon","6/19/20","4","1","41063","25"
"Wasco","1","42","Oregon","6/19/20","38","4","41065","10.53"
"Washington","20","992","Oregon","6/19/20","849","143","41067","16.84"
"Yamhill","1","97","Oregon","6/19/20","91","6","41071","6.59"
"Adams","4","309","Pennsylvania","6/19/20","284","25","42001","8.8"
"Allegheny","11","2139","Pennsylvania","6/19/20","2065","74","42003","3.58"
"Armstrong","0","69","Pennsylvania","6/19/20","66","3","42005","4.55"
"Beaver","1","619","Pennsylvania","6/19/20","611","8","42007","1.31"
"Bedford","2","63","Pennsylvania","6/19/20","46","17","42009","36.96"
"Berks","13","4374","Pennsylvania","6/19/20","4281","93","42011","2.17"
"Blair","0","56","Pennsylvania","6/19/20","54","2","42013","3.7"
"Bradford","0","49","Pennsylvania","6/19/20","46","3","42015","6.52"
"Bucks","16","5510","Pennsylvania","6/19/20","5396","114","42017","2.11"
"Butler","1","263","Pennsylvania","6/19/20","256","7","42019","2.73"
"Cambria","0","62","Pennsylvania","6/19/20","62","0","42021","0"
"Cameron","0","2","Pennsylvania","6/19/20","2","0","42023","0"
"Carbon","1","264","Pennsylvania","6/19/20","257","7","42025","2.72"
"Centre","2","176","Pennsylvania","6/19/20","165","11","42027","6.67"
"Chester","27","3437","Pennsylvania","6/19/20","3247","190","42029","5.85"
"Clarion","0","31","Pennsylvania","6/19/20","30","1","42031","3.33"
"Clearfield","2","63","Pennsylvania","6/19/20","50","13","42033","26"
"Clinton","1","67","Pennsylvania","6/19/20","61","6","42035","9.84"
"Columbia","3","390","Pennsylvania","6/19/20","371","19","42037","5.12"
"Crawford","0","38","Pennsylvania","6/19/20","35","3","42039","8.57"
"Cumberland","8","768","Pennsylvania","6/19/20","709","59","42041","8.32"
"Dauphin","20","1725","Pennsylvania","6/19/20","1587","138","42043","8.7"
"Delaware","24","7003","Pennsylvania","6/19/20","6837","166","42045","2.43"
"Elk","0","8","Pennsylvania","6/19/20","6","2","42047","33.33"
"Erie","11","515","Pennsylvania","6/19/20","439","76","42049","17.31"
"Fayette","1","103","Pennsylvania","6/19/20","95","8","42051","8.42"
"Forest","0","7","Pennsylvania","6/19/20","7","0","42053","0"
"Franklin","5","872","Pennsylvania","6/19/20","837","35","42055","4.18"
"Fulton","0","17","Pennsylvania","6/19/20","16","1","42057","6.25"
"Greene","0","30","Pennsylvania","6/19/20","30","0","42059","0"
"Huntingdon","0","240","Pennsylvania","6/19/20","237","3","42061","1.27"
"Indiana","1","98","Pennsylvania","6/19/20","93","5","42063","5.38"
"Jefferson","0","20","Pennsylvania","6/19/20","18","2","42065","11.11"
"Juniata","1","109","Pennsylvania","6/19/20","105","4","42067","3.81"
"Lackawanna","3","1617","Pennsylvania","6/19/20","1598","19","42069","1.19"
"Lancaster","33","3911","Pennsylvania","6/19/20","3682","229","42071","6.22"
"Lawrence","1","90","Pennsylvania","6/19/20","86","4","42073","4.65"
"Lebanon","12","1226","Pennsylvania","6/19/20","1140","86","42075","7.54"
"Lehigh","14","4024","Pennsylvania","6/19/20","3926","98","42077","2.5"
"Luzerne","4","2850","Pennsylvania","6/19/20","2823","27","42079","0.96"
"Lycoming","1","172","Pennsylvania","6/19/20","168","4","42081","2.38"
"McKean","0","13","Pennsylvania","6/19/20","13","0","42083","0"
"Mercer","1","118","Pennsylvania","6/19/20","114","4","42085","3.51"
"Mifflin","0","61","Pennsylvania","6/19/20","59","2","42087","3.39"
"Monroe","3","1366","Pennsylvania","6/19/20","1347","19","42089","1.41"
"Montgomery","30","8046","Pennsylvania","6/19/20","7834","212","42091","2.71"
"Montour","2","68","Pennsylvania","6/19/20","56","12","42093","21.43"
"Northampton","10","3284","Pennsylvania","6/19/20","3217","67","42095","2.08"
"Northumberland","5","254","Pennsylvania","6/19/20","219","35","42097","15.98"
"Perry","1","79","Pennsylvania","6/19/20","70","9","42099","12.86"
"Philadelphia","88","24841","Pennsylvania","6/19/20","24228","613","42101","2.53"
"Pike","1","487","Pennsylvania","6/19/20","482","5","42103","1.04"
"Potter","0","13","Pennsylvania","6/19/20","13","0","42105","0"
"Schuylkill","4","703","Pennsylvania","6/19/20","677","26","42107","3.84"
"Snyder","0","61","Pennsylvania","6/19/20","59","2","42109","3.39"
"Somerset","1","46","Pennsylvania","6/19/20","39","7","42111","17.95"
"Sullivan","0","3","Pennsylvania","6/19/20","3","0","42113","0"
"Susquehanna","2","178","Pennsylvania","6/19/20","166","12","42115","7.23"
"Tioga","0","20","Pennsylvania","6/19/20","20","0","42117","0"
"Union","0","84","Pennsylvania","6/19/20","81","3","42119","3.7"
"Venango","0","17","Pennsylvania","6/19/20","17","0","42121","0"
"Warren","0","5","Pennsylvania","6/19/20","5","0","42123","0"
"Washington","1","162","Pennsylvania","6/19/20","153","9","42125","5.88"
"Wayne","1","129","Pennsylvania","6/19/20","125","4","42127","3.2"
"Westmoreland","4","510","Pennsylvania","6/19/20","483","27","42129","5.59"
"Wyoming","0","36","Pennsylvania","6/19/20","36","0","42131","0"
"York","13","1229","Pennsylvania","6/19/20","1141","88","42133","7.71"
"","94","6195","Puerto Rico","6/19/20","5536","659",,"11.9"
"Bristol","1","240","Rhode Island","6/19/20","231","9","44001","3.9"
"Kent","3","1128","Rhode Island","6/19/20","1105","23","44003","2.08"
"Newport","1","277","Rhode Island","6/19/20","269","8","44005","2.97"
"Providence","58","12363","Rhode Island","6/19/20","11959","404","44007","3.38"
"Washington","0","516","Rhode Island","6/19/20","513","3","44009","0.58"
"Abbeville","2","73","South Carolina","6/19/20","62","11","45001","17.74"
"Aiken","5","261","South Carolina","6/19/20","225","36","45003","16"
"Allendale","1","45","South Carolina","6/19/20","40","5","45005","12.5"
"Anderson","13","400","South Carolina","6/19/20","306","94","45007","30.72"
"Bamberg","2","54","South Carolina","6/19/20","40","14","45009","35"
"Barnwell","0","57","South Carolina","6/19/20","54","3","45011","5.56"
"Beaufort","31","760","South Carolina","6/19/20","540","220","45013","40.74"
"Berkeley","24","515","South Carolina","6/19/20","346","169","45015","48.84"
"Calhoun","4","58","South Carolina","6/19/20","27","31","45017","114.81"
"Charleston","85","1554","South Carolina","6/19/20","959","595","45019","62.04"
"Cherokee","2","99","South Carolina","6/19/20","86","13","45021","15.12"
"Chester","2","131","South Carolina","6/19/20","114","17","45023","14.91"
"Chesterfield","4","306","South Carolina","6/19/20","281","25","45025","8.9"
"Clarendon","3","349","South Carolina","6/19/20","325","24","45027","7.38"
"Colleton","6","217","South Carolina","6/19/20","177","40","45029","22.6"
"Darlington","4","371","South Carolina","6/19/20","343","28","45031","8.16"
"Dillon","3","219","South Carolina","6/19/20","198","21","45033","10.61"
"Dorchester","13","323","South Carolina","6/19/20","230","93","45035","40.43"
"Edgefield","1","63","South Carolina","6/19/20","58","5","45037","8.62"
"Fairfield","3","246","South Carolina","6/19/20","223","23","45039","10.31"
"Florence","15","878","South Carolina","6/19/20","770","108","45041","14.03"
"Georgetown","14","227","South Carolina","6/19/20","132","95","45043","71.97"
"Greenville","113","3413","South Carolina","6/19/20","2624","789","45045","30.07"
"Greenwood","12","345","South Carolina","6/19/20","259","86","45047","33.2"
"Hampton","0","53","South Carolina","6/19/20","50","3","45049","6"
"Horry","109","1697","South Carolina","6/19/20","936","761","45051","81.3"
"Jasper","2","67","South Carolina","6/19/20","54","13","45053","24.07"
"Kershaw","12","502","South Carolina","6/19/20","419","83","45055","19.81"
"Lancaster","10","298","South Carolina","6/19/20","230","68","45057","29.57"
"Laurens","12","202","South Carolina","6/19/20","120","82","45059","68.33"
"Lee","2","246","South Carolina","6/19/20","233","13","45061","5.58"
"Lexington","47","1377","South Carolina","6/19/20","1049","328","45063","31.27"
"Marion","5","122","South Carolina","6/19/20","88","34","45067","38.64"
"Marlboro","4","253","South Carolina","6/19/20","226","27","45069","11.95"
"McCormick","0","11","South Carolina","6/19/20","11","0","45065","0"
"Newberry","3","117","South Carolina","6/19/20","93","24","45071","25.81"
"Oconee","5","105","South Carolina","6/19/20","73","32","45073","43.84"
"Orangeburg","21","457","South Carolina","6/19/20","309","148","45075","47.9"
"Pickens","24","429","South Carolina","6/19/20","262","167","45077","63.74"
"Richland","65","2531","South Carolina","6/19/20","2076","455","45079","21.92"
"Saluda","3","179","South Carolina","6/19/20","158","21","45081","13.29"
"Spartanburg","37","1146","South Carolina","6/19/20","887","259","45083","29.2"
"Sumter","22","736","South Carolina","6/19/20","580","156","45085","26.9"
"Union","2","54","South Carolina","6/19/20","43","11","45087","25.58"
"Williamsburg","7","322","South Carolina","6/19/20","274","48","45089","17.52"
"York","23","740","South Carolina","6/19/20","580","160","45091","27.59"
"Aurora","1","34","South Dakota","6/19/20","30","4","46003","13.33"
"Beadle","8","476","South Dakota","6/19/20","418","58","46005","13.88"
"Bennett","0","2","South Dakota","6/19/20","0","2","46007","1"
"Bon Homme","0","11","South Dakota","6/19/20","8","3","46009","37.5"
"Brookings","3","47","South Dakota","6/19/20","26","21","46011","80.77"
"Brown","2","321","South Dakota","6/19/20","307","14","46013","4.56"
"Brule","1","15","South Dakota","6/19/20","7","8","46015","114.29"
"Buffalo","3","58","South Dakota","6/19/20","39","19","46017","48.72"
"Charles Mix","3","45","South Dakota","6/19/20","21","24","46023","114.29"
"Clark","1","11","South Dakota","6/19/20","7","4","46025","57.14"
"Clay","2","70","South Dakota","6/19/20","56","14","46027","25"
"Codington","0","47","South Dakota","6/19/20","44","3","46029","6.82"
"Corson","1","13","South Dakota","6/19/20","9","4","46031","44.44"
"Custer","0","3","South Dakota","6/19/20","2","1","46033","50"
"Davison","0","33","South Dakota","6/19/20","31","2","46035","6.45"
"Day","0","13","South Dakota","6/19/20","13","0","46037","0"
"Deuel","0","1","South Dakota","6/19/20","1","0","46039","0"
"Dewey","0","4","South Dakota","6/19/20","2","2","46041","100"
"Douglas","0","4","South Dakota","6/19/20","4","0","46043","0"
"Edmunds","0","4","South Dakota","6/19/20","4","0","46045","0"
"Fall River","0","6","South Dakota","6/19/20","6","0","46047","0"
"Faulk","0","21","South Dakota","6/19/20","19","2","46049","10.53"
"Grant","0","13","South Dakota","6/19/20","13","0","46051","0"
"Gregory","0","1","South Dakota","6/19/20","1","0","46053","0"
"Hamlin","0","10","South Dakota","6/19/20","9","1","46057","11.11"
"Hand","0","6","South Dakota","6/19/20","6","0","46059","0"
"Hanson","0","3","South Dakota","6/19/20","3","0","46061","0"
"Hughes","1","29","South Dakota","6/19/20","21","8","46065","38.1"
"Hutchinson","0","10","South Dakota","6/19/20","8","2","46067","25"
"Hyde","0","3","South Dakota","6/19/20","3","0","46069","0"
"Jackson","0","6","South Dakota","6/19/20","4","2","46071","50"
"Jerauld","0","39","South Dakota","6/19/20","40","-1","46073","-2.5"
"Kingsbury","0","3","South Dakota","6/19/20","5","-2","46077","-40"
"Lake","0","17","South Dakota","6/19/20","14","3","46079","21.43"
"Lawrence","1","16","South Dakota","6/19/20","12","4","46081","33.33"
"Lincoln","2","278","South Dakota","6/19/20","262","16","46083","6.11"
"Lyman","2","44","South Dakota","6/19/20","32","12","46085","37.5"
"Marshall","0","5","South Dakota","6/19/20","4","1","46091","25"
"McCook","0","8","South Dakota","6/19/20","8","0","46087","0"
"McPherson","0","3","South Dakota","6/19/20","3","0","46089","0"
"Meade","2","41","South Dakota","6/19/20","30","11","46093","36.67"
"Mellette","0","2","South Dakota","6/19/20","0","2","46095","1"
"Miner","0","4","South Dakota","6/19/20","3","1","46097","33.33"
"Minnehaha","10","3526","South Dakota","6/19/20","3458","68","46099","1.97"
"Moody","0","21","South Dakota","6/19/20","20","1","46101","5"
"Oglala Lakota","1","53","South Dakota","6/19/20","45","8","46102","17.78"
"Pennington","11","437","South Dakota","6/19/20","362","75","46103","20.72"
"Roberts","0","40","South Dakota","6/19/20","40","0","46109","0"
"Sanborn","0","12","South Dakota","6/19/20","13","-1","46111","-7.69"
"Spink","0","6","South Dakota","6/19/20","5","1","46115","20"
"Stanley","0","11","South Dakota","6/19/20","11","0","46117","0"
"Sully","0","1","South Dakota","6/19/20","1","0","46119","0"
"Todd","1","50","South Dakota","6/19/20","46","4","46121","8.7"
"Tripp","0","9","South Dakota","6/19/20","7","2","46123","28.57"
"Turner","0","25","South Dakota","6/19/20","25","0","46125","0"
"Union","1","114","South Dakota","6/19/20","109","5","46127","4.59"
"Walworth","0","7","South Dakota","6/19/20","5","2","46129","40"
"Yankton","1","64","South Dakota","6/19/20","58","6","46135","10.34"
"Ziebach","0","2","South Dakota","6/19/20","2","0","46137","0"
"Anderson","2","74","Tennessee","6/19/20","59","15","47001","25.42"
"Bedford","6","416","Tennessee","6/19/20","376","40","47003","10.64"
"Benton","0","8","Tennessee","6/19/20","8","0","47005","0"
"Bledsoe","0","614","Tennessee","6/19/20","614","0","47007","0"
"Blount","2","119","Tennessee","6/19/20","104","15","47009","14.42"
"Bradley","7","314","Tennessee","6/19/20","266","48","47011","18.05"
"Campbell","1","26","Tennessee","6/19/20","22","4","47013","18.18"
"Cannon","0","34","Tennessee","6/19/20","34","0","47015","0"
"Carroll","0","36","Tennessee","6/19/20","34","2","47017","5.88"
"Carter","1","27","Tennessee","6/19/20","20","7","47019","35"
"Cheatham","2","164","Tennessee","6/19/20","152","12","47021","7.89"
"Chester","0","14","Tennessee","6/19/20","12","2","47023","16.67"
"Claiborne","0","16","Tennessee","6/19/20","15","1","47025","6.67"
"Clay","1","13","Tennessee","6/19/20","9","4","47027","44.44"
"Cocke","0","27","Tennessee","6/19/20","26","1","47029","3.85"
"Coffee","1","99","Tennessee","6/19/20","92","7","47031","7.61"
"Crockett","1","25","Tennessee","6/19/20","18","7","47033","38.89"
"Cumberland","1","137","Tennessee","6/19/20","130","7","47035","5.38"
"Davidson","160","7502","Tennessee","6/19/20","6379","1123","47037","17.6"
"Decatur","0","15","Tennessee","6/19/20","14","1","47039","7.14"
"DeKalb","0","41","Tennessee","6/19/20","41","0","47041","0"
"Dickson","2","145","Tennessee","6/19/20","131","14","47043","10.69"
"Dyer","8","141","Tennessee","6/19/20","82","59","47045","71.95"
"Fayette","4","193","Tennessee","6/19/20","167","26","47047","15.57"
"Fentress","0","15","Tennessee","6/19/20","14","1","47049","7.14"
"Franklin","1","65","Tennessee","6/19/20","59","6","47051","10.17"
"Gibson","1","74","Tennessee","6/19/20","68","6","47053","8.82"
"Giles","0","24","Tennessee","6/19/20","21","3","47055","14.29"
"Grainger","1","25","Tennessee","6/19/20","18","7","47057","38.89"
"Greene","0","55","Tennessee","6/19/20","53","2","47059","3.77"
"Grundy","1","39","Tennessee","6/19/20","32","7","47061","21.88"
"Hamblen","3","96","Tennessee","6/19/20","75","21","47063","28"
"Hamilton","81","2000","Tennessee","6/19/20","1433","567","47065","39.57"
"Hancock","0","2","Tennessee","6/19/20","1","1","47067","100"
"Hardeman","5","252","Tennessee","6/19/20","215","37","47069","17.21"
"Hardin","3","51","Tennessee","6/19/20","30","21","47071","70"
"Hawkins","1","38","Tennessee","6/19/20","34","4","47073","11.76"
"Haywood","1","40","Tennessee","6/19/20","36","4","47075","11.11"
"Henderson","0","19","Tennessee","6/19/20","17","2","47077","11.76"
"Henry","0","36","Tennessee","6/19/20","34","2","47079","5.88"
"Hickman","0","63","Tennessee","6/19/20","61","2","47081","3.28"
"Houston","0","10","Tennessee","6/19/20","9","1","47083","11.11"
"Humphreys","0","18","Tennessee","6/19/20","18","0","47085","0"
"Jackson","0","21","Tennessee","6/19/20","19","2","47087","10.53"
"Jefferson","2","59","Tennessee","6/19/20","42","17","47089","40.48"
"Johnson","0","26","Tennessee","6/19/20","24","2","47091","8.33"
"Knox","12","609","Tennessee","6/19/20","525","84","47093","16"
"Lake","0","689","Tennessee","6/19/20","691","-2","47095","-0.29"
"Lauderdale","1","71","Tennessee","6/19/20","61","10","47097","16.39"
"Lawrence","3","78","Tennessee","6/19/20","57","21","47099","36.84"
"Lewis","0","5","Tennessee","6/19/20","5","0","47101","0"
"Lincoln","1","48","Tennessee","6/19/20","42","6","47103","14.29"
"Loudon","5","226","Tennessee","6/19/20","188","38","47105","20.21"
"Macon","4","217","Tennessee","6/19/20","191","26","47111","13.61"
"Madison","1","190","Tennessee","6/19/20","182","8","47113","4.4"
"Marion","0","48","Tennessee","6/19/20","48","0","47115","0"
"Marshall","1","44","Tennessee","6/19/20","40","4","47117","10"
"Maury","8","205","Tennessee","6/19/20","147","58","47119","39.46"
"McMinn","1","172","Tennessee","6/19/20","162","10","47107","6.17"
"McNairy","2","38","Tennessee","6/19/20","26","12","47109","46.15"
"Meigs","0","30","Tennessee","6/19/20","29","1","47121","3.45"
"Monroe","3","108","Tennessee","6/19/20","85","23","47123","27.06"
"Montgomery","6","363","Tennessee","6/19/20","319","44","47125","13.79"
"Moore","0","5","Tennessee","6/19/20","5","0","47127","0"
"Morgan","1","22","Tennessee","6/19/20","18","4","47129","22.22"
"Obion","2","71","Tennessee","6/19/20","56","15","47131","26.79"
"Out of TN","16","566","Tennessee","6/19/20","457","109","80047","23.85"
"Overton","0","40","Tennessee","6/19/20","37","3","47133","8.11"
"Perry","0","28","Tennessee","6/19/20","25","3","47135","12"
"Pickett","0","4","Tennessee","6/19/20","4","0","47137","0"
"Polk","1","32","Tennessee","6/19/20","28","4","47139","14.29"
"Putnam","8","643","Tennessee","6/19/20","588","55","47141","9.35"
"Rhea","4","247","Tennessee","6/19/20","222","25","47143","11.26"
"Roane","0","34","Tennessee","6/19/20","33","1","47145","3.03"
"Robertson","15","703","Tennessee","6/19/20","597","106","47147","17.76"
"Rutherford","48","1990","Tennessee","6/19/20","1653","337","47149","20.39"
"Scott","0","15","Tennessee","6/19/20","14","1","47151","7.14"
"Sequatchie","0","22","Tennessee","6/19/20","21","1","47153","4.76"
"Sevier","26","387","Tennessee","6/19/20","206","181","47155","87.86"
"Shelby","167","7623","Tennessee","6/19/20","6451","1172","47157","18.17"
"Smith","1","48","Tennessee","6/19/20","39","9","47159","23.08"
"Stewart","0","17","Tennessee","6/19/20","14","3","47161","21.43"
"Sullivan","0","72","Tennessee","6/19/20","70","2","47163","2.86"
"Sumner","14","1155","Tennessee","6/19/20","1059","96","47165","9.07"
"Tipton","8","551","Tennessee","6/19/20","497","54","47167","10.87"
"Trousdale","1","1464","Tennessee","6/19/20","1458","6","47169","0.41"
"Unicoi","0","52","Tennessee","6/19/20","52","0","47171","0"
"Union","0","9","Tennessee","6/19/20","7","2","47173","28.57"
"Van Buren","0","5","Tennessee","6/19/20","4","1","47175","25"
"Warren","1","36","Tennessee","6/19/20","32","4","47177","12.5"
"Washington","2","101","Tennessee","6/19/20","88","13","47179","14.77"
"Wayne","0","64","Tennessee","6/19/20","64","0","47181","0"
"Weakley","2","39","Tennessee","6/19/20","28","11","47183","39.29"
"White","1","52","Tennessee","6/19/20","46","6","47185","13.04"
"Williamson","14","767","Tennessee","6/19/20","670","97","47187","14.48"
"Wilson","10","580","Tennessee","6/19/20","511","69","47189","13.5"
"Anderson","130","1007","Texas","6/19/20","95","912","48001","960"
"Andrews","1","35","Texas","6/19/20","27","8","48003","29.63"
"Angelina","8","366","Texas","6/19/20","309","57","48005","18.45"
"Aransas","0","7","Texas","6/19/20","6","1","48007","16.67"
"Archer","0","3","Texas","6/19/20","3","0","48009","0"
"Armstrong","0","3","Texas","6/19/20","3","0","48011","0"
"Atascosa","3","62","Texas","6/19/20","43","19","48013","44.19"
"Austin","1","42","Texas","6/19/20","33","9","48015","27.27"
"Bailey","8","83","Texas","6/19/20","30","53","48017","176.67"
"Bandera","1","13","Texas","6/19/20","7","6","48019","85.71"
"Bastrop","7","338","Texas","6/19/20","288","50","48021","17.36"
"Baylor","0","1","Texas","6/19/20","1","0","48023","0"
"Bee","0","33","Texas","6/19/20","31","2","48025","6.45"
"Bell","28","769","Texas","6/19/20","574","195","48027","33.97"
"Bexar","244","5550","Texas","6/19/20","3840","1710","48029","44.53"
"Blanco","0","14","Texas","6/19/20","11","3","48031","27.27"
"Bosque","0","7","Texas","6/19/20","7","0","48035","0"
"Bowie","4","394","Texas","6/19/20","367","27","48037","7.36"
"Brazoria","114","1609","Texas","6/19/20","813","796","48039","97.91"
"Brazos","55","1095","Texas","6/19/20","710","385","48041","54.23"
"Brewster","3","24","Texas","6/19/20","1","23","48043","2300"
"Briscoe","0","1","Texas","6/19/20","1","0","48045","0"
"Brooks","0","3","Texas","6/19/20","1","2","48047","200"
"Brown","0","62","Texas","6/19/20","60","2","48049","3.33"
"Burleson","2","53","Texas","6/19/20","40","13","48051","32.5"
"Burnet","3","79","Texas","6/19/20","56","23","48053","41.07"
"Caldwell","16","197","Texas","6/19/20","87","110","48055","126.44"
"Calhoun","1","52","Texas","6/19/20","46","6","48057","13.04"
"Callahan","0","13","Texas","6/19/20","12","1","48059","8.33"
"Cameron","49","1371","Texas","6/19/20","1031","340","48061","32.98"
"Camp","2","109","Texas","6/19/20","98","11","48063","11.22"
"Carson","0","6","Texas","6/19/20","6","0","48065","0"
"Cass","0","36","Texas","6/19/20","34","2","48067","5.88"
"Castro","2","51","Texas","6/19/20","39","12","48069","30.77"
"Chambers","6","138","Texas","6/19/20","98","40","48071","40.82"
"Cherokee","2","67","Texas","6/19/20","54","13","48073","24.07"
"Childress","0","6","Texas","6/19/20","6","0","48075","0"
"Clay","0","5","Texas","6/19/20","5","0","48077","0"
"Cochran","0","1","Texas","6/19/20","1","0","48079","0"
"Coke","0","4","Texas","6/19/20","4","0","48081","0"
"Coleman","0","3","Texas","6/19/20","3","0","48083","0"
"Collin","67","2026","Texas","6/19/20","1560","466","48085","29.87"
"Collingsworth","0","5","Texas","6/19/20","5","0","48087","0"
"Colorado","2","46","Texas","6/19/20","31","15","48089","48.39"
"Comal","11","219","Texas","6/19/20","141","78","48091","55.32"
"Comanche","0","14","Texas","6/19/20","12","2","48093","16.67"
"Concho","0","1","Texas","6/19/20","1","0","48095","0"
"Cooke","1","27","Texas","6/19/20","23","4","48097","17.39"
"Coryell","1","305","Texas","6/19/20","299","6","48099","2.01"
"Cottle","0","4","Texas","6/19/20","4","0","48101","0"
"Crane","2","45","Texas","6/19/20","32","13","48103","40.62"
"Crockett","0","5","Texas","6/19/20","5","0","48105","0"
"Crosby","1","8","Texas","6/19/20","4","4","48107","100"
"Dallam","2","49","Texas","6/19/20","36","13","48111","36.11"
"Dallas","351","16042","Texas","6/19/20","13585","2457","48113","18.09"
"Dawson","0","45","Texas","6/19/20","45","0","48115","0"
"Deaf Smith","4","233","Texas","6/19/20","203","30","48117","14.78"
"Delta","0","4","Texas","6/19/20","2","2","48119","100"
"Denton","50","1980","Texas","6/19/20","1632","348","48121","21.32"
"DeWitt","1","35","Texas","6/19/20","26","9","48123","34.62"
"Dickens","0","2","Texas","6/19/20","2","0","48125","0"
"Dimmit","0","3","Texas","6/19/20","1","2","48127","200"
"Donley","0","27","Texas","6/19/20","28","-1","48129","-3.57"
"Duval","0","5","Texas","6/19/20","5","0","48131","0"
"Eastland","0","7","Texas","6/19/20","7","0","48133","0"
"Ector","10","300","Texas","6/19/20","227","73","48135","32.16"
"El Paso","75","4178","Texas","6/19/20","3650","528","48141","14.47"
"Ellis","10","510","Texas","6/19/20","437","73","48139","16.7"
"Erath","2","44","Texas","6/19/20","32","12","48143","37.5"
"Falls","1","22","Texas","6/19/20","14","8","48145","57.14"
"Fannin","2","65","Texas","6/19/20","52","13","48147","25"
"Fayette","1","52","Texas","6/19/20","44","8","48149","18.18"
"Fisher","0","2","Texas","6/19/20","2","0","48151","0"
"Floyd","0","18","Texas","6/19/20","16","2","48153","12.5"
"Fort Bend","58","2726","Texas","6/19/20","2320","406","48157","17.5"
"Franklin","1","30","Texas","6/19/20","24","6","48159","25"
"Freestone","0","18","Texas","6/19/20","15","3","48161","20"
"Frio","9","119","Texas","6/19/20","57","62","48163","108.77"
"Gaines","1","14","Texas","6/19/20","9","5","48165","55.56"
"Galveston","60","1535","Texas","6/19/20","1114","421","48167","37.79"
"Garza","0","7","Texas","6/19/20","6","1","48169","16.67"
"Gillespie","2","16","Texas","6/19/20","5","11","48171","220"
"Glasscock","1","5","Texas","6/19/20","1","4","48173","400"
"Goliad","0","7","Texas","6/19/20","7","0","48175","0"
"Gonzales","7","203","Texas","6/19/20","157","46","48177","29.3"
"Gray","0","113","Texas","6/19/20","111","2","48179","1.8"
"Grayson","12","491","Texas","6/19/20","408","83","48181","20.34"
"Gregg","4","304","Texas","6/19/20","274","30","48183","10.95"
"Grimes","3","288","Texas","6/19/20","270","18","48185","6.67"
"Guadalupe","17","280","Texas","6/19/20","160","120","48187","75"
"Hale","7","122","Texas","6/19/20","76","46","48189","60.53"
"Hall","0","2","Texas","6/19/20","2","0","48191","0"
"Hamilton","1","18","Texas","6/19/20","11","7","48193","63.64"
"Hansford","0","23","Texas","6/19/20","21","2","48195","9.52"
"Hardeman","0","4","Texas","6/19/20","4","0","48197","0"
"Hardin","3","167","Texas","6/19/20","145","22","48199","15.17"
"Harris","507","19739","Texas","6/19/20","16188","3551","48201","21.94"
"Harrison","0","268","Texas","6/19/20","267","1","48203","0.37"
"Hartley","0","13","Texas","6/19/20","12","1","48205","8.33"
"Haskell","0","4","Texas","6/19/20","4","0","48207","0"
"Hays","125","1448","Texas","6/19/20","574","874","48209","152.26"
"Hemphill","0","2","Texas","6/19/20","1","1","48211","100"
"Henderson","3","94","Texas","6/19/20","74","20","48213","27.03"
"Hidalgo","76","1447","Texas","6/19/20","912","535","48215","58.66"
"Hill","2","47","Texas","6/19/20","34","13","48217","38.24"
"Hockley","0","29","Texas","6/19/20","28","1","48219","3.57"
"Hood","0","35","Texas","6/19/20","34","1","48221","2.94"
"Hopkins","1","48","Texas","6/19/20","41","7","48223","17.07"
"Houston","-1","147","Texas","6/19/20","154","-7","48225","-4.55"
"Howard","1","24","Texas","6/19/20","18","6","48227","33.33"
"Hudspeth","0","14","Texas","6/19/20","12","2","48229","16.67"
"Hunt","9","227","Texas","6/19/20","162","65","48231","40.12"
"Hutchinson","1","49","Texas","6/19/20","45","4","48233","8.89"
"Irion","0","1","Texas","6/19/20","1","0","48235","0"
"Jack","0","4","Texas","6/19/20","4","0","48237","0"
"Jackson","1","24","Texas","6/19/20","20","4","48239","20"
"Jasper","0","33","Texas","6/19/20","32","1","48241","3.12"
"Jefferson","19","1356","Texas","6/19/20","1222","134","48245","10.97"
"Jim Hogg","0","6","Texas","6/19/20","4","2","48247","50"
"Jim Wells","1","21","Texas","6/19/20","17","4","48249","23.53"
"Johnson","4","254","Texas","6/19/20","229","25","48251","10.92"
"Jones","-3","610","Texas","6/19/20","633","-23","48253","-3.63"
"Karnes","1","11","Texas","6/19/20","4","7","48255","175"
"Kaufman","5","360","Texas","6/19/20","325","35","48257","10.77"
"Kendall","1","44","Texas","6/19/20","35","9","48259","25.71"
"Kerr","2","32","Texas","6/19/20","20","12","48265","60"
"Kimble","0","1","Texas","6/19/20","1","0","48267","0"
"Kinney","0","1","Texas","6/19/20","1","0","48271","0"
"Kleberg","1","24","Texas","6/19/20","20","4","48273","20"
"Knox","0","1","Texas","6/19/20","1","0","48275","0"
"La Salle","0","7","Texas","6/19/20","4","3","48283","75"
"Lamar","5","199","Texas","6/19/20","163","36","48277","22.09"
"Lamb","2","29","Texas","6/19/20","18","11","48279","61.11"
"Lampasas","1","15","Texas","6/19/20","9","6","48281","66.67"
"Lavaca","3","43","Texas","6/19/20","21","22","48285","104.76"
"Lee","2","47","Texas","6/19/20","35","12","48287","34.29"
"Leon","0","13","Texas","6/19/20","11","2","48289","18.18"
"Liberty","7","169","Texas","6/19/20","121","48","48291","39.67"
"Limestone","1","40","Texas","6/19/20","36","4","48293","11.11"
"Lipscomb","0","9","Texas","6/19/20","7","2","48295","28.57"
"Live Oak","0","10","Texas","6/19/20","9","1","48297","11.11"
"Llano","0","5","Texas","6/19/20","4","1","48299","25"
"Lubbock","49","1136","Texas","6/19/20","790","346","48303","43.8"
"Lynn","1","21","Texas","6/19/20","14","7","48305","50"
"Madison","1","25","Texas","6/19/20","19","6","48313","31.58"
"Marion","0","21","Texas","6/19/20","19","2","48315","10.53"
"Martin","0","5","Texas","6/19/20","3","2","48317","66.67"
"Mason","0","33","Texas","6/19/20","33","0","48319","0"
"Matagorda","3","104","Texas","6/19/20","80","24","48321","30"
"Maverick","8","206","Texas","6/19/20","149","57","48323","38.26"
"McCulloch","0","4","Texas","6/19/20","3","1","48307","33.33"
"McLennan","14","245","Texas","6/19/20","150","95","48309","63.33"
"Medina","3","244","Texas","6/19/20","220","24","48325","10.91"
"Midland","13","287","Texas","6/19/20","194","93","48329","47.94"
"Milam","2","56","Texas","6/19/20","40","16","48331","40"
"Mills","0","1","Texas","6/19/20","1","0","48333","0"
"Mitchell","0","2","Texas","6/19/20","2","0","48335","0"
"Montague","0","12","Texas","6/19/20","9","3","48337","33.33"
"Montgomery","32","1484","Texas","6/19/20","1258","226","48339","17.97"
"Moore","1","877","Texas","6/19/20","871","6","48341","0.69"
"Morris","0","31","Texas","6/19/20","28","3","48343","10.71"
"Motley","0","1","Texas","6/19/20","1","0","48345","0"
"Nacogdoches","3","341","Texas","6/19/20","317","24","48347","7.57"
"Navarro","5","116","Texas","6/19/20","84","32","48349","38.1"
"Newton","0","6","Texas","6/19/20","6","0","48351","0"
"Nolan","1","8","Texas","6/19/20","3","5","48353","166.67"
"Nueces","23","485","Texas","6/19/20","321","164","48355","51.09"
"Ochiltree","0","53","Texas","6/19/20","53","0","48357","0"
"Oldham","0","4","Texas","6/19/20","4","0","48359","0"
"Orange","4","135","Texas","6/19/20","105","30","48361","28.57"
"Palo Pinto","0","14","Texas","6/19/20","14","0","48363","0"
"Panola","-1","209","Texas","6/19/20","216","-7","48365","-3.24"
"Parker","2","124","Texas","6/19/20","110","14","48367","12.73"
"Parmer","6","155","Texas","6/19/20","111","44","48369","39.64"
"Pecos","1","112","Texas","6/19/20","107","5","48371","4.67"
"Polk","1","73","Texas","6/19/20","65","8","48373","12.31"
"Potter","5","2819","Texas","6/19/20","2785","34","48375","1.22"
"Presidio","1","11","Texas","6/19/20","2","9","48377","450"
"Rains","0","7","Texas","6/19/20","4","3","48379","75"
"Randall","3","771","Texas","6/19/20","748","23","48381","3.07"
"Reagan","0","2","Texas","6/19/20","2","0","48383","0"
"Real","0","1","Texas","6/19/20","1","0","48385","0"
"Red River","1","96","Texas","6/19/20","89","7","48387","7.87"
"Reeves","0","14","Texas","6/19/20","12","2","48389","16.67"
"Refugio","0","6","Texas","6/19/20","5","1","48391","20"
"Roberts","0","2","Texas","6/19/20","2","0","48393","0"
"Robertson","1","22","Texas","6/19/20","18","4","48395","22.22"
"Rockwall","4","264","Texas","6/19/20","233","31","48397","13.3"
"Runnels","0","3","Texas","6/19/20","2","1","48399","50"
"Rusk","25","245","Texas","6/19/20","68","177","48401","260.29"
"Sabine","0","15","Texas","6/19/20","15","0","48403","0"
"San Augustine","4","86","Texas","6/19/20","55","31","48405","56.36"
"San Jacinto","0","23","Texas","6/19/20","20","3","48407","15"
"San Patricio","4","66","Texas","6/19/20","41","25","48409","60.98"
"San Saba","0","2","Texas","6/19/20","1","1","48411","100"
"Schleicher","1","10","Texas","6/19/20","0","10","48413","1"
"Scurry","0","29","Texas","6/19/20","28","1","48415","3.57"
"Shackelford","0","1","Texas","6/19/20","1","0","48417","0"
"Shelby","2","241","Texas","6/19/20","226","15","48419","6.64"
"Sherman","0","30","Texas","6/19/20","28","2","48421","7.14"
"Smith","11","318","Texas","6/19/20","244","74","48423","30.33"
"Somervell","0","3","Texas","6/19/20","2","1","48425","50"
"Starr","20","227","Texas","6/19/20","88","139","48427","157.95"
"Stephens","0","5","Texas","6/19/20","4","1","48429","25"
"Sutton","0","1","Texas","6/19/20","0","1","48435","1"
"Swisher","0","23","Texas","6/19/20","21","2","48437","9.52"
"Tarrant","173","8331","Texas","6/19/20","7120","1211","48439","17.01"
"Taylor","2","268","Texas","6/19/20","252","16","48441","6.35"
"Terry","0","14","Texas","6/19/20","13","1","48445","7.69"
"Throckmorton","0","1","Texas","6/19/20","1","0","48447","0"
"Titus","11","729","Texas","6/19/20","655","74","48449","11.3"
"Tom Green","12","223","Texas","6/19/20","137","86","48451","62.77"
"Travis","97","4991","Texas","6/19/20","4314","677","48453","15.69"
"Trinity","0","21","Texas","6/19/20","22","-1","48455","-4.55"
"Tyler","0","14","Texas","6/19/20","16","-2","48457","-12.5"
"Upshur","1","41","Texas","6/19/20","37","4","48459","10.81"
"Upton","0","1","Texas","6/19/20","0","1","48461","1"
"Uvalde","1","31","Texas","6/19/20","24","7","48463","29.17"
"Val Verde","3","53","Texas","6/19/20","32","21","48465","65.62"
"Van Zandt","1","54","Texas","6/19/20","44","10","48467","22.73"
"Victoria","8","241","Texas","6/19/20","184","57","48469","30.98"
"Walker","3","1890","Texas","6/19/20","1868","22","48471","1.18"
"Waller","2","104","Texas","6/19/20","90","14","48473","15.56"
"Ward","0","7","Texas","6/19/20","4","3","48475","75"
"Washington","1","222","Texas","6/19/20","216","6","48477","2.78"
"Webb","28","854","Texas","6/19/20","661","193","48479","29.2"
"Wharton","4","114","Texas","6/19/20","89","25","48481","28.09"
"Wheeler","0","16","Texas","6/19/20","15","1","48483","6.67"
"Wichita","8","150","Texas","6/19/20","93","57","48485","61.29"
"Wilbarger","0","7","Texas","6/19/20","7","0","48487","0"
"Willacy","3","75","Texas","6/19/20","52","23","48489","44.23"
"Williamson","48","1159","Texas","6/19/20","820","339","48491","41.34"
"Wilson","2","65","Texas","6/19/20","50","15","48493","30"
"Winkler","0","6","Texas","6/19/20","4","2","48495","50"
"Wise","1","62","Texas","6/19/20","55","7","48497","12.73"
"Wood","3","70","Texas","6/19/20","51","19","48499","37.25"
"Yoakum","0","11","Texas","6/19/20","8","3","48501","37.5"
"Young","0","16","Texas","6/19/20","14","2","48503","14.29"
"Zapata","2","31","Texas","6/19/20","14","17","48505","121.43"
"Zavala","0","13","Texas","6/19/20","12","1","48507","8.33"
"Bear River","37","1188","Utah","6/19/20","927","261","00000","28.16"
"Central Utah","4","89","Utah","6/19/20","61","28","00000","45.9"
"Davis","21","775","Utah","6/19/20","628","147","49011","23.41"
"Salt Lake","203","8363","Utah","6/19/20","6942","1421","49035","20.47"
"San Juan","4","380","Utah","6/19/20","350","30","49037","8.57"
"Southeast Utah","0","31","Utah","6/19/20","28","3","00000","10.71"
"Southwest Utah","34","974","Utah","6/19/20","739","235","00000","31.8"
"Summit","2","455","Utah","6/19/20","444","11","49043","2.48"
"Tooele","4","188","Utah","6/19/20","159","29","49045","18.24"
"TriCounty","2","38","Utah","6/19/20","27","11","00000","40.74"
"Utah","67","2957","Utah","6/19/20","2491","466","49049","18.71"
"Wasatch","4","371","Utah","6/19/20","342","29","49051","8.48"
"Weber-Morgan","25","616","Utah","6/19/20","439","177","00000","40.32"
"Addison","0","67","Vermont","6/19/20","66","1","50001","1.52"
"Bennington","0","69","Vermont","6/19/20","67","2","50003","2.99"
"Caledonia","0","16","Vermont","6/19/20","16","0","50005","0"
"Chittenden","2","579","Vermont","6/19/20","564","15","50007","2.66"
"Essex","0","3","Vermont","6/19/20","3","0","50009","0"
"Franklin","0","102","Vermont","6/19/20","102","0","50011","0"
"Grand Isle","0","8","Vermont","6/19/20","8","0","50013","0"
"Lamoille","0","30","Vermont","6/19/20","29","1","50015","3.45"
"Orange","0","9","Vermont","6/19/20","9","0","50017","0"
"Orleans","0","14","Vermont","6/19/20","13","1","50019","7.69"
"Rutland","0","61","Vermont","6/19/20","58","3","50021","5.17"
"Washington","0","41","Vermont","6/19/20","40","1","50023","2.5"
"Windham","0","85","Vermont","6/19/20","84","1","50025","1.19"
"Windsor","0","55","Vermont","6/19/20","55","0","50027","0"
"","0","73","Virgin Islands","6/19/20","72","1",,"1.39"
"Accomack","5","1022","Virginia","6/19/20","987","35","51001","3.55"
"Albemarle","5","304","Virginia","6/19/20","272","32","51003","11.76"
"Alexandria","10","2198","Virginia","6/19/20","2128","70","51510","3.29"
"Alleghany","0","30","Virginia","6/19/20","27","3","51005","11.11"
"Amelia","1","41","Virginia","6/19/20","37","4","51007","10.81"
"Amherst","0","28","Virginia","6/19/20","27","1","51009","3.7"
"Appomattox","0","35","Virginia","6/19/20","34","1","51011","2.94"
"Arlington","13","2396","Virginia","6/19/20","2307","89","51013","3.86"
"Augusta","4","166","Virginia","6/19/20","141","25","51015","17.73"
"Bedford","1","95","Virginia","6/19/20","86","9","51019","10.47"
"Bland","0","1","Virginia","6/19/20","0","1","51021","1"
"Botetourt","2","55","Virginia","6/19/20","44","11","51023","25"
"Bristol","0","4","Virginia","6/19/20","4","0","51520","0"
"Brunswick","7","90","Virginia","6/19/20","44","46","51025","104.55"
"Buchanan","0","18","Virginia","6/19/20","18","0","51027","0"
"Buckingham","5","552","Virginia","6/19/20","518","34","51029","6.56"
"Buena Vista","0","12","Virginia","6/19/20","12","0","51530","0"
"Campbell","1","30","Virginia","6/19/20","22","8","51031","36.36"
"Caroline","3","121","Virginia","6/19/20","101","20","51033","19.8"
"Carroll","4","187","Virginia","6/19/20","159","28","51035","17.61"
"Charles City","1","35","Virginia","6/19/20","28","7","51036","25"
"Charlotte","0","30","Virginia","6/19/20","30","0","51037","0"
"Charlottesville","3","164","Virginia","6/19/20","146","18","51540","12.33"
"Chesapeake","10","709","Virginia","6/19/20","636","73","51550","11.48"
"Chesterfield","50","2456","Virginia","6/19/20","2109","347","51041","16.45"
"Clarke","1","44","Virginia","6/19/20","37","7","51043","18.92"
"Colonial Heights","2","126","Virginia","6/19/20","111","15","51570","13.51"
"Covington","0","4","Virginia","6/19/20","4","0","51580","0"
"Craig","0","6","Virginia","6/19/20","6","0","51045","0"
"Culpeper","3","792","Virginia","6/19/20","774","18","51047","2.33"
"Cumberland","1","50","Virginia","6/19/20","46","4","51049","8.7"
"Danville","1","68","Virginia","6/19/20","63","5","51590","7.94"
"Dickenson","0","1","Virginia","6/19/20","0","1","51051","1"
"Dinwiddie","2","118","Virginia","6/19/20","105","13","51053","12.38"
"Emporia","3","112","Virginia","6/19/20","94","18","51595","19.15"
"Essex","0","54","Virginia","6/19/20","52","2","51057","3.85"
"Fairfax","54","13244","Virginia","6/19/20","12863","381","51059","2.96"
"Fairfax City","0","67","Virginia","6/19/20","68","-1","51600","-1.47"
"Falls Church","0","58","Virginia","6/19/20","56","2","51610","3.57"
"Fauquier","4","401","Virginia","6/19/20","376","25","51061","6.65"
"Floyd","0","10","Virginia","6/19/20","8","2","51063","25"
"Fluvanna","0","103","Virginia","6/19/20","101","2","51065","1.98"
"Franklin","1","48","Virginia","6/19/20","42","6","51067","14.29"
"Franklin City","0","44","Virginia","6/19/20","43","1","51620","2.33"
"Frederick","3","446","Virginia","6/19/20","423","23","51069","5.44"
"Fredericksburg","3","219","Virginia","6/19/20","199","20","51630","10.05"
"Galax","7","217","Virginia","6/19/20","171","46","51640","26.9"
"Giles","0","6","Virginia","6/19/20","5","1","51071","20"
"Gloucester","1","41","Virginia","6/19/20","35","6","51073","17.14"
"Goochland","0","115","Virginia","6/19/20","112","3","51075","2.68"
"Grayson","2","74","Virginia","6/19/20","63","11","51077","17.46"
"Greene","0","48","Virginia","6/19/20","45","3","51079","6.67"
"Greensville","5","344","Virginia","6/19/20","306","38","51081","12.42"
"Halifax","1","39","Virginia","6/19/20","32","7","51083","21.88"
"Hampton","3","252","Virginia","6/19/20","234","18","51650","7.69"
"Hanover","4","387","Virginia","6/19/20","362","25","51085","6.91"
"Harrisonburg","3","874","Virginia","6/19/20","850","24","51660","2.82"
"Henrico","25","2368","Virginia","6/19/20","2193","175","51087","7.98"
"Henry","4","224","Virginia","6/19/20","193","31","51089","16.06"
"Highland","0","3","Virginia","6/19/20","2","1","51091","50"
"Hopewell","3","151","Virginia","6/19/20","129","22","51670","17.05"
"Isle of Wight","1","159","Virginia","6/19/20","150","9","51093","6"
"James City","1","238","Virginia","6/19/20","230","8","51095","3.48"
"King and Queen","0","24","Virginia","6/19/20","24","0","51097","0"
"King George","1","95","Virginia","6/19/20","87","8","51099","9.2"
"King William","0","33","Virginia","6/19/20","32","1","51101","3.12"
"Lancaster","0","11","Virginia","6/19/20","11","0","51103","0"
"Lee","0","9","Virginia","6/19/20","9","0","51105","0"
"Lexington","0","8","Virginia","6/19/20","8","0","51678","0"
"Loudoun","32","3504","Virginia","6/19/20","3280","224","51107","6.83"
"Louisa","1","102","Virginia","6/19/20","98","4","51109","4.08"
"Lunenburg","0","21","Virginia","6/19/20","19","2","51111","10.53"
"Lynchburg","2","105","Virginia","6/19/20","91","14","51680","15.38"
"Madison","0","42","Virginia","6/19/20","42","0","51113","0"
"Manassas","10","1352","Virginia","6/19/20","1282","70","51683","5.46"
"Manassas Park","5","402","Virginia","6/19/20","369","33","51685","8.94"
"Martinsville","1","59","Virginia","6/19/20","54","5","51690","9.26"
"Mathews","0","5","Virginia","6/19/20","5","0","51115","0"
"Mecklenburg","1","234","Virginia","6/19/20","226","8","51117","3.54"
"Middlesex","0","14","Virginia","6/19/20","14","0","51119","0"
"Montgomery","0","97","Virginia","6/19/20","96","1","51121","1.04"
"Nelson","0","18","Virginia","6/19/20","18","0","51125","0"
"New Kent","1","48","Virginia","6/19/20","44","4","51127","9.09"
"Newport News","8","410","Virginia","6/19/20","351","59","51700","16.81"
"Norfolk","11","707","Virginia","6/19/20","630","77","51710","12.22"
"Northampton","1","267","Virginia","6/19/20","259","8","51131","3.09"
"Northumberland","0","28","Virginia","6/19/20","25","3","51133","12"
"Norton","0","2","Virginia","6/19/20","2","0","51720","0"
"Nottoway","2","80","Virginia","6/19/20","63","17","51135","26.98"
"Orange","2","136","Virginia","6/19/20","124","12","51137","9.68"
"Page","2","261","Virginia","6/19/20","250","11","51139","4.4"
"Patrick","1","36","Virginia","6/19/20","31","5","51141","16.13"
"Petersburg","3","197","Virginia","6/19/20","178","19","51730","10.67"
"Pittsylvania","2","76","Virginia","6/19/20","59","17","51143","28.81"
"Poquoson","0","12","Virginia","6/19/20","11","1","51735","9.09"
"Portsmouth","5","405","Virginia","6/19/20","370","35","51740","9.46"
"Powhatan","1","59","Virginia","6/19/20","50","9","51145","18"
"Prince Edward","2","173","Virginia","6/19/20","161","12","51147","7.45"
"Prince George","3","179","Virginia","6/19/20","158","21","51149","13.29"
"Prince William","45","6756","Virginia","6/19/20","6439","317","51153","4.92"
"Pulaski","0","31","Virginia","6/19/20","30","1","51155","3.33"
"Radford","0","9","Virginia","6/19/20","7","2","51750","28.57"
"Rappahannock","0","16","Virginia","6/19/20","16","0","51157","0"
"Richmond","2","301","Virginia","6/19/20","290","11","51159","3.79"
"Richmond City","28","1929","Virginia","6/19/20","1733","196","51760","11.31"
"Roanoke","4","161","Virginia","6/19/20","132","29","51161","21.97"
"Roanoke City","8","291","Virginia","6/19/20","232","59","51770","25.43"
"Rockbridge","0","18","Virginia","6/19/20","19","-1","51163","-5.26"
"Rockingham","5","646","Virginia","6/19/20","614","32","51165","5.21"
"Russell","0","9","Virginia","6/19/20","8","1","51167","12.5"
"Salem","1","49","Virginia","6/19/20","43","6","51775","13.95"
"Scott","0","8","Virginia","6/19/20","7","1","51169","14.29"
"Shenandoah","4","534","Virginia","6/19/20","505","29","51171","5.74"
"Smyth","2","30","Virginia","6/19/20","18","12","51173","66.67"
"Southampton","0","154","Virginia","6/19/20","155","-1","51175","-0.65"
"Spotsylvania","19","874","Virginia","6/19/20","739","135","51177","18.27"
"Stafford","8","921","Virginia","6/19/20","862","59","51179","6.84"
"Staunton","1","62","Virginia","6/19/20","57","5","51790","8.77"
"Suffolk","2","353","Virginia","6/19/20","337","16","51800","4.75"
"Surry","0","13","Virginia","6/19/20","13","0","51181","0"
"Sussex","1","185","Virginia","6/19/20","177","8","51183","4.52"
"Tazewell","0","9","Virginia","6/19/20","9","0","51185","0"
"Virginia Beach","15","950","Virginia","6/19/20","847","103","51810","12.16"
"Warren","1","235","Virginia","6/19/20","228","7","51187","3.07"
"Washington","0","58","Virginia","6/19/20","58","0","51191","0"
"Waynesboro","1","61","Virginia","6/19/20","53","8","51820","15.09"
"Westmoreland","0","87","Virginia","6/19/20","84","3","51193","3.57"
"Williamsburg","1","54","Virginia","6/19/20","49","5","51830","10.2"
"Winchester","3","278","Virginia","6/19/20","260","18","51840","6.92"
"Wise","0","27","Virginia","6/19/20","27","0","51195","0"
"Wythe","0","42","Virginia","6/19/20","42","0","51197","0"
"York","1","97","Virginia","6/19/20","90","7","51199","7.78"
"Adams","2","102","Washington","6/19/20","89","13","53001","14.61"
"Asotin","0","20","Washington","6/19/20","20","0","53003","0"
"Benton","34","1313","Washington","6/19/20","1075","238","53005","22.14"
"Chelan","1","278","Washington","6/19/20","271","7","53007","2.58"
"Clallam","1","33","Washington","6/19/20","28","5","53009","17.86"
"Clark","4","635","Washington","6/19/20","604","31","53011","5.13"
"Columbia","0","2","Washington","6/19/20","1","1","53013","100"
"Cowlitz","4","130","Washington","6/19/20","102","28","53015","27.45"
"Douglas","1","186","Washington","6/19/20","178","8","53017","4.49"
"Ferry","0","1","Washington","6/19/20","1","0","53019","0"
"Franklin","38","1113","Washington","6/19/20","847","266","53021","31.4"
"Grant","15","348","Washington","6/19/20","241","107","53025","44.4"
"Grays Harbor","0","22","Washington","6/19/20","20","2","53027","10"
"Island","1","186","Washington","6/19/20","182","4","53029","2.2"
"Jefferson","0","33","Washington","6/19/20","31","2","53031","6.45"
"King","64","9061","Washington","6/19/20","8611","450","53033","5.23"
"Kitsap","2","185","Washington","6/19/20","173","12","53035","6.94"
"Kittitas","0","94","Washington","6/19/20","92","2","53037","2.17"
"Klickitat","1","51","Washington","6/19/20","42","9","53039","21.43"
"Lewis","1","47","Washington","6/19/20","38","9","53041","23.68"
"Lincoln","0","2","Washington","6/19/20","2","0","53043","0"
"Mason","0","41","Washington","6/19/20","39","2","53045","5.13"
"Okanogan","1","63","Washington","6/19/20","57","6","53047","10.53"
"Pacific","0","12","Washington","6/19/20","11","1","53049","9.09"
"Pend Oreille","0","3","Washington","6/19/20","3","0","53051","0"
"Pierce","19","2230","Washington","6/19/20","2097","133","53053","6.34"
"San Juan","0","16","Washington","6/19/20","15","1","53055","6.67"
"Skagit","4","479","Washington","6/19/20","454","25","53057","5.51"
"Skamania","0","5","Washington","6/19/20","3","2","53059","66.67"
"Snohomish","14","3208","Washington","6/19/20","3107","101","53061","3.25"
"Spokane","16","902","Washington","6/19/20","791","111","53063","14.03"
"Stevens","0","16","Washington","6/19/20","15","1","53065","6.67"
"Thurston","4","209","Washington","6/19/20","183","26","53067","14.21"
"Wahkiakum","0","4","Washington","6/19/20","4","0","53069","0"
"Walla Walla","2","129","Washington","6/19/20","118","11","53071","9.32"
"Whatcom","5","474","Washington","6/19/20","436","38","53073","8.72"
"Whitman","0","28","Washington","6/19/20","27","1","53075","3.7"
"Yakima","112","5915","Washington","6/19/20","5129","786","53077","15.32"
"Barbour","0","11","West Virginia","6/19/20","10","1","54001","10"
"Berkeley","7","427","West Virginia","6/19/20","376","51","54003","13.56"
"Boone","0","20","West Virginia","6/19/20","17","3","54005","17.65"
"Braxton","0","3","West Virginia","6/19/20","3","0","54007","0"
"Brooke","0","6","West Virginia","6/19/20","5","1","54009","20"
"Cabell","1","80","West Virginia","6/19/20","72","8","54011","11.11"
"Calhoun","0","2","West Virginia","6/19/20","2","0","54013","0"
"Clay","0","10","West Virginia","6/19/20","8","2","54015","25"
"Fayette","0","56","West Virginia","6/19/20","54","2","54019","3.7"
"Gilmer","0","10","West Virginia","6/19/20","10","0","54021","0"
"Grant","0","16","West Virginia","6/19/20","16","0","54023","0"
"Greenbrier","4","42","West Virginia","6/19/20","11","31","54025","281.82"
"Hampshire","1","40","West Virginia","6/19/20","35","5","54027","14.29"
"Hancock","0","21","West Virginia","6/19/20","20","1","54029","5"
"Hardy","0","41","West Virginia","6/19/20","40","1","54031","2.5"
"Harrison","1","49","West Virginia","6/19/20","43","6","54033","13.95"
"Jackson","0","141","West Virginia","6/19/20","141","0","54035","0"
"Jefferson","1","215","West Virginia","6/19/20","205","10","54037","4.88"
"Kanawha","2","261","West Virginia","6/19/20","247","14","54039","5.67"
"Lewis","1","15","West Virginia","6/19/20","8","7","54041","87.5"
"Lincoln","0","5","West Virginia","6/19/20","5","0","54043","0"
"Logan","0","21","West Virginia","6/19/20","21","0","54045","0"
"Marion","0","53","West Virginia","6/19/20","53","0","54049","0"
"Marshall","0","37","West Virginia","6/19/20","37","0","54051","0"
"Mason","0","15","West Virginia","6/19/20","15","0","54053","0"
"McDowell","0","6","West Virginia","6/19/20","6","0","54047","0"
"Mercer","0","16","West Virginia","6/19/20","13","3","54055","23.08"
"Mineral","0","53","West Virginia","6/19/20","51","2","54057","3.92"
"Mingo","0","14","West Virginia","6/19/20","12","2","54059","16.67"
"Monongalia","1","149","West Virginia","6/19/20","142","7","54061","4.93"
"Monroe","0","9","West Virginia","6/19/20","9","0","54063","0"
"Morgan","0","20","West Virginia","6/19/20","19","1","54065","5.26"
"Nicholas","0","7","West Virginia","6/19/20","7","0","54067","0"
"Ohio","2","67","West Virginia","6/19/20","53","14","54069","26.42"
"Pendleton","0","13","West Virginia","6/19/20","13","0","54071","0"
"Pleasants","0","4","West Virginia","6/19/20","4","0","54073","0"
"Pocahontas","0","22","West Virginia","6/19/20","21","1","54075","4.76"
"Preston","3","43","West Virginia","6/19/20","24","19","54077","79.17"
"Putnam","0","41","West Virginia","6/19/20","42","-1","54079","-2.38"
"Raleigh","1","29","West Virginia","6/19/20","23","6","54081","26.09"
"Randolph","1","148","West Virginia","6/19/20","141","7","54083","4.96"
"Ritchie","0","2","West Virginia","6/19/20","2","0","54085","0"
"Roane","0","11","West Virginia","6/19/20","10","1","54087","10"
"Summers","0","1","West Virginia","6/19/20","1","0","54089","0"
"Taylor","0","13","West Virginia","6/19/20","10","3","54091","30"
"Tucker","0","5","West Virginia","6/19/20","5","0","54093","0"
"Tyler","0","3","West Virginia","6/19/20","3","0","54095","0"
"Upshur","1","13","West Virginia","6/19/20","7","6","54097","85.71"
"Wayne","0","106","West Virginia","6/19/20","104","2","54099","1.92"
"Wetzel","0","9","West Virginia","6/19/20","9","0","54103","0"
"Wirt","0","4","West Virginia","6/19/20","4","0","54105","0"
"Wood","0","56","West Virginia","6/19/20","55","1","54107","1.82"
"Wyoming","0","7","West Virginia","6/19/20","5","2","54109","40"
"Adams","0","10","Wisconsin","6/19/20","7","3","55001","42.86"
"Ashland","0","3","Wisconsin","6/19/20","3","0","55003","0"
"Barron","1","30","Wisconsin","6/19/20","24","6","55005","25"
"Bayfield","0","3","Wisconsin","6/19/20","3","0","55007","0"
"Brown","14","2538","Wisconsin","6/19/20","2442","96","55009","3.93"
"Buffalo","0","7","Wisconsin","6/19/20","7","0","55011","0"
"Burnett","0","2","Wisconsin","6/19/20","2","0","55013","0"
"Calumet","1","90","Wisconsin","6/19/20","84","6","55015","7.14"
"Chippewa","0","65","Wisconsin","6/19/20","64","1","55017","1.56"
"Clark","1","56","Wisconsin","6/19/20","50","6","55019","12"
"Columbia","1","63","Wisconsin","6/19/20","55","8","55021","14.55"
"Crawford","0","27","Wisconsin","6/19/20","26","1","55023","3.85"
"Dane","15","1034","Wisconsin","6/19/20","930","104","55025","11.18"
"Dodge","2","429","Wisconsin","6/19/20","415","14","55027","3.37"
"Door","0","40","Wisconsin","6/19/20","41","-1","55029","-2.44"
"Douglas","0","20","Wisconsin","6/19/20","20","0","55031","0"
"Dunn","0","29","Wisconsin","6/19/20","29","0","55033","0"
"Eau Claire","3","151","Wisconsin","6/19/20","130","21","55035","16.15"
"Florence","0","2","Wisconsin","6/19/20","2","0","55037","0"
"Fond du Lac","4","278","Wisconsin","6/19/20","253","25","55039","9.88"
"Forest","0","34","Wisconsin","6/19/20","34","0","55041","0"
"Grant","2","114","Wisconsin","6/19/20","103","11","55043","10.68"
"Green","0","78","Wisconsin","6/19/20","75","3","55045","4"
"Green Lake","0","24","Wisconsin","6/19/20","24","0","55047","0"
"Iowa","0","18","Wisconsin","6/19/20","16","2","55049","12.5"
"Iron","0","2","Wisconsin","6/19/20","2","0","55051","0"
"Jackson","0","24","Wisconsin","6/19/20","21","3","55053","14.29"
"Jefferson","2","168","Wisconsin","6/19/20","152","16","55055","10.53"
"Juneau","0","27","Wisconsin","6/19/20","24","3","55057","12.5"
"Kenosha","9","1400","Wisconsin","6/19/20","1336","64","55059","4.79"
"Kewaunee","1","42","Wisconsin","6/19/20","37","5","55061","13.51"
"La Crosse","15","203","Wisconsin","6/19/20","100","103","55063","103"
"Lafayette","2","49","Wisconsin","6/19/20","38","11","55065","28.95"
"Langlade","0","7","Wisconsin","6/19/20","5","2","55067","40"
"Lincoln","0","8","Wisconsin","6/19/20","7","1","55069","14.29"
"Manitowoc","2","58","Wisconsin","6/19/20","42","16","55071","38.1"
"Marathon","3","101","Wisconsin","6/19/20","80","21","55073","26.25"
"Marinette","1","42","Wisconsin","6/19/20","37","5","55075","13.51"
"Marquette","0","9","Wisconsin","6/19/20","9","0","55077","0"
"Menominee","0","4","Wisconsin","6/19/20","3","1","55078","33.33"
"Milwaukee","106","10049","Wisconsin","6/19/20","9310","739","55079","7.94"
"Monroe","2","40","Wisconsin","6/19/20","29","11","55081","37.93"
"Oconto","0","46","Wisconsin","6/19/20","43","3","55083","6.98"
"Oneida","0","17","Wisconsin","6/19/20","14","3","55085","21.43"
"Outagamie","8","377","Wisconsin","6/19/20","318","59","55087","18.55"
"Ozaukee","2","201","Wisconsin","6/19/20","188","13","55089","6.91"
"Pepin","0","1","Wisconsin","6/19/20","1","0","55091","0"
"Pierce","1","57","Wisconsin","6/19/20","51","6","55093","11.76"
"Polk","0","39","Wisconsin","6/19/20","36","3","55095","8.33"
"Portage","3","87","Wisconsin","6/19/20","68","19","55097","27.94"
"Price","0","2","Wisconsin","6/19/20","2","0","55099","0"
"Racine","13","2066","Wisconsin","6/19/20","1975","91","55101","4.61"
"Richland","0","15","Wisconsin","6/19/20","14","1","55103","7.14"
"Rock","5","777","Wisconsin","6/19/20","744","33","55105","4.44"
"Rusk","0","10","Wisconsin","6/19/20","9","1","55107","11.11"
"Sauk","1","90","Wisconsin","6/19/20","84","6","55111","7.14"
"Sawyer","0","9","Wisconsin","6/19/20","9","0","55113","0"
"Shawano","1","66","Wisconsin","6/19/20","62","4","55115","6.45"
"Sheboygan","6","176","Wisconsin","6/19/20","137","39","55117","28.47"
"St. Croix","2","122","Wisconsin","6/19/20","110","12","55109","10.91"
"Taylor","1","8","Wisconsin","6/19/20","2","6","55119","300"
"Trempealeau","5","86","Wisconsin","6/19/20","49","37","55121","75.51"
"Vernon","1","29","Wisconsin","6/19/20","23","6","55123","26.09"
"Vilas","0","10","Wisconsin","6/19/20","8","2","55125","25"
"Walworth","3","488","Wisconsin","6/19/20","469","19","55127","4.05"
"Washburn","0","4","Wisconsin","6/19/20","3","1","55129","33.33"
"Washington","3","307","Wisconsin","6/19/20","289","18","55131","6.23"
"Waukesha","13","972","Wisconsin","6/19/20","884","88","55133","9.95"
"Waupaca","3","87","Wisconsin","6/19/20","66","21","55135","31.82"
"Waushara","0","19","Wisconsin","6/19/20","16","3","55137","18.75"
"Winnebago","13","579","Wisconsin","6/19/20","485","94","55139","19.38"
"Wood","2","29","Wisconsin","6/19/20","16","13","55141","81.25"
"Albany","0","28","Wyoming","6/19/20","25","3","56001","12"
"Big Horn","0","11","Wyoming","6/19/20","10","1","56003","10"
"Campbell","1","46","Wyoming","6/19/20","40","6","56005","15"
"Carbon","0","22","Wyoming","6/19/20","20","2","56007","10"
"Converse","0","24","Wyoming","6/19/20","24","0","56009","0"
"Crook","0","6","Wyoming","6/19/20","5","1","56011","20"
"Fremont","3","326","Wyoming","6/19/20","303","23","56013","7.59"
"Goshen","0","5","Wyoming","6/19/20","5","0","56015","0"
"Hot Springs","0","12","Wyoming","6/19/20","12","0","56017","0"
"Johnson","0","19","Wyoming","6/19/20","18","1","56019","5.56"
"Laramie","2","204","Wyoming","6/19/20","191","13","56021","6.81"
"Lincoln","0","15","Wyoming","6/19/20","15","0","56023","0"
"Natrona","1","95","Wyoming","6/19/20","87","8","56025","9.2"
"Niobrara","0","2","Wyoming","6/19/20","2","0","56027","0"
"Park","1","9","Wyoming","6/19/20","3","6","56029","200"
"Platte","0","1","Wyoming","6/19/20","1","0","56031","0"
"Sheridan","0","19","Wyoming","6/19/20","19","0","56033","0"
"Sublette","0","4","Wyoming","6/19/20","3","1","56035","33.33"
"Sweetwater","1","48","Wyoming","6/19/20","38","10","56037","26.32"
"Teton","1","109","Wyoming","6/19/20","104","5","56039","4.81"
"Uinta","9","128","Wyoming","6/19/20","62","66","56041","106.45"
"Washakie","0","39","Wyoming","6/19/20","39","0","56043","0"
"Weston","0","1","Wyoming","6/19/20","1","0","56045","0"
